HydroGp,Species,time,col,TCI,row,value,Year,reference,diff
Group 1,BB,-1.5,2,14,1,3,2015,7,-4
Group 1,BB,-1.5,2,14,2,8,2015,11,-3
Group 1,BB,-1.5,2,14,3,9,2015,6,3
Group 1,BB,-1.5,2,14,4,7,2015,4,3
Group 1,BB,-1.5,2,14,5,8,2015,9,-1
Group 1,BB,-1.5,2,14,6,7,2015,7,0
Group 1,BB,-1.5,2,14,7,9,2015,5,4
Group 1,BB,-1.5,2,14,8,7,2015,13,-6
Group 1,BB,-1.5,2,14,9,12,2015,7,5
Group 1,BB,-1.5,2,14,10,3,2015,8,-5
Group 1,BB,-1.5,2,14,11,8,2015,4,4
Group 1,BB,-1.5,2,14,12,7,2015,7,0
Group 1,BB,-1.5,2,14,13,6,2015,6,0
Group 1,BB,-1.5,2,14,14,8,2015,5,3
Group 1,BB,-1.5,2,14,15,7,2015,7,0
Group 1,BB,-1.5,2,14,16,11,2015,8,3
Group 1,BB,-1.5,2,14,17,8,2015,6,2
Group 1,BB,-1.5,2,14,18,7,2015,6,1
Group 1,BB,-1.5,2,14,19,6,2015,8,-2
Group 1,BB,-1.5,2,14,20,9,2015,3,6
Group 1,BB,-1.5,2,14,21,10,2015,11,-1
Group 1,BB,-1.5,2,14,22,6,2015,5,1
Group 1,BB,-1.5,2,14,23,6,2015,7,-1
Group 1,BB,-1.5,2,14,24,7,2015,6,1
Group 1,BB,-1.5,2,14,25,8,2015,8,0
Group 1,BB,-1.5,2,14,26,5,2015,8,-3
Group 1,BB,-1.5,2,14,27,8,2015,8,0
Group 1,BB,-1.5,2,14,28,6,2015,8,-2
Group 1,BB,-1.5,2,14,29,8,2015,9,-1
Group 1,BB,-1.5,2,14,30,11,2015,10,1
Group 1,BB,-1.5,2,14,31,6,2015,6,0
Group 1,BB,-1.5,2,14,32,8,2015,5,3
Group 1,BB,-1.5,2,14,33,10,2015,8,2
Group 1,BB,-1.5,2,14,34,10,2015,8,2
Group 1,BB,-1.5,2,14,35,8,2015,8,0
Group 1,BB,-1.5,2,14,36,6,2015,6,0
Group 1,BB,-1.5,2,14,37,6,2015,5,1
Group 1,BB,-1.5,2,14,38,6,2015,5,1
Group 1,BB,-1.5,2,14,39,8,2015,7,1
Group 1,BB,-1.5,2,14,40,7,2015,7,0
Group 1,BB,-1.5,2,14,41,7,2015,5,2
Group 1,BB,-1.5,2,14,42,7,2015,7,0
Group 1,BB,-1.5,2,14,43,11,2015,6,5
Group 1,BB,-1.5,2,14,44,9,2015,4,5
Group 1,BB,-1.5,2,14,45,8,2015,7,1
Group 1,BB,-1.5,2,14,46,8,2015,7,1
Group 1,BB,-1.5,2,14,47,5,2015,3,2
Group 1,BB,-1.5,2,14,48,7,2015,7,0
Group 1,BB,-1.5,2,14,49,6,2015,3,3
Group 1,BB,-1.5,2,14,50,7,2015,5,2
Group 1,BB,-1.5,2,14,51,7,2015,3,4
Group 1,BB,-1.5,2,14,52,8,2015,8,0
Group 1,BB,-1.5,2,14,53,7,2015,3,4
Group 1,BB,-1.5,2,14,54,7,2015,6,1
Group 1,BB,-1.5,2,14,55,6,2015,3,3
Group 1,BB,-1.5,2,14,56,9,2015,8,1
Group 1,BB,-1.5,2,14,57,7,2015,4,3
Group 1,BB,-1.5,2,14,58,5,2015,10,-5
Group 1,BB,-1.5,2,14,59,5,2015,6,-1
Group 1,BB,-1.5,2,14,60,6,2015,9,-3
Group 1,BB,-1.5,2,14,61,8,2015,7,1
Group 1,BB,-1.5,2,14,62,8,2015,4,4
Group 1,BB,-1.5,2,14,63,9,2015,10,-1
Group 1,BB,-1.5,2,14,64,6,2015,2,4
Group 1,BB,-1.5,2,14,65,11,2015,3,8
Group 1,BB,-1.5,2,14,66,12,2015,4,8
Group 1,BB,-1.5,2,14,67,8,2015,7,1
Group 1,BB,-1.5,2,14,68,9,2015,3,6
Group 1,BB,-1.5,2,14,69,8,2015,3,5
Group 1,BB,-1.5,2,14,70,8,2015,7,1
Group 1,BB,-1.5,2,14,71,9,2015,9,0
Group 1,BB,-1.5,2,14,72,7,2015,4,3
Group 1,BB,-1.5,2,14,73,9,2015,3,6
Group 1,BB,-1.5,2,14,74,11,2015,8,3
Group 1,BB,-1.5,2,14,75,11,2015,8,3
Group 1,BB,-1.5,2,14,76,4,2015,6,-2
Group 1,BB,-1.5,2,14,77,7,2015,8,-1
Group 1,BB,-1.5,2,14,78,8,2015,9,-1
Group 1,BB,-1.5,2,14,79,7,2015,10,-3
Group 1,BB,-1.5,2,14,80,7,2015,9,-2
Group 1,BB,-1.5,2,14,81,5,2015,10,-5
Group 1,BB,-1.5,2,14,82,8,2015,9,-1
Group 1,BB,-1.5,2,14,83,7,2015,8,-1
Group 1,BB,-1.5,2,14,84,6,2015,9,-3
Group 1,BB,-1.5,2,14,85,10,2015,7,3
Group 1,BB,-1.5,2,14,86,9,2015,7,2
Group 1,BB,-1.5,2,14,87,10,2015,5,5
Group 1,BB,-1.5,2,14,88,6,2015,8,-2
Group 1,BB,-1.5,2,14,89,5,2015,5,0
Group 1,BB,-1.5,2,14,90,6,2015,5,1
Group 1,BB,-1.5,2,14,91,5,2015,2,3
Group 1,BB,-1.5,2,14,92,8,2015,7,1
Group 1,BB,-1.5,2,14,93,6,2015,8,-2
Group 1,BB,-1.5,2,14,94,9,2015,1,8
Group 1,BB,-1.5,2,14,95,4,2015,6,-2
Group 1,BB,-1.5,2,14,96,5,2015,7,-2
Group 1,BB,-1.5,2,14,97,8,2015,7,1
Group 1,BB,-1.5,2,14,98,7,2015,7,0
Group 1,BB,-1.5,2,14,99,2,2015,6,-4
Group 1,BB,-1.5,2,14,100,10,2015,7,3
Group 1,BB,-1.5,2,14,101,5,2015,8,-3
Group 1,BB,-1.5,2,14,102,9,2015,7,2
Group 1,BB,-1.5,2,14,103,11,2015,4,7
Group 1,BB,-1.5,2,14,104,8,2015,5,3
Group 1,BB,-1.5,2,14,105,7,2015,9,-2
Group 1,BB,-1.5,2,14,106,7,2015,7,0
Group 1,BB,-1.5,2,14,107,6,2015,5,1
Group 1,BB,-1.5,2,14,108,7,2015,12,-5
Group 1,BB,-1.5,2,14,109,7,2015,11,-4
Group 1,BB,-1.5,2,14,110,8,2015,6,2
Group 1,BB,-1.5,2,14,111,9,2015,7,2
Group 1,BB,-1.5,2,14,112,3,2015,9,-6
Group 1,BB,-1.5,2,14,113,8,2015,5,3
Group 1,BB,-1.5,2,14,114,9,2015,6,3
Group 1,BB,-1.5,2,14,115,5,2015,8,-3
Group 1,BB,-1.5,2,14,116,10,2015,9,1
Group 1,BB,-1.5,2,14,117,7,2015,6,1
Group 1,BB,-1.5,2,14,118,8,2015,7,1
Group 1,BB,-1.5,2,14,119,7,2015,5,2
Group 1,BB,-1.5,2,14,120,7,2015,6,1
Group 1,BB,-1.5,2,14,121,6,2015,7,-1
Group 1,BB,-1.5,2,14,122,6,2015,5,1
Group 1,BB,-1.5,2,14,123,6,2015,7,-1
Group 1,BB,-1.5,2,14,124,8,2015,5,3
Group 1,BB,-1.5,2,14,125,6,2015,7,-1
Group 1,BB,-1.5,2,14,126,7,2015,6,1
Group 1,BB,-1.5,2,14,127,4,2015,8,-4
Group 1,BB,-1.5,2,14,128,6,2015,5,1
Group 1,BB,-1.5,2,14,129,8,2015,9,-1
Group 1,BB,-1.5,2,14,130,8,2015,7,1
Group 1,BB,-1.5,2,14,131,7,2015,10,-3
Group 1,BB,-1.5,2,14,132,10,2015,9,1
Group 1,BB,-1.5,2,14,133,10,2015,8,2
Group 1,BB,-1.5,2,14,134,7,2015,9,-2
Group 1,BB,-1.5,2,14,135,4,2015,8,-4
Group 1,BB,-1.5,2,14,136,9,2015,4,5
Group 1,BB,-1.5,2,14,137,11,2015,1,10
Group 1,BB,-1.5,2,14,138,9,2015,8,1
Group 1,BB,-1.5,2,14,139,7,2015,9,-2
Group 1,BB,-1.5,2,14,140,7,2015,5,2
Group 1,BB,-1.5,2,14,141,8,2015,10,-2
Group 1,BB,-1.5,2,14,142,8,2015,8,0
Group 1,BB,-1.5,2,14,143,7,2015,3,4
Group 1,BB,-1.5,2,14,144,9,2015,5,4
Group 1,BB,-1.5,2,14,145,4,2015,6,-2
Group 1,BB,-1.5,2,14,146,8,2015,10,-2
Group 1,BB,-1.5,2,14,147,7,2015,7,0
Group 1,BB,-1.5,2,14,148,10,2015,7,3
Group 1,BB,-1.5,2,14,149,9,2015,9,0
Group 1,BB,-1.5,2,14,150,6,2015,5,1
Group 1,BB,-1.5,2,14,151,6,2015,7,-1
Group 1,BB,-1.5,2,14,152,9,2015,4,5
Group 1,BB,-1.5,2,14,153,6,2015,7,-1
Group 1,BB,-1.5,2,14,154,9,2015,7,2
Group 1,BB,-1.5,2,14,155,9,2015,6,3
Group 1,BB,-1.5,2,14,156,6,2015,9,-3
Group 1,BB,-1.5,2,14,157,11,2015,5,6
Group 1,BB,-1.5,2,14,158,9,2015,8,1
Group 1,BB,-1.5,2,14,159,5,2015,2,3
Group 1,BB,-1.5,2,14,160,8,2015,8,0
Group 1,BB,-1.5,2,14,161,8,2015,7,1
Group 1,BB,-1.5,2,14,162,9,2015,6,3
Group 1,BB,-1.5,2,14,163,9,2015,9,0
Group 1,BB,-1.5,2,14,164,7,2015,5,2
Group 1,BB,-1.5,2,14,165,9,2015,4,5
Group 1,BB,-1.5,2,14,166,8,2015,3,5
Group 1,BB,-1.5,2,14,167,8,2015,9,-1
Group 1,BB,-1.5,2,14,168,7,2015,2,5
Group 1,BB,-1.5,2,14,169,8,2015,7,1
Group 1,BB,-1.5,2,14,170,5,2015,3,2
Group 1,BB,-1.5,2,14,171,10,2015,7,3
Group 1,BB,-1.5,2,14,172,7,2015,10,-3
Group 1,BB,-1.5,2,14,173,5,2015,8,-3
Group 1,BB,-1.5,2,14,174,10,2015,5,5
Group 1,BB,-1.5,2,14,175,9,2015,7,2
Group 1,BB,-1.5,2,14,176,5,2015,11,-6
Group 1,BB,-1.5,2,14,177,8,2015,8,0
Group 1,BB,-1.5,2,14,178,9,2015,10,-1
Group 1,BB,-1.5,2,14,179,9,2015,6,3
Group 1,BB,-1.5,2,14,180,7,2015,5,2
Group 1,BB,-1.5,2,14,181,5,2015,8,-3
Group 1,BB,-1.5,2,14,182,8,2015,5,3
Group 1,BB,-1.5,2,14,183,5,2015,6,-1
Group 1,BB,-1.5,2,14,184,6,2015,11,-5
Group 1,BB,-1.5,2,14,185,6,2015,7,-1
Group 1,BB,-1.5,2,14,186,11,2015,7,4
Group 1,BB,-1.5,2,14,187,5,2015,6,-1
Group 1,BB,-1.5,2,14,188,5,2015,8,-3
Group 1,BB,-1.5,2,14,189,7,2015,9,-2
Group 1,BB,-1.5,2,14,190,9,2015,5,4
Group 1,BB,-1.5,2,14,191,9,2015,5,4
Group 1,BB,-1.5,2,14,192,7,2015,3,4
Group 1,BB,-1.5,2,14,193,7,2015,9,-2
Group 1,BB,-1.5,2,14,194,4,2015,9,-5
Group 1,BB,-1.5,2,14,195,11,2015,6,5
Group 1,BB,-1.5,2,14,196,8,2015,6,2
Group 1,BB,-1.5,2,14,197,11,2015,5,6
Group 1,BB,-1.5,2,14,198,7,2015,6,1
Group 1,BB,-1.5,2,14,199,5,2015,5,0
Group 1,BB,-1.5,2,14,200,9,2015,5,4
Group 1,BB,-1.5,2,14,201,7,2015,6,1
Group 1,BB,-1.5,2,14,202,8,2015,10,-2
Group 1,BB,-1.5,2,14,203,11,2015,6,5
Group 1,BB,-1.5,2,14,204,10,2015,9,1
Group 1,BB,-1.5,2,14,205,9,2015,9,0
Group 1,BB,-1.5,2,14,206,7,2015,4,3
Group 1,BB,-1.5,2,14,207,8,2015,8,0
Group 1,BB,-1.5,2,14,208,10,2015,5,5
Group 1,BB,-1.5,2,14,209,9,2015,10,-1
Group 1,BB,-1.5,2,14,210,6,2015,7,-1
Group 1,BB,-1.5,2,14,211,7,2015,6,1
Group 1,BB,-1.5,2,14,212,9,2015,10,-1
Group 1,BB,-1.5,2,14,213,7,2015,4,3
Group 1,BB,-1.5,2,14,214,11,2015,12,-1
Group 1,BB,-1.5,2,14,215,10,2015,9,1
Group 1,BB,-1.5,2,14,216,9,2015,8,1
Group 1,BB,-1.5,2,14,217,9,2015,8,1
Group 1,BB,-1.5,2,14,218,6,2015,7,-1
Group 1,BB,-1.5,2,14,219,6,2015,9,-3
Group 1,BB,-1.5,2,14,220,6,2015,9,-3
Group 1,BB,-1.5,2,14,221,8,2015,6,2
Group 1,BB,-1.5,2,14,222,11,2015,10,1
Group 1,BB,-1.5,2,14,223,6,2015,3,3
Group 1,BB,-1.5,2,14,224,6,2015,7,-1
Group 1,BB,-1.5,2,14,225,5,2015,7,-2
Group 1,BB,-1.5,2,14,226,6,2015,5,1
Group 1,BB,-1.5,2,14,227,6,2015,5,1
Group 1,BB,-1.5,2,14,228,7,2015,8,-1
Group 1,BB,-1.5,2,14,229,10,2015,5,5
Group 1,BB,-1.5,2,14,230,7,2015,6,1
Group 1,BB,-1.5,2,14,231,8,2015,5,3
Group 1,BB,-1.5,2,14,232,7,2015,13,-6
Group 1,BB,-1.5,2,14,233,6,2015,5,1
Group 1,BB,-1.5,2,14,234,7,2015,8,-1
Group 1,BB,-1.5,2,14,235,8,2015,6,2
Group 1,BB,-1.5,2,14,236,11,2015,5,6
Group 1,BB,-1.5,2,14,237,8,2015,9,-1
Group 1,BB,-1.5,2,14,238,8,2015,8,0
Group 1,BB,-1.5,2,14,239,9,2015,6,3
Group 1,BB,-1.5,2,14,240,11,2015,6,5
Group 1,BB,-1.5,2,14,241,6,2015,9,-3
Group 1,BB,-1.5,2,14,242,8,2015,9,-1
Group 1,BB,-1.5,2,14,243,8,2015,6,2
Group 1,BB,-1.5,2,14,244,7,2015,9,-2
Group 1,BB,-1.5,2,14,245,6,2015,3,3
Group 1,BB,-1.5,2,14,246,5,2015,7,-2
Group 1,BB,-1.5,2,14,247,6,2015,8,-2
Group 1,BB,-1.5,2,14,248,9,2015,4,5
Group 1,BB,-1.5,2,14,249,7,2015,7,0
Group 1,BB,-1.5,2,14,250,6,2015,9,-3
Group 1,BB,-1.5,2,14,251,7,2015,8,-1
Group 1,BB,-1.5,2,14,252,10,2015,5,5
Group 1,BB,-1.5,2,14,253,7,2015,7,0
Group 1,BB,-1.5,2,14,254,10,2015,6,4
Group 1,BB,-1.5,2,14,255,6,2015,5,1
Group 1,BB,-1.5,2,14,256,9,2015,7,2
Group 1,BB,-1.5,2,14,257,8,2015,8,0
Group 1,BB,-1.5,2,14,258,7,2015,5,2
Group 1,BB,-1.5,2,14,259,8,2015,7,1
Group 1,BB,-1.5,2,14,260,9,2015,6,3
Group 1,BB,-1.5,2,14,261,7,2015,7,0
Group 1,BB,-1.5,2,14,262,9,2015,5,4
Group 1,BB,-1.5,2,14,263,8,2015,8,0
Group 1,BB,-1.5,2,14,264,9,2015,12,-3
Group 1,BB,-1.5,2,14,265,8,2015,7,1
Group 1,BB,-1.5,2,14,266,4,2015,9,-5
Group 1,BB,-1.5,2,14,267,7,2015,7,0
Group 1,BB,-1.5,2,14,268,4,2015,10,-6
Group 1,BB,-1.5,2,14,269,4,2015,10,-6
Group 1,BB,-1.5,2,14,270,10,2015,8,2
Group 1,BB,-1.5,2,14,271,9,2015,7,2
Group 1,BB,-1.5,2,14,272,12,2015,5,7
Group 1,BB,-1.5,2,14,273,5,2015,2,3
Group 1,BB,-1.5,2,14,274,5,2015,10,-5
Group 1,BB,-1.5,2,14,275,11,2015,9,2
Group 1,BB,-1.5,2,14,276,10,2015,8,2
Group 1,BB,-1.5,2,14,277,6,2015,5,1
Group 1,BB,-1.5,2,14,278,6,2015,10,-4
Group 1,BB,-1.5,2,14,279,8,2015,5,3
Group 1,BB,-1.5,2,14,280,4,2015,5,-1
Group 1,BB,-1.5,2,14,281,7,2015,10,-3
Group 1,BB,-1.5,2,14,282,4,2015,6,-2
Group 1,BB,-1.5,2,14,283,7,2015,2,5
Group 1,BB,-1.5,2,14,284,7,2015,3,4
Group 1,BB,-1.5,2,14,285,8,2015,10,-2
Group 1,BB,-1.5,2,14,286,7,2015,9,-2
Group 1,BB,-1.5,2,14,287,6,2015,6,0
Group 1,BB,-1.5,2,14,288,1,2015,7,-6
Group 1,BB,-1.5,2,14,289,6,2015,7,-1
Group 1,BB,-1.5,2,14,290,7,2015,9,-2
Group 1,BB,-1.5,2,14,291,9,2015,9,0
Group 1,BB,-1.5,2,14,292,8,2015,7,1
Group 1,BB,-1.5,2,14,293,8,2015,7,1
Group 1,BB,-1.5,2,14,294,9,2015,8,1
Group 1,BB,-1.5,2,14,295,7,2015,3,4
Group 1,BB,-1.5,2,14,296,8,2015,9,-1
Group 1,BB,-1.5,2,14,297,11,2015,6,5
Group 1,BB,-1.5,2,14,298,6,2015,8,-2
Group 1,BB,-1.5,2,14,299,7,2015,6,1
Group 1,BB,-1.5,2,14,300,6,2015,8,-2
Group 1,BB,-1.5,2,14,301,8,2015,9,-1
Group 1,BB,-1.5,2,14,302,9,2015,4,5
Group 1,BB,-1.5,2,14,303,9,2015,9,0
Group 1,BB,-1.5,2,14,304,8,2015,9,-1
Group 1,BB,-1.5,2,14,305,8,2015,8,0
Group 1,BB,-1.5,2,14,306,8,2015,10,-2
Group 1,BB,-1.5,2,14,307,5,2015,5,0
Group 1,BB,-1.5,2,14,308,10,2015,9,1
Group 1,BB,-1.5,2,14,309,6,2015,8,-2
Group 1,BB,-1.5,2,14,310,10,2015,7,3
Group 1,BB,-1.5,2,14,311,7,2015,9,-2
Group 1,BB,-1.5,2,14,312,7,2015,6,1
Group 1,BB,-1.5,2,14,313,10,2015,11,-1
Group 1,BB,-1.5,2,14,314,9,2015,12,-3
Group 1,BB,-1.5,2,14,315,8,2015,8,0
Group 1,BB,-1.5,2,14,316,5,2015,10,-5
Group 1,BB,-1.5,2,14,317,9,2015,8,1
Group 1,BB,-1.5,2,14,318,7,2015,7,0
Group 1,BB,-1.5,2,14,319,9,2015,9,0
Group 1,BB,-1.5,2,14,320,8,2015,7,1
Group 1,BB,-1.5,2,14,321,6,2015,8,-2
Group 1,BB,-1.5,2,14,322,9,2015,8,1
Group 1,BB,-1.5,2,14,323,6,2015,13,-7
Group 1,BB,-1.5,2,14,324,8,2015,10,-2
Group 1,BB,-1.5,2,14,325,9,2015,6,3
Group 1,BB,-1.5,2,14,326,13,2015,8,5
Group 1,BB,-1.5,2,14,327,5,2015,5,0
Group 1,BB,-1.5,2,14,328,5,2015,9,-4
Group 1,BB,-1.5,2,14,329,12,2015,5,7
Group 1,BB,-1.5,2,14,330,7,2015,10,-3
Group 1,BB,-1.5,2,14,331,8,2015,7,1
Group 1,BB,-1.5,2,14,332,10,2015,9,1
Group 1,BB,-1.5,2,14,333,8,2015,8,0
Group 1,BB,-1.5,2,14,334,9,2015,5,4
Group 1,BB,-1.5,2,14,335,10,2015,8,2
Group 1,BB,-1.5,2,14,336,10,2015,7,3
Group 1,BB,-1.5,2,14,337,9,2015,6,3
Group 1,BB,-1.5,2,14,338,9,2015,7,2
Group 1,BB,-1.5,2,14,339,6,2015,4,2
Group 1,BB,-1.5,2,14,340,11,2015,11,0
Group 1,BB,-1.5,2,14,341,8,2015,12,-4
Group 1,BB,-1.5,2,14,342,8,2015,7,1
Group 1,BB,-1.5,2,14,343,7,2015,7,0
Group 1,BB,-1.5,2,14,344,5,2015,5,0
Group 1,BB,-1.5,2,14,345,8,2015,9,-1
Group 1,BB,-1.5,2,14,346,6,2015,8,-2
Group 1,BB,-1.5,2,14,347,9,2015,8,1
Group 1,BB,-1.5,2,14,348,6,2015,7,-1
Group 1,BB,-1.5,2,14,349,8,2015,6,2
Group 1,BB,-1.5,2,14,350,1,2015,8,-7
Group 1,BB,-1.5,2,14,351,11,2015,7,4
Group 1,BB,-1.5,2,14,352,10,2015,7,3
Group 1,BB,-1.5,2,14,353,9,2015,4,5
Group 1,BB,-1.5,2,14,354,9,2015,4,5
Group 1,BB,-1.5,2,14,355,8,2015,5,3
Group 1,BB,-1.5,2,14,356,8,2015,7,1
Group 1,BB,-1.5,2,14,357,9,2015,10,-1
Group 1,BB,-1.5,2,14,358,11,2015,11,0
Group 1,BB,-1.5,2,14,359,10,2015,9,1
Group 1,BB,-1.5,2,14,360,9,2015,3,6
Group 1,BB,-1.5,2,14,361,6,2015,8,-2
Group 1,BB,-1.5,2,14,362,7,2015,7,0
Group 1,BB,-1.5,2,14,363,8,2015,6,2
Group 1,BB,-1.5,2,14,364,7,2015,5,2
Group 1,BB,-1.5,2,14,365,7,2015,12,-5
Group 1,BB,-1.5,2,14,366,8,2015,6,2
Group 1,BB,-1.5,2,14,367,8,2015,7,1
Group 1,BB,-1.5,2,14,368,3,2015,8,-5
Group 1,BB,-1.5,2,14,369,9,2015,11,-2
Group 1,BB,-1.5,2,14,370,7,2015,8,-1
Group 1,BB,-1.5,2,14,371,7,2015,6,1
Group 1,BB,-1.5,2,14,372,4,2015,3,1
Group 1,BB,-1.5,2,14,373,6,2015,7,-1
Group 1,BB,-1.5,2,14,374,8,2015,1,7
Group 1,BB,-1.5,2,14,375,7,2015,5,2
Group 1,BB,-1.5,2,14,376,7,2015,7,0
Group 1,BB,-1.5,2,14,377,8,2015,10,-2
Group 1,BB,-1.5,2,14,378,9,2015,5,4
Group 1,BB,-1.5,2,14,379,6,2015,8,-2
Group 1,BB,-1.5,2,14,380,9,2015,6,3
Group 1,BB,-1.5,2,14,381,6,2015,9,-3
Group 1,BB,-1.5,2,14,382,8,2015,3,5
Group 1,BB,-1.5,2,14,383,7,2015,5,2
Group 1,BB,-1.5,2,14,384,10,2015,6,4
Group 1,BB,-1.5,2,14,385,9,2015,6,3
Group 1,BB,-1.5,2,14,386,9,2015,11,-2
Group 1,BB,-1.5,2,14,387,7,2015,8,-1
Group 1,BB,-1.5,2,14,388,9,2015,7,2
Group 1,BB,-1.5,2,14,389,5,2015,9,-4
Group 1,BB,-1.5,2,14,390,11,2015,4,7
Group 1,BB,-1.5,2,14,391,9,2015,5,4
Group 1,BB,-1.5,2,14,392,7,2015,2,5
Group 1,BB,-1.5,2,14,393,6,2015,11,-5
Group 1,BB,-1.5,2,14,394,4,2015,6,-2
Group 1,BB,-1.5,2,14,395,5,2015,7,-2
Group 1,BB,-1.5,2,14,396,6,2015,7,-1
Group 1,BB,-1.5,2,14,397,6,2015,6,0
Group 1,BB,-1.5,2,14,398,7,2015,7,0
Group 1,BB,-1.5,2,14,399,5,2015,4,1
Group 1,BB,-1.5,2,14,400,7,2015,5,2
Group 1,BB,-1.5,2,14,401,10,2015,5,5
Group 1,BB,-1.5,2,14,402,9,2015,6,3
Group 1,BB,-1.5,2,14,403,6,2015,5,1
Group 1,BB,-1.5,2,14,404,5,2015,4,1
Group 1,BB,-1.5,2,14,405,9,2015,7,2
Group 1,BB,-1.5,2,14,406,7,2015,8,-1
Group 1,BB,-1.5,2,14,407,8,2015,9,-1
Group 1,BB,-1.5,2,14,408,6,2015,8,-2
Group 1,BB,-1.5,2,14,409,4,2015,10,-6
Group 1,BB,-1.5,2,14,410,8,2015,11,-3
Group 1,BB,-1.5,2,14,411,4,2015,9,-5
Group 1,BB,-1.5,2,14,412,7,2015,6,1
Group 1,BB,-1.5,2,14,413,8,2015,10,-2
Group 1,BB,-1.5,2,14,414,8,2015,7,1
Group 1,BB,-1.5,2,14,415,6,2015,5,1
Group 1,BB,-1.5,2,14,416,9,2015,6,3
Group 1,BB,-1.5,2,14,417,5,2015,5,0
Group 1,BB,-1.5,2,14,418,5,2015,8,-3
Group 1,BB,-1.5,2,14,419,4,2015,4,0
Group 1,BB,-1.5,2,14,420,7,2015,5,2
Group 1,BB,-1.5,2,14,421,10,2015,8,2
Group 1,BB,-1.5,2,14,422,10,2015,6,4
Group 1,BB,-1.5,2,14,423,7,2015,5,2
Group 1,BB,-1.5,2,14,424,8,2015,5,3
Group 1,BB,-1.5,2,14,425,9,2015,6,3
Group 1,BB,-1.5,2,14,426,6,2015,6,0
Group 1,BB,-1.5,2,14,427,4,2015,9,-5
Group 1,BB,-1.5,2,14,428,8,2015,8,0
Group 1,BB,-1.5,2,14,429,6,2015,11,-5
Group 1,BB,-1.5,2,14,430,10,2015,6,4
Group 1,BB,-1.5,2,14,431,7,2015,7,0
Group 1,BB,-1.5,2,14,432,12,2015,11,1
Group 1,BB,-1.5,2,14,433,10,2015,7,3
Group 1,BB,-1.5,2,14,434,7,2015,6,1
Group 1,BB,-1.5,2,14,435,8,2015,7,1
Group 1,BB,-1.5,2,14,436,6,2015,8,-2
Group 1,BB,-1.5,2,14,437,9,2015,8,1
Group 1,BB,-1.5,2,14,438,9,2015,3,6
Group 1,BB,-1.5,2,14,439,7,2015,6,1
Group 1,BB,-1.5,2,14,440,4,2015,6,-2
Group 1,BB,-1.5,2,14,441,6,2015,7,-1
Group 1,BB,-1.5,2,14,442,7,2015,10,-3
Group 1,BB,-1.5,2,14,443,8,2015,9,-1
Group 1,BB,-1.5,2,14,444,7,2015,5,2
Group 1,BB,-1.5,2,14,445,13,2015,9,4
Group 1,BB,-1.5,2,14,446,10,2015,8,2
Group 1,BB,-1.5,2,14,447,7,2015,3,4
Group 1,BB,-1.5,2,14,448,7,2015,7,0
Group 1,BB,-1.5,2,14,449,10,2015,6,4
Group 1,BB,-1.5,2,14,450,11,2015,5,6
Group 1,BB,-1.5,2,14,451,10,2015,7,3
Group 1,BB,-1.5,2,14,452,7,2015,6,1
Group 1,BB,-1.5,2,14,453,5,2015,11,-6
Group 1,BB,-1.5,2,14,454,9,2015,5,4
Group 1,BB,-1.5,2,14,455,4,2015,4,0
Group 1,BB,-1.5,2,14,456,9,2015,5,4
Group 1,BB,-1.5,2,14,457,10,2015,5,5
Group 1,BB,-1.5,2,14,458,6,2015,5,1
Group 1,BB,-1.5,2,14,459,8,2015,7,1
Group 1,BB,-1.5,2,14,460,10,2015,8,2
Group 1,BB,-1.5,2,14,461,9,2015,9,0
Group 1,BB,-1.5,2,14,462,10,2015,7,3
Group 1,BB,-1.5,2,14,463,7,2015,10,-3
Group 1,BB,-1.5,2,14,464,8,2015,6,2
Group 1,BB,-1.5,2,14,465,7,2015,8,-1
Group 1,BB,-1.5,2,14,466,8,2015,2,6
Group 1,BB,-1.5,2,14,467,7,2015,4,3
Group 1,BB,-1.5,2,14,468,7,2015,5,2
Group 1,BB,-1.5,2,14,469,8,2015,8,0
Group 1,BB,-1.5,2,14,470,8,2015,7,1
Group 1,BB,-1.5,2,14,471,4,2015,4,0
Group 1,BB,-1.5,2,14,472,5,2015,6,-1
Group 1,BB,-1.5,2,14,473,5,2015,6,-1
Group 1,BB,-1.5,2,14,474,7,2015,7,0
Group 1,BB,-1.5,2,14,475,6,2015,7,-1
Group 1,BB,-1.5,2,14,476,5,2015,10,-5
Group 1,BB,-1.5,2,14,477,8,2015,4,4
Group 1,BB,-1.5,2,14,478,7,2015,5,2
Group 1,BB,-1.5,2,14,479,10,2015,7,3
Group 1,BB,-1.5,2,14,480,9,2015,11,-2
Group 1,BB,-1.5,2,14,481,4,2015,4,0
Group 1,BB,-1.5,2,14,482,7,2015,9,-2
Group 1,BB,-1.5,2,14,483,7,2015,8,-1
Group 1,BB,-1.5,2,14,484,5,2015,4,1
Group 1,BB,-1.5,2,14,485,8,2015,10,-2
Group 1,BB,-1.5,2,14,486,8,2015,6,2
Group 1,BB,-1.5,2,14,487,10,2015,8,2
Group 1,BB,-1.5,2,14,488,8,2015,9,-1
Group 1,BB,-1.5,2,14,489,11,2015,5,6
Group 1,BB,-1.5,2,14,490,5,2015,9,-4
Group 1,BB,-1.5,2,14,491,10,2015,9,1
Group 1,BB,-1.5,2,14,492,6,2015,9,-3
Group 1,BB,-1.5,2,14,493,10,2015,10,0
Group 1,BB,-1.5,2,14,494,8,2015,7,1
Group 1,BB,-1.5,2,14,495,7,2015,6,1
Group 1,BB,-1.5,2,14,496,10,2015,11,-1
Group 1,BB,-1.5,2,14,497,7,2015,5,2
Group 1,BB,-1.5,2,14,498,10,2015,8,2
Group 1,BB,-1.5,2,14,499,7,2015,9,-2
Group 1,BB,-1.5,2,14,500,11,2015,10,1
Group 1,BB,-1.5,2,14,501,9,2015,5,4
Group 1,BB,-1.5,2,14,502,7,2015,0,7
Group 1,BB,-1.5,2,14,503,9,2015,13,-4
Group 1,BB,-1.5,2,14,504,5,2015,6,-1
Group 1,BB,-1.5,2,14,505,7,2015,0,7
Group 1,BB,-1.5,2,14,506,5,2015,1,4
Group 1,BB,-1.5,2,14,507,7,2015,6,1
Group 1,BB,-1.5,2,14,508,8,2015,6,2
Group 1,BB,-1.5,2,14,509,6,2015,8,-2
Group 1,BB,-1.5,2,14,510,10,2015,6,4
Group 1,BB,-1.5,2,14,511,8,2015,1,7
Group 1,BB,-1.5,2,14,512,8,2015,8,0
Group 1,BB,-1.5,2,14,513,11,2015,7,4
Group 1,BB,-1.5,2,14,514,9,2015,3,6
Group 1,BB,-1.5,2,14,515,7,2015,7,0
Group 1,BB,-1.5,2,14,516,9,2015,5,4
Group 1,BB,-1.5,2,14,517,9,2015,5,4
Group 1,BB,-1.5,2,14,518,8,2015,3,5
Group 1,BB,-1.5,2,14,519,9,2015,8,1
Group 1,BB,-1.5,2,14,520,8,2015,7,1
Group 1,BB,-1.5,2,14,521,12,2015,6,6
Group 1,BB,-1.5,2,14,522,7,2015,9,-2
Group 1,BB,-1.5,2,14,523,9,2015,7,2
Group 1,BB,-1.5,2,14,524,7,2015,9,-2
Group 1,BB,-1.5,2,14,525,8,2015,9,-1
Group 1,BB,-1.5,2,14,526,4,2015,3,1
Group 1,BB,-1.5,2,14,527,8,2015,4,4
Group 1,BB,-1.5,2,14,528,7,2015,7,0
Group 1,BB,-1.5,2,14,529,6,2015,6,0
Group 1,BB,-1.5,2,14,530,7,2015,4,3
Group 1,BB,-1.5,2,14,531,6,2015,5,1
Group 1,BB,-1.5,2,14,532,8,2015,5,3
Group 1,BB,-1.5,2,14,533,8,2015,8,0
Group 1,BB,-1.5,2,14,534,8,2015,8,0
Group 1,BB,-1.5,2,14,535,5,2015,7,-2
Group 1,BB,-1.5,2,14,536,8,2015,5,3
Group 1,BB,-1.5,2,14,537,9,2015,9,0
Group 1,BB,-1.5,2,14,538,10,2015,6,4
Group 1,BB,-1.5,2,14,539,7,2015,3,4
Group 1,BB,-1.5,2,14,540,7,2015,12,-5
Group 1,BB,-1.5,2,14,541,10,2015,7,3
Group 1,BB,-1.5,2,14,542,6,2015,7,-1
Group 1,BB,-1.5,2,14,543,8,2015,7,1
Group 1,BB,-1.5,2,14,544,8,2015,7,1
Group 1,BB,-1.5,2,14,545,8,2015,5,3
Group 1,BB,-1.5,2,14,546,8,2015,9,-1
Group 1,BB,-1.5,2,14,547,9,2015,5,4
Group 1,BB,-1.5,2,14,548,6,2015,6,0
Group 1,BB,-1.5,2,14,549,8,2015,6,2
Group 1,BB,-1.5,2,14,550,10,2015,7,3
Group 1,BB,-1.5,2,14,551,9,2015,5,4
Group 1,BB,-1.5,2,14,552,9,2015,6,3
Group 1,BB,-1.5,2,14,553,9,2015,6,3
Group 1,BB,-1.5,2,14,554,9,2015,8,1
Group 1,BB,-1.5,2,14,555,12,2015,8,4
Group 1,BB,-1.5,2,14,556,7,2015,5,2
Group 1,BB,-1.5,2,14,557,7,2015,11,-4
Group 1,BB,-1.5,2,14,558,9,2015,8,1
Group 1,BB,-1.5,2,14,559,9,2015,10,-1
Group 1,BB,-1.5,2,14,560,6,2015,6,0
Group 1,BB,-1.5,2,14,561,6,2015,6,0
Group 1,BB,-1.5,2,14,562,9,2015,10,-1
Group 1,BB,-1.5,2,14,563,10,2015,9,1
Group 1,BB,-1.5,2,14,564,7,2015,11,-4
Group 1,BB,-1.5,2,14,565,9,2015,7,2
Group 1,BB,-1.5,2,14,566,6,2015,11,-5
Group 1,BB,-1.5,2,14,567,7,2015,8,-1
Group 1,BB,-1.5,2,14,568,7,2015,2,5
Group 1,BB,-1.5,2,14,569,7,2015,6,1
Group 1,BB,-1.5,2,14,570,10,2015,8,2
Group 1,BB,-1.5,2,14,571,9,2015,4,5
Group 1,BB,-1.5,2,14,572,9,2015,8,1
Group 1,BB,-1.5,2,14,573,11,2015,5,6
Group 1,BB,-1.5,2,14,574,11,2015,6,5
Group 1,BB,-1.5,2,14,575,12,2015,8,4
Group 1,BB,-1.5,2,14,576,10,2015,10,0
Group 1,BB,-1.5,2,14,577,8,2015,10,-2
Group 1,BB,-1.5,2,14,578,5,2015,8,-3
Group 1,BB,-1.5,2,14,579,12,2015,7,5
Group 1,BB,-1.5,2,14,580,6,2015,4,2
Group 1,BB,-1.5,2,14,581,6,2015,8,-2
Group 1,BB,-1.5,2,14,582,10,2015,5,5
Group 1,BB,-1.5,2,14,583,8,2015,7,1
Group 1,BB,-1.5,2,14,584,5,2015,5,0
Group 1,BB,-1.5,2,14,585,6,2015,10,-4
Group 1,BB,-1.5,2,14,586,9,2015,11,-2
Group 1,BB,-1.5,2,14,587,4,2015,12,-8
Group 1,BB,-1.5,2,14,588,7,2015,10,-3
Group 1,BB,-1.5,2,14,589,8,2015,6,2
Group 1,BB,-1.5,2,14,590,10,2015,5,5
Group 1,BB,-1.5,2,14,591,7,2015,10,-3
Group 1,BB,-1.5,2,14,592,10,2015,5,5
Group 1,BB,-1.5,2,14,593,8,2015,6,2
Group 1,BB,-1.5,2,14,594,8,2015,9,-1
Group 1,BB,-1.5,2,14,595,7,2015,7,0
Group 1,BB,-1.5,2,14,596,8,2015,7,1
Group 1,BB,-1.5,2,14,597,10,2015,6,4
Group 1,BB,-1.5,2,14,598,9,2015,7,2
Group 1,BB,-1.5,2,14,599,8,2015,8,0
Group 1,BB,-1.5,2,14,600,4,2015,3,1
Group 1,BB,-1.5,2,14,601,5,2015,6,-1
Group 1,BB,-1.5,2,14,602,10,2015,9,1
Group 1,BB,-1.5,2,14,603,11,2015,7,4
Group 1,BB,-1.5,2,14,604,10,2015,7,3
Group 1,BB,-1.5,2,14,605,6,2015,8,-2
Group 1,BB,-1.5,2,14,606,9,2015,9,0
Group 1,BB,-1.5,2,14,607,8,2015,7,1
Group 1,BB,-1.5,2,14,608,13,2015,6,7
Group 1,BB,-1.5,2,14,609,4,2015,5,-1
Group 1,BB,-1.5,2,14,610,8,2015,7,1
Group 1,BB,-1.5,2,14,611,9,2015,9,0
Group 1,BB,-1.5,2,14,612,6,2015,9,-3
Group 1,BB,-1.5,2,14,613,5,2015,4,1
Group 1,BB,-1.5,2,14,614,8,2015,9,-1
Group 1,BB,-1.5,2,14,615,7,2015,6,1
Group 1,BB,-1.5,2,14,616,7,2015,6,1
Group 1,BB,-1.5,2,14,617,6,2015,5,1
Group 1,BB,-1.5,2,14,618,6,2015,6,0
Group 1,BB,-1.5,2,14,619,10,2015,9,1
Group 1,BB,-1.5,2,14,620,9,2015,8,1
Group 1,BB,-1.5,2,14,621,8,2015,5,3
Group 1,BB,-1.5,2,14,622,6,2015,10,-4
Group 1,BB,-1.5,2,14,623,6,2015,5,1
Group 1,BB,-1.5,2,14,624,10,2015,6,4
Group 1,BB,-1.5,2,14,625,4,2015,5,-1
Group 1,BB,-1.5,2,14,626,7,2015,8,-1
Group 1,BB,-1.5,2,14,627,7,2015,5,2
Group 1,BB,-1.5,2,14,628,4,2015,5,-1
Group 1,BB,-1.5,2,14,629,6,2015,5,1
Group 1,BB,-1.5,2,14,630,7,2015,4,3
Group 1,BB,-1.5,2,14,631,9,2015,7,2
Group 1,BB,-1.5,2,14,632,10,2015,7,3
Group 1,BB,-1.5,2,14,633,8,2015,5,3
Group 1,BB,-1.5,2,14,634,9,2015,9,0
Group 1,BB,-1.5,2,14,635,5,2015,7,-2
Group 1,BB,-1.5,2,14,636,8,2015,6,2
Group 1,BB,-1.5,2,14,637,11,2015,8,3
Group 1,BB,-1.5,2,14,638,8,2015,6,2
Group 1,BB,-1.5,2,14,639,6,2015,7,-1
Group 1,BB,-1.5,2,14,640,9,2015,14,-5
Group 1,BB,-1.5,2,14,641,9,2015,4,5
Group 1,BB,-1.5,2,14,642,2,2015,5,-3
Group 1,BB,-1.5,2,14,643,6,2015,8,-2
Group 1,BB,-1.5,2,14,644,8,2015,8,0
Group 1,BB,-1.5,2,14,645,4,2015,8,-4
Group 1,BB,-1.5,2,14,646,8,2015,8,0
Group 1,BB,-1.5,2,14,647,5,2015,6,-1
Group 1,BB,-1.5,2,14,648,8,2015,10,-2
Group 1,BB,-1.5,2,14,649,5,2015,5,0
Group 1,BB,-1.5,2,14,650,5,2015,6,-1
Group 1,BB,-1.5,2,14,651,8,2015,5,3
Group 1,BB,-1.5,2,14,652,6,2015,7,-1
Group 1,BB,-1.5,2,14,653,8,2015,6,2
Group 1,BB,-1.5,2,14,654,8,2015,4,4
Group 1,BB,-1.5,2,14,655,8,2015,9,-1
Group 1,BB,-1.5,2,14,656,7,2015,8,-1
Group 1,BB,-1.5,2,14,657,6,2015,5,1
Group 1,BB,-1.5,2,14,658,9,2015,10,-1
Group 1,BB,-1.5,2,14,659,9,2015,9,0
Group 1,BB,-1.5,2,14,660,4,2015,10,-6
Group 1,BB,-1.5,2,14,661,8,2015,6,2
Group 1,BB,-1.5,2,14,662,13,2015,2,11
Group 1,BB,-1.5,2,14,663,5,2015,7,-2
Group 1,BB,-1.5,2,14,664,7,2015,8,-1
Group 1,BB,-1.5,2,14,665,6,2015,8,-2
Group 1,BB,-1.5,2,14,666,9,2015,6,3
Group 1,BB,-1.5,2,14,667,8,2015,5,3
Group 1,BB,-1.5,2,14,668,8,2015,7,1
Group 1,BB,-1.5,2,14,669,9,2015,5,4
Group 1,BB,-1.5,2,14,670,7,2015,8,-1
Group 1,BB,-1.5,2,14,671,10,2015,7,3
Group 1,BB,-1.5,2,14,672,6,2015,6,0
Group 1,BB,-1.5,2,14,673,7,2015,5,2
Group 1,BB,-1.5,2,14,674,8,2015,8,0
Group 1,BB,-1.5,2,14,675,6,2015,7,-1
Group 1,BB,-1.5,2,14,676,8,2015,6,2
Group 1,BB,-1.5,2,14,677,6,2015,4,2
Group 1,BB,-1.5,2,14,678,8,2015,9,-1
Group 1,BB,-1.5,2,14,679,8,2015,9,-1
Group 1,BB,-1.5,2,14,680,6,2015,9,-3
Group 1,BB,-1.5,2,14,681,5,2015,7,-2
Group 1,BB,-1.5,2,14,682,7,2015,8,-1
Group 1,BB,-1.5,2,14,683,4,2015,7,-3
Group 1,BB,-1.5,2,14,684,5,2015,3,2
Group 1,BB,-1.5,2,14,685,11,2015,4,7
Group 1,BB,-1.5,2,14,686,8,2015,10,-2
Group 1,BB,-1.5,2,14,687,8,2015,5,3
Group 1,BB,-1.5,2,14,688,6,2015,9,-3
Group 1,BB,-1.5,2,14,689,10,2015,7,3
Group 1,BB,-1.5,2,14,690,9,2015,5,4
Group 1,BB,-1.5,2,14,691,5,2015,10,-5
Group 1,BB,-1.5,2,14,692,7,2015,8,-1
Group 1,BB,-1.5,2,14,693,7,2015,7,0
Group 1,BB,-1.5,2,14,694,11,2015,9,2
Group 1,BB,-1.5,2,14,695,7,2015,7,0
Group 1,BB,-1.5,2,14,696,7,2015,8,-1
Group 1,BB,-1.5,2,14,697,6,2015,11,-5
Group 1,BB,-1.5,2,14,698,6,2015,12,-6
Group 1,BB,-1.5,2,14,699,8,2015,7,1
Group 1,BB,-1.5,2,14,700,8,2015,6,2
Group 1,BB,-1.5,2,14,701,5,2015,3,2
Group 1,BB,-1.5,2,14,702,11,2015,8,3
Group 1,BB,-1.5,2,14,703,11,2015,8,3
Group 1,BB,-1.5,2,14,704,8,2015,6,2
Group 1,BB,-1.5,2,14,705,7,2015,7,0
Group 1,BB,-1.5,2,14,706,6,2015,4,2
Group 1,BB,-1.5,2,14,707,8,2015,6,2
Group 1,BB,-1.5,2,14,708,8,2015,6,2
Group 1,BB,-1.5,2,14,709,7,2015,6,1
Group 1,BB,-1.5,2,14,710,10,2015,7,3
Group 1,BB,-1.5,2,14,711,8,2015,7,1
Group 1,BB,-1.5,2,14,712,4,2015,9,-5
Group 1,BB,-1.5,2,14,713,6,2015,9,-3
Group 1,BB,-1.5,2,14,714,6,2015,9,-3
Group 1,BB,-1.5,2,14,715,8,2015,3,5
Group 1,BB,-1.5,2,14,716,13,2015,6,7
Group 1,BB,-1.5,2,14,717,8,2015,5,3
Group 1,BB,-1.5,2,14,718,10,2015,4,6
Group 1,BB,-1.5,2,14,719,5,2015,6,-1
Group 1,BB,-1.5,2,14,720,3,2015,10,-7
Group 1,BB,-1.5,2,14,721,9,2015,4,5
Group 1,BB,-1.5,2,14,722,6,2015,9,-3
Group 1,BB,-1.5,2,14,723,5,2015,7,-2
Group 1,BB,-1.5,2,14,724,9,2015,5,4
Group 1,BB,-1.5,2,14,725,8,2015,6,2
Group 1,BB,-1.5,2,14,726,7,2015,8,-1
Group 1,BB,-1.5,2,14,727,9,2015,10,-1
Group 1,BB,-1.5,2,14,728,12,2015,6,6
Group 1,BB,-1.5,2,14,729,5,2015,8,-3
Group 1,BB,-1.5,2,14,730,10,2015,8,2
Group 1,BB,-1.5,2,14,731,6,2015,2,4
Group 1,BB,-1.5,2,14,732,8,2015,7,1
Group 1,BB,-1.5,2,14,733,8,2015,7,1
Group 1,BB,-1.5,2,14,734,8,2015,11,-3
Group 1,BB,-1.5,2,14,735,9,2015,6,3
Group 1,BB,-1.5,2,14,736,8,2015,8,0
Group 1,BB,-1.5,2,14,737,7,2015,4,3
Group 1,BB,-1.5,2,14,738,9,2015,8,1
Group 1,BB,-1.5,2,14,739,10,2015,9,1
Group 1,BB,-1.5,2,14,740,5,2015,7,-2
Group 1,BB,-1.5,2,14,741,9,2015,6,3
Group 1,BB,-1.5,2,14,742,8,2015,8,0
Group 1,BB,-1.5,2,14,743,6,2015,10,-4
Group 1,BB,-1.5,2,14,744,8,2015,10,-2
Group 1,BB,-1.5,2,14,745,7,2015,6,1
Group 1,BB,-1.5,2,14,746,9,2015,7,2
Group 1,BB,-1.5,2,14,747,5,2015,8,-3
Group 1,BB,-1.5,2,14,748,11,2015,7,4
Group 1,BB,-1.5,2,14,749,8,2015,5,3
Group 1,BB,-1.5,2,14,750,7,2015,5,2
Group 1,BB,-1.5,2,14,751,6,2015,6,0
Group 1,BB,-1.5,2,14,752,4,2015,4,0
Group 1,BB,-1.5,2,14,753,11,2015,8,3
Group 1,BB,-1.5,2,14,754,7,2015,9,-2
Group 1,BB,-1.5,2,14,755,10,2015,5,5
Group 1,BB,-1.5,2,14,756,7,2015,5,2
Group 1,BB,-1.5,2,14,757,5,2015,5,0
Group 1,BB,-1.5,2,14,758,9,2015,9,0
Group 1,BB,-1.5,2,14,759,9,2015,5,4
Group 1,BB,-1.5,2,14,760,9,2015,6,3
Group 1,BB,-1.5,2,14,761,5,2015,9,-4
Group 1,BB,-1.5,2,14,762,5,2015,6,-1
Group 1,BB,-1.5,2,14,763,5,2015,9,-4
Group 1,BB,-1.5,2,14,764,7,2015,10,-3
Group 1,BB,-1.5,2,14,765,5,2015,5,0
Group 1,BB,-1.5,2,14,766,8,2015,7,1
Group 1,BB,-1.5,2,14,767,11,2015,4,7
Group 1,BB,-1.5,2,14,768,8,2015,6,2
Group 1,BB,-1.5,2,14,769,5,2015,10,-5
Group 1,BB,-1.5,2,14,770,9,2015,7,2
Group 1,BB,-1.5,2,14,771,6,2015,7,-1
Group 1,BB,-1.5,2,14,772,8,2015,8,0
Group 1,BB,-1.5,2,14,773,12,2015,5,7
Group 1,BB,-1.5,2,14,774,3,2015,5,-2
Group 1,BB,-1.5,2,14,775,5,2015,6,-1
Group 1,BB,-1.5,2,14,776,9,2015,8,1
Group 1,BB,-1.5,2,14,777,8,2015,7,1
Group 1,BB,-1.5,2,14,778,7,2015,5,2
Group 1,BB,-1.5,2,14,779,5,2015,4,1
Group 1,BB,-1.5,2,14,780,3,2015,5,-2
Group 1,BB,-1.5,2,14,781,10,2015,10,0
Group 1,BB,-1.5,2,14,782,7,2015,8,-1
Group 1,BB,-1.5,2,14,783,7,2015,9,-2
Group 1,BB,-1.5,2,14,784,4,2015,7,-3
Group 1,BB,-1.5,2,14,785,7,2015,5,2
Group 1,BB,-1.5,2,14,786,10,2015,7,3
Group 1,BB,-1.5,2,14,787,8,2015,9,-1
Group 1,BB,-1.5,2,14,788,7,2015,9,-2
Group 1,BB,-1.5,2,14,789,12,2015,7,5
Group 1,BB,-1.5,2,14,790,8,2015,5,3
Group 1,BB,-1.5,2,14,791,7,2015,8,-1
Group 1,BB,-1.5,2,14,792,6,2015,7,-1
Group 1,BB,-1.5,2,14,793,8,2015,6,2
Group 1,BB,-1.5,2,14,794,6,2015,7,-1
Group 1,BB,-1.5,2,14,795,7,2015,12,-5
Group 1,BB,-1.5,2,14,796,7,2015,10,-3
Group 1,BB,-1.5,2,14,797,8,2015,8,0
Group 1,BB,-1.5,2,14,798,6,2015,10,-4
Group 1,BB,-1.5,2,14,799,3,2015,6,-3
Group 1,BB,-1.5,2,14,800,9,2015,8,1
Group 1,BB,-1.5,2,14,801,7,2015,6,1
Group 1,BB,-1.5,2,14,802,7,2015,7,0
Group 1,BB,-1.5,2,14,803,8,2015,5,3
Group 1,BB,-1.5,2,14,804,6,2015,5,1
Group 1,BB,-1.5,2,14,805,4,2015,6,-2
Group 1,BB,-1.5,2,14,806,2,2015,8,-6
Group 1,BB,-1.5,2,14,807,10,2015,5,5
Group 1,BB,-1.5,2,14,808,6,2015,7,-1
Group 1,BB,-1.5,2,14,809,9,2015,7,2
Group 1,BB,-1.5,2,14,810,5,2015,6,-1
Group 1,BB,-1.5,2,14,811,12,2015,5,7
Group 1,BB,-1.5,2,14,812,5,2015,5,0
Group 1,BB,-1.5,2,14,813,8,2015,5,3
Group 1,BB,-1.5,2,14,814,6,2015,6,0
Group 1,BB,-1.5,2,14,815,6,2015,7,-1
Group 1,BB,-1.5,2,14,816,4,2015,9,-5
Group 1,BB,-1.5,2,14,817,8,2015,8,0
Group 1,BB,-1.5,2,14,818,5,2015,10,-5
Group 1,BB,-1.5,2,14,819,6,2015,9,-3
Group 1,BB,-1.5,2,14,820,9,2015,3,6
Group 1,BB,-1.5,2,14,821,6,2015,6,0
Group 1,BB,-1.5,2,14,822,6,2015,7,-1
Group 1,BB,-1.5,2,14,823,6,2015,6,0
Group 1,BB,-1.5,2,14,824,6,2015,7,-1
Group 1,BB,-1.5,2,14,825,8,2015,5,3
Group 1,BB,-1.5,2,14,826,10,2015,8,2
Group 1,BB,-1.5,2,14,827,8,2015,7,1
Group 1,BB,-1.5,2,14,828,10,2015,8,2
Group 1,BB,-1.5,2,14,829,9,2015,7,2
Group 1,BB,-1.5,2,14,830,8,2015,7,1
Group 1,BB,-1.5,2,14,831,11,2015,7,4
Group 1,BB,-1.5,2,14,832,8,2015,12,-4
Group 1,BB,-1.5,2,14,833,10,2015,4,6
Group 1,BB,-1.5,2,14,834,8,2015,7,1
Group 1,BB,-1.5,2,14,835,8,2015,3,5
Group 1,BB,-1.5,2,14,836,7,2015,5,2
Group 1,BB,-1.5,2,14,837,10,2015,6,4
Group 1,BB,-1.5,2,14,838,8,2015,7,1
Group 1,BB,-1.5,2,14,839,6,2015,8,-2
Group 1,BB,-1.5,2,14,840,8,2015,9,-1
Group 1,BB,-1.5,2,14,841,9,2015,4,5
Group 1,BB,-1.5,2,14,842,9,2015,8,1
Group 1,BB,-1.5,2,14,843,6,2015,8,-2
Group 1,BB,-1.5,2,14,844,7,2015,10,-3
Group 1,BB,-1.5,2,14,845,5,2015,8,-3
Group 1,BB,-1.5,2,14,846,8,2015,6,2
Group 1,BB,-1.5,2,14,847,5,2015,9,-4
Group 1,BB,-1.5,2,14,848,5,2015,6,-1
Group 1,BB,-1.5,2,14,849,7,2015,7,0
Group 1,BB,-1.5,2,14,850,12,2015,12,0
Group 1,BB,-1.5,2,14,851,10,2015,7,3
Group 1,BB,-1.5,2,14,852,7,2015,6,1
Group 1,BB,-1.5,2,14,853,8,2015,4,4
Group 1,BB,-1.5,2,14,854,8,2015,6,2
Group 1,BB,-1.5,2,14,855,6,2015,8,-2
Group 1,BB,-1.5,2,14,856,7,2015,4,3
Group 1,BB,-1.5,2,14,857,5,2015,9,-4
Group 1,BB,-1.5,2,14,858,7,2015,8,-1
Group 1,BB,-1.5,2,14,859,6,2015,6,0
Group 1,BB,-1.5,2,14,860,11,2015,5,6
Group 1,BB,-1.5,2,14,861,5,2015,9,-4
Group 1,BB,-1.5,2,14,862,7,2015,6,1
Group 1,BB,-1.5,2,14,863,5,2015,6,-1
Group 1,BB,-1.5,2,14,864,6,2015,3,3
Group 1,BB,-1.5,2,14,865,7,2015,5,2
Group 1,BB,-1.5,2,14,866,4,2015,9,-5
Group 1,BB,-1.5,2,14,867,4,2015,9,-5
Group 1,BB,-1.5,2,14,868,10,2015,7,3
Group 1,BB,-1.5,2,14,869,9,2015,10,-1
Group 1,BB,-1.5,2,14,870,5,2015,8,-3
Group 1,BB,-1.5,2,14,871,9,2015,10,-1
Group 1,BB,-1.5,2,14,872,9,2015,4,5
Group 1,BB,-1.5,2,14,873,7,2015,9,-2
Group 1,BB,-1.5,2,14,874,5,2015,5,0
Group 1,BB,-1.5,2,14,875,4,2015,8,-4
Group 1,BB,-1.5,2,14,876,7,2015,7,0
Group 1,BB,-1.5,2,14,877,9,2015,6,3
Group 1,BB,-1.5,2,14,878,6,2015,6,0
Group 1,BB,-1.5,2,14,879,6,2015,8,-2
Group 1,BB,-1.5,2,14,880,5,2015,5,0
Group 1,BB,-1.5,2,14,881,8,2015,8,0
Group 1,BB,-1.5,2,14,882,11,2015,6,5
Group 1,BB,-1.5,2,14,883,9,2015,3,6
Group 1,BB,-1.5,2,14,884,7,2015,7,0
Group 1,BB,-1.5,2,14,885,8,2015,9,-1
Group 1,BB,-1.5,2,14,886,5,2015,11,-6
Group 1,BB,-1.5,2,14,887,9,2015,5,4
Group 1,BB,-1.5,2,14,888,9,2015,9,0
Group 1,BB,-1.5,2,14,889,9,2015,7,2
Group 1,BB,-1.5,2,14,890,10,2015,8,2
Group 1,BB,-1.5,2,14,891,6,2015,8,-2
Group 1,BB,-1.5,2,14,892,5,2015,6,-1
Group 1,BB,-1.5,2,14,893,9,2015,3,6
Group 1,BB,-1.5,2,14,894,7,2015,8,-1
Group 1,BB,-1.5,2,14,895,8,2015,3,5
Group 1,BB,-1.5,2,14,896,8,2015,12,-4
Group 1,BB,-1.5,2,14,897,3,2015,4,-1
Group 1,BB,-1.5,2,14,898,2,2015,11,-9
Group 1,BB,-1.5,2,14,899,10,2015,5,5
Group 1,BB,-1.5,2,14,900,7,2015,7,0
Group 1,BB,-1.5,2,14,901,11,2015,7,4
Group 1,BB,-1.5,2,14,902,8,2015,6,2
Group 1,BB,-1.5,2,14,903,6,2015,7,-1
Group 1,BB,-1.5,2,14,904,10,2015,7,3
Group 1,BB,-1.5,2,14,905,7,2015,5,2
Group 1,BB,-1.5,2,14,906,10,2015,6,4
Group 1,BB,-1.5,2,14,907,10,2015,9,1
Group 1,BB,-1.5,2,14,908,7,2015,7,0
Group 1,BB,-1.5,2,14,909,8,2015,10,-2
Group 1,BB,-1.5,2,14,910,7,2015,9,-2
Group 1,BB,-1.5,2,14,911,5,2015,10,-5
Group 1,BB,-1.5,2,14,912,6,2015,6,0
Group 1,BB,-1.5,2,14,913,10,2015,3,7
Group 1,BB,-1.5,2,14,914,4,2015,7,-3
Group 1,BB,-1.5,2,14,915,11,2015,4,7
Group 1,BB,-1.5,2,14,916,6,2015,4,2
Group 1,BB,-1.5,2,14,917,7,2015,8,-1
Group 1,BB,-1.5,2,14,918,5,2015,7,-2
Group 1,BB,-1.5,2,14,919,6,2015,7,-1
Group 1,BB,-1.5,2,14,920,9,2015,5,4
Group 1,BB,-1.5,2,14,921,8,2015,8,0
Group 1,BB,-1.5,2,14,922,9,2015,6,3
Group 1,BB,-1.5,2,14,923,7,2015,12,-5
Group 1,BB,-1.5,2,14,924,8,2015,6,2
Group 1,BB,-1.5,2,14,925,7,2015,4,3
Group 1,BB,-1.5,2,14,926,4,2015,6,-2
Group 1,BB,-1.5,2,14,927,5,2015,5,0
Group 1,BB,-1.5,2,14,928,8,2015,7,1
Group 1,BB,-1.5,2,14,929,7,2015,8,-1
Group 1,BB,-1.5,2,14,930,9,2015,8,1
Group 1,BB,-1.5,2,14,931,8,2015,10,-2
Group 1,BB,-1.5,2,14,932,8,2015,5,3
Group 1,BB,-1.5,2,14,933,8,2015,8,0
Group 1,BB,-1.5,2,14,934,8,2015,7,1
Group 1,BB,-1.5,2,14,935,6,2015,6,0
Group 1,BB,-1.5,2,14,936,8,2015,3,5
Group 1,BB,-1.5,2,14,937,6,2015,7,-1
Group 1,BB,-1.5,2,14,938,9,2015,6,3
Group 1,BB,-1.5,2,14,939,7,2015,5,2
Group 1,BB,-1.5,2,14,940,7,2015,8,-1
Group 1,BB,-1.5,2,14,941,6,2015,6,0
Group 1,BB,-1.5,2,14,942,8,2015,6,2
Group 1,BB,-1.5,2,14,943,8,2015,8,0
Group 1,BB,-1.5,2,14,944,9,2015,5,4
Group 1,BB,-1.5,2,14,945,4,2015,8,-4
Group 1,BB,-1.5,2,14,946,5,2015,11,-6
Group 1,BB,-1.5,2,14,947,9,2015,10,-1
Group 1,BB,-1.5,2,14,948,6,2015,5,1
Group 1,BB,-1.5,2,14,949,6,2015,7,-1
Group 1,BB,-1.5,2,14,950,6,2015,6,0
Group 1,BB,-1.5,2,14,951,4,2015,8,-4
Group 1,BB,-1.5,2,14,952,9,2015,7,2
Group 1,BB,-1.5,2,14,953,8,2015,5,3
Group 1,BB,-1.5,2,14,954,7,2015,7,0
Group 1,BB,-1.5,2,14,955,7,2015,8,-1
Group 1,BB,-1.5,2,14,956,7,2015,11,-4
Group 1,BB,-1.5,2,14,957,7,2015,7,0
Group 1,BB,-1.5,2,14,958,4,2015,5,-1
Group 1,BB,-1.5,2,14,959,7,2015,10,-3
Group 1,BB,-1.5,2,14,960,7,2015,5,2
Group 1,BB,-1.5,2,14,961,2,2015,9,-7
Group 1,BB,-1.5,2,14,962,6,2015,9,-3
Group 1,BB,-1.5,2,14,963,6,2015,7,-1
Group 1,BB,-1.5,2,14,964,9,2015,7,2
Group 1,BB,-1.5,2,14,965,6,2015,5,1
Group 1,BB,-1.5,2,14,966,8,2015,6,2
Group 1,BB,-1.5,2,14,967,9,2015,7,2
Group 1,BB,-1.5,2,14,968,9,2015,11,-2
Group 1,BB,-1.5,2,14,969,7,2015,3,4
Group 1,BB,-1.5,2,14,970,7,2015,5,2
Group 1,BB,-1.5,2,14,971,6,2015,9,-3
Group 1,BB,-1.5,2,14,972,4,2015,8,-4
Group 1,BB,-1.5,2,14,973,9,2015,6,3
Group 1,BB,-1.5,2,14,974,6,2015,8,-2
Group 1,BB,-1.5,2,14,975,11,2015,7,4
Group 1,BB,-1.5,2,14,976,8,2015,5,3
Group 1,BB,-1.5,2,14,977,6,2015,5,1
Group 1,BB,-1.5,2,14,978,6,2015,5,1
Group 1,BB,-1.5,2,14,979,8,2015,7,1
Group 1,BB,-1.5,2,14,980,10,2015,11,-1
Group 1,BB,-1.5,2,14,981,7,2015,4,3
Group 1,BB,-1.5,2,14,982,8,2015,3,5
Group 1,BB,-1.5,2,14,983,7,2015,6,1
Group 1,BB,-1.5,2,14,984,6,2015,5,1
Group 1,BB,-1.5,2,14,985,10,2015,6,4
Group 1,BB,-1.5,2,14,986,5,2015,7,-2
Group 1,BB,-1.5,2,14,987,11,2015,8,3
Group 1,BB,-1.5,2,14,988,10,2015,7,3
Group 1,BB,-1.5,2,14,989,3,2015,6,-3
Group 1,BB,-1.5,2,14,990,3,2015,5,-2
Group 1,BB,-1.5,2,14,991,4,2015,7,-3
Group 1,BB,-1.5,2,14,992,5,2015,11,-6
Group 1,BB,-1.5,2,14,993,7,2015,9,-2
Group 1,BB,-1.5,2,14,994,10,2015,6,4
Group 1,BB,-1.5,2,14,995,9,2015,6,3
Group 1,BB,-1.5,2,14,996,9,2015,8,1
Group 1,BB,-1.5,2,14,997,10,2015,10,0
Group 1,BB,-1.5,2,14,998,7,2015,5,2
Group 1,BB,-1.5,2,14,999,8,2015,8,0
Group 1,BB,-1.5,2,14,1000,8,2015,10,-2
Group 1,BB,-1.5,2,14,1001,6,2015,10,-4
Group 1,BB,-1.5,2,14,1002,7,2015,8,-1
Group 1,BB,-1.5,2,14,1003,4,2015,7,-3
Group 1,BB,-1.5,2,14,1004,12,2015,8,4
Group 1,BB,-1.5,2,14,1005,6,2015,9,-3
Group 1,BB,-1.5,2,14,1006,5,2015,5,0
Group 1,BB,-1.5,2,14,1007,8,2015,5,3
Group 1,BB,-1.5,2,14,1008,4,2015,8,-4
Group 1,BB,-1.5,2,14,1009,7,2015,8,-1
Group 1,BB,-1.5,2,14,1010,8,2015,6,2
Group 1,BB,-1.5,2,14,1011,9,2015,8,1
Group 1,BB,-1.5,2,14,1012,7,2015,8,-1
Group 1,BB,-1.5,2,14,1013,6,2015,1,5
Group 1,BB,-1.5,2,14,1014,9,2015,7,2
Group 1,BB,-1.5,2,14,1015,9,2015,9,0
Group 1,BB,-1.5,2,14,1016,9,2015,7,2
Group 1,BB,-1.5,2,14,1017,5,2015,5,0
Group 1,BB,-1.5,2,14,1018,9,2015,10,-1
Group 1,BB,-1.5,2,14,1019,5,2015,7,-2
Group 1,BB,-1.5,2,14,1020,5,2015,8,-3
Group 1,BB,-1.5,2,14,1021,5,2015,8,-3
Group 1,BB,-1.5,2,14,1022,10,2015,7,3
Group 1,BB,-1.5,2,14,1023,10,2015,9,1
Group 1,BB,-1.5,2,14,1024,6,2015,7,-1
Group 1,BB,-1.5,2,14,1025,6,2015,4,2
Group 1,BB,-1.5,2,14,1026,8,2015,5,3
Group 1,BB,-1.5,2,14,1027,8,2015,4,4
Group 1,BB,-1.5,2,14,1028,10,2015,4,6
Group 1,BB,-1.5,2,14,1029,7,2015,9,-2
Group 1,BB,-1.5,2,14,1030,6,2015,9,-3
Group 1,BB,-1.5,2,14,1031,10,2015,6,4
Group 1,BB,-1.5,2,14,1032,8,2015,5,3
Group 1,BB,-1.5,2,14,1033,8,2015,3,5
Group 1,BB,-1.5,2,14,1034,8,2015,6,2
Group 1,BB,-1.5,2,14,1035,8,2015,6,2
Group 1,BB,-1.5,2,14,1036,7,2015,5,2
Group 1,BB,-1.5,2,14,1037,7,2015,8,-1
Group 1,BB,-1.5,2,14,1038,8,2015,10,-2
Group 1,BB,-1.5,2,14,1039,8,2015,6,2
Group 1,BB,-1.5,2,14,1040,8,2015,4,4
Group 1,BB,-1.5,2,14,1041,9,2015,8,1
Group 1,BB,-1.5,2,14,1042,4,2015,9,-5
Group 1,BB,-1.5,2,14,1043,6,2015,6,0
Group 1,BB,-1.5,2,14,1044,6,2015,6,0
Group 1,BB,-1.5,2,14,1045,9,2015,6,3
Group 1,BB,-1.5,2,14,1046,6,2015,6,0
Group 1,BB,-1.5,2,14,1047,7,2015,6,1
Group 1,BB,-1.5,2,14,1048,8,2015,8,0
Group 1,BB,-1.5,2,14,1049,4,2015,9,-5
Group 1,BB,-1.5,2,14,1050,8,2015,6,2
Group 1,BB,-1.5,2,14,1051,5,2015,9,-4
Group 1,BB,-1.5,2,14,1052,6,2015,9,-3
Group 1,BB,-1.5,2,14,1053,4,2015,8,-4
Group 1,BB,-1.5,2,14,1054,8,2015,11,-3
Group 1,BB,-1.5,2,14,1055,11,2015,4,7
Group 1,BB,-1.5,2,14,1056,6,2015,5,1
Group 1,BB,-1.5,2,14,1057,8,2015,8,0
Group 1,BB,-1.5,2,14,1058,7,2015,8,-1
Group 1,BB,-1.5,2,14,1059,7,2015,11,-4
Group 1,BB,-1.5,2,14,1060,10,2015,7,3
Group 1,BB,-1.5,2,14,1061,8,2015,6,2
Group 1,BB,-1.5,2,14,1062,4,2015,8,-4
Group 1,BB,-1.5,2,14,1063,5,2015,8,-3
Group 1,BB,-1.5,2,14,1064,9,2015,6,3
Group 1,BB,-1.5,2,14,1065,8,2015,10,-2
Group 1,BB,-1.5,2,14,1066,9,2015,7,2
Group 1,BB,-1.5,2,14,1067,7,2015,9,-2
Group 1,BB,-1.5,2,14,1068,8,2015,10,-2
Group 1,BB,-1.5,2,14,1069,6,2015,5,1
Group 1,BB,-1.5,2,14,1070,7,2015,9,-2
Group 1,BB,-1.5,2,14,1071,7,2015,8,-1
Group 1,BB,-1.5,2,14,1072,10,2015,8,2
Group 1,BB,-1.5,2,14,1073,8,2015,7,1
Group 1,BB,-1.5,2,14,1074,7,2015,7,0
Group 1,BB,-1.5,2,14,1075,6,2015,7,-1
Group 1,BB,-1.5,2,14,1076,11,2015,8,3
Group 1,BB,-1.5,2,14,1077,6,2015,9,-3
Group 1,BB,-1.5,2,14,1078,6,2015,9,-3
Group 1,BB,-1.5,2,14,1079,7,2015,5,2
Group 1,BB,-1.5,2,14,1080,7,2015,9,-2
Group 1,BB,-1.5,2,14,1081,10,2015,5,5
Group 1,BB,-1.5,2,14,1082,5,2015,10,-5
Group 1,BB,-1.5,2,14,1083,8,2015,9,-1
Group 1,BB,-1.5,2,14,1084,6,2015,6,0
Group 1,BB,-1.5,2,14,1085,4,2015,9,-5
Group 1,BB,-1.5,2,14,1086,8,2015,8,0
Group 1,BB,-1.5,2,14,1087,12,2015,9,3
Group 1,BB,-1.5,2,14,1088,11,2015,9,2
Group 1,BB,-1.5,2,14,1089,5,2015,7,-2
Group 1,BB,-1.5,2,14,1090,4,2015,9,-5
Group 1,BB,-1.5,2,14,1091,5,2015,4,1
Group 1,BB,-1.5,2,14,1092,8,2015,8,0
Group 1,BB,-1.5,2,14,1093,10,2015,2,8
Group 1,BB,-1.5,2,14,1094,7,2015,7,0
Group 1,BB,-1.5,2,14,1095,9,2015,7,2
Group 1,BB,-1.5,2,14,1096,8,2015,7,1
Group 1,BB,-1.5,2,14,1097,11,2015,6,5
Group 1,BB,-1.5,2,14,1098,7,2015,7,0
Group 1,BB,-1.5,2,14,1099,12,2015,7,5
Group 1,BB,-1.5,2,14,1100,9,2015,11,-2
Group 1,BB,-1.5,2,14,1101,8,2015,7,1
Group 1,BB,-1.5,2,14,1102,9,2015,8,1
Group 1,BB,-1.5,2,14,1103,9,2015,9,0
Group 1,BB,-1.5,2,14,1104,9,2015,9,0
Group 1,BB,-1.5,2,14,1105,9,2015,7,2
Group 1,BB,-1.5,2,14,1106,9,2015,9,0
Group 1,BB,-1.5,2,14,1107,9,2015,6,3
Group 1,BB,-1.5,2,14,1108,5,2015,6,-1
Group 1,BB,-1.5,2,14,1109,11,2015,6,5
Group 1,BB,-1.5,2,14,1110,10,2015,10,0
Group 1,BB,-1.5,2,14,1111,11,2015,9,2
Group 1,BB,-1.5,2,14,1112,10,2015,8,2
Group 1,BB,-1.5,2,14,1113,8,2015,6,2
Group 1,BB,-1.5,2,14,1114,8,2015,4,4
Group 1,BB,-1.5,2,14,1115,7,2015,5,2
Group 1,BB,-1.5,2,14,1116,9,2015,6,3
Group 1,BB,-1.5,2,14,1117,8,2015,7,1
Group 1,BB,-1.5,2,14,1118,6,2015,6,0
Group 1,BB,-1.5,2,14,1119,6,2015,7,-1
Group 1,BB,-1.5,2,14,1120,8,2015,7,1
Group 1,BB,-1.5,2,14,1121,7,2015,8,-1
Group 1,BB,-1.5,2,14,1122,8,2015,5,3
Group 1,BB,-1.5,2,14,1123,10,2015,10,0
Group 1,BB,-1.5,2,14,1124,8,2015,11,-3
Group 1,BB,-1.5,2,14,1125,9,2015,9,0
Group 1,BB,-1.5,2,14,1126,9,2015,7,2
Group 1,BB,-1.5,2,14,1127,6,2015,6,0
Group 1,BB,-1.5,2,14,1128,4,2015,9,-5
Group 1,BB,-1.5,2,14,1129,8,2015,5,3
Group 1,BB,-1.5,2,14,1130,11,2015,6,5
Group 1,BB,-1.5,2,14,1131,6,2015,1,5
Group 1,BB,-1.5,2,14,1132,9,2015,4,5
Group 1,BB,-1.5,2,14,1133,14,2015,9,5
Group 1,BB,-1.5,2,14,1134,6,2015,7,-1
Group 1,BB,-1.5,2,14,1135,5,2015,7,-2
Group 1,BB,-1.5,2,14,1136,7,2015,9,-2
Group 1,BB,-1.5,2,14,1137,6,2015,5,1
Group 1,BB,-1.5,2,14,1138,6,2015,8,-2
Group 1,BB,-1.5,2,14,1139,8,2015,5,3
Group 1,BB,-1.5,2,14,1140,8,2015,9,-1
Group 1,BB,-1.5,2,14,1141,9,2015,10,-1
Group 1,BB,-1.5,2,14,1142,8,2015,9,-1
Group 1,BB,-1.5,2,14,1143,3,2015,7,-4
Group 1,BB,-1.5,2,14,1144,8,2015,9,-1
Group 1,BB,-1.5,2,14,1145,6,2015,8,-2
Group 1,BB,-1.5,2,14,1146,10,2015,4,6
Group 1,BB,-1.5,2,14,1147,5,2015,5,0
Group 1,BB,-1.5,2,14,1148,6,2015,8,-2
Group 1,BB,-1.5,2,14,1149,6,2015,6,0
Group 1,BB,-1.5,2,14,1150,8,2015,6,2
Group 1,BB,-1.5,2,14,1151,4,2015,8,-4
Group 1,BB,-1.5,2,14,1152,7,2015,6,1
Group 1,BB,-1.5,2,14,1153,6,2015,6,0
Group 1,BB,-1.5,2,14,1154,5,2015,7,-2
Group 1,BB,-1.5,2,14,1155,8,2015,7,1
Group 1,BB,-1.5,2,14,1156,8,2015,5,3
Group 1,BB,-1.5,2,14,1157,7,2015,10,-3
Group 1,BB,-1.5,2,14,1158,8,2015,9,-1
Group 1,BB,-1.5,2,14,1159,7,2015,7,0
Group 1,BB,-1.5,2,14,1160,8,2015,8,0
Group 1,BB,-1.5,2,14,1161,9,2015,7,2
Group 1,BB,-1.5,2,14,1162,6,2015,7,-1
Group 1,BB,-1.5,2,14,1163,9,2015,8,1
Group 1,BB,-1.5,2,14,1164,5,2015,8,-3
Group 1,BB,-1.5,2,14,1165,8,2015,6,2
Group 1,BB,-1.5,2,14,1166,8,2015,5,3
Group 1,BB,-1.5,2,14,1167,6,2015,8,-2
Group 1,BB,-1.5,2,14,1168,9,2015,8,1
Group 1,BB,-1.5,2,14,1169,5,2015,9,-4
Group 1,BB,-1.5,2,14,1170,8,2015,6,2
Group 1,BB,-1.5,2,14,1171,10,2015,11,-1
Group 1,BB,-1.5,2,14,1172,10,2015,8,2
Group 1,BB,-1.5,2,14,1173,5,2015,6,-1
Group 1,BB,-1.5,2,14,1174,11,2015,6,5
Group 1,BB,-1.5,2,14,1175,6,2015,8,-2
Group 1,BB,-1.5,2,14,1176,6,2015,6,0
Group 1,BB,-1.5,2,14,1177,8,2015,8,0
Group 1,BB,-1.5,2,14,1178,5,2015,9,-4
Group 1,BB,-1.5,2,14,1179,9,2015,3,6
Group 1,BB,-1.5,2,14,1180,10,2015,7,3
Group 1,BB,-1.5,2,14,1181,10,2015,6,4
Group 1,BB,-1.5,2,14,1182,9,2015,5,4
Group 1,BB,-1.5,2,14,1183,6,2015,5,1
Group 1,BB,-1.5,2,14,1184,7,2015,7,0
Group 1,BB,-1.5,2,14,1185,9,2015,7,2
Group 1,BB,-1.5,2,14,1186,12,2015,4,8
Group 1,BB,-1.5,2,14,1187,7,2015,7,0
Group 1,BB,-1.5,2,14,1188,7,2015,6,1
Group 1,BB,-1.5,2,14,1189,4,2015,6,-2
Group 1,BB,-1.5,2,14,1190,6,2015,7,-1
Group 1,BB,-1.5,2,14,1191,10,2015,5,5
Group 1,BB,-1.5,2,14,1192,9,2015,10,-1
Group 1,BB,-1.5,2,14,1193,9,2015,10,-1
Group 1,BB,-1.5,2,14,1194,5,2015,6,-1
Group 1,BB,-1.5,2,14,1195,7,2015,9,-2
Group 1,BB,-1.5,2,14,1196,8,2015,7,1
Group 1,BB,-1.5,2,14,1197,9,2015,9,0
Group 1,BB,-1.5,2,14,1198,4,2015,5,-1
Group 1,BB,-1.5,2,14,1199,10,2015,5,5
Group 1,BB,-1.5,2,14,1200,8,2015,4,4
Group 1,BB,-1.5,2,14,1201,8,2015,10,-2
Group 1,BB,-1.5,2,14,1202,7,2015,8,-1
Group 1,BB,-1.5,2,14,1203,11,2015,7,4
Group 1,BB,-1.5,2,14,1204,7,2015,4,3
Group 1,BB,-1.5,2,14,1205,5,2015,6,-1
Group 1,BB,-1.5,2,14,1206,7,2015,9,-2
Group 1,BB,-1.5,2,14,1207,7,2015,9,-2
Group 1,BB,-1.5,2,14,1208,6,2015,3,3
Group 1,BB,-1.5,2,14,1209,7,2015,3,4
Group 1,BB,-1.5,2,14,1210,8,2015,4,4
Group 1,BB,-1.5,2,14,1211,7,2015,10,-3
Group 1,BB,-1.5,2,14,1212,2,2015,5,-3
Group 1,BB,-1.5,2,14,1213,6,2015,9,-3
Group 1,BB,-1.5,2,14,1214,3,2015,9,-6
Group 1,BB,-1.5,2,14,1215,5,2015,5,0
Group 1,BB,-1.5,2,14,1216,8,2015,8,0
Group 1,BB,-1.5,2,14,1217,9,2015,8,1
Group 1,BB,-1.5,2,14,1218,8,2015,4,4
Group 1,BB,-1.5,2,14,1219,7,2015,6,1
Group 1,BB,-1.5,2,14,1220,8,2015,6,2
Group 1,BB,-1.5,2,14,1221,10,2015,5,5
Group 1,BB,-1.5,2,14,1222,7,2015,7,0
Group 1,BB,-1.5,2,14,1223,8,2015,9,-1
Group 1,BB,-1.5,2,14,1224,8,2015,10,-2
Group 1,BB,-1.5,2,14,1225,8,2015,6,2
Group 1,BB,-1.5,2,14,1226,10,2015,8,2
Group 1,BB,-1.5,2,14,1227,7,2015,7,0
Group 1,BB,-1.5,2,14,1228,8,2015,10,-2
Group 1,BB,-1.5,2,14,1229,10,2015,7,3
Group 1,BB,-1.5,2,14,1230,11,2015,5,6
Group 1,BB,-1.5,2,14,1231,10,2015,6,4
Group 1,BB,-1.5,2,14,1232,7,2015,9,-2
Group 1,BB,-1.5,2,14,1233,10,2015,7,3
Group 1,BB,-1.5,2,14,1234,10,2015,10,0
Group 1,BB,-1.5,2,14,1235,9,2015,3,6
Group 1,BB,-1.5,2,14,1236,7,2015,7,0
Group 1,BB,-1.5,2,14,1237,2,2015,9,-7
Group 1,BB,-1.5,2,14,1238,6,2015,10,-4
Group 1,BB,-1.5,2,14,1239,6,2015,9,-3
Group 1,BB,-1.5,2,14,1240,5,2015,5,0
Group 1,BB,-1.5,2,14,1241,9,2015,9,0
Group 1,BB,-1.5,2,14,1242,4,2015,5,-1
Group 1,BB,-1.5,2,14,1243,7,2015,2,5
Group 1,BB,-1.5,2,14,1244,7,2015,11,-4
Group 1,BB,-1.5,2,14,1245,7,2015,8,-1
Group 1,BB,-1.5,2,14,1246,7,2015,9,-2
Group 1,BB,-1.5,2,14,1247,7,2015,9,-2
Group 1,BB,-1.5,2,14,1248,7,2015,8,-1
Group 1,BB,-1.5,2,14,1249,8,2015,6,2
Group 1,BB,-1.5,2,14,1250,8,2015,7,1
Group 1,BB,-1.5,2,14,1251,5,2015,9,-4
Group 1,BB,-1.5,2,14,1252,6,2015,8,-2
Group 1,BB,-1.5,2,14,1253,9,2015,4,5
Group 1,BB,-1.5,2,14,1254,10,2015,8,2
Group 1,BB,-1.5,2,14,1255,9,2015,3,6
Group 1,BB,-1.5,2,14,1256,10,2015,7,3
Group 1,BB,-1.5,2,14,1257,6,2015,8,-2
Group 1,BB,-1.5,2,14,1258,6,2015,6,0
Group 1,BB,-1.5,2,14,1259,5,2015,4,1
Group 1,BB,-1.5,2,14,1260,11,2015,9,2
Group 1,BB,-1.5,2,14,1261,5,2015,4,1
Group 1,BB,-1.5,2,14,1262,7,2015,6,1
Group 1,BB,-1.5,2,14,1263,10,2015,6,4
Group 1,BB,-1.5,2,14,1264,7,2015,11,-4
Group 1,BB,-1.5,2,14,1265,5,2015,4,1
Group 1,BB,-1.5,2,14,1266,7,2015,9,-2
Group 1,BB,-1.5,2,14,1267,6,2015,8,-2
Group 1,BB,-1.5,2,14,1268,8,2015,6,2
Group 1,BB,-1.5,2,14,1269,8,2015,2,6
Group 1,BB,-1.5,2,14,1270,11,2015,3,8
Group 1,BB,-1.5,2,14,1271,9,2015,8,1
Group 1,BB,-1.5,2,14,1272,8,2015,9,-1
Group 1,BB,-1.5,2,14,1273,7,2015,7,0
Group 1,BB,-1.5,2,14,1274,9,2015,7,2
Group 1,BB,-1.5,2,14,1275,6,2015,8,-2
Group 1,BB,-1.5,2,14,1276,9,2015,8,1
Group 1,BB,-1.5,2,14,1277,7,2015,8,-1
Group 1,BB,-1.5,2,14,1278,7,2015,9,-2
Group 1,BB,-1.5,2,14,1279,8,2015,8,0
Group 1,BB,-1.5,2,14,1280,7,2015,8,-1
Group 1,BB,-1.5,2,14,1281,9,2015,6,3
Group 1,BB,-1.5,2,14,1282,3,2015,7,-4
Group 1,BB,-1.5,2,14,1283,9,2015,8,1
Group 1,BB,-1.5,2,14,1284,3,2015,6,-3
Group 1,BB,-1.5,2,14,1285,7,2015,5,2
Group 1,BB,-1.5,2,14,1286,7,2015,8,-1
Group 1,BB,-1.5,2,14,1287,9,2015,3,6
Group 1,BB,-1.5,2,14,1288,6,2015,7,-1
Group 1,BB,-1.5,2,14,1289,8,2015,5,3
Group 1,BB,-1.5,2,14,1290,8,2015,5,3
Group 1,BB,-1.5,2,14,1291,9,2015,4,5
Group 1,BB,-1.5,2,14,1292,6,2015,6,0
Group 1,BB,-1.5,2,14,1293,2,2015,4,-2
Group 1,BB,-1.5,2,14,1294,8,2015,7,1
Group 1,BB,-1.5,2,14,1295,6,2015,6,0
Group 1,BB,-1.5,2,14,1296,8,2015,8,0
Group 1,BB,-1.5,2,14,1297,9,2015,7,2
Group 1,BB,-1.5,2,14,1298,9,2015,8,1
Group 1,BB,-1.5,2,14,1299,8,2015,7,1
Group 1,BB,-1.5,2,14,1300,7,2015,6,1
Group 1,BB,-1.5,2,14,1301,6,2015,11,-5
Group 1,BB,-1.5,2,14,1302,6,2015,4,2
Group 1,BB,-1.5,2,14,1303,8,2015,5,3
Group 1,BB,-1.5,2,14,1304,9,2015,5,4
Group 1,BB,-1.5,2,14,1305,5,2015,8,-3
Group 1,BB,-1.5,2,14,1306,8,2015,9,-1
Group 1,BB,-1.5,2,14,1307,8,2015,5,3
Group 1,BB,-1.5,2,14,1308,6,2015,9,-3
Group 1,BB,-1.5,2,14,1309,12,2015,13,-1
Group 1,BB,-1.5,2,14,1310,8,2015,9,-1
Group 1,BB,-1.5,2,14,1311,10,2015,8,2
Group 1,BB,-1.5,2,14,1312,9,2015,10,-1
Group 1,BB,-1.5,2,14,1313,10,2015,7,3
Group 1,BB,-1.5,2,14,1314,7,2015,4,3
Group 1,BB,-1.5,2,14,1315,12,2015,5,7
Group 1,BB,-1.5,2,14,1316,7,2015,2,5
Group 1,BB,-1.5,2,14,1317,8,2015,4,4
Group 1,BB,-1.5,2,14,1318,11,2015,6,5
Group 1,BB,-1.5,2,14,1319,7,2015,8,-1
Group 1,BB,-1.5,2,14,1320,10,2015,12,-2
Group 1,BB,-1.5,2,14,1321,10,2015,5,5
Group 1,BB,-1.5,2,14,1322,4,2015,7,-3
Group 1,BB,-1.5,2,14,1323,12,2015,6,6
Group 1,BB,-1.5,2,14,1324,9,2015,3,6
Group 1,BB,-1.5,2,14,1325,8,2015,3,5
Group 1,BB,-1.5,2,14,1326,8,2015,6,2
Group 1,BB,-1.5,2,14,1327,13,2015,6,7
Group 1,BB,-1.5,2,14,1328,5,2015,6,-1
Group 1,BB,-1.5,2,14,1329,9,2015,8,1
Group 1,BB,-1.5,2,14,1330,12,2015,5,7
Group 1,BB,-1.5,2,14,1331,8,2015,7,1
Group 1,BB,-1.5,2,14,1332,8,2015,8,0
Group 1,BB,-1.5,2,14,1333,6,2015,3,3
Group 1,BB,-1.5,2,14,1334,5,2015,3,2
Group 1,BB,-1.5,2,14,1335,9,2015,5,4
Group 1,BB,-1.5,2,14,1336,8,2015,9,-1
Group 1,BB,-1.5,2,14,1337,8,2015,5,3
Group 1,BB,-1.5,2,14,1338,10,2015,10,0
Group 1,BB,-1.5,2,14,1339,7,2015,7,0
Group 1,BB,-1.5,2,14,1340,5,2015,6,-1
Group 1,BB,-1.5,2,14,1341,6,2015,9,-3
Group 1,BB,-1.5,2,14,1342,10,2015,7,3
Group 1,BB,-1.5,2,14,1343,8,2015,5,3
Group 1,BB,-1.5,2,14,1344,7,2015,8,-1
Group 1,BB,-1.5,2,14,1345,11,2015,7,4
Group 1,BB,-1.5,2,14,1346,6,2015,6,0
Group 1,BB,-1.5,2,14,1347,11,2015,7,4
Group 1,BB,-1.5,2,14,1348,9,2015,9,0
Group 1,BB,-1.5,2,14,1349,8,2015,6,2
Group 1,BB,-1.5,2,14,1350,7,2015,6,1
Group 1,BB,-1.5,2,14,1351,10,2015,5,5
Group 1,BB,-1.5,2,14,1352,10,2015,7,3
Group 1,BB,-1.5,2,14,1353,8,2015,8,0
Group 1,BB,-1.5,2,14,1354,6,2015,6,0
Group 1,BB,-1.5,2,14,1355,11,2015,9,2
Group 1,BB,-1.5,2,14,1356,10,2015,6,4
Group 1,BB,-1.5,2,14,1357,12,2015,7,5
Group 1,BB,-1.5,2,14,1358,7,2015,9,-2
Group 1,BB,-1.5,2,14,1359,9,2015,8,1
Group 1,BB,-1.5,2,14,1360,6,2015,4,2
Group 1,BB,-1.5,2,14,1361,6,2015,7,-1
Group 1,BB,-1.5,2,14,1362,8,2015,6,2
Group 1,BB,-1.5,2,14,1363,6,2015,8,-2
Group 1,BB,-1.5,2,14,1364,5,2015,7,-2
Group 1,BB,-1.5,2,14,1365,10,2015,9,1
Group 1,BB,-1.5,2,14,1366,9,2015,10,-1
Group 1,BB,-1.5,2,14,1367,6,2015,8,-2
Group 1,BB,-1.5,2,14,1368,10,2015,9,1
Group 1,BB,-1.5,2,14,1369,8,2015,12,-4
Group 1,BB,-1.5,2,14,1370,7,2015,8,-1
Group 1,BB,-1.5,2,14,1371,9,2015,5,4
Group 1,BB,-1.5,2,14,1372,7,2015,12,-5
Group 1,BB,-1.5,2,14,1373,10,2015,6,4
Group 1,BB,-1.5,2,14,1374,8,2015,4,4
Group 1,BB,-1.5,2,14,1375,9,2015,5,4
Group 1,BB,-1.5,2,14,1376,10,2015,7,3
Group 1,BB,-1.5,2,14,1377,6,2015,6,0
Group 1,BB,-1.5,2,14,1378,9,2015,7,2
Group 1,BB,-1.5,2,14,1379,7,2015,6,1
Group 1,BB,-1.5,2,14,1380,9,2015,8,1
Group 1,BB,-1.5,2,14,1381,9,2015,6,3
Group 1,BB,-1.5,2,14,1382,8,2015,8,0
Group 1,BB,-1.5,2,14,1383,8,2015,8,0
Group 1,BB,-1.5,2,14,1384,7,2015,10,-3
Group 1,BB,-1.5,2,14,1385,5,2015,10,-5
Group 1,BB,-1.5,2,14,1386,7,2015,9,-2
Group 1,BB,-1.5,2,14,1387,12,2015,10,2
Group 1,BB,-1.5,2,14,1388,7,2015,4,3
Group 1,BB,-1.5,2,14,1389,9,2015,9,0
Group 1,BB,-1.5,2,14,1390,7,2015,10,-3
Group 1,BB,-1.5,2,14,1391,9,2015,8,1
Group 1,BB,-1.5,2,14,1392,9,2015,4,5
Group 1,BB,-1.5,2,14,1393,10,2015,7,3
Group 1,BB,-1.5,2,14,1394,7,2015,11,-4
Group 1,BB,-1.5,2,14,1395,7,2015,8,-1
Group 1,BB,-1.5,2,14,1396,12,2015,9,3
Group 1,BB,-1.5,2,14,1397,6,2015,5,1
Group 1,BB,-1.5,2,14,1398,7,2015,6,1
Group 1,BB,-1.5,2,14,1399,7,2015,7,0
Group 1,BB,-1.5,2,14,1400,4,2015,6,-2
Group 1,BB,-1.5,2,14,1401,8,2015,5,3
Group 1,BB,-1.5,2,14,1402,11,2015,8,3
Group 1,BB,-1.5,2,14,1403,8,2015,10,-2
Group 1,BB,-1.5,2,14,1404,5,2015,6,-1
Group 1,BB,-1.5,2,14,1405,8,2015,5,3
Group 1,BB,-1.5,2,14,1406,9,2015,5,4
Group 1,BB,-1.5,2,14,1407,7,2015,8,-1
Group 1,BB,-1.5,2,14,1408,6,2015,5,1
Group 1,BB,-1.5,2,14,1409,9,2015,5,4
Group 1,BB,-1.5,2,14,1410,7,2015,4,3
Group 1,BB,-1.5,2,14,1411,6,2015,7,-1
Group 1,BB,-1.5,2,14,1412,9,2015,8,1
Group 1,BB,-1.5,2,14,1413,7,2015,7,0
Group 1,BB,-1.5,2,14,1414,9,2015,7,2
Group 1,BB,-1.5,2,14,1415,7,2015,7,0
Group 1,BB,-1.5,2,14,1416,5,2015,7,-2
Group 1,BB,-1.5,2,14,1417,8,2015,9,-1
Group 1,BB,-1.5,2,14,1418,10,2015,9,1
Group 1,BB,-1.5,2,14,1419,7,2015,10,-3
Group 1,BB,-1.5,2,14,1420,11,2015,12,-1
Group 1,BB,-1.5,2,14,1421,6,2015,10,-4
Group 1,BB,-1.5,2,14,1422,8,2015,8,0
Group 1,BB,-1.5,2,14,1423,12,2015,3,9
Group 1,BB,-1.5,2,14,1424,7,2015,5,2
Group 1,BB,-1.5,2,14,1425,9,2015,8,1
Group 1,BB,-1.5,2,14,1426,4,2015,7,-3
Group 1,BB,-1.5,2,14,1427,7,2015,10,-3
Group 1,BB,-1.5,2,14,1428,6,2015,12,-6
Group 1,BB,-1.5,2,14,1429,6,2015,5,1
Group 1,BB,-1.5,2,14,1430,3,2015,8,-5
Group 1,BB,-1.5,2,14,1431,6,2015,7,-1
Group 1,BB,-1.5,2,14,1432,11,2015,6,5
Group 1,BB,-1.5,2,14,1433,8,2015,10,-2
Group 1,BB,-1.5,2,14,1434,7,2015,6,1
Group 1,BB,-1.5,2,14,1435,4,2015,8,-4
Group 1,BB,-1.5,2,14,1436,8,2015,5,3
Group 1,BB,-1.5,2,14,1437,7,2015,9,-2
Group 1,BB,-1.5,2,14,1438,9,2015,7,2
Group 1,BB,-1.5,2,14,1439,10,2015,11,-1
Group 1,BB,-1.5,2,14,1440,8,2015,7,1
Group 1,BB,-1.5,2,14,1441,8,2015,9,-1
Group 1,BB,-1.5,2,14,1442,9,2015,8,1
Group 1,BB,-1.5,2,14,1443,8,2015,9,-1
Group 1,BB,-1.5,2,14,1444,9,2015,5,4
Group 1,BB,-1.5,2,14,1445,6,2015,10,-4
Group 1,BB,-1.5,2,14,1446,8,2015,7,1
Group 1,BB,-1.5,2,14,1447,7,2015,8,-1
Group 1,BB,-1.5,2,14,1448,7,2015,5,2
Group 1,BB,-1.5,2,14,1449,9,2015,7,2
Group 1,BB,-1.5,2,14,1450,8,2015,11,-3
Group 1,BB,-1.5,2,14,1451,8,2015,6,2
Group 1,BB,-1.5,2,14,1452,7,2015,8,-1
Group 1,BB,-1.5,2,14,1453,7,2015,8,-1
Group 1,BB,-1.5,2,14,1454,6,2015,7,-1
Group 1,BB,-1.5,2,14,1455,9,2015,8,1
Group 1,BB,-1.5,2,14,1456,5,2015,7,-2
Group 1,BB,-1.5,2,14,1457,9,2015,4,5
Group 1,BB,-1.5,2,14,1458,6,2015,6,0
Group 1,BB,-1.5,2,14,1459,5,2015,7,-2
Group 1,BB,-1.5,2,14,1460,7,2015,3,4
Group 1,BB,-1.5,2,14,1461,7,2015,10,-3
Group 1,BB,-1.5,2,14,1462,3,2015,8,-5
Group 1,BB,-1.5,2,14,1463,10,2015,5,5
Group 1,BB,-1.5,2,14,1464,5,2015,10,-5
Group 1,BB,-1.5,2,14,1465,12,2015,9,3
Group 1,BB,-1.5,2,14,1466,8,2015,10,-2
Group 1,BB,-1.5,2,14,1467,7,2015,4,3
Group 1,BB,-1.5,2,14,1468,5,2015,6,-1
Group 1,BB,-1.5,2,14,1469,6,2015,5,1
Group 1,BB,-1.5,2,14,1470,5,2015,6,-1
Group 1,BB,-1.5,2,14,1471,5,2015,9,-4
Group 1,BB,-1.5,2,14,1472,7,2015,8,-1
Group 1,BB,-1.5,2,14,1473,10,2015,7,3
Group 1,BB,-1.5,2,14,1474,4,2015,8,-4
Group 1,BB,-1.5,2,14,1475,8,2015,9,-1
Group 1,BB,-1.5,2,14,1476,7,2015,10,-3
Group 1,BB,-1.5,2,14,1477,8,2015,6,2
Group 1,BB,-1.5,2,14,1478,6,2015,6,0
Group 1,BB,-1.5,2,14,1479,8,2015,4,4
Group 1,BB,-1.5,2,14,1480,9,2015,7,2
Group 1,BB,-1.5,2,14,1481,13,2015,8,5
Group 1,BB,-1.5,2,14,1482,10,2015,6,4
Group 1,BB,-1.5,2,14,1483,5,2015,10,-5
Group 1,BB,-1.5,2,14,1484,11,2015,6,5
Group 1,BB,-1.5,2,14,1485,7,2015,3,4
Group 1,BB,-1.5,2,14,1486,9,2015,4,5
Group 1,BB,-1.5,2,14,1487,6,2015,4,2
Group 1,BB,-1.5,2,14,1488,9,2015,4,5
Group 1,BB,-1.5,2,14,1489,11,2015,9,2
Group 1,BB,-1.5,2,14,1490,7,2015,5,2
Group 1,BB,-1.5,2,14,1491,6,2015,4,2
Group 1,BB,-1.5,2,14,1492,7,2015,3,4
Group 1,BB,-1.5,2,14,1493,9,2015,7,2
Group 1,BB,-1.5,2,14,1494,6,2015,7,-1
Group 1,BB,-1.5,2,14,1495,10,2015,10,0
Group 1,BB,-1.5,2,14,1496,8,2015,5,3
Group 1,BB,-1.5,2,14,1497,5,2015,3,2
Group 1,BB,-1.5,2,14,1498,10,2015,2,8
Group 1,BB,-1.5,2,14,1499,8,2015,4,4
Group 1,BB,-1.5,2,14,1500,10,2015,6,4
Group 1,BB,-1.5,2,14,1501,8,2015,7,1
Group 1,BB,-1.5,2,14,1502,5,2015,7,-2
Group 1,BB,-1.5,2,14,1503,8,2015,10,-2
Group 1,BB,-1.5,2,14,1504,8,2015,6,2
Group 1,BB,-1.5,2,14,1505,8,2015,5,3
Group 1,BB,-1.5,2,14,1506,12,2015,3,9
Group 1,BB,-1.5,2,14,1507,6,2015,10,-4
Group 1,BB,-1.5,2,14,1508,11,2015,7,4
Group 1,BB,-1.5,2,14,1509,7,2015,10,-3
Group 1,BB,-1.5,2,14,1510,8,2015,6,2
Group 1,BB,-1.5,2,14,1511,6,2015,13,-7
Group 1,BB,-1.5,2,14,1512,6,2015,7,-1
Group 1,BB,-1.5,2,14,1513,5,2015,7,-2
Group 1,BB,-1.5,2,14,1514,9,2015,8,1
Group 1,BB,-1.5,2,14,1515,6,2015,11,-5
Group 1,BB,-1.5,2,14,1516,9,2015,5,4
Group 1,BB,-1.5,2,14,1517,7,2015,9,-2
Group 1,BB,-1.5,2,14,1518,5,2015,6,-1
Group 1,BB,-1.5,2,14,1519,6,2015,9,-3
Group 1,BB,-1.5,2,14,1520,4,2015,10,-6
Group 1,BB,-1.5,2,14,1521,10,2015,10,0
Group 1,BB,-1.5,2,14,1522,4,2015,7,-3
Group 1,BB,-1.5,2,14,1523,4,2015,4,0
Group 1,BB,-1.5,2,14,1524,10,2015,6,4
Group 1,BB,-1.5,2,14,1525,6,2015,6,0
Group 1,BB,-1.5,2,14,1526,10,2015,7,3
Group 1,BB,-1.5,2,14,1527,9,2015,8,1
Group 1,BB,-1.5,2,14,1528,9,2015,8,1
Group 1,BB,-1.5,2,14,1529,6,2015,7,-1
Group 1,BB,-1.5,2,14,1530,6,2015,7,-1
Group 1,BB,-1.5,2,14,1531,5,2015,7,-2
Group 1,BB,-1.5,2,14,1532,9,2015,7,2
Group 1,BB,-1.5,2,14,1533,11,2015,10,1
Group 1,BB,-1.5,2,14,1534,8,2015,9,-1
Group 1,BB,-1.5,2,14,1535,12,2015,3,9
Group 1,BB,-1.5,2,14,1536,5,2015,11,-6
Group 1,BB,-1.5,2,14,1537,6,2015,8,-2
Group 1,BB,-1.5,2,14,1538,6,2015,7,-1
Group 1,BB,-1.5,2,14,1539,5,2015,7,-2
Group 1,BB,-1.5,2,14,1540,9,2015,10,-1
Group 1,BB,-1.5,2,14,1541,10,2015,7,3
Group 1,BB,-1.5,2,14,1542,6,2015,7,-1
Group 1,BB,-1.5,2,14,1543,10,2015,5,5
Group 1,BB,-1.5,2,14,1544,6,2015,7,-1
Group 1,BB,-1.5,2,14,1545,9,2015,6,3
Group 1,BB,-1.5,2,14,1546,7,2015,5,2
Group 1,BB,-1.5,2,14,1547,9,2015,6,3
Group 1,BB,-1.5,2,14,1548,10,2015,4,6
Group 1,BB,-1.5,2,14,1549,9,2015,12,-3
Group 1,BB,-1.5,2,14,1550,9,2015,8,1
Group 1,BB,-1.5,2,14,1551,6,2015,10,-4
Group 1,BB,-1.5,2,14,1552,12,2015,4,8
Group 1,BB,-1.5,2,14,1553,9,2015,4,5
Group 1,BB,-1.5,2,14,1554,6,2015,6,0
Group 1,BB,-1.5,2,14,1555,11,2015,8,3
Group 1,BB,-1.5,2,14,1556,7,2015,2,5
Group 1,BB,-1.5,2,14,1557,7,2015,6,1
Group 1,BB,-1.5,2,14,1558,2,2015,7,-5
Group 1,BB,-1.5,2,14,1559,5,2015,6,-1
Group 1,BB,-1.5,2,14,1560,9,2015,9,0
Group 1,BB,-1.5,2,14,1561,8,2015,10,-2
Group 1,BB,-1.5,2,14,1562,7,2015,9,-2
Group 1,BB,-1.5,2,14,1563,8,2015,4,4
Group 1,BB,-1.5,2,14,1564,8,2015,6,2
Group 1,BB,-1.5,2,14,1565,11,2015,8,3
Group 1,BB,-1.5,2,14,1566,10,2015,4,6
Group 1,BB,-1.5,2,14,1567,9,2015,7,2
Group 1,BB,-1.5,2,14,1568,6,2015,4,2
Group 1,BB,-1.5,2,14,1569,10,2015,7,3
Group 1,BB,-1.5,2,14,1570,11,2015,3,8
Group 1,BB,-1.5,2,14,1571,10,2015,7,3
Group 1,BB,-1.5,2,14,1572,5,2015,8,-3
Group 1,BB,-1.5,2,14,1573,6,2015,4,2
Group 1,BB,-1.5,2,14,1574,11,2015,9,2
Group 1,BB,-1.5,2,14,1575,8,2015,11,-3
Group 1,BB,-1.5,2,14,1576,10,2015,12,-2
Group 1,BB,-1.5,2,14,1577,6,2015,6,0
Group 1,BB,-1.5,2,14,1578,10,2015,9,1
Group 1,BB,-1.5,2,14,1579,7,2015,9,-2
Group 1,BB,-1.5,2,14,1580,5,2015,7,-2
Group 1,BB,-1.5,2,14,1581,4,2015,5,-1
Group 1,BB,-1.5,2,14,1582,8,2015,8,0
Group 1,BB,-1.5,2,14,1583,7,2015,7,0
Group 1,BB,-1.5,2,14,1584,11,2015,11,0
Group 1,BB,-1.5,2,14,1585,11,2015,7,4
Group 1,BB,-1.5,2,14,1586,11,2015,4,7
Group 1,BB,-1.5,2,14,1587,8,2015,8,0
Group 1,BB,-1.5,2,14,1588,5,2015,10,-5
Group 1,BB,-1.5,2,14,1589,5,2015,6,-1
Group 1,BB,-1.5,2,14,1590,6,2015,4,2
Group 1,BB,-1.5,2,14,1591,12,2015,8,4
Group 1,BB,-1.5,2,14,1592,6,2015,7,-1
Group 1,BB,-1.5,2,14,1593,7,2015,5,2
Group 1,BB,-1.5,2,14,1594,8,2015,3,5
Group 1,BB,-1.5,2,14,1595,10,2015,7,3
Group 1,BB,-1.5,2,14,1596,7,2015,7,0
Group 1,BB,-1.5,2,14,1597,8,2015,7,1
Group 1,BB,-1.5,2,14,1598,4,2015,3,1
Group 1,BB,-1.5,2,14,1599,8,2015,5,3
Group 1,BB,-1.5,2,14,1600,8,2015,3,5
Group 1,BB,-1.5,2,14,1601,9,2015,6,3
Group 1,BB,-1.5,2,14,1602,5,2015,5,0
Group 1,BB,-1.5,2,14,1603,8,2015,10,-2
Group 1,BB,-1.5,2,14,1604,7,2015,7,0
Group 1,BB,-1.5,2,14,1605,10,2015,9,1
Group 1,BB,-1.5,2,14,1606,7,2015,11,-4
Group 1,BB,-1.5,2,14,1607,5,2015,7,-2
Group 1,BB,-1.5,2,14,1608,8,2015,5,3
Group 1,BB,-1.5,2,14,1609,8,2015,11,-3
Group 1,BB,-1.5,2,14,1610,9,2015,9,0
Group 1,BB,-1.5,2,14,1611,5,2015,8,-3
Group 1,BB,-1.5,2,14,1612,7,2015,10,-3
Group 1,BB,-1.5,2,14,1613,8,2015,6,2
Group 1,BB,-1.5,2,14,1614,5,2015,9,-4
Group 1,BB,-1.5,2,14,1615,5,2015,7,-2
Group 1,BB,-1.5,2,14,1616,11,2015,3,8
Group 1,BB,-1.5,2,14,1617,8,2015,8,0
Group 1,BB,-1.5,2,14,1618,10,2015,5,5
Group 1,BB,-1.5,2,14,1619,5,2015,6,-1
Group 1,BB,-1.5,2,14,1620,6,2015,9,-3
Group 1,BB,-1.5,2,14,1621,9,2015,6,3
Group 1,BB,-1.5,2,14,1622,9,2015,6,3
Group 1,BB,-1.5,2,14,1623,12,2015,6,6
Group 1,BB,-1.5,2,14,1624,10,2015,7,3
Group 1,BB,-1.5,2,14,1625,9,2015,7,2
Group 1,BB,-1.5,2,14,1626,6,2015,5,1
Group 1,BB,-1.5,2,14,1627,7,2015,5,2
Group 1,BB,-1.5,2,14,1628,11,2015,11,0
Group 1,BB,-1.5,2,14,1629,8,2015,11,-3
Group 1,BB,-1.5,2,14,1630,10,2015,8,2
Group 1,BB,-1.5,2,14,1631,7,2015,7,0
Group 1,BB,-1.5,2,14,1632,8,2015,11,-3
Group 1,BB,-1.5,2,14,1633,9,2015,8,1
Group 1,BB,-1.5,2,14,1634,6,2015,7,-1
Group 1,BB,-1.5,2,14,1635,7,2015,7,0
Group 1,BB,-1.5,2,14,1636,7,2015,4,3
Group 1,BB,-1.5,2,14,1637,9,2015,5,4
Group 1,BB,-1.5,2,14,1638,5,2015,7,-2
Group 1,BB,-1.5,2,14,1639,9,2015,7,2
Group 1,BB,-1.5,2,14,1640,6,2015,9,-3
Group 1,BB,-1.5,2,14,1641,4,2015,8,-4
Group 1,BB,-1.5,2,14,1642,7,2015,4,3
Group 1,BB,-1.5,2,14,1643,8,2015,7,1
Group 1,BB,-1.5,2,14,1644,7,2015,7,0
Group 1,BB,-1.5,2,14,1645,3,2015,7,-4
Group 1,BB,-1.5,2,14,1646,6,2015,7,-1
Group 1,BB,-1.5,2,14,1647,12,2015,4,8
Group 1,BB,-1.5,2,14,1648,9,2015,8,1
Group 1,BB,-1.5,2,14,1649,7,2015,6,1
Group 1,BB,-1.5,2,14,1650,11,2015,7,4
Group 1,BB,-1.5,2,14,1651,6,2015,8,-2
Group 1,BB,-1.5,2,14,1652,7,2015,7,0
Group 1,BB,-1.5,2,14,1653,6,2015,8,-2
Group 1,BB,-1.5,2,14,1654,10,2015,5,5
Group 1,BB,-1.5,2,14,1655,12,2015,10,2
Group 1,BB,-1.5,2,14,1656,9,2015,6,3
Group 1,BB,-1.5,2,14,1657,7,2015,8,-1
Group 1,BB,-1.5,2,14,1658,8,2015,11,-3
Group 1,BB,-1.5,2,14,1659,8,2015,7,1
Group 1,BB,-1.5,2,14,1660,8,2015,9,-1
Group 1,BB,-1.5,2,14,1661,5,2015,8,-3
Group 1,BB,-1.5,2,14,1662,7,2015,10,-3
Group 1,BB,-1.5,2,14,1663,10,2015,11,-1
Group 1,BB,-1.5,2,14,1664,6,2015,5,1
Group 1,BB,-1.5,2,14,1665,9,2015,6,3
Group 1,BB,-1.5,2,14,1666,8,2015,1,7
Group 1,BB,-1.5,2,14,1667,10,2015,8,2
Group 1,BB,-1.5,2,14,1668,12,2015,8,4
Group 1,BB,-1.5,2,14,1669,7,2015,9,-2
Group 1,BB,-1.5,2,14,1670,9,2015,5,4
Group 1,BB,-1.5,2,14,1671,10,2015,6,4
Group 1,BB,-1.5,2,14,1672,6,2015,5,1
Group 1,BB,-1.5,2,14,1673,10,2015,7,3
Group 1,BB,-1.5,2,14,1674,6,2015,8,-2
Group 1,BB,-1.5,2,14,1675,11,2015,7,4
Group 1,BB,-1.5,2,14,1676,6,2015,7,-1
Group 1,BB,-1.5,2,14,1677,8,2015,6,2
Group 1,BB,-1.5,2,14,1678,11,2015,7,4
Group 1,BB,-1.5,2,14,1679,10,2015,7,3
Group 1,BB,-1.5,2,14,1680,7,2015,6,1
Group 1,BB,-1.5,2,14,1681,12,2015,8,4
Group 1,BB,-1.5,2,14,1682,9,2015,7,2
Group 1,BB,-1.5,2,14,1683,9,2015,8,1
Group 1,BB,-1.5,2,14,1684,7,2015,9,-2
Group 1,BB,-1.5,2,14,1685,6,2015,8,-2
Group 1,BB,-1.5,2,14,1686,6,2015,5,1
Group 1,BB,-1.5,2,14,1687,11,2015,6,5
Group 1,BB,-1.5,2,14,1688,8,2015,7,1
Group 1,BB,-1.5,2,14,1689,10,2015,6,4
Group 1,BB,-1.5,2,14,1690,6,2015,8,-2
Group 1,BB,-1.5,2,14,1691,8,2015,8,0
Group 1,BB,-1.5,2,14,1692,6,2015,6,0
Group 1,BB,-1.5,2,14,1693,5,2015,6,-1
Group 1,BB,-1.5,2,14,1694,10,2015,8,2
Group 1,BB,-1.5,2,14,1695,9,2015,10,-1
Group 1,BB,-1.5,2,14,1696,8,2015,7,1
Group 1,BB,-1.5,2,14,1697,5,2015,7,-2
Group 1,BB,-1.5,2,14,1698,4,2015,11,-7
Group 1,BB,-1.5,2,14,1699,9,2015,4,5
Group 1,BB,-1.5,2,14,1700,8,2015,8,0
Group 1,BB,-1.5,2,14,1701,5,2015,3,2
Group 1,BB,-1.5,2,14,1702,6,2015,7,-1
Group 1,BB,-1.5,2,14,1703,7,2015,5,2
Group 1,BB,-1.5,2,14,1704,5,2015,6,-1
Group 1,BB,-1.5,2,14,1705,6,2015,8,-2
Group 1,BB,-1.5,2,14,1706,10,2015,6,4
Group 1,BB,-1.5,2,14,1707,7,2015,6,1
Group 1,BB,-1.5,2,14,1708,8,2015,5,3
Group 1,BB,-1.5,2,14,1709,5,2015,5,0
Group 1,BB,-1.5,2,14,1710,6,2015,8,-2
Group 1,BB,-1.5,2,14,1711,8,2015,7,1
Group 1,BB,-1.5,2,14,1712,6,2015,9,-3
Group 1,BB,-1.5,2,14,1713,10,2015,9,1
Group 1,BB,-1.5,2,14,1714,5,2015,7,-2
Group 1,BB,-1.5,2,14,1715,6,2015,10,-4
Group 1,BB,-1.5,2,14,1716,7,2015,9,-2
Group 1,BB,-1.5,2,14,1717,4,2015,7,-3
Group 1,BB,-1.5,2,14,1718,12,2015,5,7
Group 1,BB,-1.5,2,14,1719,9,2015,5,4
Group 1,BB,-1.5,2,14,1720,11,2015,6,5
Group 1,BB,-1.5,2,14,1721,11,2015,5,6
Group 1,BB,-1.5,2,14,1722,9,2015,7,2
Group 1,BB,-1.5,2,14,1723,8,2015,6,2
Group 1,BB,-1.5,2,14,1724,6,2015,7,-1
Group 1,BB,-1.5,2,14,1725,7,2015,6,1
Group 1,BB,-1.5,2,14,1726,6,2015,8,-2
Group 1,BB,-1.5,2,14,1727,7,2015,8,-1
Group 1,BB,-1.5,2,14,1728,6,2015,8,-2
Group 1,BB,-1.5,2,14,1729,7,2015,6,1
Group 1,BB,-1.5,2,14,1730,6,2015,8,-2
Group 1,BB,-1.5,2,14,1731,4,2015,6,-2
Group 1,BB,-1.5,2,14,1732,6,2015,9,-3
Group 1,BB,-1.5,2,14,1733,7,2015,9,-2
Group 1,BB,-1.5,2,14,1734,10,2015,7,3
Group 1,BB,-1.5,2,14,1735,5,2015,6,-1
Group 1,BB,-1.5,2,14,1736,5,2015,2,3
Group 1,BB,-1.5,2,14,1737,8,2015,8,0
Group 1,BB,-1.5,2,14,1738,5,2015,7,-2
Group 1,BB,-1.5,2,14,1739,3,2015,7,-4
Group 1,BB,-1.5,2,14,1740,8,2015,5,3
Group 1,BB,-1.5,2,14,1741,9,2015,7,2
Group 1,BB,-1.5,2,14,1742,9,2015,4,5
Group 1,BB,-1.5,2,14,1743,9,2015,2,7
Group 1,BB,-1.5,2,14,1744,6,2015,8,-2
Group 1,BB,-1.5,2,14,1745,6,2015,5,1
Group 1,BB,-1.5,2,14,1746,7,2015,12,-5
Group 1,BB,-1.5,2,14,1747,6,2015,7,-1
Group 1,BB,-1.5,2,14,1748,7,2015,8,-1
Group 1,BB,-1.5,2,14,1749,7,2015,6,1
Group 1,BB,-1.5,2,14,1750,9,2015,5,4
Group 1,BB,-1.5,2,14,1751,5,2015,7,-2
Group 1,BB,-1.5,2,14,1752,6,2015,10,-4
Group 1,BB,-1.5,2,14,1753,8,2015,9,-1
Group 1,BB,-1.5,2,14,1754,11,2015,4,7
Group 1,BB,-1.5,2,14,1755,9,2015,9,0
Group 1,BB,-1.5,2,14,1756,8,2015,6,2
Group 1,BB,-1.5,2,14,1757,6,2015,9,-3
Group 1,BB,-1.5,2,14,1758,7,2015,5,2
Group 1,BB,-1.5,2,14,1759,8,2015,0,8
Group 1,BB,-1.5,2,14,1760,10,2015,11,-1
Group 1,BB,-1.5,2,14,1761,7,2015,8,-1
Group 1,BB,-1.5,2,14,1762,8,2015,5,3
Group 1,BB,-1.5,2,14,1763,8,2015,12,-4
Group 1,BB,-1.5,2,14,1764,11,2015,7,4
Group 1,BB,-1.5,2,14,1765,11,2015,6,5
Group 1,BB,-1.5,2,14,1766,9,2015,10,-1
Group 1,BB,-1.5,2,14,1767,8,2015,5,3
Group 1,BB,-1.5,2,14,1768,6,2015,9,-3
Group 1,BB,-1.5,2,14,1769,5,2015,4,1
Group 1,BB,-1.5,2,14,1770,11,2015,8,3
Group 1,BB,-1.5,2,14,1771,5,2015,7,-2
Group 1,BB,-1.5,2,14,1772,10,2015,6,4
Group 1,BB,-1.5,2,14,1773,10,2015,6,4
Group 1,BB,-1.5,2,14,1774,8,2015,8,0
Group 1,BB,-1.5,2,14,1775,8,2015,8,0
Group 1,BB,-1.5,2,14,1776,4,2015,8,-4
Group 1,BB,-1.5,2,14,1777,4,2015,6,-2
Group 1,BB,-1.5,2,14,1778,8,2015,7,1
Group 1,BB,-1.5,2,14,1779,7,2015,9,-2
Group 1,BB,-1.5,2,14,1780,12,2015,4,8
Group 1,BB,-1.5,2,14,1781,7,2015,7,0
Group 1,BB,-1.5,2,14,1782,8,2015,8,0
Group 1,BB,-1.5,2,14,1783,10,2015,8,2
Group 1,BB,-1.5,2,14,1784,6,2015,10,-4
Group 1,BB,-1.5,2,14,1785,10,2015,7,3
Group 1,BB,-1.5,2,14,1786,5,2015,7,-2
Group 1,BB,-1.5,2,14,1787,6,2015,3,3
Group 1,BB,-1.5,2,14,1788,5,2015,3,2
Group 1,BB,-1.5,2,14,1789,10,2015,7,3
Group 1,BB,-1.5,2,14,1790,7,2015,7,0
Group 1,BB,-1.5,2,14,1791,7,2015,7,0
Group 1,BB,-1.5,2,14,1792,7,2015,6,1
Group 1,BB,-1.5,2,14,1793,7,2015,5,2
Group 1,BB,-1.5,2,14,1794,9,2015,8,1
Group 1,BB,-1.5,2,14,1795,8,2015,8,0
Group 1,BB,-1.5,2,14,1796,11,2015,3,8
Group 1,BB,-1.5,2,14,1797,9,2015,6,3
Group 1,BB,-1.5,2,14,1798,8,2015,10,-2
Group 1,BB,-1.5,2,14,1799,7,2015,10,-3
Group 1,BB,-1.5,2,14,1800,9,2015,6,3
Group 1,BB,-1.5,2,14,1801,9,2015,3,6
Group 1,BB,-1.5,2,14,1802,10,2015,8,2
Group 1,BB,-1.5,2,14,1803,7,2015,5,2
Group 1,BB,-1.5,2,14,1804,6,2015,6,0
Group 1,BB,-1.5,2,14,1805,9,2015,4,5
Group 1,BB,-1.5,2,14,1806,5,2015,4,1
Group 1,BB,-1.5,2,14,1807,5,2015,3,2
Group 1,BB,-1.5,2,14,1808,4,2015,5,-1
Group 1,BB,-1.5,2,14,1809,7,2015,7,0
Group 1,BB,-1.5,2,14,1810,8,2015,7,1
Group 1,BB,-1.5,2,14,1811,8,2015,7,1
Group 1,BB,-1.5,2,14,1812,11,2015,9,2
Group 1,BB,-1.5,2,14,1813,5,2015,4,1
Group 1,BB,-1.5,2,14,1814,9,2015,8,1
Group 1,BB,-1.5,2,14,1815,11,2015,5,6
Group 1,BB,-1.5,2,14,1816,12,2015,8,4
Group 1,BB,-1.5,2,14,1817,7,2015,6,1
Group 1,BB,-1.5,2,14,1818,6,2015,11,-5
Group 1,BB,-1.5,2,14,1819,2,2015,5,-3
Group 1,BB,-1.5,2,14,1820,6,2015,7,-1
Group 1,BB,-1.5,2,14,1821,5,2015,5,0
Group 1,BB,-1.5,2,14,1822,5,2015,5,0
Group 1,BB,-1.5,2,14,1823,9,2015,7,2
Group 1,BB,-1.5,2,14,1824,9,2015,4,5
Group 1,BB,-1.5,2,14,1825,5,2015,7,-2
Group 1,BB,-1.5,2,14,1826,4,2015,5,-1
Group 1,BB,-1.5,2,14,1827,8,2015,3,5
Group 1,BB,-1.5,2,14,1828,10,2015,7,3
Group 1,BB,-1.5,2,14,1829,6,2015,7,-1
Group 1,BB,-1.5,2,14,1830,9,2015,7,2
Group 1,BB,-1.5,2,14,1831,7,2015,7,0
Group 1,BB,-1.5,2,14,1832,9,2015,6,3
Group 1,BB,-1.5,2,14,1833,7,2015,3,4
Group 1,BB,-1.5,2,14,1834,10,2015,9,1
Group 1,BB,-1.5,2,14,1835,11,2015,7,4
Group 1,BB,-1.5,2,14,1836,7,2015,9,-2
Group 1,BB,-1.5,2,14,1837,7,2015,5,2
Group 1,BB,-1.5,2,14,1838,8,2015,6,2
Group 1,BB,-1.5,2,14,1839,7,2015,10,-3
Group 1,BB,-1.5,2,14,1840,9,2015,7,2
Group 1,BB,-1.5,2,14,1841,9,2015,8,1
Group 1,BB,-1.5,2,14,1842,6,2015,7,-1
Group 1,BB,-1.5,2,14,1843,9,2015,8,1
Group 1,BB,-1.5,2,14,1844,9,2015,6,3
Group 1,BB,-1.5,2,14,1845,10,2015,6,4
Group 1,BB,-1.5,2,14,1846,8,2015,10,-2
Group 1,BB,-1.5,2,14,1847,6,2015,4,2
Group 1,BB,-1.5,2,14,1848,9,2015,5,4
Group 1,BB,-1.5,2,14,1849,6,2015,6,0
Group 1,BB,-1.5,2,14,1850,9,2015,3,6
Group 1,BB,-1.5,2,14,1851,7,2015,9,-2
Group 1,BB,-1.5,2,14,1852,6,2015,6,0
Group 1,BB,-1.5,2,14,1853,10,2015,9,1
Group 1,BB,-1.5,2,14,1854,8,2015,10,-2
Group 1,BB,-1.5,2,14,1855,6,2015,6,0
Group 1,BB,-1.5,2,14,1856,9,2015,6,3
Group 1,BB,-1.5,2,14,1857,5,2015,3,2
Group 1,BB,-1.5,2,14,1858,7,2015,3,4
Group 1,BB,-1.5,2,14,1859,10,2015,5,5
Group 1,BB,-1.5,2,14,1860,9,2015,8,1
Group 1,BB,-1.5,2,14,1861,9,2015,11,-2
Group 1,BB,-1.5,2,14,1862,8,2015,7,1
Group 1,BB,-1.5,2,14,1863,10,2015,4,6
Group 1,BB,-1.5,2,14,1864,9,2015,7,2
Group 1,BB,-1.5,2,14,1865,11,2015,5,6
Group 1,BB,-1.5,2,14,1866,9,2015,6,3
Group 1,BB,-1.5,2,14,1867,8,2015,7,1
Group 1,BB,-1.5,2,14,1868,5,2015,10,-5
Group 1,BB,-1.5,2,14,1869,7,2015,8,-1
Group 1,BB,-1.5,2,14,1870,5,2015,9,-4
Group 1,BB,-1.5,2,14,1871,6,2015,5,1
Group 1,BB,-1.5,2,14,1872,7,2015,7,0
Group 1,BB,-1.5,2,14,1873,11,2015,7,4
Group 1,BB,-1.5,2,14,1874,9,2015,10,-1
Group 1,BB,-1.5,2,14,1875,9,2015,5,4
Group 1,BB,-1.5,2,14,1876,8,2015,8,0
Group 1,BB,-1.5,2,14,1877,8,2015,9,-1
Group 1,BB,-1.5,2,14,1878,9,2015,6,3
Group 1,BB,-1.5,2,14,1879,10,2015,9,1
Group 1,BB,-1.5,2,14,1880,8,2015,5,3
Group 1,BB,-1.5,2,14,1881,10,2015,11,-1
Group 1,BB,-1.5,2,14,1882,8,2015,3,5
Group 1,BB,-1.5,2,14,1883,1,2015,8,-7
Group 1,BB,-1.5,2,14,1884,5,2015,8,-3
Group 1,BB,-1.5,2,14,1885,9,2015,5,4
Group 1,BB,-1.5,2,14,1886,8,2015,6,2
Group 1,BB,-1.5,2,14,1887,10,2015,7,3
Group 1,BB,-1.5,2,14,1888,4,2015,6,-2
Group 1,BB,-1.5,2,14,1889,10,2015,8,2
Group 1,BB,-1.5,2,14,1890,9,2015,9,0
Group 1,BB,-1.5,2,14,1891,6,2015,9,-3
Group 1,BB,-1.5,2,14,1892,10,2015,3,7
Group 1,BB,-1.5,2,14,1893,12,2015,5,7
Group 1,BB,-1.5,2,14,1894,6,2015,3,3
Group 1,BB,-1.5,2,14,1895,5,2015,5,0
Group 1,BB,-1.5,2,14,1896,7,2015,5,2
Group 1,BB,-1.5,2,14,1897,5,2015,7,-2
Group 1,BB,-1.5,2,14,1898,10,2015,6,4
Group 1,BB,-1.5,2,14,1899,10,2015,3,7
Group 1,BB,-1.5,2,14,1900,9,2015,4,5
Group 1,BB,-1.5,2,14,1901,8,2015,9,-1
Group 1,BB,-1.5,2,14,1902,9,2015,5,4
Group 1,BB,-1.5,2,14,1903,6,2015,5,1
Group 1,BB,-1.5,2,14,1904,8,2015,8,0
Group 1,BB,-1.5,2,14,1905,9,2015,6,3
Group 1,BB,-1.5,2,14,1906,6,2015,9,-3
Group 1,BB,-1.5,2,14,1907,8,2015,4,4
Group 1,BB,-1.5,2,14,1908,7,2015,9,-2
Group 1,BB,-1.5,2,14,1909,5,2015,5,0
Group 1,BB,-1.5,2,14,1910,7,2015,8,-1
Group 1,BB,-1.5,2,14,1911,9,2015,6,3
Group 1,BB,-1.5,2,14,1912,6,2015,2,4
Group 1,BB,-1.5,2,14,1913,5,2015,7,-2
Group 1,BB,-1.5,2,14,1914,8,2015,6,2
Group 1,BB,-1.5,2,14,1915,9,2015,9,0
Group 1,BB,-1.5,2,14,1916,7,2015,9,-2
Group 1,BB,-1.5,2,14,1917,9,2015,9,0
Group 1,BB,-1.5,2,14,1918,6,2015,8,-2
Group 1,BB,-1.5,2,14,1919,6,2015,9,-3
Group 1,BB,-1.5,2,14,1920,7,2015,7,0
Group 1,BB,-1.5,2,14,1921,8,2015,4,4
Group 1,BB,-1.5,2,14,1922,5,2015,5,0
Group 1,BB,-1.5,2,14,1923,9,2015,9,0
Group 1,BB,-1.5,2,14,1924,8,2015,5,3
Group 1,BB,-1.5,2,14,1925,8,2015,8,0
Group 1,BB,-1.5,2,14,1926,8,2015,7,1
Group 1,BB,-1.5,2,14,1927,10,2015,8,2
Group 1,BB,-1.5,2,14,1928,8,2015,6,2
Group 1,BB,-1.5,2,14,1929,6,2015,8,-2
Group 1,BB,-1.5,2,14,1930,7,2015,7,0
Group 1,BB,-1.5,2,14,1931,11,2015,9,2
Group 1,BB,-1.5,2,14,1932,3,2015,4,-1
Group 1,BB,-1.5,2,14,1933,4,2015,7,-3
Group 1,BB,-1.5,2,14,1934,9,2015,10,-1
Group 1,BB,-1.5,2,14,1935,8,2015,7,1
Group 1,BB,-1.5,2,14,1936,11,2015,7,4
Group 1,BB,-1.5,2,14,1937,9,2015,8,1
Group 1,BB,-1.5,2,14,1938,4,2015,10,-6
Group 1,BB,-1.5,2,14,1939,6,2015,8,-2
Group 1,BB,-1.5,2,14,1940,11,2015,7,4
Group 1,BB,-1.5,2,14,1941,8,2015,8,0
Group 1,BB,-1.5,2,14,1942,8,2015,8,0
Group 1,BB,-1.5,2,14,1943,8,2015,6,2
Group 1,BB,-1.5,2,14,1944,6,2015,10,-4
Group 1,BB,-1.5,2,14,1945,9,2015,8,1
Group 1,BB,-1.5,2,14,1946,10,2015,10,0
Group 1,BB,-1.5,2,14,1947,9,2015,2,7
Group 1,BB,-1.5,2,14,1948,8,2015,8,0
Group 1,BB,-1.5,2,14,1949,6,2015,4,2
Group 1,BB,-1.5,2,14,1950,8,2015,9,-1
Group 1,BB,-1.5,2,14,1951,9,2015,7,2
Group 1,BB,-1.5,2,14,1952,12,2015,9,3
Group 1,BB,-1.5,2,14,1953,7,2015,8,-1
Group 1,BB,-1.5,2,14,1954,8,2015,8,0
Group 1,BB,-1.5,2,14,1955,8,2015,8,0
Group 1,BB,-1.5,2,14,1956,6,2015,10,-4
Group 1,BB,-1.5,2,14,1957,8,2015,9,-1
Group 1,BB,-1.5,2,14,1958,8,2015,7,1
Group 1,BB,-1.5,2,14,1959,5,2015,6,-1
Group 1,BB,-1.5,2,14,1960,6,2015,8,-2
Group 1,BB,-1.5,2,14,1961,6,2015,8,-2
Group 1,BB,-1.5,2,14,1962,11,2015,6,5
Group 1,BB,-1.5,2,14,1963,5,2015,8,-3
Group 1,BB,-1.5,2,14,1964,8,2015,5,3
Group 1,BB,-1.5,2,14,1965,4,2015,6,-2
Group 1,BB,-1.5,2,14,1966,8,2015,6,2
Group 1,BB,-1.5,2,14,1967,8,2015,7,1
Group 1,BB,-1.5,2,14,1968,8,2015,8,0
Group 1,BB,-1.5,2,14,1969,6,2015,9,-3
Group 1,BB,-1.5,2,14,1970,7,2015,8,-1
Group 1,BB,-1.5,2,14,1971,9,2015,2,7
Group 1,BB,-1.5,2,14,1972,4,2015,4,0
Group 1,BB,-1.5,2,14,1973,9,2015,8,1
Group 1,BB,-1.5,2,14,1974,10,2015,4,6
Group 1,BB,-1.5,2,14,1975,11,2015,6,5
Group 1,BB,-1.5,2,14,1976,7,2015,5,2
Group 1,BB,-1.5,2,14,1977,8,2015,2,6
Group 1,BB,-1.5,2,14,1978,8,2015,11,-3
Group 1,BB,-1.5,2,14,1979,10,2015,11,-1
Group 1,BB,-1.5,2,14,1980,8,2015,8,0
Group 1,BB,-1.5,2,14,1981,9,2015,9,0
Group 1,BB,-1.5,2,14,1982,9,2015,6,3
Group 1,BB,-1.5,2,14,1983,7,2015,4,3
Group 1,BB,-1.5,2,14,1984,8,2015,8,0
Group 1,BB,-1.5,2,14,1985,10,2015,8,2
Group 1,BB,-1.5,2,14,1986,11,2015,5,6
Group 1,BB,-1.5,2,14,1987,11,2015,12,-1
Group 1,BB,-1.5,2,14,1988,9,2015,10,-1
Group 1,BB,-1.5,2,14,1989,5,2015,1,4
Group 1,BB,-1.5,2,14,1990,9,2015,6,3
Group 1,BB,-1.5,2,14,1991,4,2015,6,-2
Group 1,BB,-1.5,2,14,1992,5,2015,7,-2
Group 1,BB,-1.5,2,14,1993,5,2015,5,0
Group 1,BB,-1.5,2,14,1994,9,2015,9,0
Group 1,BB,-1.5,2,14,1995,5,2015,8,-3
Group 1,BB,-1.5,2,14,1996,10,2015,12,-2
Group 1,BB,-1.5,2,14,1997,8,2015,8,0
Group 1,BB,-1.5,2,14,1998,6,2015,6,0
Group 1,BB,-1.5,2,14,1999,7,2015,8,-1
Group 1,BB,-1.5,2,14,2000,8,2015,10,-2
Group 1,BB,-1.5,2,14,2001,10,2015,6,4
Group 1,BB,-1.5,2,14,2002,7,2015,7,0
Group 1,BB,-1.5,2,14,2003,10,2015,7,3
Group 1,BB,-1.5,2,14,2004,7,2015,8,-1
Group 1,BB,-1.5,2,14,2005,8,2015,7,1
Group 1,BB,-1.5,2,14,2006,6,2015,11,-5
Group 1,BB,-1.5,2,14,2007,6,2015,7,-1
Group 1,BB,-1.5,2,14,2008,7,2015,10,-3
Group 1,BB,-1.5,2,14,2009,10,2015,5,5
Group 1,BB,-1.5,2,14,2010,10,2015,11,-1
Group 1,BB,-1.5,2,14,2011,11,2015,10,1
Group 1,BB,-1.5,2,14,2012,10,2015,8,2
Group 1,BB,-1.5,2,14,2013,7,2015,6,1
Group 1,BB,-1.5,2,14,2014,10,2015,8,2
Group 1,BB,-1.5,2,14,2015,5,2015,9,-4
Group 1,BB,-1.5,2,14,2016,7,2015,10,-3
Group 1,BB,-1.5,2,14,2017,7,2015,5,2
Group 1,BB,-1.5,2,14,2018,10,2015,7,3
Group 1,BB,-1.5,2,14,2019,5,2015,9,-4
Group 1,BB,-1.5,2,14,2020,8,2015,3,5
Group 1,BB,-1.5,2,14,2021,9,2015,4,5
Group 1,BB,-1.5,2,14,2022,5,2015,6,-1
Group 1,BB,-1.5,2,14,2023,10,2015,6,4
Group 1,BB,-1.5,2,14,2024,8,2015,6,2
Group 1,BB,-1.5,2,14,2025,8,2015,9,-1
Group 1,BB,-1.5,2,14,2026,9,2015,8,1
Group 1,BB,-1.5,2,14,2027,9,2015,7,2
Group 1,BB,-1.5,2,14,2028,8,2015,8,0
Group 1,BB,-1.5,2,14,2029,8,2015,7,1
Group 1,BB,-1.5,2,14,2030,3,2015,10,-7
Group 1,BB,-1.5,2,14,2031,11,2015,7,4
Group 1,BB,-1.5,2,14,2032,7,2015,13,-6
Group 1,BB,-1.5,2,14,2033,6,2015,10,-4
Group 1,BB,-1.5,2,14,2034,6,2015,6,0
Group 1,BB,-1.5,2,14,2035,9,2015,12,-3
Group 1,BB,-1.5,2,14,2036,6,2015,6,0
Group 1,BB,-1.5,2,14,2037,6,2015,9,-3
Group 1,BB,-1.5,2,14,2038,9,2015,8,1
Group 1,BB,-1.5,2,14,2039,9,2015,10,-1
Group 1,BB,-1.5,2,14,2040,6,2015,6,0
Group 1,BB,-1.5,2,14,2041,12,2015,8,4
Group 1,BB,-1.5,2,14,2042,3,2015,3,0
Group 1,BB,-1.5,2,14,2043,10,2015,4,6
Group 1,BB,-1.5,2,14,2044,6,2015,6,0
Group 1,BB,-1.5,2,14,2045,4,2015,7,-3
Group 1,BB,-1.5,2,14,2046,5,2015,7,-2
Group 1,BB,-1.5,2,14,2047,6,2015,9,-3
Group 1,BB,-1.5,2,14,2048,4,2015,9,-5
Group 1,BB,-1.5,2,14,2049,10,2015,5,5
Group 1,BB,-1.5,2,14,2050,11,2015,8,3
Group 1,BB,-1.5,2,14,2051,9,2015,4,5
Group 1,BB,-1.5,2,14,2052,3,2015,9,-6
Group 1,BB,-1.5,2,14,2053,8,2015,7,1
Group 1,BB,-1.5,2,14,2054,9,2015,8,1
Group 1,BB,-1.5,2,14,2055,8,2015,8,0
Group 1,BB,-1.5,2,14,2056,8,2015,3,5
Group 1,BB,-1.5,2,14,2057,7,2015,7,0
Group 1,BB,-1.5,2,14,2058,9,2015,12,-3
Group 1,BB,-1.5,2,14,2059,6,2015,6,0
Group 1,BB,-1.5,2,14,2060,11,2015,6,5
Group 1,BB,-1.5,2,14,2061,7,2015,8,-1
Group 1,BB,-1.5,2,14,2062,9,2015,5,4
Group 1,BB,-1.5,2,14,2063,6,2015,12,-6
Group 1,BB,-1.5,2,14,2064,8,2015,5,3
Group 1,BB,-1.5,2,14,2065,7,2015,5,2
Group 1,BB,-1.5,2,14,2066,6,2015,5,1
Group 1,BB,-1.5,2,14,2067,5,2015,9,-4
Group 1,BB,-1.5,2,14,2068,4,2015,4,0
Group 1,BB,-1.5,2,14,2069,5,2015,8,-3
Group 1,BB,-1.5,2,14,2070,5,2015,7,-2
Group 1,BB,-1.5,2,14,2071,6,2015,8,-2
Group 1,BB,-1.5,2,14,2072,9,2015,5,4
Group 1,BB,-1.5,2,14,2073,7,2015,8,-1
Group 1,BB,-1.5,2,14,2074,5,2015,4,1
Group 1,BB,-1.5,2,14,2075,6,2015,6,0
Group 1,BB,-1.5,2,14,2076,6,2015,8,-2
Group 1,BB,-1.5,2,14,2077,7,2015,7,0
Group 1,BB,-1.5,2,14,2078,8,2015,9,-1
Group 1,BB,-1.5,2,14,2079,6,2015,5,1
Group 1,BB,-1.5,2,14,2080,8,2015,1,7
Group 1,BB,-1.5,2,14,2081,8,2015,4,4
Group 1,BB,-1.5,2,14,2082,4,2015,6,-2
Group 1,BB,-1.5,2,14,2083,10,2015,8,2
Group 1,BB,-1.5,2,14,2084,7,2015,7,0
Group 1,BB,-1.5,2,14,2085,9,2015,7,2
Group 1,BB,-1.5,2,14,2086,6,2015,6,0
Group 1,BB,-1.5,2,14,2087,7,2015,11,-4
Group 1,BB,-1.5,2,14,2088,11,2015,8,3
Group 1,BB,-1.5,2,14,2089,7,2015,6,1
Group 1,BB,-1.5,2,14,2090,8,2015,4,4
Group 1,BB,-1.5,2,14,2091,11,2015,7,4
Group 1,BB,-1.5,2,14,2092,10,2015,6,4
Group 1,BB,-1.5,2,14,2093,10,2015,10,0
Group 1,BB,-1.5,2,14,2094,8,2015,11,-3
Group 1,BB,-1.5,2,14,2095,9,2015,6,3
Group 1,BB,-1.5,2,14,2096,7,2015,9,-2
Group 1,BB,-1.5,2,14,2097,6,2015,10,-4
Group 1,BB,-1.5,2,14,2098,8,2015,7,1
Group 1,BB,-1.5,2,14,2099,6,2015,6,0
Group 1,BB,-1.5,2,14,2100,5,2015,7,-2
Group 1,BB,-1.5,2,14,2101,5,2015,8,-3
Group 1,BB,-1.5,2,14,2102,9,2015,7,2
Group 1,BB,-1.5,2,14,2103,6,2015,7,-1
Group 1,BB,-1.5,2,14,2104,3,2015,8,-5
Group 1,BB,-1.5,2,14,2105,7,2015,9,-2
Group 1,BB,-1.5,2,14,2106,4,2015,8,-4
Group 1,BB,-1.5,2,14,2107,10,2015,7,3
Group 1,BB,-1.5,2,14,2108,10,2015,8,2
Group 1,BB,-1.5,2,14,2109,9,2015,7,2
Group 1,BB,-1.5,2,14,2110,9,2015,6,3
Group 1,BB,-1.5,2,14,2111,10,2015,8,2
Group 1,BB,-1.5,2,14,2112,10,2015,9,1
Group 1,BB,-1.5,2,14,2113,6,2015,7,-1
Group 1,BB,-1.5,2,14,2114,6,2015,5,1
Group 1,BB,-1.5,2,14,2115,4,2015,6,-2
Group 1,BB,-1.5,2,14,2116,7,2015,5,2
Group 1,BB,-1.5,2,14,2117,7,2015,8,-1
Group 1,BB,-1.5,2,14,2118,9,2015,10,-1
Group 1,BB,-1.5,2,14,2119,7,2015,10,-3
Group 1,BB,-1.5,2,14,2120,2,2015,9,-7
Group 1,BB,-1.5,2,14,2121,7,2015,11,-4
Group 1,BB,-1.5,2,14,2122,10,2015,11,-1
Group 1,BB,-1.5,2,14,2123,9,2015,7,2
Group 1,BB,-1.5,2,14,2124,5,2015,5,0
Group 1,BB,-1.5,2,14,2125,5,2015,10,-5
Group 1,BB,-1.5,2,14,2126,10,2015,11,-1
Group 1,BB,-1.5,2,14,2127,9,2015,7,2
Group 1,BB,-1.5,2,14,2128,7,2015,6,1
Group 1,BB,-1.5,2,14,2129,4,2015,7,-3
Group 1,BB,-1.5,2,14,2130,6,2015,6,0
Group 1,BB,-1.5,2,14,2131,7,2015,2,5
Group 1,BB,-1.5,2,14,2132,11,2015,2,9
Group 1,BB,-1.5,2,14,2133,10,2015,2,8
Group 1,BB,-1.5,2,14,2134,7,2015,4,3
Group 1,BB,-1.5,2,14,2135,7,2015,3,4
Group 1,BB,-1.5,2,14,2136,6,2015,8,-2
Group 1,BB,-1.5,2,14,2137,8,2015,3,5
Group 1,BB,-1.5,2,14,2138,9,2015,8,1
Group 1,BB,-1.5,2,14,2139,7,2015,3,4
Group 1,BB,-1.5,2,14,2140,8,2015,6,2
Group 1,BB,-1.5,2,14,2141,5,2015,9,-4
Group 1,BB,-1.5,2,14,2142,4,2015,8,-4
Group 1,BB,-1.5,2,14,2143,9,2015,5,4
Group 1,BB,-1.5,2,14,2144,8,2015,10,-2
Group 1,BB,-1.5,2,14,2145,5,2015,4,1
Group 1,BB,-1.5,2,14,2146,5,2015,6,-1
Group 1,BB,-1.5,2,14,2147,8,2015,7,1
Group 1,BB,-1.5,2,14,2148,6,2015,8,-2
Group 1,BB,-1.5,2,14,2149,7,2015,8,-1
Group 1,BB,-1.5,2,14,2150,8,2015,7,1
Group 1,BB,-1.5,2,14,2151,6,2015,8,-2
Group 1,BB,-1.5,2,14,2152,8,2015,10,-2
Group 1,BB,-1.5,2,14,2153,8,2015,7,1
Group 1,BB,-1.5,2,14,2154,10,2015,4,6
Group 1,BB,-1.5,2,14,2155,5,2015,3,2
Group 1,BB,-1.5,2,14,2156,11,2015,8,3
Group 1,BB,-1.5,2,14,2157,8,2015,6,2
Group 1,BB,-1.5,2,14,2158,4,2015,6,-2
Group 1,BB,-1.5,2,14,2159,10,2015,4,6
Group 1,BB,-1.5,2,14,2160,11,2015,6,5
Group 1,BB,-1.5,2,14,2161,10,2015,9,1
Group 1,BB,-1.5,2,14,2162,9,2015,7,2
Group 1,BB,-1.5,2,14,2163,9,2015,6,3
Group 1,BB,-1.5,2,14,2164,4,2015,8,-4
Group 1,BB,-1.5,2,14,2165,8,2015,4,4
Group 1,BB,-1.5,2,14,2166,7,2015,10,-3
Group 1,BB,-1.5,2,14,2167,9,2015,5,4
Group 1,BB,-1.5,2,14,2168,9,2015,5,4
Group 1,BB,-1.5,2,14,2169,6,2015,1,5
Group 1,BB,-1.5,2,14,2170,5,2015,4,1
Group 1,BB,-1.5,2,14,2171,8,2015,5,3
Group 1,BB,-1.5,2,14,2172,7,2015,2,5
Group 1,BB,-1.5,2,14,2173,12,2015,11,1
Group 1,BB,-1.5,2,14,2174,10,2015,9,1
Group 1,BB,-1.5,2,14,2175,7,2015,9,-2
Group 1,BB,-1.5,2,14,2176,6,2015,8,-2
Group 1,BB,-1.5,2,14,2177,9,2015,7,2
Group 1,BB,-1.5,2,14,2178,8,2015,8,0
Group 1,BB,-1.5,2,14,2179,8,2015,10,-2
Group 1,BB,-1.5,2,14,2180,7,2015,7,0
Group 1,BB,-1.5,2,14,2181,6,2015,7,-1
Group 1,BB,-1.5,2,14,2182,6,2015,4,2
Group 1,BB,-1.5,2,14,2183,8,2015,7,1
Group 1,BB,-1.5,2,14,2184,8,2015,7,1
Group 1,BB,-1.5,2,14,2185,8,2015,8,0
Group 1,BB,-1.5,2,14,2186,8,2015,5,3
Group 1,BB,-1.5,2,14,2187,5,2015,4,1
Group 1,BB,-1.5,2,14,2188,7,2015,6,1
Group 1,BB,-1.5,2,14,2189,6,2015,8,-2
Group 1,BB,-1.5,2,14,2190,8,2015,11,-3
Group 1,BB,-1.5,2,14,2191,8,2015,12,-4
Group 1,BB,-1.5,2,14,2192,7,2015,7,0
Group 1,BB,-1.5,2,14,2193,4,2015,8,-4
Group 1,BB,-1.5,2,14,2194,6,2015,8,-2
Group 1,BB,-1.5,2,14,2195,8,2015,6,2
Group 1,BB,-1.5,2,14,2196,12,2015,7,5
Group 1,BB,-1.5,2,14,2197,5,2015,6,-1
Group 1,BB,-1.5,2,14,2198,4,2015,6,-2
Group 1,BB,-1.5,2,14,2199,6,2015,6,0
Group 1,BB,-1.5,2,14,2200,7,2015,5,2
Group 1,BB,-1.5,2,14,2201,7,2015,3,4
Group 1,BB,-1.5,2,14,2202,11,2015,8,3
Group 1,BB,-1.5,2,14,2203,10,2015,7,3
Group 1,BB,-1.5,2,14,2204,9,2015,9,0
Group 1,BB,-1.5,2,14,2205,9,2015,9,0
Group 1,BB,-1.5,2,14,2206,8,2015,11,-3
Group 1,BB,-1.5,2,14,2207,11,2015,9,2
Group 1,BB,-1.5,2,14,2208,8,2015,4,4
Group 1,BB,-1.5,2,14,2209,8,2015,8,0
Group 1,BB,-1.5,2,14,2210,7,2015,6,1
Group 1,BB,-1.5,2,14,2211,6,2015,8,-2
Group 1,BB,-1.5,2,14,2212,5,2015,10,-5
Group 1,BB,-1.5,2,14,2213,8,2015,9,-1
Group 1,BB,-1.5,2,14,2214,8,2015,6,2
Group 1,BB,-1.5,2,14,2215,4,2015,6,-2
Group 1,BB,-1.5,2,14,2216,3,2015,8,-5
Group 1,BB,-1.5,2,14,2217,9,2015,6,3
Group 1,BB,-1.5,2,14,2218,8,2015,9,-1
Group 1,BB,-1.5,2,14,2219,6,2015,8,-2
Group 1,BB,-1.5,2,14,2220,9,2015,7,2
Group 1,BB,-1.5,2,14,2221,10,2015,9,1
Group 1,BB,-1.5,2,14,2222,10,2015,8,2
Group 1,BB,-1.5,2,14,2223,9,2015,7,2
Group 1,BB,-1.5,2,14,2224,10,2015,12,-2
Group 1,BB,-1.5,2,14,2225,8,2015,6,2
Group 1,BB,-1.5,2,14,2226,9,2015,7,2
Group 1,BB,-1.5,2,14,2227,7,2015,6,1
Group 1,BB,-1.5,2,14,2228,9,2015,10,-1
Group 1,BB,-1.5,2,14,2229,6,2015,8,-2
Group 1,BB,-1.5,2,14,2230,8,2015,9,-1
Group 1,BB,-1.5,2,14,2231,7,2015,7,0
Group 1,BB,-1.5,2,14,2232,7,2015,7,0
Group 1,BB,-1.5,2,14,2233,12,2015,5,7
Group 1,BB,-1.5,2,14,2234,7,2015,7,0
Group 1,BB,-1.5,2,14,2235,5,2015,7,-2
Group 1,BB,-1.5,2,14,2236,7,2015,7,0
Group 1,BB,-1.5,2,14,2237,9,2015,9,0
Group 1,BB,-1.5,2,14,2238,12,2015,9,3
Group 1,BB,-1.5,2,14,2239,7,2015,7,0
Group 1,BB,-1.5,2,14,2240,7,2015,9,-2
Group 1,BB,-1.5,2,14,2241,9,2015,6,3
Group 1,BB,-1.5,2,14,2242,6,2015,10,-4
Group 1,BB,-1.5,2,14,2243,9,2015,7,2
Group 1,BB,-1.5,2,14,2244,6,2015,8,-2
Group 1,BB,-1.5,2,14,2245,8,2015,6,2
Group 1,BB,-1.5,2,14,2246,7,2015,5,2
Group 1,BB,-1.5,2,14,2247,10,2015,6,4
Group 1,BB,-1.5,2,14,2248,9,2015,7,2
Group 1,BB,-1.5,2,14,2249,8,2015,3,5
Group 1,BB,-1.5,2,14,2250,11,2015,4,7
Group 1,BB,-1.5,2,14,2251,9,2015,5,4
Group 1,BB,-1.5,2,14,2252,10,2015,4,6
Group 1,BB,-1.5,2,14,2253,6,2015,3,3
Group 1,BB,-1.5,2,14,2254,10,2015,7,3
Group 1,BB,-1.5,2,14,2255,6,2015,3,3
Group 1,BB,-1.5,2,14,2256,10,2015,9,1
Group 1,BB,-1.5,2,14,2257,6,2015,10,-4
Group 1,BB,-1.5,2,14,2258,4,2015,8,-4
Group 1,BB,-1.5,2,14,2259,4,2015,6,-2
Group 1,BB,-1.5,2,14,2260,6,2015,7,-1
Group 1,BB,-1.5,2,14,2261,10,2015,4,6
Group 1,BB,-1.5,2,14,2262,8,2015,4,4
Group 1,BB,-1.5,2,14,2263,11,2015,9,2
Group 1,BB,-1.5,2,14,2264,8,2015,7,1
Group 1,BB,-1.5,2,14,2265,6,2015,9,-3
Group 1,BB,-1.5,2,14,2266,6,2015,8,-2
Group 1,BB,-1.5,2,14,2267,4,2015,9,-5
Group 1,BB,-1.5,2,14,2268,5,2015,11,-6
Group 1,BB,-1.5,2,14,2269,7,2015,5,2
Group 1,BB,-1.5,2,14,2270,7,2015,4,3
Group 1,BB,-1.5,2,14,2271,6,2015,4,2
Group 1,BB,-1.5,2,14,2272,10,2015,7,3
Group 1,BB,-1.5,2,14,2273,8,2015,9,-1
Group 1,BB,-1.5,2,14,2274,9,2015,9,0
Group 1,BB,-1.5,2,14,2275,10,2015,8,2
Group 1,BB,-1.5,2,14,2276,12,2015,8,4
Group 1,BB,-1.5,2,14,2277,6,2015,10,-4
Group 1,BB,-1.5,2,14,2278,7,2015,7,0
Group 1,BB,-1.5,2,14,2279,8,2015,7,1
Group 1,BB,-1.5,2,14,2280,3,2015,8,-5
Group 1,BB,-1.5,2,14,2281,7,2015,4,3
Group 1,BB,-1.5,2,14,2282,8,2015,11,-3
Group 1,BB,-1.5,2,14,2283,4,2015,4,0
Group 1,BB,-1.5,2,14,2284,11,2015,8,3
Group 1,BB,-1.5,2,14,2285,10,2015,7,3
Group 1,BB,-1.5,2,14,2286,6,2015,6,0
Group 1,BB,-1.5,2,14,2287,11,2015,6,5
Group 1,BB,-1.5,2,14,2288,7,2015,10,-3
Group 1,BB,-1.5,2,14,2289,5,2015,10,-5
Group 1,BB,-1.5,2,14,2290,10,2015,6,4
Group 1,BB,-1.5,2,14,2291,2,2015,6,-4
Group 1,BB,-1.5,2,14,2292,7,2015,6,1
Group 1,BB,-1.5,2,14,2293,8,2015,10,-2
Group 1,BB,-1.5,2,14,2294,5,2015,6,-1
Group 1,BB,-1.5,2,14,2295,8,2015,7,1
Group 1,BB,-1.5,2,14,2296,4,2015,10,-6
Group 1,BB,-1.5,2,14,2297,10,2015,11,-1
Group 1,BB,-1.5,2,14,2298,9,2015,6,3
Group 1,BB,-1.5,2,14,2299,9,2015,4,5
Group 1,BB,-1.5,2,14,2300,6,2015,8,-2
Group 1,BB,-1.5,2,14,2301,11,2015,10,1
Group 1,BB,-1.5,2,14,2302,10,2015,11,-1
Group 1,BB,-1.5,2,14,2303,5,2015,9,-4
Group 1,BB,-1.5,2,14,2304,7,2015,10,-3
Group 1,BB,-1.5,2,14,2305,6,2015,8,-2
Group 1,BB,-1.5,2,14,2306,4,2015,6,-2
Group 1,BB,-1.5,2,14,2307,7,2015,8,-1
Group 1,BB,-1.5,2,14,2308,7,2015,11,-4
Group 1,BB,-1.5,2,14,2309,5,2015,8,-3
Group 1,BB,-1.5,2,14,2310,9,2015,5,4
Group 1,BB,-1.5,2,14,2311,7,2015,5,2
Group 1,BB,-1.5,2,14,2312,11,2015,8,3
Group 1,BB,-1.5,2,14,2313,8,2015,10,-2
Group 1,BB,-1.5,2,14,2314,8,2015,6,2
Group 1,BB,-1.5,2,14,2315,7,2015,6,1
Group 1,BB,-1.5,2,14,2316,7,2015,7,0
Group 1,BB,-1.5,2,14,2317,7,2015,7,0
Group 1,BB,-1.5,2,14,2318,9,2015,8,1
Group 1,BB,-1.5,2,14,2319,6,2015,6,0
Group 1,BB,-1.5,2,14,2320,8,2015,6,2
Group 1,BB,-1.5,2,14,2321,4,2015,5,-1
Group 1,BB,-1.5,2,14,2322,8,2015,7,1
Group 1,BB,-1.5,2,14,2323,7,2015,11,-4
Group 1,BB,-1.5,2,14,2324,4,2015,11,-7
Group 1,BB,-1.5,2,14,2325,6,2015,8,-2
Group 1,BB,-1.5,2,14,2326,10,2015,8,2
Group 1,BB,-1.5,2,14,2327,7,2015,9,-2
Group 1,BB,-1.5,2,14,2328,7,2015,9,-2
Group 1,BB,-1.5,2,14,2329,9,2015,5,4
Group 1,BB,-1.5,2,14,2330,7,2015,8,-1
Group 1,BB,-1.5,2,14,2331,7,2015,6,1
Group 1,BB,-1.5,2,14,2332,8,2015,7,1
Group 1,BB,-1.5,2,14,2333,8,2015,9,-1
Group 1,BB,-1.5,2,14,2334,5,2015,4,1
Group 1,BB,-1.5,2,14,2335,10,2015,4,6
Group 1,BB,-1.5,2,14,2336,5,2015,7,-2
Group 1,BB,-1.5,2,14,2337,7,2015,9,-2
Group 1,BB,-1.5,2,14,2338,6,2015,9,-3
Group 1,BB,-1.5,2,14,2339,8,2015,6,2
Group 1,BB,-1.5,2,14,2340,9,2015,3,6
Group 1,BB,-1.5,2,14,2341,12,2015,6,6
Group 1,BB,-1.5,2,14,2342,8,2015,7,1
Group 1,BB,-1.5,2,14,2343,7,2015,7,0
Group 1,BB,-1.5,2,14,2344,5,2015,5,0
Group 1,BB,-1.5,2,14,2345,6,2015,7,-1
Group 1,BB,-1.5,2,14,2346,8,2015,6,2
Group 1,BB,-1.5,2,14,2347,9,2015,9,0
Group 1,BB,-1.5,2,14,2348,8,2015,6,2
Group 1,BB,-1.5,2,14,2349,7,2015,6,1
Group 1,BB,-1.5,2,14,2350,9,2015,10,-1
Group 1,BB,-1.5,2,14,2351,6,2015,4,2
Group 1,BB,-1.5,2,14,2352,7,2015,7,0
Group 1,BB,-1.5,2,14,2353,5,2015,5,0
Group 1,BB,-1.5,2,14,2354,5,2015,9,-4
Group 1,BB,-1.5,2,14,2355,7,2015,8,-1
Group 1,BB,-1.5,2,14,2356,8,2015,10,-2
Group 1,BB,-1.5,2,14,2357,8,2015,6,2
Group 1,BB,-1.5,2,14,2358,12,2015,11,1
Group 1,BB,-1.5,2,14,2359,12,2015,7,5
Group 1,BB,-1.5,2,14,2360,9,2015,7,2
Group 1,BB,-1.5,2,14,2361,6,2015,6,0
Group 1,BB,-1.5,2,14,2362,10,2015,8,2
Group 1,BB,-1.5,2,14,2363,9,2015,7,2
Group 1,BB,-1.5,2,14,2364,7,2015,8,-1
Group 1,BB,-1.5,2,14,2365,6,2015,6,0
Group 1,BB,-1.5,2,14,2366,7,2015,6,1
Group 1,BB,-1.5,2,14,2367,5,2015,7,-2
Group 1,BB,-1.5,2,14,2368,6,2015,12,-6
Group 1,BB,-1.5,2,14,2369,6,2015,8,-2
Group 1,BB,-1.5,2,14,2370,8,2015,9,-1
Group 1,BB,-1.5,2,14,2371,6,2015,6,0
Group 1,BB,-1.5,2,14,2372,2,2015,10,-8
Group 1,BB,-1.5,2,14,2373,9,2015,10,-1
Group 1,BB,-1.5,2,14,2374,10,2015,6,4
Group 1,BB,-1.5,2,14,2375,6,2015,8,-2
Group 1,BB,-1.5,2,14,2376,10,2015,4,6
Group 1,BB,-1.5,2,14,2377,10,2015,10,0
Group 1,BB,-1.5,2,14,2378,8,2015,2,6
Group 1,BB,-1.5,2,14,2379,7,2015,5,2
Group 1,BB,-1.5,2,14,2380,10,2015,9,1
Group 1,BB,-1.5,2,14,2381,6,2015,6,0
Group 1,BB,-1.5,2,14,2382,6,2015,5,1
Group 1,BB,-1.5,2,14,2383,10,2015,5,5
Group 1,BB,-1.5,2,14,2384,7,2015,6,1
Group 1,BB,-1.5,2,14,2385,8,2015,7,1
Group 1,BB,-1.5,2,14,2386,9,2015,5,4
Group 1,BB,-1.5,2,14,2387,4,2015,9,-5
Group 1,BB,-1.5,2,14,2388,6,2015,5,1
Group 1,BB,-1.5,2,14,2389,10,2015,9,1
Group 1,BB,-1.5,2,14,2390,6,2015,5,1
Group 1,BB,-1.5,2,14,2391,10,2015,9,1
Group 1,BB,-1.5,2,14,2392,7,2015,8,-1
Group 1,BB,-1.5,2,14,2393,7,2015,8,-1
Group 1,BB,-1.5,2,14,2394,8,2015,1,7
Group 1,BB,-1.5,2,14,2395,6,2015,13,-7
Group 1,BB,-1.5,2,14,2396,9,2015,5,4
Group 1,BB,-1.5,2,14,2397,10,2015,7,3
Group 1,BB,-1.5,2,14,2398,8,2015,10,-2
Group 1,BB,-1.5,2,14,2399,8,2015,6,2
Group 1,BB,-1.5,2,14,2400,9,2015,7,2
Group 1,BB,-1.5,2,14,2401,4,2015,5,-1
Group 1,BB,-1.5,2,14,2402,6,2015,5,1
Group 1,BB,-1.5,2,14,2403,10,2015,6,4
Group 1,BB,-1.5,2,14,2404,5,2015,8,-3
Group 1,BB,-1.5,2,14,2405,9,2015,4,5
Group 1,BB,-1.5,2,14,2406,4,2015,8,-4
Group 1,BB,-1.5,2,14,2407,7,2015,8,-1
Group 1,BB,-1.5,2,14,2408,9,2015,10,-1
Group 1,BB,-1.5,2,14,2409,8,2015,7,1
Group 1,BB,-1.5,2,14,2410,8,2015,6,2
Group 1,BB,-1.5,2,14,2411,11,2015,5,6
Group 1,BB,-1.5,2,14,2412,10,2015,6,4
Group 1,BB,-1.5,2,14,2413,9,2015,7,2
Group 1,BB,-1.5,2,14,2414,10,2015,10,0
Group 1,BB,-1.5,2,14,2415,10,2015,5,5
Group 1,BB,-1.5,2,14,2416,9,2015,10,-1
Group 1,BB,-1.5,2,14,2417,4,2015,10,-6
Group 1,BB,-1.5,2,14,2418,7,2015,5,2
Group 1,BB,-1.5,2,14,2419,7,2015,8,-1
Group 1,BB,-1.5,2,14,2420,12,2015,2,10
Group 1,BB,-1.5,2,14,2421,7,2015,7,0
Group 1,BB,-1.5,2,14,2422,8,2015,7,1
Group 1,BB,-1.5,2,14,2423,10,2015,9,1
Group 1,BB,-1.5,2,14,2424,7,2015,10,-3
Group 1,BB,-1.5,2,14,2425,6,2015,6,0
Group 1,BB,-1.5,2,14,2426,5,2015,11,-6
Group 1,BB,-1.5,2,14,2427,6,2015,8,-2
Group 1,BB,-1.5,2,14,2428,9,2015,5,4
Group 1,BB,-1.5,2,14,2429,10,2015,5,5
Group 1,BB,-1.5,2,14,2430,5,2015,2,3
Group 1,BB,-1.5,2,14,2431,11,2015,7,4
Group 1,BB,-1.5,2,14,2432,6,2015,8,-2
Group 1,BB,-1.5,2,14,2433,8,2015,3,5
Group 1,BB,-1.5,2,14,2434,4,2015,7,-3
Group 1,BB,-1.5,2,14,2435,5,2015,8,-3
Group 1,BB,-1.5,2,14,2436,7,2015,11,-4
Group 1,BB,-1.5,2,14,2437,6,2015,7,-1
Group 1,BB,-1.5,2,14,2438,8,2015,7,1
Group 1,BB,-1.5,2,14,2439,6,2015,5,1
Group 1,BB,-1.5,2,14,2440,10,2015,7,3
Group 1,BB,-1.5,2,14,2441,7,2015,5,2
Group 1,BB,-1.5,2,14,2442,6,2015,5,1
Group 1,BB,-1.5,2,14,2443,9,2015,7,2
Group 1,BB,-1.5,2,14,2444,10,2015,9,1
Group 1,BB,-1.5,2,14,2445,8,2015,9,-1
Group 1,BB,-1.5,2,14,2446,9,2015,7,2
Group 1,BB,-1.5,2,14,2447,5,2015,5,0
Group 1,BB,-1.5,2,14,2448,10,2015,8,2
Group 1,BB,-1.5,2,14,2449,11,2015,9,2
Group 1,BB,-1.5,2,14,2450,8,2015,7,1
Group 1,BB,-1.5,2,14,2451,8,2015,6,2
Group 1,BB,-1.5,2,14,2452,5,2015,11,-6
Group 1,BB,-1.5,2,14,2453,8,2015,7,1
Group 1,BB,-1.5,2,14,2454,10,2015,12,-2
Group 1,BB,-1.5,2,14,2455,8,2015,4,4
Group 1,BB,-1.5,2,14,2456,7,2015,8,-1
Group 1,BB,-1.5,2,14,2457,6,2015,8,-2
Group 1,BB,-1.5,2,14,2458,8,2015,5,3
Group 1,BB,-1.5,2,14,2459,4,2015,9,-5
Group 1,BB,-1.5,2,14,2460,10,2015,5,5
Group 1,BB,-1.5,2,14,2461,10,2015,9,1
Group 1,BB,-1.5,2,14,2462,7,2015,3,4
Group 1,BB,-1.5,2,14,2463,7,2015,9,-2
Group 1,BB,-1.5,2,14,2464,7,2015,9,-2
Group 1,BB,-1.5,2,14,2465,12,2015,5,7
Group 1,BB,-1.5,2,14,2466,10,2015,7,3
Group 1,BB,-1.5,2,14,2467,12,2015,9,3
Group 1,BB,-1.5,2,14,2468,7,2015,8,-1
Group 1,BB,-1.5,2,14,2469,10,2015,7,3
Group 1,BB,-1.5,2,14,2470,8,2015,4,4
Group 1,BB,-1.5,2,14,2471,10,2015,6,4
Group 1,BB,-1.5,2,14,2472,8,2015,3,5
Group 1,BB,-1.5,2,14,2473,5,2015,6,-1
Group 1,BB,-1.5,2,14,2474,10,2015,9,1
Group 1,BB,-1.5,2,14,2475,10,2015,6,4
Group 1,BB,-1.5,2,14,2476,7,2015,6,1
Group 1,BB,-1.5,2,14,2477,7,2015,9,-2
Group 1,BB,-1.5,2,14,2478,11,2015,8,3
Group 1,BB,-1.5,2,14,2479,5,2015,9,-4
Group 1,BB,-1.5,2,14,2480,4,2015,8,-4
Group 1,BB,-1.5,2,14,2481,2,2015,5,-3
Group 1,BB,-1.5,2,14,2482,3,2015,6,-3
Group 1,BB,-1.5,2,14,2483,7,2015,8,-1
Group 1,BB,-1.5,2,14,2484,8,2015,7,1
Group 1,BB,-1.5,2,14,2485,10,2015,9,1
Group 1,BB,-1.5,2,14,2486,6,2015,7,-1
Group 1,BB,-1.5,2,14,2487,8,2015,7,1
Group 1,BB,-1.5,2,14,2488,7,2015,5,2
Group 1,BB,-1.5,2,14,2489,6,2015,7,-1
Group 1,BB,-1.5,2,14,2490,9,2015,8,1
Group 1,BB,-1.5,2,14,2491,6,2015,10,-4
Group 1,BB,-1.5,2,14,2492,7,2015,7,0
Group 1,BB,-1.5,2,14,2493,10,2015,6,4
Group 1,BB,-1.5,2,14,2494,7,2015,9,-2
Group 1,BB,-1.5,2,14,2495,7,2015,7,0
Group 1,BB,-1.5,2,14,2496,7,2015,4,3
Group 1,BB,-1.5,2,14,2497,9,2015,10,-1
Group 1,BB,-1.5,2,14,2498,9,2015,4,5
Group 1,BB,-1.5,2,14,2499,9,2015,3,6
Group 1,BB,-1.5,2,14,2500,12,2015,5,7
Group 1,BB,-1.5,2,14,2501,9,2015,8,1
Group 1,BB,-1.5,2,14,2502,5,2015,10,-5
Group 1,BB,-1.5,2,14,2503,7,2015,7,0
Group 1,BB,-1.5,2,14,2504,5,2015,10,-5
Group 1,BB,-1.5,2,14,2505,6,2015,4,2
Group 1,BB,-1.5,2,14,2506,5,2015,5,0
Group 1,BB,-1.5,2,14,2507,8,2015,8,0
Group 1,BB,-1.5,2,14,2508,6,2015,10,-4
Group 1,BB,-1.5,2,14,2509,11,2015,13,-2
Group 1,BB,-1.5,2,14,2510,7,2015,8,-1
Group 1,BB,-1.5,2,14,2511,10,2015,10,0
Group 1,BB,-1.5,2,14,2512,8,2015,12,-4
Group 1,BB,-1.5,2,14,2513,7,2015,9,-2
Group 1,BB,-1.5,2,14,2514,3,2015,5,-2
Group 1,BB,-1.5,2,14,2515,9,2015,6,3
Group 1,BB,-1.5,2,14,2516,7,2015,7,0
Group 1,BB,-1.5,2,14,2517,9,2015,7,2
Group 1,BB,-1.5,2,14,2518,8,2015,8,0
Group 1,BB,-1.5,2,14,2519,7,2015,5,2
Group 1,BB,-1.5,2,14,2520,9,2015,3,6
Group 1,BB,-1.5,2,14,2521,7,2015,6,1
Group 1,BB,-1.5,2,14,2522,8,2015,5,3
Group 1,BB,-1.5,2,14,2523,3,2015,5,-2
Group 1,BB,-1.5,2,14,2524,7,2015,4,3
Group 1,BB,-1.5,2,14,2525,9,2015,10,-1
Group 1,BB,-1.5,2,14,2526,11,2015,6,5
Group 1,BB,-1.5,2,14,2527,8,2015,6,2
Group 1,BB,-1.5,2,14,2528,3,2015,5,-2
Group 1,BB,-1.5,2,14,2529,11,2015,4,7
Group 1,BB,-1.5,2,14,2530,11,2015,6,5
Group 1,BB,-1.5,2,14,2531,7,2015,4,3
Group 1,BB,-1.5,2,14,2532,8,2015,6,2
Group 1,BB,-1.5,2,14,2533,4,2015,3,1
Group 1,BB,-1.5,2,14,2534,6,2015,6,0
Group 1,BB,-1.5,2,14,2535,7,2015,7,0
Group 1,BB,-1.5,2,14,2536,9,2015,3,6
Group 1,BB,-1.5,2,14,2537,11,2015,7,4
Group 1,BB,-1.5,2,14,2538,9,2015,9,0
Group 1,BB,-1.5,2,14,2539,8,2015,9,-1
Group 1,BB,-1.5,2,14,2540,4,2015,8,-4
Group 1,BB,-1.5,2,14,2541,5,2015,6,-1
Group 1,BB,-1.5,2,14,2542,2,2015,7,-5
Group 1,BB,-1.5,2,14,2543,8,2015,6,2
Group 1,BB,-1.5,2,14,2544,6,2015,5,1
Group 1,BB,-1.5,2,14,2545,8,2015,7,1
Group 1,BB,-1.5,2,14,2546,6,2015,8,-2
Group 1,BB,-1.5,2,14,2547,6,2015,9,-3
Group 1,BB,-1.5,2,14,2548,9,2015,10,-1
Group 1,BB,-1.5,2,14,2549,5,2015,10,-5
Group 1,BB,-1.5,2,14,2550,7,2015,8,-1
Group 1,BB,-1.5,2,14,2551,7,2015,7,0
Group 1,BB,-1.5,2,14,2552,7,2015,7,0
Group 1,BB,-1.5,2,14,2553,10,2015,6,4
Group 1,BB,-1.5,2,14,2554,8,2015,9,-1
Group 1,BB,-1.5,2,14,2555,6,2015,5,1
Group 1,BB,-1.5,2,14,2556,7,2015,6,1
Group 1,BB,-1.5,2,14,2557,10,2015,6,4
Group 1,BB,-1.5,2,14,2558,4,2015,5,-1
Group 1,BB,-1.5,2,14,2559,10,2015,12,-2
Group 1,BB,-1.5,2,14,2560,7,2015,7,0
Group 1,BB,-1.5,2,14,2561,8,2015,4,4
Group 1,BB,-1.5,2,14,2562,10,2015,12,-2
Group 1,BB,-1.5,2,14,2563,5,2015,7,-2
Group 1,BB,-1.5,2,14,2564,9,2015,5,4
Group 1,BB,-1.5,2,14,2565,7,2015,9,-2
Group 1,BB,-1.5,2,14,2566,7,2015,7,0
Group 1,BB,-1.5,2,14,2567,9,2015,7,2
Group 1,BB,-1.5,2,14,2568,7,2015,13,-6
Group 1,BB,-1.5,2,14,2569,10,2015,4,6
Group 1,BB,-1.5,2,14,2570,6,2015,3,3
Group 1,BB,-1.5,2,14,2571,4,2015,6,-2
Group 1,BB,-1.5,2,14,2572,6,2015,7,-1
Group 1,BB,-1.5,2,14,2573,6,2015,7,-1
Group 1,BB,-1.5,2,14,2574,9,2015,11,-2
Group 1,BB,-1.5,2,14,2575,8,2015,5,3
Group 1,BB,-1.5,2,14,2576,7,2015,8,-1
Group 1,BB,-1.5,2,14,2577,11,2015,7,4
Group 1,BB,-1.5,2,14,2578,8,2015,7,1
Group 1,BB,-1.5,2,14,2579,5,2015,6,-1
Group 1,BB,-1.5,2,14,2580,7,2015,9,-2
Group 1,BB,-1.5,2,14,2581,7,2015,9,-2
Group 1,BB,-1.5,2,14,2582,8,2015,8,0
Group 1,BB,-1.5,2,14,2583,4,2015,6,-2
Group 1,BB,-1.5,2,14,2584,7,2015,8,-1
Group 1,BB,-1.5,2,14,2585,9,2015,10,-1
Group 1,BB,-1.5,2,14,2586,7,2015,7,0
Group 1,BB,-1.5,2,14,2587,10,2015,8,2
Group 1,BB,-1.5,2,14,2588,7,2015,8,-1
Group 1,BB,-1.5,2,14,2589,3,2015,9,-6
Group 1,BB,-1.5,2,14,2590,11,2015,11,0
Group 1,BB,-1.5,2,14,2591,7,2015,10,-3
Group 1,BB,-1.5,2,14,2592,5,2015,9,-4
Group 1,BB,-1.5,2,14,2593,10,2015,7,3
Group 1,BB,-1.5,2,14,2594,6,2015,8,-2
Group 1,BB,-1.5,2,14,2595,9,2015,10,-1
Group 1,BB,-1.5,2,14,2596,9,2015,10,-1
Group 1,BB,-1.5,2,14,2597,7,2015,11,-4
Group 1,BB,-1.5,2,14,2598,5,2015,7,-2
Group 1,BB,-1.5,2,14,2599,7,2015,5,2
Group 1,BB,-1.5,2,14,2600,12,2015,8,4
Group 1,BB,-1.5,2,14,2601,8,2015,10,-2
Group 1,BB,-1.5,2,14,2602,5,2015,6,-1
Group 1,BB,-1.5,2,14,2603,9,2015,9,0
Group 1,BB,-1.5,2,14,2604,5,2015,8,-3
Group 1,BB,-1.5,2,14,2605,8,2015,9,-1
Group 1,BB,-1.5,2,14,2606,10,2015,8,2
Group 1,BB,-1.5,2,14,2607,10,2015,2,8
Group 1,BB,-1.5,2,14,2608,12,2015,9,3
Group 1,BB,-1.5,2,14,2609,9,2015,10,-1
Group 1,BB,-1.5,2,14,2610,7,2015,6,1
Group 1,BB,-1.5,2,14,2611,6,2015,9,-3
Group 1,BB,-1.5,2,14,2612,9,2015,6,3
Group 1,BB,-1.5,2,14,2613,6,2015,7,-1
Group 1,BB,-1.5,2,14,2614,6,2015,8,-2
Group 1,BB,-1.5,2,14,2615,11,2015,3,8
Group 1,BB,-1.5,2,14,2616,5,2015,5,0
Group 1,BB,-1.5,2,14,2617,5,2015,4,1
Group 1,BB,-1.5,2,14,2618,7,2015,9,-2
Group 1,BB,-1.5,2,14,2619,9,2015,7,2
Group 1,BB,-1.5,2,14,2620,6,2015,7,-1
Group 1,BB,-1.5,2,14,2621,9,2015,7,2
Group 1,BB,-1.5,2,14,2622,9,2015,9,0
Group 1,BB,-1.5,2,14,2623,6,2015,5,1
Group 1,BB,-1.5,2,14,2624,9,2015,5,4
Group 1,BB,-1.5,2,14,2625,8,2015,8,0
Group 1,BB,-1.5,2,14,2626,6,2015,10,-4
Group 1,BB,-1.5,2,14,2627,6,2015,11,-5
Group 1,BB,-1.5,2,14,2628,7,2015,12,-5
Group 1,BB,-1.5,2,14,2629,8,2015,4,4
Group 1,BB,-1.5,2,14,2630,7,2015,10,-3
Group 1,BB,-1.5,2,14,2631,8,2015,6,2
Group 1,BB,-1.5,2,14,2632,5,2015,8,-3
Group 1,BB,-1.5,2,14,2633,7,2015,4,3
Group 1,BB,-1.5,2,14,2634,10,2015,5,5
Group 1,BB,-1.5,2,14,2635,9,2015,7,2
Group 1,BB,-1.5,2,14,2636,4,2015,6,-2
Group 1,BB,-1.5,2,14,2637,4,2015,4,0
Group 1,BB,-1.5,2,14,2638,5,2015,9,-4
Group 1,BB,-1.5,2,14,2639,4,2015,7,-3
Group 1,BB,-1.5,2,14,2640,5,2015,4,1
Group 1,BB,-1.5,2,14,2641,6,2015,8,-2
Group 1,BB,-1.5,2,14,2642,7,2015,10,-3
Group 1,BB,-1.5,2,14,2643,7,2015,5,2
Group 1,BB,-1.5,2,14,2644,6,2015,4,2
Group 1,BB,-1.5,2,14,2645,7,2015,6,1
Group 1,BB,-1.5,2,14,2646,6,2015,9,-3
Group 1,BB,-1.5,2,14,2647,10,2015,7,3
Group 1,BB,-1.5,2,14,2648,6,2015,6,0
Group 1,BB,-1.5,2,14,2649,4,2015,11,-7
Group 1,BB,-1.5,2,14,2650,6,2015,8,-2
Group 1,BB,-1.5,2,14,2651,7,2015,7,0
Group 1,BB,-1.5,2,14,2652,4,2015,9,-5
Group 1,BB,-1.5,2,14,2653,6,2015,5,1
Group 1,BB,-1.5,2,14,2654,10,2015,7,3
Group 1,BB,-1.5,2,14,2655,6,2015,10,-4
Group 1,BB,-1.5,2,14,2656,8,2015,5,3
Group 1,BB,-1.5,2,14,2657,6,2015,7,-1
Group 1,BB,-1.5,2,14,2658,9,2015,3,6
Group 1,BB,-1.5,2,14,2659,8,2015,5,3
Group 1,BB,-1.5,2,14,2660,5,2015,6,-1
Group 1,BB,-1.5,2,14,2661,7,2015,11,-4
Group 1,BB,-1.5,2,14,2662,8,2015,6,2
Group 1,BB,-1.5,2,14,2663,7,2015,8,-1
Group 1,BB,-1.5,2,14,2664,9,2015,7,2
Group 1,BB,-1.5,2,14,2665,8,2015,6,2
Group 1,BB,-1.5,2,14,2666,7,2015,6,1
Group 1,BB,-1.5,2,14,2667,10,2015,5,5
Group 1,BB,-1.5,2,14,2668,6,2015,8,-2
Group 1,BB,-1.5,2,14,2669,7,2015,4,3
Group 1,BB,-1.5,2,14,2670,10,2015,9,1
Group 1,BB,-1.5,2,14,2671,6,2015,8,-2
Group 1,BB,-1.5,2,14,2672,8,2015,8,0
Group 1,BB,-1.5,2,14,2673,10,2015,3,7
Group 1,BB,-1.5,2,14,2674,12,2015,7,5
Group 1,BB,-1.5,2,14,2675,7,2015,6,1
Group 1,BB,-1.5,2,14,2676,5,2015,5,0
Group 1,BB,-1.5,2,14,2677,7,2015,8,-1
Group 1,BB,-1.5,2,14,2678,5,2015,4,1
Group 1,BB,-1.5,2,14,2679,7,2015,8,-1
Group 1,BB,-1.5,2,14,2680,7,2015,8,-1
Group 1,BB,-1.5,2,14,2681,8,2015,5,3
Group 1,BB,-1.5,2,14,2682,8,2015,9,-1
Group 1,BB,-1.5,2,14,2683,11,2015,3,8
Group 1,BB,-1.5,2,14,2684,7,2015,7,0
Group 1,BB,-1.5,2,14,2685,8,2015,11,-3
Group 1,BB,-1.5,2,14,2686,5,2015,5,0
Group 1,BB,-1.5,2,14,2687,11,2015,5,6
Group 1,BB,-1.5,2,14,2688,8,2015,3,5
Group 1,BB,-1.5,2,14,2689,8,2015,7,1
Group 1,BB,-1.5,2,14,2690,7,2015,7,0
Group 1,BB,-1.5,2,14,2691,7,2015,8,-1
Group 1,BB,-1.5,2,14,2692,10,2015,6,4
Group 1,BB,-1.5,2,14,2693,8,2015,3,5
Group 1,BB,-1.5,2,14,2694,7,2015,5,2
Group 1,BB,-1.5,2,14,2695,10,2015,7,3
Group 1,BB,-1.5,2,14,2696,7,2015,5,2
Group 1,BB,-1.5,2,14,2697,8,2015,6,2
Group 1,BB,-1.5,2,14,2698,5,2015,10,-5
Group 1,BB,-1.5,2,14,2699,8,2015,11,-3
Group 1,BB,-1.5,2,14,2700,5,2015,12,-7
Group 1,BB,-1.5,2,14,2701,7,2015,9,-2
Group 1,BB,-1.5,2,14,2702,11,2015,4,7
Group 1,BB,-1.5,2,14,2703,11,2015,5,6
Group 1,BB,-1.5,2,14,2704,8,2015,5,3
Group 1,BB,-1.5,2,14,2705,11,2015,7,4
Group 1,BB,-1.5,2,14,2706,6,2015,10,-4
Group 1,BB,-1.5,2,14,2707,9,2015,8,1
Group 1,BB,-1.5,2,14,2708,5,2015,10,-5
Group 1,BB,-1.5,2,14,2709,9,2015,10,-1
Group 1,BB,-1.5,2,14,2710,8,2015,9,-1
Group 1,BB,-1.5,2,14,2711,8,2015,7,1
Group 1,BB,-1.5,2,14,2712,10,2015,7,3
Group 1,BB,-1.5,2,14,2713,8,2015,5,3
Group 1,BB,-1.5,2,14,2714,8,2015,12,-4
Group 1,BB,-1.5,2,14,2715,9,2015,10,-1
Group 1,BB,-1.5,2,14,2716,7,2015,5,2
Group 1,BB,-1.5,2,14,2717,5,2015,9,-4
Group 1,BB,-1.5,2,14,2718,8,2015,8,0
Group 1,BB,-1.5,2,14,2719,10,2015,6,4
Group 1,BB,-1.5,2,14,2720,4,2015,3,1
Group 1,BB,-1.5,2,14,2721,6,2015,8,-2
Group 1,BB,-1.5,2,14,2722,8,2015,11,-3
Group 1,BB,-1.5,2,14,2723,5,2015,5,0
Group 1,BB,-1.5,2,14,2724,4,2015,7,-3
Group 1,BB,-1.5,2,14,2725,6,2015,12,-6
Group 1,BB,-1.5,2,14,2726,6,2015,9,-3
Group 1,BB,-1.5,2,14,2727,4,2015,10,-6
Group 1,BB,-1.5,2,14,2728,9,2015,9,0
Group 1,BB,-1.5,2,14,2729,4,2015,8,-4
Group 1,BB,-1.5,2,14,2730,5,2015,3,2
Group 1,BB,-1.5,2,14,2731,6,2015,11,-5
Group 1,BB,-1.5,2,14,2732,7,2015,6,1
Group 1,BB,-1.5,2,14,2733,8,2015,4,4
Group 1,BB,-1.5,2,14,2734,6,2015,7,-1
Group 1,BB,-1.5,2,14,2735,6,2015,8,-2
Group 1,BB,-1.5,2,14,2736,4,2015,4,0
Group 1,BB,-1.5,2,14,2737,7,2015,7,0
Group 1,BB,-1.5,2,14,2738,9,2015,10,-1
Group 1,BB,-1.5,2,14,2739,8,2015,6,2
Group 1,BB,-1.5,2,14,2740,4,2015,5,-1
Group 1,BB,-1.5,2,14,2741,4,2015,2,2
Group 1,BB,-1.5,2,14,2742,8,2015,6,2
Group 1,BB,-1.5,2,14,2743,8,2015,8,0
Group 1,BB,-1.5,2,14,2744,11,2015,1,10
Group 1,BB,-1.5,2,14,2745,8,2015,9,-1
Group 1,BB,-1.5,2,14,2746,6,2015,6,0
Group 1,BB,-1.5,2,14,2747,10,2015,9,1
Group 1,BB,-1.5,2,14,2748,7,2015,6,1
Group 1,BB,-1.5,2,14,2749,8,2015,10,-2
Group 1,BB,-1.5,2,14,2750,7,2015,7,0
Group 1,BB,-1.5,2,14,2751,6,2015,8,-2
Group 1,BB,-1.5,2,14,2752,9,2015,6,3
Group 1,BB,-1.5,2,14,2753,9,2015,6,3
Group 1,BB,-1.5,2,14,2754,5,2015,8,-3
Group 1,BB,-1.5,2,14,2755,4,2015,6,-2
Group 1,BB,-1.5,2,14,2756,7,2015,6,1
Group 1,BB,-1.5,2,14,2757,8,2015,11,-3
Group 1,BB,-1.5,2,14,2758,9,2015,10,-1
Group 1,BB,-1.5,2,14,2759,6,2015,3,3
Group 1,BB,-1.5,2,14,2760,4,2015,5,-1
Group 1,BB,-1.5,2,14,2761,10,2015,7,3
Group 1,BB,-1.5,2,14,2762,7,2015,9,-2
Group 1,BB,-1.5,2,14,2763,8,2015,9,-1
Group 1,BB,-1.5,2,14,2764,8,2015,4,4
Group 1,BB,-1.5,2,14,2765,9,2015,4,5
Group 1,BB,-1.5,2,14,2766,8,2015,7,1
Group 1,BB,-1.5,2,14,2767,9,2015,5,4
Group 1,BB,-1.5,2,14,2768,9,2015,8,1
Group 1,BB,-1.5,2,14,2769,7,2015,8,-1
Group 1,BB,-1.5,2,14,2770,8,2015,2,6
Group 1,BB,-1.5,2,14,2771,7,2015,8,-1
Group 1,BB,-1.5,2,14,2772,9,2015,9,0
Group 1,BB,-1.5,2,14,2773,10,2015,8,2
Group 1,BB,-1.5,2,14,2774,10,2015,9,1
Group 1,BB,-1.5,2,14,2775,7,2015,9,-2
Group 1,BB,-1.5,2,14,2776,10,2015,6,4
Group 1,BB,-1.5,2,14,2777,7,2015,10,-3
Group 1,BB,-1.5,2,14,2778,7,2015,7,0
Group 1,BB,-1.5,2,14,2779,7,2015,8,-1
Group 1,BB,-1.5,2,14,2780,11,2015,10,1
Group 1,BB,-1.5,2,14,2781,6,2015,6,0
Group 1,BB,-1.5,2,14,2782,6,2015,9,-3
Group 1,BB,-1.5,2,14,2783,6,2015,8,-2
Group 1,BB,-1.5,2,14,2784,6,2015,8,-2
Group 1,BB,-1.5,2,14,2785,5,2015,6,-1
Group 1,BB,-1.5,2,14,2786,6,2015,4,2
Group 1,BB,-1.5,2,14,2787,5,2015,8,-3
Group 1,BB,-1.5,2,14,2788,6,2015,11,-5
Group 1,BB,-1.5,2,14,2789,5,2015,12,-7
Group 1,BB,-1.5,2,14,2790,8,2015,8,0
Group 1,BB,-1.5,2,14,2791,5,2015,7,-2
Group 1,BB,-1.5,2,14,2792,6,2015,7,-1
Group 1,BB,-1.5,2,14,2793,4,2015,5,-1
Group 1,BB,-1.5,2,14,2794,8,2015,7,1
Group 1,BB,-1.5,2,14,2795,8,2015,2,6
Group 1,BB,-1.5,2,14,2796,7,2015,5,2
Group 1,BB,-1.5,2,14,2797,9,2015,4,5
Group 1,BB,-1.5,2,14,2798,6,2015,11,-5
Group 1,BB,-1.5,2,14,2799,8,2015,2,6
Group 1,BB,-1.5,2,14,2800,7,2015,5,2
Group 1,BB,-1.5,2,14,2801,8,2015,9,-1
Group 1,BB,-1.5,2,14,2802,9,2015,8,1
Group 1,BB,-1.5,2,14,2803,9,2015,7,2
Group 1,BB,-1.5,2,14,2804,6,2015,9,-3
Group 1,BB,-1.5,2,14,2805,8,2015,8,0
Group 1,BB,-1.5,2,14,2806,8,2015,9,-1
Group 1,BB,-1.5,2,14,2807,4,2015,10,-6
Group 1,BB,-1.5,2,14,2808,6,2015,9,-3
Group 1,BB,-1.5,2,14,2809,9,2015,5,4
Group 1,BB,-1.5,2,14,2810,9,2015,5,4
Group 1,BB,-1.5,2,14,2811,9,2015,9,0
Group 1,BB,-1.5,2,14,2812,6,2015,6,0
Group 1,BB,-1.5,2,14,2813,7,2015,11,-4
Group 1,BB,-1.5,2,14,2814,8,2015,8,0
Group 1,BB,-1.5,2,14,2815,6,2015,8,-2
Group 1,BB,-1.5,2,14,2816,6,2015,8,-2
Group 1,BB,-1.5,2,14,2817,10,2015,8,2
Group 1,BB,-1.5,2,14,2818,6,2015,7,-1
Group 1,BB,-1.5,2,14,2819,8,2015,9,-1
Group 1,BB,-1.5,2,14,2820,6,2015,9,-3
Group 1,BB,-1.5,2,14,2821,9,2015,9,0
Group 1,BB,-1.5,2,14,2822,9,2015,8,1
Group 1,BB,-1.5,2,14,2823,7,2015,9,-2
Group 1,BB,-1.5,2,14,2824,5,2015,5,0
Group 1,BB,-1.5,2,14,2825,4,2015,7,-3
Group 1,BB,-1.5,2,14,2826,7,2015,3,4
Group 1,BB,-1.5,2,14,2827,8,2015,7,1
Group 1,BB,-1.5,2,14,2828,7,2015,8,-1
Group 1,BB,-1.5,2,14,2829,7,2015,7,0
Group 1,BB,-1.5,2,14,2830,6,2015,9,-3
Group 1,BB,-1.5,2,14,2831,7,2015,4,3
Group 1,BB,-1.5,2,14,2832,12,2015,7,5
Group 1,BB,-1.5,2,14,2833,8,2015,6,2
Group 1,BB,-1.5,2,14,2834,6,2015,10,-4
Group 1,BB,-1.5,2,14,2835,6,2015,3,3
Group 1,BB,-1.5,2,14,2836,7,2015,6,1
Group 1,BB,-1.5,2,14,2837,10,2015,8,2
Group 1,BB,-1.5,2,14,2838,7,2015,11,-4
Group 1,BB,-1.5,2,14,2839,10,2015,7,3
Group 1,BB,-1.5,2,14,2840,8,2015,4,4
Group 1,BB,-1.5,2,14,2841,6,2015,8,-2
Group 1,BB,-1.5,2,14,2842,6,2015,5,1
Group 1,BB,-1.5,2,14,2843,7,2015,5,2
Group 1,BB,-1.5,2,14,2844,6,2015,6,0
Group 1,BB,-1.5,2,14,2845,8,2015,8,0
Group 1,BB,-1.5,2,14,2846,8,2015,9,-1
Group 1,BB,-1.5,2,14,2847,8,2015,6,2
Group 1,BB,-1.5,2,14,2848,8,2015,8,0
Group 1,BB,-1.5,2,14,2849,10,2015,7,3
Group 1,BB,-1.5,2,14,2850,6,2015,7,-1
Group 1,BB,-1.5,2,14,2851,5,2015,5,0
Group 1,BB,-1.5,2,14,2852,10,2015,9,1
Group 1,BB,-1.5,2,14,2853,11,2015,10,1
Group 1,BB,-1.5,2,14,2854,8,2015,6,2
Group 1,BB,-1.5,2,14,2855,10,2015,10,0
Group 1,BB,-1.5,2,14,2856,10,2015,7,3
Group 1,BB,-1.5,2,14,2857,5,2015,4,1
Group 1,BB,-1.5,2,14,2858,4,2015,9,-5
Group 1,BB,-1.5,2,14,2859,7,2015,8,-1
Group 1,BB,-1.5,2,14,2860,8,2015,7,1
Group 1,BB,-1.5,2,14,2861,9,2015,6,3
Group 1,BB,-1.5,2,14,2862,9,2015,7,2
Group 1,BB,-1.5,2,14,2863,9,2015,3,6
Group 1,BB,-1.5,2,14,2864,7,2015,6,1
Group 1,BB,-1.5,2,14,2865,9,2015,6,3
Group 1,BB,-1.5,2,14,2866,9,2015,7,2
Group 1,BB,-1.5,2,14,2867,10,2015,5,5
Group 1,BB,-1.5,2,14,2868,8,2015,6,2
Group 1,BB,-1.5,2,14,2869,5,2015,4,1
Group 1,BB,-1.5,2,14,2870,6,2015,6,0
Group 1,BB,-1.5,2,14,2871,5,2015,9,-4
Group 1,BB,-1.5,2,14,2872,7,2015,12,-5
Group 1,BB,-1.5,2,14,2873,6,2015,13,-7
Group 1,BB,-1.5,2,14,2874,8,2015,5,3
Group 1,BB,-1.5,2,14,2875,6,2015,7,-1
Group 1,BB,-1.5,2,14,2876,10,2015,8,2
Group 1,BB,-1.5,2,14,2877,8,2015,8,0
Group 1,BB,-1.5,2,14,2878,12,2015,7,5
Group 1,BB,-1.5,2,14,2879,4,2015,7,-3
Group 1,BB,-1.5,2,14,2880,8,2015,3,5
Group 1,BB,-1.5,2,14,2881,7,2015,3,4
Group 1,BB,-1.5,2,14,2882,4,2015,7,-3
Group 1,BB,-1.5,2,14,2883,7,2015,8,-1
Group 1,BB,-1.5,2,14,2884,8,2015,10,-2
Group 1,BB,-1.5,2,14,2885,5,2015,4,1
Group 1,BB,-1.5,2,14,2886,8,2015,4,4
Group 1,BB,-1.5,2,14,2887,4,2015,4,0
Group 1,BB,-1.5,2,14,2888,6,2015,6,0
Group 1,BB,-1.5,2,14,2889,8,2015,9,-1
Group 1,BB,-1.5,2,14,2890,9,2015,8,1
Group 1,BB,-1.5,2,14,2891,11,2015,7,4
Group 1,BB,-1.5,2,14,2892,6,2015,12,-6
Group 1,BB,-1.5,2,14,2893,8,2015,8,0
Group 1,BB,-1.5,2,14,2894,9,2015,6,3
Group 1,BB,-1.5,2,14,2895,6,2015,7,-1
Group 1,BB,-1.5,2,14,2896,8,2015,7,1
Group 1,BB,-1.5,2,14,2897,8,2015,10,-2
Group 1,BB,-1.5,2,14,2898,9,2015,4,5
Group 1,BB,-1.5,2,14,2899,9,2015,7,2
Group 1,BB,-1.5,2,14,2900,7,2015,5,2
Group 1,BB,-1.5,2,14,2901,8,2015,6,2
Group 1,BB,-1.5,2,14,2902,6,2015,6,0
Group 1,BB,-1.5,2,14,2903,8,2015,6,2
Group 1,BB,-1.5,2,14,2904,13,2015,6,7
Group 1,BB,-1.5,2,14,2905,7,2015,10,-3
Group 1,BB,-1.5,2,14,2906,7,2015,6,1
Group 1,BB,-1.5,2,14,2907,11,2015,2,9
Group 1,BB,-1.5,2,14,2908,7,2015,5,2
Group 1,BB,-1.5,2,14,2909,10,2015,4,6
Group 1,BB,-1.5,2,14,2910,8,2015,8,0
Group 1,BB,-1.5,2,14,2911,6,2015,11,-5
Group 1,BB,-1.5,2,14,2912,9,2015,6,3
Group 1,BB,-1.5,2,14,2913,9,2015,7,2
Group 1,BB,-1.5,2,14,2914,4,2015,4,0
Group 1,BB,-1.5,2,14,2915,11,2015,8,3
Group 1,BB,-1.5,2,14,2916,10,2015,7,3
Group 1,BB,-1.5,2,14,2917,8,2015,5,3
Group 1,BB,-1.5,2,14,2918,7,2015,9,-2
Group 1,BB,-1.5,2,14,2919,7,2015,8,-1
Group 1,BB,-1.5,2,14,2920,6,2015,8,-2
Group 1,BB,-1.5,2,14,2921,7,2015,5,2
Group 1,BB,-1.5,2,14,2922,7,2015,9,-2
Group 1,BB,-1.5,2,14,2923,10,2015,7,3
Group 1,BB,-1.5,2,14,2924,6,2015,6,0
Group 1,BB,-1.5,2,14,2925,5,2015,5,0
Group 1,BB,-1.5,2,14,2926,9,2015,11,-2
Group 1,BB,-1.5,2,14,2927,8,2015,10,-2
Group 1,BB,-1.5,2,14,2928,8,2015,6,2
Group 1,BB,-1.5,2,14,2929,7,2015,3,4
Group 1,BB,-1.5,2,14,2930,11,2015,7,4
Group 1,BB,-1.5,2,14,2931,4,2015,5,-1
Group 1,BB,-1.5,2,14,2932,10,2015,10,0
Group 1,BB,-1.5,2,14,2933,6,2015,8,-2
Group 1,BB,-1.5,2,14,2934,7,2015,10,-3
Group 1,BB,-1.5,2,14,2935,5,2015,9,-4
Group 1,BB,-1.5,2,14,2936,7,2015,8,-1
Group 1,BB,-1.5,2,14,2937,8,2015,7,1
Group 1,BB,-1.5,2,14,2938,10,2015,4,6
Group 1,BB,-1.5,2,14,2939,9,2015,7,2
Group 1,BB,-1.5,2,14,2940,7,2015,9,-2
Group 1,BB,-1.5,2,14,2941,8,2015,10,-2
Group 1,BB,-1.5,2,14,2942,11,2015,6,5
Group 1,BB,-1.5,2,14,2943,6,2015,8,-2
Group 1,BB,-1.5,2,14,2944,9,2015,6,3
Group 1,BB,-1.5,2,14,2945,11,2015,6,5
Group 1,BB,-1.5,2,14,2946,6,2015,8,-2
Group 1,BB,-1.5,2,14,2947,6,2015,7,-1
Group 1,BB,-1.5,2,14,2948,8,2015,5,3
Group 1,BB,-1.5,2,14,2949,7,2015,7,0
Group 1,BB,-1.5,2,14,2950,9,2015,6,3
Group 1,BB,-1.5,2,14,2951,7,2015,2,5
Group 1,BB,-1.5,2,14,2952,7,2015,8,-1
Group 1,BB,-1.5,2,14,2953,11,2015,6,5
Group 1,BB,-1.5,2,14,2954,3,2015,8,-5
Group 1,BB,-1.5,2,14,2955,8,2015,4,4
Group 1,BB,-1.5,2,14,2956,9,2015,7,2
Group 1,BB,-1.5,2,14,2957,6,2015,10,-4
Group 1,BB,-1.5,2,14,2958,10,2015,9,1
Group 1,BB,-1.5,2,14,2959,5,2015,7,-2
Group 1,BB,-1.5,2,14,2960,9,2015,11,-2
Group 1,BB,-1.5,2,14,2961,7,2015,8,-1
Group 1,BB,-1.5,2,14,2962,7,2015,6,1
Group 1,BB,-1.5,2,14,2963,7,2015,8,-1
Group 1,BB,-1.5,2,14,2964,8,2015,6,2
Group 1,BB,-1.5,2,14,2965,9,2015,7,2
Group 1,BB,-1.5,2,14,2966,8,2015,9,-1
Group 1,BB,-1.5,2,14,2967,7,2015,4,3
Group 1,BB,-1.5,2,14,2968,9,2015,8,1
Group 1,BB,-1.5,2,14,2969,9,2015,6,3
Group 1,BB,-1.5,2,14,2970,8,2015,7,1
Group 1,BB,-1.5,2,14,2971,5,2015,9,-4
Group 1,BB,-1.5,2,14,2972,9,2015,9,0
Group 1,BB,-1.5,2,14,2973,6,2015,9,-3
Group 1,BB,-1.5,2,14,2974,7,2015,9,-2
Group 1,BB,-1.5,2,14,2975,7,2015,6,1
Group 1,BB,-1.5,2,14,2976,7,2015,8,-1
Group 1,BB,-1.5,2,14,2977,6,2015,8,-2
Group 1,BB,-1.5,2,14,2978,7,2015,8,-1
Group 1,BB,-1.5,2,14,2979,7,2015,8,-1
Group 1,BB,-1.5,2,14,2980,7,2015,6,1
Group 1,BB,-1.5,2,14,2981,7,2015,8,-1
Group 1,BB,-1.5,2,14,2982,7,2015,9,-2
Group 1,BB,-1.5,2,14,2983,9,2015,4,5
Group 1,BB,-1.5,2,14,2984,6,2015,4,2
Group 1,BB,-1.5,2,14,2985,9,2015,7,2
Group 1,BB,-1.5,2,14,2986,7,2015,7,0
Group 1,BB,-1.5,2,14,2987,7,2015,8,-1
Group 1,BB,-1.5,2,14,2988,7,2015,8,-1
Group 1,BB,-1.5,2,14,2989,9,2015,5,4
Group 1,BB,-1.5,2,14,2990,3,2015,6,-3
Group 1,BB,-1.5,2,14,2991,11,2015,7,4
Group 1,BB,-1.5,2,14,2992,12,2015,6,6
Group 1,BB,-1.5,2,14,2993,8,2015,8,0
Group 1,BB,-1.5,2,14,2994,6,2015,1,5
Group 1,BB,-1.5,2,14,2995,9,2015,5,4
Group 1,BB,-1.5,2,14,2996,9,2015,6,3
Group 1,BB,-1.5,2,14,2997,7,2015,9,-2
Group 1,BB,-1.5,2,14,2998,7,2015,5,2
Group 1,BB,-1.5,2,14,2999,6,2015,6,0
Group 1,BB,-1.5,2,14,3000,9,2015,12,-3
Group 1,BB,-1.5,2,14,3001,10,2015,7,3
Group 1,BB,-1.5,2,14,3002,8,2015,5,3
Group 1,BB,-1.5,2,14,3003,8,2015,10,-2
Group 1,BB,-1.5,2,14,3004,6,2015,6,0
Group 1,BB,-1.5,2,14,3005,9,2015,4,5
Group 1,BB,-1.5,2,14,3006,7,2015,5,2
Group 1,BB,-1.5,2,14,3007,7,2015,3,4
Group 1,BB,-1.5,2,14,3008,6,2015,9,-3
Group 1,BB,-1.5,2,14,3009,9,2015,9,0
Group 1,BB,-1.5,2,14,3010,5,2015,8,-3
Group 1,BB,-1.5,2,14,3011,4,2015,6,-2
Group 1,BB,-1.5,2,14,3012,9,2015,7,2
Group 1,BB,-1.5,2,14,3013,8,2015,9,-1
Group 1,BB,-1.5,2,14,3014,7,2015,4,3
Group 1,BB,-1.5,2,14,3015,5,2015,8,-3
Group 1,BB,-1.5,2,14,3016,9,2015,6,3
Group 1,BB,-1.5,2,14,3017,6,2015,7,-1
Group 1,BB,-1.5,2,14,3018,6,2015,6,0
Group 1,BB,-1.5,2,14,3019,11,2015,13,-2
Group 1,BB,-1.5,2,14,3020,7,2015,7,0
Group 1,BB,-1.5,2,14,3021,8,2015,4,4
Group 1,BB,-1.5,2,14,3022,6,2015,8,-2
Group 1,BB,-1.5,2,14,3023,8,2015,5,3
Group 1,BB,-1.5,2,14,3024,10,2015,7,3
Group 1,BB,-1.5,2,14,3025,9,2015,8,1
Group 1,BB,-1.5,2,14,3026,9,2015,6,3
Group 1,BB,-1.5,2,14,3027,10,2015,9,1
Group 1,BB,-1.5,2,14,3028,8,2015,10,-2
Group 1,BB,-1.5,2,14,3029,10,2015,10,0
Group 1,BB,-1.5,2,14,3030,10,2015,12,-2
Group 1,BB,-1.5,2,14,3031,10,2015,6,4
Group 1,BB,-1.5,2,14,3032,10,2015,4,6
Group 1,BB,-1.5,2,14,3033,9,2015,8,1
Group 1,BB,-1.5,2,14,3034,6,2015,7,-1
Group 1,BB,-1.5,2,14,3035,9,2015,6,3
Group 1,BB,-1.5,2,14,3036,7,2015,8,-1
Group 1,BB,-1.5,2,14,3037,9,2015,7,2
Group 1,BB,-1.5,2,14,3038,6,2015,8,-2
Group 1,BB,-1.5,2,14,3039,7,2015,5,2
Group 1,BB,-1.5,2,14,3040,8,2015,7,1
Group 1,BB,-1.5,2,14,3041,6,2015,6,0
Group 1,BB,-1.5,2,14,3042,8,2015,9,-1
Group 1,BB,-1.5,2,14,3043,10,2015,8,2
Group 1,BB,-1.5,2,14,3044,8,2015,4,4
Group 1,BB,-1.5,2,14,3045,9,2015,8,1
Group 1,BB,-1.5,2,14,3046,10,2015,9,1
Group 1,BB,-1.5,2,14,3047,9,2015,6,3
Group 1,BB,-1.5,2,14,3048,9,2015,6,3
Group 1,BB,-1.5,2,14,3049,10,2015,8,2
Group 1,BB,-1.5,2,14,3050,7,2015,11,-4
Group 1,BB,-1.5,2,14,3051,10,2015,9,1
Group 1,BB,-1.5,2,14,3052,10,2015,8,2
Group 1,BB,-1.5,2,14,3053,7,2015,7,0
Group 1,BB,-1.5,2,14,3054,10,2015,6,4
Group 1,BB,-1.5,2,14,3055,10,2015,5,5
Group 1,BB,-1.5,2,14,3056,6,2015,7,-1
Group 1,BB,-1.5,2,14,3057,6,2015,7,-1
Group 1,BB,-1.5,2,14,3058,6,2015,4,2
Group 1,BB,-1.5,2,14,3059,7,2015,9,-2
Group 1,BB,-1.5,2,14,3060,8,2015,7,1
Group 1,BB,-1.5,2,14,3061,11,2015,5,6
Group 1,BB,-1.5,2,14,3062,7,2015,9,-2
Group 1,BB,-1.5,2,14,3063,6,2015,10,-4
Group 1,BB,-1.5,2,14,3064,9,2015,10,-1
Group 1,BB,-1.5,2,14,3065,8,2015,6,2
Group 1,BB,-1.5,2,14,3066,5,2015,5,0
Group 1,BB,-1.5,2,14,3067,8,2015,4,4
Group 1,BB,-1.5,2,14,3068,9,2015,7,2
Group 1,BB,-1.5,2,14,3069,11,2015,7,4
Group 1,BB,-1.5,2,14,3070,8,2015,2,6
Group 1,BB,-1.5,2,14,3071,5,2015,7,-2
Group 1,BB,-1.5,2,14,3072,6,2015,7,-1
Group 1,BB,-1.5,2,14,3073,5,2015,8,-3
Group 1,BB,-1.5,2,14,3074,8,2015,6,2
Group 1,BB,-1.5,2,14,3075,7,2015,8,-1
Group 1,BB,-1.5,2,14,3076,6,2015,8,-2
Group 1,BB,-1.5,2,14,3077,5,2015,5,0
Group 1,BB,-1.5,2,14,3078,10,2015,6,4
Group 1,BB,-1.5,2,14,3079,7,2015,6,1
Group 1,BB,-1.5,2,14,3080,6,2015,7,-1
Group 1,BB,-1.5,2,14,3081,5,2015,12,-7
Group 1,BB,-1.5,2,14,3082,4,2015,4,0
Group 1,BB,-1.5,2,14,3083,11,2015,5,6
Group 1,BB,-1.5,2,14,3084,10,2015,5,5
Group 1,BB,-1.5,2,14,3085,6,2015,8,-2
Group 1,BB,-1.5,2,14,3086,8,2015,12,-4
Group 1,BB,-1.5,2,14,3087,5,2015,9,-4
Group 1,BB,-1.5,2,14,3088,9,2015,5,4
Group 1,BB,-1.5,2,14,3089,6,2015,7,-1
Group 1,BB,-1.5,2,14,3090,7,2015,8,-1
Group 1,BB,-1.5,2,14,3091,8,2015,10,-2
Group 1,BB,-1.5,2,14,3092,11,2015,8,3
Group 1,BB,-1.5,2,14,3093,8,2015,0,8
Group 1,BB,-1.5,2,14,3094,13,2015,10,3
Group 1,BB,-1.5,2,14,3095,11,2015,6,5
Group 1,BB,-1.5,2,14,3096,7,2015,9,-2
Group 1,BB,-1.5,2,14,3097,8,2015,8,0
Group 1,BB,-1.5,2,14,3098,8,2015,3,5
Group 1,BB,-1.5,2,14,3099,5,2015,3,2
Group 1,BB,-1.5,2,14,3100,8,2015,4,4
Group 1,BB,-1.5,2,14,3101,9,2015,8,1
Group 1,BB,-1.5,2,14,3102,9,2015,5,4
Group 1,BB,-1.5,2,14,3103,6,2015,5,1
Group 1,BB,-1.5,2,14,3104,6,2015,12,-6
Group 1,BB,-1.5,2,14,3105,12,2015,4,8
Group 1,BB,-1.5,2,14,3106,5,2015,8,-3
Group 1,BB,-1.5,2,14,3107,7,2015,7,0
Group 1,BB,-1.5,2,14,3108,6,2015,7,-1
Group 1,BB,-1.5,2,14,3109,5,2015,4,1
Group 1,BB,-1.5,2,14,3110,7,2015,10,-3
Group 1,BB,-1.5,2,14,3111,10,2015,8,2
Group 1,BB,-1.5,2,14,3112,6,2015,6,0
Group 1,BB,-1.5,2,14,3113,10,2015,8,2
Group 1,BB,-1.5,2,14,3114,6,2015,5,1
Group 1,BB,-1.5,2,14,3115,7,2015,7,0
Group 1,BB,-1.5,2,14,3116,9,2015,4,5
Group 1,BB,-1.5,2,14,3117,6,2015,10,-4
Group 1,BB,-1.5,2,14,3118,8,2015,4,4
Group 1,BB,-1.5,2,14,3119,7,2015,11,-4
Group 1,BB,-1.5,2,14,3120,7,2015,3,4
Group 1,BB,-1.5,2,14,3121,7,2015,3,4
Group 1,BB,-1.5,2,14,3122,6,2015,7,-1
Group 1,BB,-1.5,2,14,3123,11,2015,9,2
Group 1,BB,-1.5,2,14,3124,5,2015,6,-1
Group 1,BB,-1.5,2,14,3125,6,2015,5,1
Group 1,BB,-1.5,2,14,3126,11,2015,8,3
Group 1,BB,-1.5,2,14,3127,6,2015,6,0
Group 1,BB,-1.5,2,14,3128,5,2015,10,-5
Group 1,BB,-1.5,2,14,3129,4,2015,10,-6
Group 1,BB,-1.5,2,14,3130,6,2015,11,-5
Group 1,BB,-1.5,2,14,3131,8,2015,9,-1
Group 1,BB,-1.5,2,14,3132,7,2015,5,2
Group 1,BB,-1.5,2,14,3133,6,2015,10,-4
Group 1,BB,-1.5,2,14,3134,7,2015,8,-1
Group 1,BB,-1.5,2,14,3135,5,2015,9,-4
Group 1,BB,-1.5,2,14,3136,7,2015,6,1
Group 1,BB,-1.5,2,14,3137,6,2015,6,0
Group 1,BB,-1.5,2,14,3138,7,2015,7,0
Group 1,BB,-1.5,2,14,3139,7,2015,11,-4
Group 1,BB,-1.5,2,14,3140,9,2015,9,0
Group 1,BB,-1.5,2,14,3141,10,2015,8,2
Group 1,BB,-1.5,2,14,3142,11,2015,6,5
Group 1,BB,-1.5,2,14,3143,7,2015,13,-6
Group 1,BB,-1.5,2,14,3144,7,2015,3,4
Group 1,BB,-1.5,2,14,3145,6,2015,2,4
Group 1,BB,-1.5,2,14,3146,5,2015,2,3
Group 1,BB,-1.5,2,14,3147,7,2015,10,-3
Group 1,BB,-1.5,2,14,3148,8,2015,8,0
Group 1,BB,-1.5,2,14,3149,5,2015,9,-4
Group 1,BB,-1.5,2,14,3150,9,2015,7,2
Group 1,BB,-1.5,2,14,3151,9,2015,7,2
Group 1,BB,-1.5,2,14,3152,8,2015,5,3
Group 1,BB,-1.5,2,14,3153,9,2015,6,3
Group 1,BB,-1.5,2,14,3154,7,2015,4,3
Group 1,BB,-1.5,2,14,3155,7,2015,8,-1
Group 1,BB,-1.5,2,14,3156,8,2015,6,2
Group 1,BB,-1.5,2,14,3157,7,2015,7,0
Group 1,BB,-1.5,2,14,3158,6,2015,7,-1
Group 1,BB,-1.5,2,14,3159,6,2015,5,1
Group 1,BB,-1.5,2,14,3160,7,2015,11,-4
Group 1,BB,-1.5,2,14,3161,8,2015,10,-2
Group 1,BB,-1.5,2,14,3162,10,2015,9,1
Group 1,BB,-1.5,2,14,3163,9,2015,7,2
Group 1,BB,-1.5,2,14,3164,7,2015,5,2
Group 1,BB,-1.5,2,14,3165,9,2015,11,-2
Group 1,BB,-1.5,2,14,3166,9,2015,11,-2
Group 1,BB,-1.5,2,14,3167,7,2015,8,-1
Group 1,BB,-1.5,2,14,3168,8,2015,8,0
Group 1,BB,-1.5,2,14,3169,6,2015,11,-5
Group 1,BB,-1.5,2,14,3170,8,2015,9,-1
Group 1,BB,-1.5,2,14,3171,4,2015,5,-1
Group 1,BB,-1.5,2,14,3172,11,2015,7,4
Group 1,BB,-1.5,2,14,3173,6,2015,6,0
Group 1,BB,-1.5,2,14,3174,5,2015,9,-4
Group 1,BB,-1.5,2,14,3175,9,2015,6,3
Group 1,BB,-1.5,2,14,3176,9,2015,4,5
Group 1,BB,-1.5,2,14,3177,8,2015,6,2
Group 1,BB,-1.5,2,14,3178,9,2015,10,-1
Group 1,BB,-1.5,2,14,3179,9,2015,7,2
Group 1,BB,-1.5,2,14,3180,6,2015,10,-4
Group 1,BB,-1.5,2,14,3181,11,2015,5,6
Group 1,BB,-1.5,2,14,3182,8,2015,8,0
Group 1,BB,-1.5,2,14,3183,9,2015,10,-1
Group 1,BB,-1.5,2,14,3184,10,2015,3,7
Group 1,BB,-1.5,2,14,3185,7,2015,4,3
Group 1,BB,-1.5,2,14,3186,8,2015,7,1
Group 1,BB,-1.5,2,14,3187,7,2015,5,2
Group 1,BB,-1.5,2,14,3188,4,2015,5,-1
Group 1,BB,-1.5,2,14,3189,8,2015,5,3
Group 1,BB,-1.5,2,14,3190,6,2015,2,4
Group 1,BB,-1.5,2,14,3191,8,2015,4,4
Group 1,BB,-1.5,2,14,3192,9,2015,2,7
Group 1,BB,-1.5,2,14,3193,7,2015,7,0
Group 1,BB,-1.5,2,14,3194,9,2015,7,2
Group 1,BB,-1.5,2,14,3195,6,2015,5,1
Group 1,BB,-1.5,2,14,3196,8,2015,4,4
Group 1,BB,-1.5,2,14,3197,10,2015,3,7
Group 1,BB,-1.5,2,14,3198,7,2015,7,0
Group 1,BB,-1.5,2,14,3199,6,2015,11,-5
Group 1,BB,-1.5,2,14,3200,4,2015,10,-6
Group 1,BB,-1.5,2,14,3201,7,2015,7,0
Group 1,BB,-1.5,2,14,3202,10,2015,6,4
Group 1,BB,-1.5,2,14,3203,10,2015,9,1
Group 1,BB,-1.5,2,14,3204,10,2015,7,3
Group 1,BB,-1.5,2,14,3205,10,2015,8,2
Group 1,BB,-1.5,2,14,3206,10,2015,6,4
Group 1,BB,-1.5,2,14,3207,6,2015,6,0
Group 1,BB,-1.5,2,14,3208,4,2015,4,0
Group 1,BB,-1.5,2,14,3209,9,2015,2,7
Group 1,BB,-1.5,2,14,3210,7,2015,8,-1
Group 1,BB,-1.5,2,14,3211,12,2015,6,6
Group 1,BB,-1.5,2,14,3212,10,2015,9,1
Group 1,BB,-1.5,2,14,3213,9,2015,7,2
Group 1,BB,-1.5,2,14,3214,9,2015,10,-1
Group 1,BB,-1.5,2,14,3215,7,2015,6,1
Group 1,BB,-1.5,2,14,3216,10,2015,6,4
Group 1,BB,-1.5,2,14,3217,6,2015,9,-3
Group 1,BB,-1.5,2,14,3218,5,2015,7,-2
Group 1,BB,-1.5,2,14,3219,2,2015,7,-5
Group 1,BB,-1.5,2,14,3220,9,2015,8,1
Group 1,BB,-1.5,2,14,3221,8,2015,9,-1
Group 1,BB,-1.5,2,14,3222,8,2015,7,1
Group 1,BB,-1.5,2,14,3223,8,2015,7,1
Group 1,BB,-1.5,2,14,3224,6,2015,8,-2
Group 1,BB,-1.5,2,14,3225,11,2015,10,1
Group 1,BB,-1.5,2,14,3226,5,2015,5,0
Group 1,BB,-1.5,2,14,3227,8,2015,4,4
Group 1,BB,-1.5,2,14,3228,6,2015,6,0
Group 1,BB,-1.5,2,14,3229,12,2015,11,1
Group 1,BB,-1.5,2,14,3230,7,2015,9,-2
Group 1,BB,-1.5,2,14,3231,7,2015,9,-2
Group 1,BB,-1.5,2,14,3232,8,2015,8,0
Group 1,BB,-1.5,2,14,3233,9,2015,11,-2
Group 1,BB,-1.5,2,14,3234,4,2015,7,-3
Group 1,BB,-1.5,2,14,3235,9,2015,6,3
Group 1,BB,-1.5,2,14,3236,9,2015,7,2
Group 1,BB,-1.5,2,14,3237,9,2015,8,1
Group 1,BB,-1.5,2,14,3238,4,2015,5,-1
Group 1,BB,-1.5,2,14,3239,11,2015,6,5
Group 1,BB,-1.5,2,14,3240,9,2015,4,5
Group 1,BB,-1.5,2,14,3241,9,2015,6,3
Group 1,BB,-1.5,2,14,3242,10,2015,8,2
Group 1,BB,-1.5,2,14,3243,11,2015,9,2
Group 1,BB,-1.5,2,14,3244,6,2015,6,0
Group 1,BB,-1.5,2,14,3245,9,2015,7,2
Group 1,BB,-1.5,2,14,3246,9,2015,4,5
Group 1,BB,-1.5,2,14,3247,12,2015,7,5
Group 1,BB,-1.5,2,14,3248,7,2015,7,0
Group 1,BB,-1.5,2,14,3249,8,2015,11,-3
Group 1,BB,-1.5,2,14,3250,8,2015,6,2
Group 1,BB,-1.5,2,14,3251,4,2015,9,-5
Group 1,BB,-1.5,2,14,3252,6,2015,4,2
Group 1,BB,-1.5,2,14,3253,7,2015,9,-2
Group 1,BB,-1.5,2,14,3254,5,2015,7,-2
Group 1,BB,-1.5,2,14,3255,5,2015,7,-2
Group 1,BB,-1.5,2,14,3256,8,2015,6,2
Group 1,BB,-1.5,2,14,3257,9,2015,9,0
Group 1,BB,-1.5,2,14,3258,5,2015,4,1
Group 1,BB,-1.5,2,14,3259,9,2015,7,2
Group 1,BB,-1.5,2,14,3260,7,2015,9,-2
Group 1,BB,-1.5,2,14,3261,8,2015,10,-2
Group 1,BB,-1.5,2,14,3262,9,2015,7,2
Group 1,BB,-1.5,2,14,3263,11,2015,9,2
Group 1,BB,-1.5,2,14,3264,5,2015,9,-4
Group 1,BB,-1.5,2,14,3265,8,2015,5,3
Group 1,BB,-1.5,2,14,3266,8,2015,5,3
Group 1,BB,-1.5,2,14,3267,7,2015,8,-1
Group 1,BB,-1.5,2,14,3268,8,2015,4,4
Group 1,BB,-1.5,2,14,3269,8,2015,7,1
Group 1,BB,-1.5,2,14,3270,9,2015,10,-1
Group 1,BB,-1.5,2,14,3271,9,2015,7,2
Group 1,BB,-1.5,2,14,3272,8,2015,5,3
Group 1,BB,-1.5,2,14,3273,6,2015,5,1
Group 1,BB,-1.5,2,14,3274,5,2015,10,-5
Group 1,BB,-1.5,2,14,3275,8,2015,7,1
Group 1,BB,-1.5,2,14,3276,9,2015,9,0
Group 1,BB,-1.5,2,14,3277,10,2015,8,2
Group 1,BB,-1.5,2,14,3278,5,2015,7,-2
Group 1,BB,-1.5,2,14,3279,9,2015,9,0
Group 1,BB,-1.5,2,14,3280,6,2015,10,-4
Group 1,BB,-1.5,2,14,3281,9,2015,5,4
Group 1,BB,-1.5,2,14,3282,9,2015,9,0
Group 1,BB,-1.5,2,14,3283,7,2015,7,0
Group 1,BB,-1.5,2,14,3284,8,2015,6,2
Group 1,BB,-1.5,2,14,3285,7,2015,6,1
Group 1,BB,-1.5,2,14,3286,7,2015,4,3
Group 1,BB,-1.5,2,14,3287,7,2015,5,2
Group 1,BB,-1.5,2,14,3288,4,2015,6,-2
Group 1,BB,-1.5,2,14,3289,10,2015,8,2
Group 1,BB,-1.5,2,14,3290,6,2015,9,-3
Group 1,BB,-1.5,2,14,3291,9,2015,8,1
Group 1,BB,-1.5,2,14,3292,10,2015,6,4
Group 1,BB,-1.5,2,14,3293,7,2015,9,-2
Group 1,BB,-1.5,2,14,3294,10,2015,9,1
Group 1,BB,-1.5,2,14,3295,7,2015,11,-4
Group 1,BB,-1.5,2,14,3296,5,2015,6,-1
Group 1,BB,-1.5,2,14,3297,7,2015,5,2
Group 1,BB,-1.5,2,14,3298,4,2015,7,-3
Group 1,BB,-1.5,2,14,3299,7,2015,6,1
Group 1,BB,-1.5,2,14,3300,9,2015,10,-1
Group 1,BB,-1.5,2,14,3301,7,2015,6,1
Group 1,BB,-1.5,2,14,3302,7,2015,8,-1
Group 1,BB,-1.5,2,14,3303,9,2015,5,4
Group 1,BB,-1.5,2,14,3304,8,2015,5,3
Group 1,BB,-1.5,2,14,3305,6,2015,7,-1
Group 1,BB,-1.5,2,14,3306,8,2015,4,4
Group 1,BB,-1.5,2,14,3307,9,2015,5,4
Group 1,BB,-1.5,2,14,3308,7,2015,7,0
Group 1,BB,-1.5,2,14,3309,6,2015,3,3
Group 1,BB,-1.5,2,14,3310,7,2015,5,2
Group 1,BB,-1.5,2,14,3311,8,2015,7,1
Group 1,BB,-1.5,2,14,3312,9,2015,7,2
Group 1,BB,-1.5,2,14,3313,11,2015,6,5
Group 1,BB,-1.5,2,14,3314,2,2015,5,-3
Group 1,BB,-1.5,2,14,3315,7,2015,8,-1
Group 1,BB,-1.5,2,14,3316,8,2015,6,2
Group 1,BB,-1.5,2,14,3317,4,2015,6,-2
Group 1,BB,-1.5,2,14,3318,8,2015,8,0
Group 1,BB,-1.5,2,14,3319,11,2015,7,4
Group 1,BB,-1.5,2,14,3320,9,2015,9,0
Group 1,BB,-1.5,2,14,3321,8,2015,10,-2
Group 1,BB,-1.5,2,14,3322,9,2015,5,4
Group 1,BB,-1.5,2,14,3323,8,2015,5,3
Group 1,BB,-1.5,2,14,3324,9,2015,6,3
Group 1,BB,-1.5,2,14,3325,8,2015,4,4
Group 1,BB,-1.5,2,14,3326,7,2015,6,1
Group 1,BB,-1.5,2,14,3327,7,2015,5,2
Group 1,BB,-1.5,2,14,3328,4,2015,6,-2
Group 1,BB,-1.5,2,14,3329,7,2015,6,1
Group 1,BB,-1.5,2,14,3330,7,2015,7,0
Group 1,BB,-1.5,2,14,3331,7,2015,7,0
Group 1,BB,-1.5,2,14,3332,9,2015,5,4
Group 1,BB,-1.5,2,14,3333,10,2015,7,3
Group 1,BB,-1.5,2,14,3334,4,2015,7,-3
Group 1,BB,-1.5,2,14,3335,5,2015,6,-1
Group 1,BB,-1.5,2,14,3336,9,2015,8,1
Group 1,BB,-1.5,2,14,3337,4,2015,8,-4
Group 1,BB,-1.5,2,14,3338,4,2015,7,-3
Group 1,BB,-1.5,2,14,3339,6,2015,5,1
Group 1,BB,-1.5,2,14,3340,5,2015,7,-2
Group 1,BB,-1.5,2,14,3341,8,2015,5,3
Group 1,BB,-1.5,2,14,3342,9,2015,6,3
Group 1,BB,-1.5,2,14,3343,12,2015,6,6
Group 1,BB,-1.5,2,14,3344,8,2015,7,1
Group 1,BB,-1.5,2,14,3345,6,2015,12,-6
Group 1,BB,-1.5,2,14,3346,8,2015,6,2
Group 1,BB,-1.5,2,14,3347,7,2015,8,-1
Group 1,BB,-1.5,2,14,3348,7,2015,3,4
Group 1,BB,-1.5,2,14,3349,9,2015,7,2
Group 1,BB,-1.5,2,14,3350,10,2015,2,8
Group 1,BB,-1.5,2,14,3351,8,2015,4,4
Group 1,BB,-1.5,2,14,3352,6,2015,11,-5
Group 1,BB,-1.5,2,14,3353,8,2015,8,0
Group 1,BB,-1.5,2,14,3354,5,2015,8,-3
Group 1,BB,-1.5,2,14,3355,10,2015,9,1
Group 1,BB,-1.5,2,14,3356,10,2015,8,2
Group 1,BB,-1.5,2,14,3357,7,2015,7,0
Group 1,BB,-1.5,2,14,3358,5,2015,4,1
Group 1,BB,-1.5,2,14,3359,8,2015,8,0
Group 1,BB,-1.5,2,14,3360,1,2015,3,-2
Group 1,BB,-1.5,2,14,3361,9,2015,7,2
Group 1,BB,-1.5,2,14,3362,9,2015,9,0
Group 1,BB,-1.5,2,14,3363,9,2015,5,4
Group 1,BB,-1.5,2,14,3364,9,2015,8,1
Group 1,BB,-1.5,2,14,3365,7,2015,10,-3
Group 1,BB,-1.5,2,14,3366,6,2015,5,1
Group 1,BB,-1.5,2,14,3367,7,2015,8,-1
Group 1,BB,-1.5,2,14,3368,7,2015,4,3
Group 1,BB,-1.5,2,14,3369,8,2015,10,-2
Group 1,BB,-1.5,2,14,3370,4,2015,6,-2
Group 1,BB,-1.5,2,14,3371,8,2015,6,2
Group 1,BB,-1.5,2,14,3372,5,2015,8,-3
Group 1,BB,-1.5,2,14,3373,5,2015,9,-4
Group 1,BB,-1.5,2,14,3374,9,2015,5,4
Group 1,BB,-1.5,2,14,3375,5,2015,7,-2
Group 1,BB,-1.5,2,14,3376,10,2015,6,4
Group 1,BB,-1.5,2,14,3377,12,2015,3,9
Group 1,BB,-1.5,2,14,3378,10,2015,6,4
Group 1,BB,-1.5,2,14,3379,10,2015,6,4
Group 1,BB,-1.5,2,14,3380,8,2015,11,-3
Group 1,BB,-1.5,2,14,3381,11,2015,5,6
Group 1,BB,-1.5,2,14,3382,9,2015,6,3
Group 1,BB,-1.5,2,14,3383,9,2015,7,2
Group 1,BB,-1.5,2,14,3384,9,2015,9,0
Group 1,BB,-1.5,2,14,3385,9,2015,8,1
Group 1,BB,-1.5,2,14,3386,10,2015,7,3
Group 1,BB,-1.5,2,14,3387,9,2015,5,4
Group 1,BB,-1.5,2,14,3388,6,2015,5,1
Group 1,BB,-1.5,2,14,3389,8,2015,7,1
Group 1,BB,-1.5,2,14,3390,9,2015,7,2
Group 1,BB,-1.5,2,14,3391,9,2015,11,-2
Group 1,BB,-1.5,2,14,3392,8,2015,7,1
Group 1,BB,-1.5,2,14,3393,5,2015,8,-3
Group 1,BB,-1.5,2,14,3394,10,2015,7,3
Group 1,BB,-1.5,2,14,3395,8,2015,3,5
Group 1,BB,-1.5,2,14,3396,9,2015,7,2
Group 1,BB,-1.5,2,14,3397,5,2015,5,0
Group 1,BB,-1.5,2,14,3398,7,2015,10,-3
Group 1,BB,-1.5,2,14,3399,9,2015,10,-1
Group 1,BB,-1.5,2,14,3400,6,2015,5,1
Group 1,BB,-1.5,2,14,3401,11,2015,9,2
Group 1,BB,-1.5,2,14,3402,4,2015,7,-3
Group 1,BB,-1.5,2,14,3403,6,2015,6,0
Group 1,BB,-1.5,2,14,3404,6,2015,10,-4
Group 1,BB,-1.5,2,14,3405,5,2015,9,-4
Group 1,BB,-1.5,2,14,3406,9,2015,5,4
Group 1,BB,-1.5,2,14,3407,9,2015,4,5
Group 1,BB,-1.5,2,14,3408,10,2015,6,4
Group 1,BB,-1.5,2,14,3409,8,2015,8,0
Group 1,BB,-1.5,2,14,3410,9,2015,10,-1
Group 1,BB,-1.5,2,14,3411,4,2015,5,-1
Group 1,BB,-1.5,2,14,3412,8,2015,10,-2
Group 1,BB,-1.5,2,14,3413,7,2015,9,-2
Group 1,BB,-1.5,2,14,3414,6,2015,6,0
Group 1,BB,-1.5,2,14,3415,8,2015,7,1
Group 1,BB,-1.5,2,14,3416,10,2015,9,1
Group 1,BB,-1.5,2,14,3417,7,2015,5,2
Group 1,BB,-1.5,2,14,3418,7,2015,4,3
Group 1,BB,-1.5,2,14,3419,6,2015,1,5
Group 1,BB,-1.5,2,14,3420,10,2015,4,6
Group 1,BB,-1.5,2,14,3421,10,2015,6,4
Group 1,BB,-1.5,2,14,3422,9,2015,7,2
Group 1,BB,-1.5,2,14,3423,8,2015,5,3
Group 1,BB,-1.5,2,14,3424,11,2015,2,9
Group 1,BB,-1.5,2,14,3425,4,2015,8,-4
Group 1,BB,-1.5,2,14,3426,7,2015,7,0
Group 1,BB,-1.5,2,14,3427,6,2015,3,3
Group 1,BB,-1.5,2,14,3428,6,2015,6,0
Group 1,BB,-1.5,2,14,3429,7,2015,9,-2
Group 1,BB,-1.5,2,14,3430,7,2015,9,-2
Group 1,BB,-1.5,2,14,3431,4,2015,8,-4
Group 1,BB,-1.5,2,14,3432,5,2015,6,-1
Group 1,BB,-1.5,2,14,3433,7,2015,9,-2
Group 1,BB,-1.5,2,14,3434,5,2015,6,-1
Group 1,BB,-1.5,2,14,3435,8,2015,5,3
Group 1,BB,-1.5,2,14,3436,7,2015,5,2
Group 1,BB,-1.5,2,14,3437,9,2015,5,4
Group 1,BB,-1.5,2,14,3438,6,2015,5,1
Group 1,BB,-1.5,2,14,3439,12,2015,6,6
Group 1,BB,-1.5,2,14,3440,6,2015,9,-3
Group 1,BB,-1.5,2,14,3441,7,2015,4,3
Group 1,BB,-1.5,2,14,3442,8,2015,6,2
Group 1,BB,-1.5,2,14,3443,11,2015,8,3
Group 1,BB,-1.5,2,14,3444,10,2015,7,3
Group 1,BB,-1.5,2,14,3445,11,2015,9,2
Group 1,BB,-1.5,2,14,3446,9,2015,10,-1
Group 1,BB,-1.5,2,14,3447,9,2015,6,3
Group 1,BB,-1.5,2,14,3448,7,2015,6,1
Group 1,BB,-1.5,2,14,3449,9,2015,7,2
Group 1,BB,-1.5,2,14,3450,6,2015,6,0
Group 1,BB,-1.5,2,14,3451,7,2015,14,-7
Group 1,BB,-1.5,2,14,3452,10,2015,7,3
Group 1,BB,-1.5,2,14,3453,12,2015,10,2
Group 1,BB,-1.5,2,14,3454,10,2015,7,3
Group 1,BB,-1.5,2,14,3455,10,2015,8,2
Group 1,BB,-1.5,2,14,3456,9,2015,5,4
Group 1,BB,-1.5,2,14,3457,10,2015,10,0
Group 1,BB,-1.5,2,14,3458,6,2015,9,-3
Group 1,BB,-1.5,2,14,3459,7,2015,9,-2
Group 1,BB,-1.5,2,14,3460,7,2015,7,0
Group 1,BB,-1.5,2,14,3461,8,2015,6,2
Group 1,BB,-1.5,2,14,3462,11,2015,8,3
Group 1,BB,-1.5,2,14,3463,7,2015,9,-2
Group 1,BB,-1.5,2,14,3464,7,2015,8,-1
Group 1,BB,-1.5,2,14,3465,5,2015,10,-5
Group 1,BB,-1.5,2,14,3466,9,2015,6,3
Group 1,BB,-1.5,2,14,3467,8,2015,8,0
Group 1,BB,-1.5,2,14,3468,7,2015,8,-1
Group 1,BB,-1.5,2,14,3469,9,2015,7,2
Group 1,BB,-1.5,2,14,3470,8,2015,10,-2
Group 1,BB,-1.5,2,14,3471,10,2015,10,0
Group 1,BB,-1.5,2,14,3472,7,2015,6,1
Group 1,BB,-1.5,2,14,3473,6,2015,7,-1
Group 1,BB,-1.5,2,14,3474,8,2015,9,-1
Group 1,BB,-1.5,2,14,3475,8,2015,11,-3
Group 1,BB,-1.5,2,14,3476,8,2015,7,1
Group 1,BB,-1.5,2,14,3477,8,2015,9,-1
Group 1,BB,-1.5,2,14,3478,8,2015,4,4
Group 1,BB,-1.5,2,14,3479,10,2015,7,3
Group 1,BB,-1.5,2,14,3480,8,2015,8,0
Group 1,BB,-1.5,2,14,3481,9,2015,6,3
Group 1,BB,-1.5,2,14,3482,8,2015,5,3
Group 1,BB,-1.5,2,14,3483,12,2015,8,4
Group 1,BB,-1.5,2,14,3484,9,2015,4,5
Group 1,BB,-1.5,2,14,3485,5,2015,7,-2
Group 1,BB,-1.5,2,14,3486,7,2015,4,3
Group 1,BB,-1.5,2,14,3487,8,2015,11,-3
Group 1,BB,-1.5,2,14,3488,9,2015,5,4
Group 1,BB,-1.5,2,14,3489,9,2015,6,3
Group 1,BB,-1.5,2,14,3490,7,2015,7,0
Group 1,BB,-1.5,2,14,3491,9,2015,8,1
Group 1,BB,-1.5,2,14,3492,7,2015,6,1
Group 1,BB,-1.5,2,14,3493,7,2015,4,3
Group 1,BB,-1.5,2,14,3494,8,2015,8,0
Group 1,BB,-1.5,2,14,3495,10,2015,8,2
Group 1,BB,-1.5,2,14,3496,5,2015,12,-7
Group 1,BB,-1.5,2,14,3497,8,2015,8,0
Group 1,BB,-1.5,2,14,3498,8,2015,7,1
Group 1,BB,-1.5,2,14,3499,6,2015,8,-2
Group 1,BB,-1.5,2,14,3500,8,2015,7,1
Group 1,BB,-1.5,2,14,3501,4,2015,6,-2
Group 1,BB,-1.5,2,14,3502,9,2015,10,-1
Group 1,BB,-1.5,2,14,3503,6,2015,5,1
Group 1,BB,-1.5,2,14,3504,7,2015,6,1
Group 1,BB,-1.5,2,14,3505,10,2015,5,5
Group 1,BB,-1.5,2,14,3506,3,2015,7,-4
Group 1,BB,-1.5,2,14,3507,11,2015,9,2
Group 1,BB,-1.5,2,14,3508,7,2015,8,-1
Group 1,BB,-1.5,2,14,3509,7,2015,6,1
Group 1,BB,-1.5,2,14,3510,10,2015,7,3
Group 1,BB,-1.5,2,14,3511,7,2015,9,-2
Group 1,BB,-1.5,2,14,3512,6,2015,7,-1
Group 1,BB,-1.5,2,14,3513,4,2015,8,-4
Group 1,BB,-1.5,2,14,3514,11,2015,8,3
Group 1,BB,-1.5,2,14,3515,9,2015,10,-1
Group 1,BB,-1.5,2,14,3516,8,2015,5,3
Group 1,BB,-1.5,2,14,3517,8,2015,10,-2
Group 1,BB,-1.5,2,14,3518,7,2015,7,0
Group 1,BB,-1.5,2,14,3519,8,2015,3,5
Group 1,BB,-1.5,2,14,3520,9,2015,5,4
Group 1,BB,-1.5,2,14,3521,10,2015,7,3
Group 1,BB,-1.5,2,14,3522,7,2015,5,2
Group 1,BB,-1.5,2,14,3523,9,2015,3,6
Group 1,BB,-1.5,2,14,3524,9,2015,8,1
Group 1,BB,-1.5,2,14,3525,9,2015,11,-2
Group 1,BB,-1.5,2,14,3526,5,2015,11,-6
Group 1,BB,-1.5,2,14,3527,6,2015,7,-1
Group 1,BB,-1.5,2,14,3528,5,2015,7,-2
Group 1,BB,-1.5,2,14,3529,4,2015,5,-1
Group 1,BB,-1.5,2,14,3530,8,2015,6,2
Group 1,BB,-1.5,2,14,3531,10,2015,6,4
Group 1,BB,-1.5,2,14,3532,7,2015,8,-1
Group 1,BB,-1.5,2,14,3533,9,2015,7,2
Group 1,BB,-1.5,2,14,3534,9,2015,9,0
Group 1,BB,-1.5,2,14,3535,9,2015,6,3
Group 1,BB,-1.5,2,14,3536,4,2015,7,-3
Group 1,BB,-1.5,2,14,3537,6,2015,10,-4
Group 1,BB,-1.5,2,14,3538,6,2015,9,-3
Group 1,BB,-1.5,2,14,3539,10,2015,10,0
Group 1,BB,-1.5,2,14,3540,9,2015,8,1
Group 1,BB,-1.5,2,14,3541,7,2015,3,4
Group 1,BB,-1.5,2,14,3542,5,2015,10,-5
Group 1,BB,-1.5,2,14,3543,9,2015,9,0
Group 1,BB,-1.5,2,14,3544,6,2015,9,-3
Group 1,BB,-1.5,2,14,3545,7,2015,4,3
Group 1,BB,-1.5,2,14,3546,6,2015,9,-3
Group 1,BB,-1.5,2,14,3547,8,2015,8,0
Group 1,BB,-1.5,2,14,3548,9,2015,4,5
Group 1,BB,-1.5,2,14,3549,10,2015,5,5
Group 1,BB,-1.5,2,14,3550,9,2015,6,3
Group 1,BB,-1.5,2,14,3551,10,2015,1,9
Group 1,BB,-1.5,2,14,3552,9,2015,6,3
Group 1,BB,-1.5,2,14,3553,8,2015,4,4
Group 1,BB,-1.5,2,14,3554,8,2015,5,3
Group 1,BB,-1.5,2,14,3555,9,2015,4,5
Group 1,BB,-1.5,2,14,3556,8,2015,7,1
Group 1,BB,-1.5,2,14,3557,9,2015,8,1
Group 1,BB,-1.5,2,14,3558,6,2015,9,-3
Group 1,BB,-1.5,2,14,3559,9,2015,8,1
Group 1,BB,-1.5,2,14,3560,8,2015,13,-5
Group 1,BB,-1.5,2,14,3561,9,2015,9,0
Group 1,BB,-1.5,2,14,3562,12,2015,9,3
Group 1,BB,-1.5,2,14,3563,9,2015,9,0
Group 1,BB,-1.5,2,14,3564,5,2015,10,-5
Group 1,BB,-1.5,2,14,3565,12,2015,9,3
Group 1,BB,-1.5,2,14,3566,7,2015,8,-1
Group 1,BB,-1.5,2,14,3567,9,2015,8,1
Group 1,BB,-1.5,2,14,3568,4,2015,10,-6
Group 1,BB,-1.5,2,14,3569,6,2015,11,-5
Group 1,BB,-1.5,2,14,3570,9,2015,7,2
Group 1,BB,-1.5,2,14,3571,8,2015,5,3
Group 1,BB,-1.5,2,14,3572,7,2015,5,2
Group 1,BB,-1.5,2,14,3573,7,2015,8,-1
Group 1,BB,-1.5,2,14,3574,9,2015,7,2
Group 1,BB,-1.5,2,14,3575,3,2015,8,-5
Group 1,BB,-1.5,2,14,3576,4,2015,9,-5
Group 1,BB,-1.5,2,14,3577,8,2015,6,2
Group 1,BB,-1.5,2,14,3578,9,2015,6,3
Group 1,BB,-1.5,2,14,3579,7,2015,6,1
Group 1,BB,-1.5,2,14,3580,7,2015,10,-3
Group 1,BB,-1.5,2,14,3581,12,2015,4,8
Group 1,BB,-1.5,2,14,3582,10,2015,9,1
Group 1,BB,-1.5,2,14,3583,10,2015,9,1
Group 1,BB,-1.5,2,14,3584,7,2015,5,2
Group 1,BB,-1.5,2,14,3585,7,2015,4,3
Group 1,BB,-1.5,2,14,3586,5,2015,6,-1
Group 1,BB,-1.5,2,14,3587,9,2015,3,6
Group 1,BB,-1.5,2,14,3588,8,2015,8,0
Group 1,BB,-1.5,2,14,3589,6,2015,6,0
Group 1,BB,-1.5,2,14,3590,7,2015,5,2
Group 1,BB,-1.5,2,14,3591,7,2015,7,0
Group 1,BB,-1.5,2,14,3592,9,2015,6,3
Group 1,BB,-1.5,2,14,3593,7,2015,10,-3
Group 1,BB,-1.5,2,14,3594,10,2015,5,5
Group 1,BB,-1.5,2,14,3595,6,2015,4,2
Group 1,BB,-1.5,2,14,3596,11,2015,7,4
Group 1,BB,-1.5,2,14,3597,7,2015,5,2
Group 1,BB,-1.5,2,14,3598,9,2015,4,5
Group 1,BB,-1.5,2,14,3599,10,2015,3,7
Group 1,BB,-1.5,2,14,3600,8,2015,12,-4
Group 1,BB,-1.5,2,14,3601,6,2015,8,-2
Group 1,BB,-1.5,2,14,3602,9,2015,6,3
Group 1,BB,-1.5,2,14,3603,4,2015,9,-5
Group 1,BB,-1.5,2,14,3604,5,2015,5,0
Group 1,BB,-1.5,2,14,3605,6,2015,11,-5
Group 1,BB,-1.5,2,14,3606,7,2015,9,-2
Group 1,BB,-1.5,2,14,3607,5,2015,6,-1
Group 1,BB,-1.5,2,14,3608,8,2015,8,0
Group 1,BB,-1.5,2,14,3609,6,2015,11,-5
Group 1,BB,-1.5,2,14,3610,8,2015,5,3
Group 1,BB,-1.5,2,14,3611,8,2015,9,-1
Group 1,BB,-1.5,2,14,3612,7,2015,9,-2
Group 1,BB,-1.5,2,14,3613,8,2015,5,3
Group 1,BB,-1.5,2,14,3614,9,2015,4,5
Group 1,BB,-1.5,2,14,3615,6,2015,7,-1
Group 1,BB,-1.5,2,14,3616,7,2015,7,0
Group 1,BB,-1.5,2,14,3617,6,2015,5,1
Group 1,BB,-1.5,2,14,3618,8,2015,8,0
Group 1,BB,-1.5,2,14,3619,10,2015,6,4
Group 1,BB,-1.5,2,14,3620,4,2015,6,-2
Group 1,BB,-1.5,2,14,3621,9,2015,6,3
Group 1,BB,-1.5,2,14,3622,11,2015,11,0
Group 1,BB,-1.5,2,14,3623,10,2015,8,2
Group 1,BB,-1.5,2,14,3624,8,2015,8,0
Group 1,BB,-1.5,2,14,3625,6,2015,10,-4
Group 1,BB,-1.5,2,14,3626,8,2015,9,-1
Group 1,BB,-1.5,2,14,3627,5,2015,12,-7
Group 1,BB,-1.5,2,14,3628,5,2015,9,-4
Group 1,BB,-1.5,2,14,3629,5,2015,6,-1
Group 1,BB,-1.5,2,14,3630,6,2015,6,0
Group 1,BB,-1.5,2,14,3631,8,2015,3,5
Group 1,BB,-1.5,2,14,3632,8,2015,5,3
Group 1,BB,-1.5,2,14,3633,9,2015,4,5
Group 1,BB,-1.5,2,14,3634,11,2015,8,3
Group 1,BB,-1.5,2,14,3635,8,2015,2,6
Group 1,BB,-1.5,2,14,3636,3,2015,6,-3
Group 1,BB,-1.5,2,14,3637,9,2015,7,2
Group 1,BB,-1.5,2,14,3638,7,2015,4,3
Group 1,BB,-1.5,2,14,3639,9,2015,9,0
Group 1,BB,-1.5,2,14,3640,12,2015,8,4
Group 1,BB,-1.5,2,14,3641,7,2015,4,3
Group 1,BB,-1.5,2,14,3642,6,2015,8,-2
Group 1,BB,-1.5,2,14,3643,8,2015,9,-1
Group 1,BB,-1.5,2,14,3644,10,2015,6,4
Group 1,BB,-1.5,2,14,3645,3,2015,7,-4
Group 1,BB,-1.5,2,14,3646,6,2015,8,-2
Group 1,BB,-1.5,2,14,3647,7,2015,8,-1
Group 1,BB,-1.5,2,14,3648,7,2015,6,1
Group 1,BB,-1.5,2,14,3649,3,2015,6,-3
Group 1,BB,-1.5,2,14,3650,5,2015,10,-5
Group 1,BB,-1.5,2,14,3651,9,2015,12,-3
Group 1,BB,-1.5,2,14,3652,7,2015,10,-3
Group 1,BB,-1.5,2,14,3653,7,2015,4,3
Group 1,BB,-1.5,2,14,3654,5,2015,9,-4
Group 1,BB,-1.5,2,14,3655,6,2015,6,0
Group 1,BB,-1.5,2,14,3656,10,2015,7,3
Group 1,BB,-1.5,2,14,3657,9,2015,9,0
Group 1,BB,-1.5,2,14,3658,6,2015,8,-2
Group 1,BB,-1.5,2,14,3659,9,2015,7,2
Group 1,BB,-1.5,2,14,3660,7,2015,10,-3
Group 1,BB,-1.5,2,14,3661,7,2015,3,4
Group 1,BB,-1.5,2,14,3662,4,2015,7,-3
Group 1,BB,-1.5,2,14,3663,8,2015,5,3
Group 1,BB,-1.5,2,14,3664,9,2015,6,3
Group 1,BB,-1.5,2,14,3665,8,2015,7,1
Group 1,BB,-1.5,2,14,3666,8,2015,7,1
Group 1,BB,-1.5,2,14,3667,1,2015,8,-7
Group 1,BB,-1.5,2,14,3668,9,2015,5,4
Group 1,BB,-1.5,2,14,3669,6,2015,9,-3
Group 1,BB,-1.5,2,14,3670,8,2015,7,1
Group 1,BB,-1.5,2,14,3671,6,2015,8,-2
Group 1,BB,-1.5,2,14,3672,6,2015,4,2
Group 1,BB,-1.5,2,14,3673,6,2015,7,-1
Group 1,BB,-1.5,2,14,3674,7,2015,9,-2
Group 1,BB,-1.5,2,14,3675,7,2015,11,-4
Group 1,BB,-1.5,2,14,3676,9,2015,10,-1
Group 1,BB,-1.5,2,14,3677,6,2015,6,0
Group 1,BB,-1.5,2,14,3678,5,2015,7,-2
Group 1,BB,-1.5,2,14,3679,10,2015,7,3
Group 1,BB,-1.5,2,14,3680,8,2015,5,3
Group 1,BB,-1.5,2,14,3681,7,2015,11,-4
Group 1,BB,-1.5,2,14,3682,10,2015,8,2
Group 1,BB,-1.5,2,14,3683,8,2015,2,6
Group 1,BB,-1.5,2,14,3684,8,2015,8,0
Group 1,BB,-1.5,2,14,3685,8,2015,10,-2
Group 1,BB,-1.5,2,14,3686,9,2015,6,3
Group 1,BB,-1.5,2,14,3687,8,2015,3,5
Group 1,BB,-1.5,2,14,3688,5,2015,7,-2
Group 1,BB,-1.5,2,14,3689,7,2015,7,0
Group 1,BB,-1.5,2,14,3690,7,2015,4,3
Group 1,BB,-1.5,2,14,3691,9,2015,8,1
Group 1,BB,-1.5,2,14,3692,8,2015,10,-2
Group 1,BB,-1.5,2,14,3693,7,2015,9,-2
Group 1,BB,-1.5,2,14,3694,9,2015,10,-1
Group 1,BB,-1.5,2,14,3695,9,2015,11,-2
Group 1,BB,-1.5,2,14,3696,11,2015,8,3
Group 1,BB,-1.5,2,14,3697,5,2015,8,-3
Group 1,BB,-1.5,2,14,3698,10,2015,9,1
Group 1,BB,-1.5,2,14,3699,8,2015,8,0
Group 1,BB,-1.5,2,14,3700,9,2015,10,-1
Group 1,BB,-1.5,2,14,3701,12,2015,10,2
Group 1,BB,-1.5,2,14,3702,9,2015,6,3
Group 1,BB,-1.5,2,14,3703,9,2015,6,3
Group 1,BB,-1.5,2,14,3704,9,2015,6,3
Group 1,BB,-1.5,2,14,3705,8,2015,10,-2
Group 1,BB,-1.5,2,14,3706,9,2015,7,2
Group 1,BB,-1.5,2,14,3707,9,2015,6,3
Group 1,BB,-1.5,2,14,3708,7,2015,8,-1
Group 1,BB,-1.5,2,14,3709,6,2015,4,2
Group 1,BB,-1.5,2,14,3710,7,2015,9,-2
Group 1,BB,-1.5,2,14,3711,11,2015,11,0
Group 1,BB,-1.5,2,14,3712,6,2015,6,0
Group 1,BB,-1.5,2,14,3713,11,2015,6,5
Group 1,BB,-1.5,2,14,3714,5,2015,3,2
Group 1,BB,-1.5,2,14,3715,10,2015,8,2
Group 1,BB,-1.5,2,14,3716,6,2015,3,3
Group 1,BB,-1.5,2,14,3717,3,2015,9,-6
Group 1,BB,-1.5,2,14,3718,9,2015,8,1
Group 1,BB,-1.5,2,14,3719,7,2015,7,0
Group 1,BB,-1.5,2,14,3720,10,2015,6,4
Group 1,BB,-1.5,2,14,3721,10,2015,5,5
Group 1,BB,-1.5,2,14,3722,7,2015,5,2
Group 1,BB,-1.5,2,14,3723,8,2015,9,-1
Group 1,BB,-1.5,2,14,3724,9,2015,8,1
Group 1,BB,-1.5,2,14,3725,9,2015,7,2
Group 1,BB,-1.5,2,14,3726,12,2015,10,2
Group 1,BB,-1.5,2,14,3727,6,2015,5,1
Group 1,BB,-1.5,2,14,3728,8,2015,3,5
Group 1,BB,-1.5,2,14,3729,7,2015,5,2
Group 1,BB,-1.5,2,14,3730,5,2015,4,1
Group 1,BB,-1.5,2,14,3731,8,2015,6,2
Group 1,BB,-1.5,2,14,3732,8,2015,7,1
Group 1,BB,-1.5,2,14,3733,4,2015,6,-2
Group 1,BB,-1.5,2,14,3734,5,2015,7,-2
Group 1,BB,-1.5,2,14,3735,6,2015,11,-5
Group 1,BB,-1.5,2,14,3736,8,2015,7,1
Group 1,BB,-1.5,2,14,3737,8,2015,11,-3
Group 1,BB,-1.5,2,14,3738,8,2015,2,6
Group 1,BB,-1.5,2,14,3739,8,2015,6,2
Group 1,BB,-1.5,2,14,3740,6,2015,8,-2
Group 1,BB,-1.5,2,14,3741,10,2015,7,3
Group 1,BB,-1.5,2,14,3742,8,2015,7,1
Group 1,BB,-1.5,2,14,3743,6,2015,9,-3
Group 1,BB,-1.5,2,14,3744,7,2015,7,0
Group 1,BB,-1.5,2,14,3745,11,2015,5,6
Group 1,BB,-1.5,2,14,3746,5,2015,7,-2
Group 1,BB,-1.5,2,14,3747,5,2015,10,-5
Group 1,BB,-1.5,2,14,3748,5,2015,8,-3
Group 1,BB,-1.5,2,14,3749,10,2015,6,4
Group 1,BB,-1.5,2,14,3750,8,2015,5,3
Group 1,BB,-1.5,2,14,3751,11,2015,9,2
Group 1,BB,-1.5,2,14,3752,8,2015,8,0
Group 1,BB,-1.5,2,14,3753,11,2015,6,5
Group 1,BB,-1.5,2,14,3754,6,2015,11,-5
Group 1,BB,-1.5,2,14,3755,8,2015,5,3
Group 1,BB,-1.5,2,14,3756,9,2015,7,2
Group 1,BB,-1.5,2,14,3757,6,2015,8,-2
Group 1,BB,-1.5,2,14,3758,8,2015,5,3
Group 1,BB,-1.5,2,14,3759,6,2015,6,0
Group 1,BB,-1.5,2,14,3760,5,2015,6,-1
Group 1,BB,-1.5,2,14,3761,7,2015,7,0
Group 1,BB,-1.5,2,14,3762,10,2015,8,2
Group 1,BB,-1.5,2,14,3763,6,2015,9,-3
Group 1,BB,-1.5,2,14,3764,13,2015,7,6
Group 1,BB,-1.5,2,14,3765,9,2015,8,1
Group 1,BB,-1.5,2,14,3766,11,2015,7,4
Group 1,BB,-1.5,2,14,3767,5,2015,11,-6
Group 1,BB,-1.5,2,14,3768,8,2015,7,1
Group 1,BB,-1.5,2,14,3769,8,2015,6,2
Group 1,BB,-1.5,2,14,3770,9,2015,8,1
Group 1,BB,-1.5,2,14,3771,6,2015,10,-4
Group 1,BB,-1.5,2,14,3772,5,2015,8,-3
Group 1,BB,-1.5,2,14,3773,6,2015,7,-1
Group 1,BB,-1.5,2,14,3774,9,2015,8,1
Group 1,BB,-1.5,2,14,3775,6,2015,7,-1
Group 1,BB,-1.5,2,14,3776,8,2015,9,-1
Group 1,BB,-1.5,2,14,3777,8,2015,11,-3
Group 1,BB,-1.5,2,14,3778,10,2015,6,4
Group 1,BB,-1.5,2,14,3779,10,2015,8,2
Group 1,BB,-1.5,2,14,3780,8,2015,11,-3
Group 1,BB,-1.5,2,14,3781,4,2015,7,-3
Group 1,BB,-1.5,2,14,3782,7,2015,5,2
Group 1,BB,-1.5,2,14,3783,9,2015,9,0
Group 1,BB,-1.5,2,14,3784,9,2015,5,4
Group 1,BB,-1.5,2,14,3785,6,2015,9,-3
Group 1,BB,-1.5,2,14,3786,7,2015,5,2
Group 1,BB,-1.5,2,14,3787,7,2015,7,0
Group 1,BB,-1.5,2,14,3788,4,2015,9,-5
Group 1,BB,-1.5,2,14,3789,5,2015,10,-5
Group 1,BB,-1.5,2,14,3790,8,2015,8,0
Group 1,BB,-1.5,2,14,3791,4,2015,7,-3
Group 1,BB,-1.5,2,14,3792,8,2015,7,1
Group 1,BB,-1.5,2,14,3793,7,2015,4,3
Group 1,BB,-1.5,2,14,3794,6,2015,2,4
Group 1,BB,-1.5,2,14,3795,3,2015,8,-5
Group 1,BB,-1.5,2,14,3796,9,2015,6,3
Group 1,BB,-1.5,2,14,3797,7,2015,11,-4
Group 1,BB,-1.5,2,14,3798,8,2015,5,3
Group 1,BB,-1.5,2,14,3799,10,2015,9,1
Group 1,BB,-1.5,2,14,3800,9,2015,9,0
Group 1,BB,-1.5,2,14,3801,7,2015,5,2
Group 1,BB,-1.5,2,14,3802,11,2015,10,1
Group 1,BB,-1.5,2,14,3803,7,2015,8,-1
Group 1,BB,-1.5,2,14,3804,8,2015,5,3
Group 1,BB,-1.5,2,14,3805,7,2015,8,-1
Group 1,BB,-1.5,2,14,3806,6,2015,8,-2
Group 1,BB,-1.5,2,14,3807,7,2015,3,4
Group 1,BB,-1.5,2,14,3808,7,2015,12,-5
Group 1,BB,-1.5,2,14,3809,9,2015,8,1
Group 1,BB,-1.5,2,14,3810,9,2015,9,0
Group 1,BB,-1.5,2,14,3811,8,2015,6,2
Group 1,BB,-1.5,2,14,3812,7,2015,3,4
Group 1,BB,-1.5,2,14,3813,9,2015,8,1
Group 1,BB,-1.5,2,14,3814,7,2015,9,-2
Group 1,BB,-1.5,2,14,3815,7,2015,6,1
Group 1,BB,-1.5,2,14,3816,8,2015,8,0
Group 1,BB,-1.5,2,14,3817,8,2015,8,0
Group 1,BB,-1.5,2,14,3818,11,2015,9,2
Group 1,BB,-1.5,2,14,3819,6,2015,8,-2
Group 1,BB,-1.5,2,14,3820,8,2015,3,5
Group 1,BB,-1.5,2,14,3821,11,2015,11,0
Group 1,BB,-1.5,2,14,3822,11,2015,7,4
Group 1,BB,-1.5,2,14,3823,10,2015,8,2
Group 1,BB,-1.5,2,14,3824,11,2015,10,1
Group 1,BB,-1.5,2,14,3825,8,2015,10,-2
Group 1,BB,-1.5,2,14,3826,8,2015,10,-2
Group 1,BB,-1.5,2,14,3827,7,2015,7,0
Group 1,BB,-1.5,2,14,3828,7,2015,5,2
Group 1,BB,-1.5,2,14,3829,5,2015,2,3
Group 1,BB,-1.5,2,14,3830,8,2015,7,1
Group 1,BB,-1.5,2,14,3831,7,2015,7,0
Group 1,BB,-1.5,2,14,3832,5,2015,6,-1
Group 1,BB,-1.5,2,14,3833,4,2015,6,-2
Group 1,BB,-1.5,2,14,3834,6,2015,6,0
Group 1,BB,-1.5,2,14,3835,5,2015,7,-2
Group 1,BB,-1.5,2,14,3836,12,2015,7,5
Group 1,BB,-1.5,2,14,3837,11,2015,6,5
Group 1,BB,-1.5,2,14,3838,4,2015,6,-2
Group 1,BB,-1.5,2,14,3839,6,2015,7,-1
Group 1,BB,-1.5,2,14,3840,9,2015,4,5
Group 1,BB,-1.5,2,14,3841,8,2015,7,1
Group 1,BB,-1.5,2,14,3842,8,2015,11,-3
Group 1,BB,-1.5,2,14,3843,9,2015,7,2
Group 1,BB,-1.5,2,14,3844,8,2015,10,-2
Group 1,BB,-1.5,2,14,3845,9,2015,8,1
Group 1,BB,-1.5,2,14,3846,6,2015,9,-3
Group 1,BB,-1.5,2,14,3847,10,2015,8,2
Group 1,BB,-1.5,2,14,3848,4,2015,5,-1
Group 1,BB,-1.5,2,14,3849,6,2015,8,-2
Group 1,BB,-1.5,2,14,3850,8,2015,6,2
Group 1,BB,-1.5,2,14,3851,4,2015,3,1
Group 1,BB,-1.5,2,14,3852,9,2015,8,1
Group 1,BB,-1.5,2,14,3853,10,2015,10,0
Group 1,BB,-1.5,2,14,3854,10,2015,9,1
Group 1,BB,-1.5,2,14,3855,9,2015,8,1
Group 1,BB,-1.5,2,14,3856,7,2015,3,4
Group 1,BB,-1.5,2,14,3857,5,2015,9,-4
Group 1,BB,-1.5,2,14,3858,10,2015,5,5
Group 1,BB,-1.5,2,14,3859,7,2015,5,2
Group 1,BB,-1.5,2,14,3860,9,2015,5,4
Group 1,BB,-1.5,2,14,3861,5,2015,8,-3
Group 1,BB,-1.5,2,14,3862,6,2015,10,-4
Group 1,BB,-1.5,2,14,3863,7,2015,9,-2
Group 1,BB,-1.5,2,14,3864,10,2015,8,2
Group 1,BB,-1.5,2,14,3865,6,2015,7,-1
Group 1,BB,-1.5,2,14,3866,8,2015,4,4
Group 1,BB,-1.5,2,14,3867,9,2015,10,-1
Group 1,BB,-1.5,2,14,3868,7,2015,11,-4
Group 1,BB,-1.5,2,14,3869,8,2015,7,1
Group 1,BB,-1.5,2,14,3870,6,2015,7,-1
Group 1,BB,-1.5,2,14,3871,7,2015,4,3
Group 1,BB,-1.5,2,14,3872,6,2015,9,-3
Group 1,BB,-1.5,2,14,3873,9,2015,9,0
Group 1,BB,-1.5,2,14,3874,9,2015,11,-2
Group 1,BB,-1.5,2,14,3875,7,2015,11,-4
Group 1,BB,-1.5,2,14,3876,6,2015,6,0
Group 1,BB,-1.5,2,14,3877,7,2015,6,1
Group 1,BB,-1.5,2,14,3878,6,2015,8,-2
Group 1,BB,-1.5,2,14,3879,7,2015,8,-1
Group 1,BB,-1.5,2,14,3880,9,2015,5,4
Group 1,BB,-1.5,2,14,3881,11,2015,8,3
Group 1,BB,-1.5,2,14,3882,10,2015,7,3
Group 1,BB,-1.5,2,14,3883,7,2015,9,-2
Group 1,BB,-1.5,2,14,3884,7,2015,4,3
Group 1,BB,-1.5,2,14,3885,7,2015,8,-1
Group 1,BB,-1.5,2,14,3886,7,2015,10,-3
Group 1,BB,-1.5,2,14,3887,7,2015,7,0
Group 1,BB,-1.5,2,14,3888,9,2015,11,-2
Group 1,BB,-1.5,2,14,3889,8,2015,5,3
Group 1,BB,-1.5,2,14,3890,8,2015,7,1
Group 1,BB,-1.5,2,14,3891,7,2015,7,0
Group 1,BB,-1.5,2,14,3892,7,2015,9,-2
Group 1,BB,-1.5,2,14,3893,9,2015,3,6
Group 1,BB,-1.5,2,14,3894,7,2015,5,2
Group 1,BB,-1.5,2,14,3895,8,2015,5,3
Group 1,BB,-1.5,2,14,3896,9,2015,5,4
Group 1,BB,-1.5,2,14,3897,8,2015,9,-1
Group 1,BB,-1.5,2,14,3898,4,2015,5,-1
Group 1,BB,-1.5,2,14,3899,8,2015,11,-3
Group 1,BB,-1.5,2,14,3900,5,2015,8,-3
Group 1,BB,-1.5,2,14,3901,7,2015,6,1
Group 1,BB,-1.5,2,14,3902,8,2015,8,0
Group 1,BB,-1.5,2,14,3903,8,2015,7,1
Group 1,BB,-1.5,2,14,3904,6,2015,6,0
Group 1,BB,-1.5,2,14,3905,5,2015,5,0
Group 1,BB,-1.5,2,14,3906,8,2015,8,0
Group 1,BB,-1.5,2,14,3907,8,2015,5,3
Group 1,BB,-1.5,2,14,3908,7,2015,5,2
Group 1,BB,-1.5,2,14,3909,7,2015,8,-1
Group 1,BB,-1.5,2,14,3910,9,2015,8,1
Group 1,BB,-1.5,2,14,3911,6,2015,7,-1
Group 1,BB,-1.5,2,14,3912,9,2015,8,1
Group 1,BB,-1.5,2,14,3913,10,2015,3,7
Group 1,BB,-1.5,2,14,3914,8,2015,7,1
Group 1,BB,-1.5,2,14,3915,6,2015,6,0
Group 1,BB,-1.5,2,14,3916,7,2015,10,-3
Group 1,BB,-1.5,2,14,3917,7,2015,9,-2
Group 1,BB,-1.5,2,14,3918,9,2015,7,2
Group 1,BB,-1.5,2,14,3919,7,2015,6,1
Group 1,BB,-1.5,2,14,3920,8,2015,7,1
Group 1,BB,-1.5,2,14,3921,8,2015,5,3
Group 1,BB,-1.5,2,14,3922,9,2015,9,0
Group 1,BB,-1.5,2,14,3923,6,2015,6,0
Group 1,BB,-1.5,2,14,3924,9,2015,8,1
Group 1,BB,-1.5,2,14,3925,12,2015,7,5
Group 1,BB,-1.5,2,14,3926,9,2015,11,-2
Group 1,BB,-1.5,2,14,3927,10,2015,12,-2
Group 1,BB,-1.5,2,14,3928,10,2015,5,5
Group 1,BB,-1.5,2,14,3929,6,2015,10,-4
Group 1,BB,-1.5,2,14,3930,10,2015,7,3
Group 1,BB,-1.5,2,14,3931,9,2015,5,4
Group 1,BB,-1.5,2,14,3932,8,2015,5,3
Group 1,BB,-1.5,2,14,3933,10,2015,8,2
Group 1,BB,-1.5,2,14,3934,8,2015,5,3
Group 1,BB,-1.5,2,14,3935,8,2015,5,3
Group 1,BB,-1.5,2,14,3936,8,2015,7,1
Group 1,BB,-1.5,2,14,3937,6,2015,6,0
Group 1,BB,-1.5,2,14,3938,7,2015,8,-1
Group 1,BB,-1.5,2,14,3939,11,2015,4,7
Group 1,BB,-1.5,2,14,3940,8,2015,10,-2
Group 1,BB,-1.5,2,14,3941,10,2015,6,4
Group 1,BB,-1.5,2,14,3942,4,2015,6,-2
Group 1,BB,-1.5,2,14,3943,6,2015,5,1
Group 1,BB,-1.5,2,14,3944,7,2015,6,1
Group 1,BB,-1.5,2,14,3945,9,2015,6,3
Group 1,BB,-1.5,2,14,3946,10,2015,8,2
Group 1,BB,-1.5,2,14,3947,9,2015,8,1
Group 1,BB,-1.5,2,14,3948,6,2015,6,0
Group 1,BB,-1.5,2,14,3949,7,2015,8,-1
Group 1,BB,-1.5,2,14,3950,7,2015,11,-4
Group 1,BB,-1.5,2,14,3951,9,2015,6,3
Group 1,BB,-1.5,2,14,3952,6,2015,12,-6
Group 1,BB,-1.5,2,14,3953,7,2015,7,0
Group 1,BB,-1.5,2,14,3954,7,2015,6,1
Group 1,BB,-1.5,2,14,3955,8,2015,7,1
Group 1,BB,-1.5,2,14,3956,6,2015,4,2
Group 1,BB,-1.5,2,14,3957,8,2015,10,-2
Group 1,BB,-1.5,2,14,3958,9,2015,3,6
Group 1,BB,-1.5,2,14,3959,9,2015,3,6
Group 1,BB,-1.5,2,14,3960,8,2015,5,3
Group 1,BB,-1.5,2,14,3961,8,2015,3,5
Group 1,BB,-1.5,2,14,3962,7,2015,12,-5
Group 1,BB,-1.5,2,14,3963,8,2015,11,-3
Group 1,BB,-1.5,2,14,3964,5,2015,6,-1
Group 1,BB,-1.5,2,14,3965,9,2015,8,1
Group 1,BB,-1.5,2,14,3966,9,2015,5,4
Group 1,BB,-1.5,2,14,3967,9,2015,10,-1
Group 1,BB,-1.5,2,14,3968,9,2015,11,-2
Group 1,BB,-1.5,2,14,3969,11,2015,6,5
Group 1,BB,-1.5,2,14,3970,7,2015,6,1
Group 1,BB,-1.5,2,14,3971,7,2015,10,-3
Group 1,BB,-1.5,2,14,3972,2,2015,7,-5
Group 1,BB,-1.5,2,14,3973,7,2015,11,-4
Group 1,BB,-1.5,2,14,3974,7,2015,5,2
Group 1,BB,-1.5,2,14,3975,6,2015,7,-1
Group 1,BB,-1.5,2,14,3976,7,2015,4,3
Group 1,BB,-1.5,2,14,3977,8,2015,8,0
Group 1,BB,-1.5,2,14,3978,8,2015,9,-1
Group 1,BB,-1.5,2,14,3979,5,2015,5,0
Group 1,BB,-1.5,2,14,3980,7,2015,10,-3
Group 1,BB,-1.5,2,14,3981,6,2015,5,1
Group 1,BB,-1.5,2,14,3982,12,2015,9,3
Group 1,BB,-1.5,2,14,3983,8,2015,8,0
Group 1,BB,-1.5,2,14,3984,7,2015,6,1
Group 1,BB,-1.5,2,14,3985,7,2015,4,3
Group 1,BB,-1.5,2,14,3986,9,2015,9,0
Group 1,BB,-1.5,2,14,3987,6,2015,6,0
Group 1,BB,-1.5,2,14,3988,10,2015,7,3
Group 1,BB,-1.5,2,14,3989,5,2015,7,-2
Group 1,BB,-1.5,2,14,3990,8,2015,6,2
Group 1,BB,-1.5,2,14,3991,9,2015,3,6
Group 1,BB,-1.5,2,14,3992,6,2015,7,-1
Group 1,BB,-1.5,2,14,3993,6,2015,7,-1
Group 1,BB,-1.5,2,14,3994,12,2015,9,3
Group 1,BB,-1.5,2,14,3995,12,2015,6,6
Group 1,BB,-1.5,2,14,3996,9,2015,7,2
Group 1,BB,-1.5,2,14,3997,8,2015,8,0
Group 1,BB,-1.5,2,14,3998,8,2015,8,0
Group 1,BB,-1.5,2,14,3999,10,2015,8,2
Group 1,BB,-1.5,2,14,4000,11,2015,4,7
Group 3,BB,-1.5,3,14,1,7,2015,7,0
Group 3,BB,-1.5,3,14,2,7,2015,11,-4
Group 3,BB,-1.5,3,14,3,8,2015,6,2
Group 3,BB,-1.5,3,14,4,9,2015,4,5
Group 3,BB,-1.5,3,14,5,9,2015,9,0
Group 3,BB,-1.5,3,14,6,10,2015,7,3
Group 3,BB,-1.5,3,14,7,7,2015,5,2
Group 3,BB,-1.5,3,14,8,8,2015,13,-5
Group 3,BB,-1.5,3,14,9,10,2015,7,3
Group 3,BB,-1.5,3,14,10,8,2015,8,0
Group 3,BB,-1.5,3,14,11,10,2015,4,6
Group 3,BB,-1.5,3,14,12,8,2015,7,1
Group 3,BB,-1.5,3,14,13,10,2015,6,4
Group 3,BB,-1.5,3,14,14,9,2015,5,4
Group 3,BB,-1.5,3,14,15,8,2015,7,1
Group 3,BB,-1.5,3,14,16,7,2015,8,-1
Group 3,BB,-1.5,3,14,17,8,2015,6,2
Group 3,BB,-1.5,3,14,18,6,2015,6,0
Group 3,BB,-1.5,3,14,19,10,2015,8,2
Group 3,BB,-1.5,3,14,20,10,2015,3,7
Group 3,BB,-1.5,3,14,21,11,2015,11,0
Group 3,BB,-1.5,3,14,22,7,2015,5,2
Group 3,BB,-1.5,3,14,23,7,2015,7,0
Group 3,BB,-1.5,3,14,24,7,2015,6,1
Group 3,BB,-1.5,3,14,25,5,2015,8,-3
Group 3,BB,-1.5,3,14,26,4,2015,8,-4
Group 3,BB,-1.5,3,14,27,12,2015,8,4
Group 3,BB,-1.5,3,14,28,12,2015,8,4
Group 3,BB,-1.5,3,14,29,10,2015,9,1
Group 3,BB,-1.5,3,14,30,6,2015,10,-4
Group 3,BB,-1.5,3,14,31,9,2015,6,3
Group 3,BB,-1.5,3,14,32,11,2015,5,6
Group 3,BB,-1.5,3,14,33,9,2015,8,1
Group 3,BB,-1.5,3,14,34,8,2015,8,0
Group 3,BB,-1.5,3,14,35,11,2015,8,3
Group 3,BB,-1.5,3,14,36,7,2015,6,1
Group 3,BB,-1.5,3,14,37,9,2015,5,4
Group 3,BB,-1.5,3,14,38,10,2015,5,5
Group 3,BB,-1.5,3,14,39,12,2015,7,5
Group 3,BB,-1.5,3,14,40,6,2015,7,-1
Group 3,BB,-1.5,3,14,41,5,2015,5,0
Group 3,BB,-1.5,3,14,42,7,2015,7,0
Group 3,BB,-1.5,3,14,43,7,2015,6,1
Group 3,BB,-1.5,3,14,44,11,2015,4,7
Group 3,BB,-1.5,3,14,45,9,2015,7,2
Group 3,BB,-1.5,3,14,46,6,2015,7,-1
Group 3,BB,-1.5,3,14,47,10,2015,3,7
Group 3,BB,-1.5,3,14,48,7,2015,7,0
Group 3,BB,-1.5,3,14,49,7,2015,3,4
Group 3,BB,-1.5,3,14,50,7,2015,5,2
Group 3,BB,-1.5,3,14,51,7,2015,3,4
Group 3,BB,-1.5,3,14,52,4,2015,8,-4
Group 3,BB,-1.5,3,14,53,8,2015,3,5
Group 3,BB,-1.5,3,14,54,13,2015,6,7
Group 3,BB,-1.5,3,14,55,7,2015,3,4
Group 3,BB,-1.5,3,14,56,7,2015,8,-1
Group 3,BB,-1.5,3,14,57,12,2015,4,8
Group 3,BB,-1.5,3,14,58,9,2015,10,-1
Group 3,BB,-1.5,3,14,59,7,2015,6,1
Group 3,BB,-1.5,3,14,60,6,2015,9,-3
Group 3,BB,-1.5,3,14,61,10,2015,7,3
Group 3,BB,-1.5,3,14,62,10,2015,4,6
Group 3,BB,-1.5,3,14,63,6,2015,10,-4
Group 3,BB,-1.5,3,14,64,5,2015,2,3
Group 3,BB,-1.5,3,14,65,8,2015,3,5
Group 3,BB,-1.5,3,14,66,7,2015,4,3
Group 3,BB,-1.5,3,14,67,6,2015,7,-1
Group 3,BB,-1.5,3,14,68,8,2015,3,5
Group 3,BB,-1.5,3,14,69,9,2015,3,6
Group 3,BB,-1.5,3,14,70,9,2015,7,2
Group 3,BB,-1.5,3,14,71,8,2015,9,-1
Group 3,BB,-1.5,3,14,72,10,2015,4,6
Group 3,BB,-1.5,3,14,73,6,2015,3,3
Group 3,BB,-1.5,3,14,74,10,2015,8,2
Group 3,BB,-1.5,3,14,75,8,2015,8,0
Group 3,BB,-1.5,3,14,76,11,2015,6,5
Group 3,BB,-1.5,3,14,77,4,2015,8,-4
Group 3,BB,-1.5,3,14,78,3,2015,9,-6
Group 3,BB,-1.5,3,14,79,8,2015,10,-2
Group 3,BB,-1.5,3,14,80,4,2015,9,-5
Group 3,BB,-1.5,3,14,81,3,2015,10,-7
Group 3,BB,-1.5,3,14,82,12,2015,9,3
Group 3,BB,-1.5,3,14,83,9,2015,8,1
Group 3,BB,-1.5,3,14,84,9,2015,9,0
Group 3,BB,-1.5,3,14,85,8,2015,7,1
Group 3,BB,-1.5,3,14,86,8,2015,7,1
Group 3,BB,-1.5,3,14,87,10,2015,5,5
Group 3,BB,-1.5,3,14,88,7,2015,8,-1
Group 3,BB,-1.5,3,14,89,13,2015,5,8
Group 3,BB,-1.5,3,14,90,11,2015,5,6
Group 3,BB,-1.5,3,14,91,9,2015,2,7
Group 3,BB,-1.5,3,14,92,7,2015,7,0
Group 3,BB,-1.5,3,14,93,8,2015,8,0
Group 3,BB,-1.5,3,14,94,8,2015,1,7
Group 3,BB,-1.5,3,14,95,8,2015,6,2
Group 3,BB,-1.5,3,14,96,9,2015,7,2
Group 3,BB,-1.5,3,14,97,11,2015,7,4
Group 3,BB,-1.5,3,14,98,11,2015,7,4
Group 3,BB,-1.5,3,14,99,13,2015,6,7
Group 3,BB,-1.5,3,14,100,11,2015,7,4
Group 3,BB,-1.5,3,14,101,5,2015,8,-3
Group 3,BB,-1.5,3,14,102,9,2015,7,2
Group 3,BB,-1.5,3,14,103,4,2015,4,0
Group 3,BB,-1.5,3,14,104,9,2015,5,4
Group 3,BB,-1.5,3,14,105,8,2015,9,-1
Group 3,BB,-1.5,3,14,106,7,2015,7,0
Group 3,BB,-1.5,3,14,107,7,2015,5,2
Group 3,BB,-1.5,3,14,108,10,2015,12,-2
Group 3,BB,-1.5,3,14,109,8,2015,11,-3
Group 3,BB,-1.5,3,14,110,10,2015,6,4
Group 3,BB,-1.5,3,14,111,7,2015,7,0
Group 3,BB,-1.5,3,14,112,5,2015,9,-4
Group 3,BB,-1.5,3,14,113,9,2015,5,4
Group 3,BB,-1.5,3,14,114,8,2015,6,2
Group 3,BB,-1.5,3,14,115,8,2015,8,0
Group 3,BB,-1.5,3,14,116,9,2015,9,0
Group 3,BB,-1.5,3,14,117,6,2015,6,0
Group 3,BB,-1.5,3,14,118,9,2015,7,2
Group 3,BB,-1.5,3,14,119,8,2015,5,3
Group 3,BB,-1.5,3,14,120,9,2015,6,3
Group 3,BB,-1.5,3,14,121,10,2015,7,3
Group 3,BB,-1.5,3,14,122,9,2015,5,4
Group 3,BB,-1.5,3,14,123,7,2015,7,0
Group 3,BB,-1.5,3,14,124,5,2015,5,0
Group 3,BB,-1.5,3,14,125,8,2015,7,1
Group 3,BB,-1.5,3,14,126,10,2015,6,4
Group 3,BB,-1.5,3,14,127,6,2015,8,-2
Group 3,BB,-1.5,3,14,128,8,2015,5,3
Group 3,BB,-1.5,3,14,129,5,2015,9,-4
Group 3,BB,-1.5,3,14,130,10,2015,7,3
Group 3,BB,-1.5,3,14,131,9,2015,10,-1
Group 3,BB,-1.5,3,14,132,7,2015,9,-2
Group 3,BB,-1.5,3,14,133,8,2015,8,0
Group 3,BB,-1.5,3,14,134,7,2015,9,-2
Group 3,BB,-1.5,3,14,135,6,2015,8,-2
Group 3,BB,-1.5,3,14,136,4,2015,4,0
Group 3,BB,-1.5,3,14,137,9,2015,1,8
Group 3,BB,-1.5,3,14,138,8,2015,8,0
Group 3,BB,-1.5,3,14,139,7,2015,9,-2
Group 3,BB,-1.5,3,14,140,9,2015,5,4
Group 3,BB,-1.5,3,14,141,5,2015,10,-5
Group 3,BB,-1.5,3,14,142,9,2015,8,1
Group 3,BB,-1.5,3,14,143,10,2015,3,7
Group 3,BB,-1.5,3,14,144,8,2015,5,3
Group 3,BB,-1.5,3,14,145,7,2015,6,1
Group 3,BB,-1.5,3,14,146,9,2015,10,-1
Group 3,BB,-1.5,3,14,147,11,2015,7,4
Group 3,BB,-1.5,3,14,148,12,2015,7,5
Group 3,BB,-1.5,3,14,149,9,2015,9,0
Group 3,BB,-1.5,3,14,150,9,2015,5,4
Group 3,BB,-1.5,3,14,151,12,2015,7,5
Group 3,BB,-1.5,3,14,152,6,2015,4,2
Group 3,BB,-1.5,3,14,153,10,2015,7,3
Group 3,BB,-1.5,3,14,154,6,2015,7,-1
Group 3,BB,-1.5,3,14,155,8,2015,6,2
Group 3,BB,-1.5,3,14,156,7,2015,9,-2
Group 3,BB,-1.5,3,14,157,9,2015,5,4
Group 3,BB,-1.5,3,14,158,11,2015,8,3
Group 3,BB,-1.5,3,14,159,10,2015,2,8
Group 3,BB,-1.5,3,14,160,10,2015,8,2
Group 3,BB,-1.5,3,14,161,5,2015,7,-2
Group 3,BB,-1.5,3,14,162,5,2015,6,-1
Group 3,BB,-1.5,3,14,163,4,2015,9,-5
Group 3,BB,-1.5,3,14,164,8,2015,5,3
Group 3,BB,-1.5,3,14,165,9,2015,4,5
Group 3,BB,-1.5,3,14,166,9,2015,3,6
Group 3,BB,-1.5,3,14,167,11,2015,9,2
Group 3,BB,-1.5,3,14,168,11,2015,2,9
Group 3,BB,-1.5,3,14,169,10,2015,7,3
Group 3,BB,-1.5,3,14,170,12,2015,3,9
Group 3,BB,-1.5,3,14,171,9,2015,7,2
Group 3,BB,-1.5,3,14,172,9,2015,10,-1
Group 3,BB,-1.5,3,14,173,6,2015,8,-2
Group 3,BB,-1.5,3,14,174,8,2015,5,3
Group 3,BB,-1.5,3,14,175,7,2015,7,0
Group 3,BB,-1.5,3,14,176,12,2015,11,1
Group 3,BB,-1.5,3,14,177,14,2015,8,6
Group 3,BB,-1.5,3,14,178,11,2015,10,1
Group 3,BB,-1.5,3,14,179,6,2015,6,0
Group 3,BB,-1.5,3,14,180,9,2015,5,4
Group 3,BB,-1.5,3,14,181,8,2015,8,0
Group 3,BB,-1.5,3,14,182,10,2015,5,5
Group 3,BB,-1.5,3,14,183,8,2015,6,2
Group 3,BB,-1.5,3,14,184,6,2015,11,-5
Group 3,BB,-1.5,3,14,185,8,2015,7,1
Group 3,BB,-1.5,3,14,186,10,2015,7,3
Group 3,BB,-1.5,3,14,187,7,2015,6,1
Group 3,BB,-1.5,3,14,188,8,2015,8,0
Group 3,BB,-1.5,3,14,189,8,2015,9,-1
Group 3,BB,-1.5,3,14,190,9,2015,5,4
Group 3,BB,-1.5,3,14,191,7,2015,5,2
Group 3,BB,-1.5,3,14,192,12,2015,3,9
Group 3,BB,-1.5,3,14,193,4,2015,9,-5
Group 3,BB,-1.5,3,14,194,10,2015,9,1
Group 3,BB,-1.5,3,14,195,4,2015,6,-2
Group 3,BB,-1.5,3,14,196,11,2015,6,5
Group 3,BB,-1.5,3,14,197,12,2015,5,7
Group 3,BB,-1.5,3,14,198,10,2015,6,4
Group 3,BB,-1.5,3,14,199,11,2015,5,6
Group 3,BB,-1.5,3,14,200,10,2015,5,5
Group 3,BB,-1.5,3,14,201,4,2015,6,-2
Group 3,BB,-1.5,3,14,202,9,2015,10,-1
Group 3,BB,-1.5,3,14,203,6,2015,6,0
Group 3,BB,-1.5,3,14,204,10,2015,9,1
Group 3,BB,-1.5,3,14,205,7,2015,9,-2
Group 3,BB,-1.5,3,14,206,9,2015,4,5
Group 3,BB,-1.5,3,14,207,9,2015,8,1
Group 3,BB,-1.5,3,14,208,8,2015,5,3
Group 3,BB,-1.5,3,14,209,11,2015,10,1
Group 3,BB,-1.5,3,14,210,3,2015,7,-4
Group 3,BB,-1.5,3,14,211,7,2015,6,1
Group 3,BB,-1.5,3,14,212,6,2015,10,-4
Group 3,BB,-1.5,3,14,213,10,2015,4,6
Group 3,BB,-1.5,3,14,214,4,2015,12,-8
Group 3,BB,-1.5,3,14,215,8,2015,9,-1
Group 3,BB,-1.5,3,14,216,10,2015,8,2
Group 3,BB,-1.5,3,14,217,10,2015,8,2
Group 3,BB,-1.5,3,14,218,5,2015,7,-2
Group 3,BB,-1.5,3,14,219,8,2015,9,-1
Group 3,BB,-1.5,3,14,220,9,2015,9,0
Group 3,BB,-1.5,3,14,221,9,2015,6,3
Group 3,BB,-1.5,3,14,222,6,2015,10,-4
Group 3,BB,-1.5,3,14,223,10,2015,3,7
Group 3,BB,-1.5,3,14,224,11,2015,7,4
Group 3,BB,-1.5,3,14,225,6,2015,7,-1
Group 3,BB,-1.5,3,14,226,7,2015,5,2
Group 3,BB,-1.5,3,14,227,6,2015,5,1
Group 3,BB,-1.5,3,14,228,11,2015,8,3
Group 3,BB,-1.5,3,14,229,11,2015,5,6
Group 3,BB,-1.5,3,14,230,9,2015,6,3
Group 3,BB,-1.5,3,14,231,10,2015,5,5
Group 3,BB,-1.5,3,14,232,11,2015,13,-2
Group 3,BB,-1.5,3,14,233,8,2015,5,3
Group 3,BB,-1.5,3,14,234,7,2015,8,-1
Group 3,BB,-1.5,3,14,235,8,2015,6,2
Group 3,BB,-1.5,3,14,236,10,2015,5,5
Group 3,BB,-1.5,3,14,237,9,2015,9,0
Group 3,BB,-1.5,3,14,238,8,2015,8,0
Group 3,BB,-1.5,3,14,239,9,2015,6,3
Group 3,BB,-1.5,3,14,240,10,2015,6,4
Group 3,BB,-1.5,3,14,241,7,2015,9,-2
Group 3,BB,-1.5,3,14,242,9,2015,9,0
Group 3,BB,-1.5,3,14,243,9,2015,6,3
Group 3,BB,-1.5,3,14,244,6,2015,9,-3
Group 3,BB,-1.5,3,14,245,7,2015,3,4
Group 3,BB,-1.5,3,14,246,8,2015,7,1
Group 3,BB,-1.5,3,14,247,10,2015,8,2
Group 3,BB,-1.5,3,14,248,4,2015,4,0
Group 3,BB,-1.5,3,14,249,9,2015,7,2
Group 3,BB,-1.5,3,14,250,6,2015,9,-3
Group 3,BB,-1.5,3,14,251,8,2015,8,0
Group 3,BB,-1.5,3,14,252,8,2015,5,3
Group 3,BB,-1.5,3,14,253,6,2015,7,-1
Group 3,BB,-1.5,3,14,254,8,2015,6,2
Group 3,BB,-1.5,3,14,255,6,2015,5,1
Group 3,BB,-1.5,3,14,256,5,2015,7,-2
Group 3,BB,-1.5,3,14,257,12,2015,8,4
Group 3,BB,-1.5,3,14,258,8,2015,5,3
Group 3,BB,-1.5,3,14,259,10,2015,7,3
Group 3,BB,-1.5,3,14,260,11,2015,6,5
Group 3,BB,-1.5,3,14,261,8,2015,7,1
Group 3,BB,-1.5,3,14,262,12,2015,5,7
Group 3,BB,-1.5,3,14,263,8,2015,8,0
Group 3,BB,-1.5,3,14,264,9,2015,12,-3
Group 3,BB,-1.5,3,14,265,3,2015,7,-4
Group 3,BB,-1.5,3,14,266,10,2015,9,1
Group 3,BB,-1.5,3,14,267,7,2015,7,0
Group 3,BB,-1.5,3,14,268,9,2015,10,-1
Group 3,BB,-1.5,3,14,269,10,2015,10,0
Group 3,BB,-1.5,3,14,270,10,2015,8,2
Group 3,BB,-1.5,3,14,271,8,2015,7,1
Group 3,BB,-1.5,3,14,272,8,2015,5,3
Group 3,BB,-1.5,3,14,273,9,2015,2,7
Group 3,BB,-1.5,3,14,274,6,2015,10,-4
Group 3,BB,-1.5,3,14,275,9,2015,9,0
Group 3,BB,-1.5,3,14,276,8,2015,8,0
Group 3,BB,-1.5,3,14,277,9,2015,5,4
Group 3,BB,-1.5,3,14,278,7,2015,10,-3
Group 3,BB,-1.5,3,14,279,7,2015,5,2
Group 3,BB,-1.5,3,14,280,7,2015,5,2
Group 3,BB,-1.5,3,14,281,8,2015,10,-2
Group 3,BB,-1.5,3,14,282,8,2015,6,2
Group 3,BB,-1.5,3,14,283,9,2015,2,7
Group 3,BB,-1.5,3,14,284,8,2015,3,5
Group 3,BB,-1.5,3,14,285,6,2015,10,-4
Group 3,BB,-1.5,3,14,286,11,2015,9,2
Group 3,BB,-1.5,3,14,287,8,2015,6,2
Group 3,BB,-1.5,3,14,288,13,2015,7,6
Group 3,BB,-1.5,3,14,289,6,2015,7,-1
Group 3,BB,-1.5,3,14,290,7,2015,9,-2
Group 3,BB,-1.5,3,14,291,8,2015,9,-1
Group 3,BB,-1.5,3,14,292,8,2015,7,1
Group 3,BB,-1.5,3,14,293,9,2015,7,2
Group 3,BB,-1.5,3,14,294,10,2015,8,2
Group 3,BB,-1.5,3,14,295,13,2015,3,10
Group 3,BB,-1.5,3,14,296,9,2015,9,0
Group 3,BB,-1.5,3,14,297,12,2015,6,6
Group 3,BB,-1.5,3,14,298,9,2015,8,1
Group 3,BB,-1.5,3,14,299,6,2015,6,0
Group 3,BB,-1.5,3,14,300,13,2015,8,5
Group 3,BB,-1.5,3,14,301,12,2015,9,3
Group 3,BB,-1.5,3,14,302,8,2015,4,4
Group 3,BB,-1.5,3,14,303,12,2015,9,3
Group 3,BB,-1.5,3,14,304,7,2015,9,-2
Group 3,BB,-1.5,3,14,305,7,2015,8,-1
Group 3,BB,-1.5,3,14,306,7,2015,10,-3
Group 3,BB,-1.5,3,14,307,9,2015,5,4
Group 3,BB,-1.5,3,14,308,7,2015,9,-2
Group 3,BB,-1.5,3,14,309,7,2015,8,-1
Group 3,BB,-1.5,3,14,310,7,2015,7,0
Group 3,BB,-1.5,3,14,311,7,2015,9,-2
Group 3,BB,-1.5,3,14,312,4,2015,6,-2
Group 3,BB,-1.5,3,14,313,9,2015,11,-2
Group 3,BB,-1.5,3,14,314,7,2015,12,-5
Group 3,BB,-1.5,3,14,315,11,2015,8,3
Group 3,BB,-1.5,3,14,316,10,2015,10,0
Group 3,BB,-1.5,3,14,317,8,2015,8,0
Group 3,BB,-1.5,3,14,318,7,2015,7,0
Group 3,BB,-1.5,3,14,319,10,2015,9,1
Group 3,BB,-1.5,3,14,320,8,2015,7,1
Group 3,BB,-1.5,3,14,321,9,2015,8,1
Group 3,BB,-1.5,3,14,322,9,2015,8,1
Group 3,BB,-1.5,3,14,323,7,2015,13,-6
Group 3,BB,-1.5,3,14,324,10,2015,10,0
Group 3,BB,-1.5,3,14,325,3,2015,6,-3
Group 3,BB,-1.5,3,14,326,12,2015,8,4
Group 3,BB,-1.5,3,14,327,13,2015,5,8
Group 3,BB,-1.5,3,14,328,8,2015,9,-1
Group 3,BB,-1.5,3,14,329,8,2015,5,3
Group 3,BB,-1.5,3,14,330,9,2015,10,-1
Group 3,BB,-1.5,3,14,331,8,2015,7,1
Group 3,BB,-1.5,3,14,332,8,2015,9,-1
Group 3,BB,-1.5,3,14,333,12,2015,8,4
Group 3,BB,-1.5,3,14,334,8,2015,5,3
Group 3,BB,-1.5,3,14,335,8,2015,8,0
Group 3,BB,-1.5,3,14,336,8,2015,7,1
Group 3,BB,-1.5,3,14,337,5,2015,6,-1
Group 3,BB,-1.5,3,14,338,6,2015,7,-1
Group 3,BB,-1.5,3,14,339,10,2015,4,6
Group 3,BB,-1.5,3,14,340,12,2015,11,1
Group 3,BB,-1.5,3,14,341,8,2015,12,-4
Group 3,BB,-1.5,3,14,342,10,2015,7,3
Group 3,BB,-1.5,3,14,343,6,2015,7,-1
Group 3,BB,-1.5,3,14,344,13,2015,5,8
Group 3,BB,-1.5,3,14,345,10,2015,9,1
Group 3,BB,-1.5,3,14,346,5,2015,8,-3
Group 3,BB,-1.5,3,14,347,9,2015,8,1
Group 3,BB,-1.5,3,14,348,8,2015,7,1
Group 3,BB,-1.5,3,14,349,10,2015,6,4
Group 3,BB,-1.5,3,14,350,5,2015,8,-3
Group 3,BB,-1.5,3,14,351,8,2015,7,1
Group 3,BB,-1.5,3,14,352,7,2015,7,0
Group 3,BB,-1.5,3,14,353,12,2015,4,8
Group 3,BB,-1.5,3,14,354,9,2015,4,5
Group 3,BB,-1.5,3,14,355,8,2015,5,3
Group 3,BB,-1.5,3,14,356,8,2015,7,1
Group 3,BB,-1.5,3,14,357,10,2015,10,0
Group 3,BB,-1.5,3,14,358,10,2015,11,-1
Group 3,BB,-1.5,3,14,359,12,2015,9,3
Group 3,BB,-1.5,3,14,360,9,2015,3,6
Group 3,BB,-1.5,3,14,361,9,2015,8,1
Group 3,BB,-1.5,3,14,362,11,2015,7,4
Group 3,BB,-1.5,3,14,363,12,2015,6,6
Group 3,BB,-1.5,3,14,364,8,2015,5,3
Group 3,BB,-1.5,3,14,365,11,2015,12,-1
Group 3,BB,-1.5,3,14,366,4,2015,6,-2
Group 3,BB,-1.5,3,14,367,6,2015,7,-1
Group 3,BB,-1.5,3,14,368,10,2015,8,2
Group 3,BB,-1.5,3,14,369,12,2015,11,1
Group 3,BB,-1.5,3,14,370,8,2015,8,0
Group 3,BB,-1.5,3,14,371,7,2015,6,1
Group 3,BB,-1.5,3,14,372,9,2015,3,6
Group 3,BB,-1.5,3,14,373,9,2015,7,2
Group 3,BB,-1.5,3,14,374,4,2015,1,3
Group 3,BB,-1.5,3,14,375,8,2015,5,3
Group 3,BB,-1.5,3,14,376,7,2015,7,0
Group 3,BB,-1.5,3,14,377,6,2015,10,-4
Group 3,BB,-1.5,3,14,378,9,2015,5,4
Group 3,BB,-1.5,3,14,379,10,2015,8,2
Group 3,BB,-1.5,3,14,380,8,2015,6,2
Group 3,BB,-1.5,3,14,381,10,2015,9,1
Group 3,BB,-1.5,3,14,382,11,2015,3,8
Group 3,BB,-1.5,3,14,383,11,2015,5,6
Group 3,BB,-1.5,3,14,384,9,2015,6,3
Group 3,BB,-1.5,3,14,385,9,2015,6,3
Group 3,BB,-1.5,3,14,386,7,2015,11,-4
Group 3,BB,-1.5,3,14,387,10,2015,8,2
Group 3,BB,-1.5,3,14,388,7,2015,7,0
Group 3,BB,-1.5,3,14,389,6,2015,9,-3
Group 3,BB,-1.5,3,14,390,9,2015,4,5
Group 3,BB,-1.5,3,14,391,8,2015,5,3
Group 3,BB,-1.5,3,14,392,6,2015,2,4
Group 3,BB,-1.5,3,14,393,10,2015,11,-1
Group 3,BB,-1.5,3,14,394,9,2015,6,3
Group 3,BB,-1.5,3,14,395,12,2015,7,5
Group 3,BB,-1.5,3,14,396,8,2015,7,1
Group 3,BB,-1.5,3,14,397,11,2015,6,5
Group 3,BB,-1.5,3,14,398,8,2015,7,1
Group 3,BB,-1.5,3,14,399,10,2015,4,6
Group 3,BB,-1.5,3,14,400,9,2015,5,4
Group 3,BB,-1.5,3,14,401,8,2015,5,3
Group 3,BB,-1.5,3,14,402,6,2015,6,0
Group 3,BB,-1.5,3,14,403,6,2015,5,1
Group 3,BB,-1.5,3,14,404,7,2015,4,3
Group 3,BB,-1.5,3,14,405,6,2015,7,-1
Group 3,BB,-1.5,3,14,406,9,2015,8,1
Group 3,BB,-1.5,3,14,407,9,2015,9,0
Group 3,BB,-1.5,3,14,408,6,2015,8,-2
Group 3,BB,-1.5,3,14,409,10,2015,10,0
Group 3,BB,-1.5,3,14,410,7,2015,11,-4
Group 3,BB,-1.5,3,14,411,5,2015,9,-4
Group 3,BB,-1.5,3,14,412,6,2015,6,0
Group 3,BB,-1.5,3,14,413,5,2015,10,-5
Group 3,BB,-1.5,3,14,414,13,2015,7,6
Group 3,BB,-1.5,3,14,415,11,2015,5,6
Group 3,BB,-1.5,3,14,416,10,2015,6,4
Group 3,BB,-1.5,3,14,417,8,2015,5,3
Group 3,BB,-1.5,3,14,418,6,2015,8,-2
Group 3,BB,-1.5,3,14,419,5,2015,4,1
Group 3,BB,-1.5,3,14,420,10,2015,5,5
Group 3,BB,-1.5,3,14,421,3,2015,8,-5
Group 3,BB,-1.5,3,14,422,8,2015,6,2
Group 3,BB,-1.5,3,14,423,3,2015,5,-2
Group 3,BB,-1.5,3,14,424,8,2015,5,3
Group 3,BB,-1.5,3,14,425,9,2015,6,3
Group 3,BB,-1.5,3,14,426,4,2015,6,-2
Group 3,BB,-1.5,3,14,427,7,2015,9,-2
Group 3,BB,-1.5,3,14,428,9,2015,8,1
Group 3,BB,-1.5,3,14,429,12,2015,11,1
Group 3,BB,-1.5,3,14,430,5,2015,6,-1
Group 3,BB,-1.5,3,14,431,11,2015,7,4
Group 3,BB,-1.5,3,14,432,7,2015,11,-4
Group 3,BB,-1.5,3,14,433,7,2015,7,0
Group 3,BB,-1.5,3,14,434,11,2015,6,5
Group 3,BB,-1.5,3,14,435,6,2015,7,-1
Group 3,BB,-1.5,3,14,436,8,2015,8,0
Group 3,BB,-1.5,3,14,437,9,2015,8,1
Group 3,BB,-1.5,3,14,438,6,2015,3,3
Group 3,BB,-1.5,3,14,439,9,2015,6,3
Group 3,BB,-1.5,3,14,440,12,2015,6,6
Group 3,BB,-1.5,3,14,441,5,2015,7,-2
Group 3,BB,-1.5,3,14,442,9,2015,10,-1
Group 3,BB,-1.5,3,14,443,10,2015,9,1
Group 3,BB,-1.5,3,14,444,6,2015,5,1
Group 3,BB,-1.5,3,14,445,9,2015,9,0
Group 3,BB,-1.5,3,14,446,11,2015,8,3
Group 3,BB,-1.5,3,14,447,9,2015,3,6
Group 3,BB,-1.5,3,14,448,11,2015,7,4
Group 3,BB,-1.5,3,14,449,11,2015,6,5
Group 3,BB,-1.5,3,14,450,7,2015,5,2
Group 3,BB,-1.5,3,14,451,8,2015,7,1
Group 3,BB,-1.5,3,14,452,8,2015,6,2
Group 3,BB,-1.5,3,14,453,10,2015,11,-1
Group 3,BB,-1.5,3,14,454,8,2015,5,3
Group 3,BB,-1.5,3,14,455,7,2015,4,3
Group 3,BB,-1.5,3,14,456,11,2015,5,6
Group 3,BB,-1.5,3,14,457,9,2015,5,4
Group 3,BB,-1.5,3,14,458,8,2015,5,3
Group 3,BB,-1.5,3,14,459,11,2015,7,4
Group 3,BB,-1.5,3,14,460,4,2015,8,-4
Group 3,BB,-1.5,3,14,461,4,2015,9,-5
Group 3,BB,-1.5,3,14,462,6,2015,7,-1
Group 3,BB,-1.5,3,14,463,6,2015,10,-4
Group 3,BB,-1.5,3,14,464,5,2015,6,-1
Group 3,BB,-1.5,3,14,465,5,2015,8,-3
Group 3,BB,-1.5,3,14,466,9,2015,2,7
Group 3,BB,-1.5,3,14,467,13,2015,4,9
Group 3,BB,-1.5,3,14,468,8,2015,5,3
Group 3,BB,-1.5,3,14,469,8,2015,8,0
Group 3,BB,-1.5,3,14,470,8,2015,7,1
Group 3,BB,-1.5,3,14,471,13,2015,4,9
Group 3,BB,-1.5,3,14,472,11,2015,6,5
Group 3,BB,-1.5,3,14,473,5,2015,6,-1
Group 3,BB,-1.5,3,14,474,7,2015,7,0
Group 3,BB,-1.5,3,14,475,7,2015,7,0
Group 3,BB,-1.5,3,14,476,10,2015,10,0
Group 3,BB,-1.5,3,14,477,9,2015,4,5
Group 3,BB,-1.5,3,14,478,9,2015,5,4
Group 3,BB,-1.5,3,14,479,5,2015,7,-2
Group 3,BB,-1.5,3,14,480,10,2015,11,-1
Group 3,BB,-1.5,3,14,481,9,2015,4,5
Group 3,BB,-1.5,3,14,482,7,2015,9,-2
Group 3,BB,-1.5,3,14,483,10,2015,8,2
Group 3,BB,-1.5,3,14,484,7,2015,4,3
Group 3,BB,-1.5,3,14,485,9,2015,10,-1
Group 3,BB,-1.5,3,14,486,9,2015,6,3
Group 3,BB,-1.5,3,14,487,7,2015,8,-1
Group 3,BB,-1.5,3,14,488,12,2015,9,3
Group 3,BB,-1.5,3,14,489,10,2015,5,5
Group 3,BB,-1.5,3,14,490,6,2015,9,-3
Group 3,BB,-1.5,3,14,491,11,2015,9,2
Group 3,BB,-1.5,3,14,492,7,2015,9,-2
Group 3,BB,-1.5,3,14,493,11,2015,10,1
Group 3,BB,-1.5,3,14,494,9,2015,7,2
Group 3,BB,-1.5,3,14,495,8,2015,6,2
Group 3,BB,-1.5,3,14,496,10,2015,11,-1
Group 3,BB,-1.5,3,14,497,8,2015,5,3
Group 3,BB,-1.5,3,14,498,10,2015,8,2
Group 3,BB,-1.5,3,14,499,11,2015,9,2
Group 3,BB,-1.5,3,14,500,12,2015,10,2
Group 3,BB,-1.5,3,14,501,10,2015,5,5
Group 3,BB,-1.5,3,14,502,7,2015,0,7
Group 3,BB,-1.5,3,14,503,10,2015,13,-3
Group 3,BB,-1.5,3,14,504,8,2015,6,2
Group 3,BB,-1.5,3,14,505,10,2015,0,10
Group 3,BB,-1.5,3,14,506,6,2015,1,5
Group 3,BB,-1.5,3,14,507,12,2015,6,6
Group 3,BB,-1.5,3,14,508,8,2015,6,2
Group 3,BB,-1.5,3,14,509,8,2015,8,0
Group 3,BB,-1.5,3,14,510,11,2015,6,5
Group 3,BB,-1.5,3,14,511,6,2015,1,5
Group 3,BB,-1.5,3,14,512,7,2015,8,-1
Group 3,BB,-1.5,3,14,513,3,2015,7,-4
Group 3,BB,-1.5,3,14,514,12,2015,3,9
Group 3,BB,-1.5,3,14,515,8,2015,7,1
Group 3,BB,-1.5,3,14,516,5,2015,5,0
Group 3,BB,-1.5,3,14,517,2,2015,5,-3
Group 3,BB,-1.5,3,14,518,9,2015,3,6
Group 3,BB,-1.5,3,14,519,11,2015,8,3
Group 3,BB,-1.5,3,14,520,12,2015,7,5
Group 3,BB,-1.5,3,14,521,5,2015,6,-1
Group 3,BB,-1.5,3,14,522,8,2015,9,-1
Group 3,BB,-1.5,3,14,523,6,2015,7,-1
Group 3,BB,-1.5,3,14,524,5,2015,9,-4
Group 3,BB,-1.5,3,14,525,6,2015,9,-3
Group 3,BB,-1.5,3,14,526,6,2015,3,3
Group 3,BB,-1.5,3,14,527,6,2015,4,2
Group 3,BB,-1.5,3,14,528,8,2015,7,1
Group 3,BB,-1.5,3,14,529,10,2015,6,4
Group 3,BB,-1.5,3,14,530,8,2015,4,4
Group 3,BB,-1.5,3,14,531,9,2015,5,4
Group 3,BB,-1.5,3,14,532,8,2015,5,3
Group 3,BB,-1.5,3,14,533,13,2015,8,5
Group 3,BB,-1.5,3,14,534,7,2015,8,-1
Group 3,BB,-1.5,3,14,535,4,2015,7,-3
Group 3,BB,-1.5,3,14,536,9,2015,5,4
Group 3,BB,-1.5,3,14,537,9,2015,9,0
Group 3,BB,-1.5,3,14,538,9,2015,6,3
Group 3,BB,-1.5,3,14,539,11,2015,3,8
Group 3,BB,-1.5,3,14,540,12,2015,12,0
Group 3,BB,-1.5,3,14,541,4,2015,7,-3
Group 3,BB,-1.5,3,14,542,6,2015,7,-1
Group 3,BB,-1.5,3,14,543,9,2015,7,2
Group 3,BB,-1.5,3,14,544,12,2015,7,5
Group 3,BB,-1.5,3,14,545,6,2015,5,1
Group 3,BB,-1.5,3,14,546,8,2015,9,-1
Group 3,BB,-1.5,3,14,547,11,2015,5,6
Group 3,BB,-1.5,3,14,548,6,2015,6,0
Group 3,BB,-1.5,3,14,549,8,2015,6,2
Group 3,BB,-1.5,3,14,550,7,2015,7,0
Group 3,BB,-1.5,3,14,551,13,2015,5,8
Group 3,BB,-1.5,3,14,552,9,2015,6,3
Group 3,BB,-1.5,3,14,553,8,2015,6,2
Group 3,BB,-1.5,3,14,554,9,2015,8,1
Group 3,BB,-1.5,3,14,555,9,2015,8,1
Group 3,BB,-1.5,3,14,556,11,2015,5,6
Group 3,BB,-1.5,3,14,557,9,2015,11,-2
Group 3,BB,-1.5,3,14,558,5,2015,8,-3
Group 3,BB,-1.5,3,14,559,10,2015,10,0
Group 3,BB,-1.5,3,14,560,6,2015,6,0
Group 3,BB,-1.5,3,14,561,9,2015,6,3
Group 3,BB,-1.5,3,14,562,11,2015,10,1
Group 3,BB,-1.5,3,14,563,3,2015,9,-6
Group 3,BB,-1.5,3,14,564,10,2015,11,-1
Group 3,BB,-1.5,3,14,565,9,2015,7,2
Group 3,BB,-1.5,3,14,566,5,2015,11,-6
Group 3,BB,-1.5,3,14,567,6,2015,8,-2
Group 3,BB,-1.5,3,14,568,10,2015,2,8
Group 3,BB,-1.5,3,14,569,6,2015,6,0
Group 3,BB,-1.5,3,14,570,9,2015,8,1
Group 3,BB,-1.5,3,14,571,7,2015,4,3
Group 3,BB,-1.5,3,14,572,10,2015,8,2
Group 3,BB,-1.5,3,14,573,8,2015,5,3
Group 3,BB,-1.5,3,14,574,11,2015,6,5
Group 3,BB,-1.5,3,14,575,6,2015,8,-2
Group 3,BB,-1.5,3,14,576,7,2015,10,-3
Group 3,BB,-1.5,3,14,577,9,2015,10,-1
Group 3,BB,-1.5,3,14,578,6,2015,8,-2
Group 3,BB,-1.5,3,14,579,8,2015,7,1
Group 3,BB,-1.5,3,14,580,10,2015,4,6
Group 3,BB,-1.5,3,14,581,7,2015,8,-1
Group 3,BB,-1.5,3,14,582,12,2015,5,7
Group 3,BB,-1.5,3,14,583,11,2015,7,4
Group 3,BB,-1.5,3,14,584,9,2015,5,4
Group 3,BB,-1.5,3,14,585,5,2015,10,-5
Group 3,BB,-1.5,3,14,586,8,2015,11,-3
Group 3,BB,-1.5,3,14,587,3,2015,12,-9
Group 3,BB,-1.5,3,14,588,8,2015,10,-2
Group 3,BB,-1.5,3,14,589,10,2015,6,4
Group 3,BB,-1.5,3,14,590,6,2015,5,1
Group 3,BB,-1.5,3,14,591,11,2015,10,1
Group 3,BB,-1.5,3,14,592,11,2015,5,6
Group 3,BB,-1.5,3,14,593,10,2015,6,4
Group 3,BB,-1.5,3,14,594,7,2015,9,-2
Group 3,BB,-1.5,3,14,595,10,2015,7,3
Group 3,BB,-1.5,3,14,596,8,2015,7,1
Group 3,BB,-1.5,3,14,597,7,2015,6,1
Group 3,BB,-1.5,3,14,598,9,2015,7,2
Group 3,BB,-1.5,3,14,599,4,2015,8,-4
Group 3,BB,-1.5,3,14,600,8,2015,3,5
Group 3,BB,-1.5,3,14,601,10,2015,6,4
Group 3,BB,-1.5,3,14,602,8,2015,9,-1
Group 3,BB,-1.5,3,14,603,7,2015,7,0
Group 3,BB,-1.5,3,14,604,4,2015,7,-3
Group 3,BB,-1.5,3,14,605,10,2015,8,2
Group 3,BB,-1.5,3,14,606,8,2015,9,-1
Group 3,BB,-1.5,3,14,607,4,2015,7,-3
Group 3,BB,-1.5,3,14,608,6,2015,6,0
Group 3,BB,-1.5,3,14,609,10,2015,5,5
Group 3,BB,-1.5,3,14,610,7,2015,7,0
Group 3,BB,-1.5,3,14,611,9,2015,9,0
Group 3,BB,-1.5,3,14,612,7,2015,9,-2
Group 3,BB,-1.5,3,14,613,7,2015,4,3
Group 3,BB,-1.5,3,14,614,4,2015,9,-5
Group 3,BB,-1.5,3,14,615,9,2015,6,3
Group 3,BB,-1.5,3,14,616,11,2015,6,5
Group 3,BB,-1.5,3,14,617,8,2015,5,3
Group 3,BB,-1.5,3,14,618,10,2015,6,4
Group 3,BB,-1.5,3,14,619,6,2015,9,-3
Group 3,BB,-1.5,3,14,620,6,2015,8,-2
Group 3,BB,-1.5,3,14,621,5,2015,5,0
Group 3,BB,-1.5,3,14,622,3,2015,10,-7
Group 3,BB,-1.5,3,14,623,6,2015,5,1
Group 3,BB,-1.5,3,14,624,10,2015,6,4
Group 3,BB,-1.5,3,14,625,12,2015,5,7
Group 3,BB,-1.5,3,14,626,8,2015,8,0
Group 3,BB,-1.5,3,14,627,12,2015,5,7
Group 3,BB,-1.5,3,14,628,9,2015,5,4
Group 3,BB,-1.5,3,14,629,8,2015,5,3
Group 3,BB,-1.5,3,14,630,13,2015,4,9
Group 3,BB,-1.5,3,14,631,10,2015,7,3
Group 3,BB,-1.5,3,14,632,9,2015,7,2
Group 3,BB,-1.5,3,14,633,6,2015,5,1
Group 3,BB,-1.5,3,14,634,10,2015,9,1
Group 3,BB,-1.5,3,14,635,13,2015,7,6
Group 3,BB,-1.5,3,14,636,10,2015,6,4
Group 3,BB,-1.5,3,14,637,6,2015,8,-2
Group 3,BB,-1.5,3,14,638,10,2015,6,4
Group 3,BB,-1.5,3,14,639,11,2015,7,4
Group 3,BB,-1.5,3,14,640,10,2015,14,-4
Group 3,BB,-1.5,3,14,641,8,2015,4,4
Group 3,BB,-1.5,3,14,642,7,2015,5,2
Group 3,BB,-1.5,3,14,643,4,2015,8,-4
Group 3,BB,-1.5,3,14,644,6,2015,8,-2
Group 3,BB,-1.5,3,14,645,9,2015,8,1
Group 3,BB,-1.5,3,14,646,9,2015,8,1
Group 3,BB,-1.5,3,14,647,10,2015,6,4
Group 3,BB,-1.5,3,14,648,10,2015,10,0
Group 3,BB,-1.5,3,14,649,3,2015,5,-2
Group 3,BB,-1.5,3,14,650,4,2015,6,-2
Group 3,BB,-1.5,3,14,651,10,2015,5,5
Group 3,BB,-1.5,3,14,652,11,2015,7,4
Group 3,BB,-1.5,3,14,653,7,2015,6,1
Group 3,BB,-1.5,3,14,654,5,2015,4,1
Group 3,BB,-1.5,3,14,655,10,2015,9,1
Group 3,BB,-1.5,3,14,656,10,2015,8,2
Group 3,BB,-1.5,3,14,657,12,2015,5,7
Group 3,BB,-1.5,3,14,658,7,2015,10,-3
Group 3,BB,-1.5,3,14,659,11,2015,9,2
Group 3,BB,-1.5,3,14,660,7,2015,10,-3
Group 3,BB,-1.5,3,14,661,6,2015,6,0
Group 3,BB,-1.5,3,14,662,14,2015,2,12
Group 3,BB,-1.5,3,14,663,10,2015,7,3
Group 3,BB,-1.5,3,14,664,12,2015,8,4
Group 3,BB,-1.5,3,14,665,11,2015,8,3
Group 3,BB,-1.5,3,14,666,9,2015,6,3
Group 3,BB,-1.5,3,14,667,6,2015,5,1
Group 3,BB,-1.5,3,14,668,9,2015,7,2
Group 3,BB,-1.5,3,14,669,9,2015,5,4
Group 3,BB,-1.5,3,14,670,6,2015,8,-2
Group 3,BB,-1.5,3,14,671,7,2015,7,0
Group 3,BB,-1.5,3,14,672,5,2015,6,-1
Group 3,BB,-1.5,3,14,673,12,2015,5,7
Group 3,BB,-1.5,3,14,674,7,2015,8,-1
Group 3,BB,-1.5,3,14,675,7,2015,7,0
Group 3,BB,-1.5,3,14,676,10,2015,6,4
Group 3,BB,-1.5,3,14,677,12,2015,4,8
Group 3,BB,-1.5,3,14,678,11,2015,9,2
Group 3,BB,-1.5,3,14,679,9,2015,9,0
Group 3,BB,-1.5,3,14,680,11,2015,9,2
Group 3,BB,-1.5,3,14,681,9,2015,7,2
Group 3,BB,-1.5,3,14,682,10,2015,8,2
Group 3,BB,-1.5,3,14,683,11,2015,7,4
Group 3,BB,-1.5,3,14,684,9,2015,3,6
Group 3,BB,-1.5,3,14,685,10,2015,4,6
Group 3,BB,-1.5,3,14,686,10,2015,10,0
Group 3,BB,-1.5,3,14,687,6,2015,5,1
Group 3,BB,-1.5,3,14,688,6,2015,9,-3
Group 3,BB,-1.5,3,14,689,7,2015,7,0
Group 3,BB,-1.5,3,14,690,13,2015,5,8
Group 3,BB,-1.5,3,14,691,6,2015,10,-4
Group 3,BB,-1.5,3,14,692,9,2015,8,1
Group 3,BB,-1.5,3,14,693,6,2015,7,-1
Group 3,BB,-1.5,3,14,694,11,2015,9,2
Group 3,BB,-1.5,3,14,695,6,2015,7,-1
Group 3,BB,-1.5,3,14,696,7,2015,8,-1
Group 3,BB,-1.5,3,14,697,10,2015,11,-1
Group 3,BB,-1.5,3,14,698,9,2015,12,-3
Group 3,BB,-1.5,3,14,699,6,2015,7,-1
Group 3,BB,-1.5,3,14,700,10,2015,6,4
Group 3,BB,-1.5,3,14,701,7,2015,3,4
Group 3,BB,-1.5,3,14,702,8,2015,8,0
Group 3,BB,-1.5,3,14,703,9,2015,8,1
Group 3,BB,-1.5,3,14,704,8,2015,6,2
Group 3,BB,-1.5,3,14,705,8,2015,7,1
Group 3,BB,-1.5,3,14,706,6,2015,4,2
Group 3,BB,-1.5,3,14,707,8,2015,6,2
Group 3,BB,-1.5,3,14,708,10,2015,6,4
Group 3,BB,-1.5,3,14,709,9,2015,6,3
Group 3,BB,-1.5,3,14,710,10,2015,7,3
Group 3,BB,-1.5,3,14,711,5,2015,7,-2
Group 3,BB,-1.5,3,14,712,3,2015,9,-6
Group 3,BB,-1.5,3,14,713,9,2015,9,0
Group 3,BB,-1.5,3,14,714,13,2015,9,4
Group 3,BB,-1.5,3,14,715,5,2015,3,2
Group 3,BB,-1.5,3,14,716,11,2015,6,5
Group 3,BB,-1.5,3,14,717,7,2015,5,2
Group 3,BB,-1.5,3,14,718,11,2015,4,7
Group 3,BB,-1.5,3,14,719,11,2015,6,5
Group 3,BB,-1.5,3,14,720,12,2015,10,2
Group 3,BB,-1.5,3,14,721,8,2015,4,4
Group 3,BB,-1.5,3,14,722,8,2015,9,-1
Group 3,BB,-1.5,3,14,723,9,2015,7,2
Group 3,BB,-1.5,3,14,724,8,2015,5,3
Group 3,BB,-1.5,3,14,725,8,2015,6,2
Group 3,BB,-1.5,3,14,726,7,2015,8,-1
Group 3,BB,-1.5,3,14,727,7,2015,10,-3
Group 3,BB,-1.5,3,14,728,11,2015,6,5
Group 3,BB,-1.5,3,14,729,12,2015,8,4
Group 3,BB,-1.5,3,14,730,6,2015,8,-2
Group 3,BB,-1.5,3,14,731,11,2015,2,9
Group 3,BB,-1.5,3,14,732,5,2015,7,-2
Group 3,BB,-1.5,3,14,733,9,2015,7,2
Group 3,BB,-1.5,3,14,734,10,2015,11,-1
Group 3,BB,-1.5,3,14,735,9,2015,6,3
Group 3,BB,-1.5,3,14,736,10,2015,8,2
Group 3,BB,-1.5,3,14,737,10,2015,4,6
Group 3,BB,-1.5,3,14,738,8,2015,8,0
Group 3,BB,-1.5,3,14,739,10,2015,9,1
Group 3,BB,-1.5,3,14,740,11,2015,7,4
Group 3,BB,-1.5,3,14,741,8,2015,6,2
Group 3,BB,-1.5,3,14,742,12,2015,8,4
Group 3,BB,-1.5,3,14,743,9,2015,10,-1
Group 3,BB,-1.5,3,14,744,11,2015,10,1
Group 3,BB,-1.5,3,14,745,13,2015,6,7
Group 3,BB,-1.5,3,14,746,12,2015,7,5
Group 3,BB,-1.5,3,14,747,11,2015,8,3
Group 3,BB,-1.5,3,14,748,8,2015,7,1
Group 3,BB,-1.5,3,14,749,5,2015,5,0
Group 3,BB,-1.5,3,14,750,5,2015,5,0
Group 3,BB,-1.5,3,14,751,8,2015,6,2
Group 3,BB,-1.5,3,14,752,9,2015,4,5
Group 3,BB,-1.5,3,14,753,10,2015,8,2
Group 3,BB,-1.5,3,14,754,10,2015,9,1
Group 3,BB,-1.5,3,14,755,9,2015,5,4
Group 3,BB,-1.5,3,14,756,9,2015,5,4
Group 3,BB,-1.5,3,14,757,4,2015,5,-1
Group 3,BB,-1.5,3,14,758,8,2015,9,-1
Group 3,BB,-1.5,3,14,759,5,2015,5,0
Group 3,BB,-1.5,3,14,760,8,2015,6,2
Group 3,BB,-1.5,3,14,761,12,2015,9,3
Group 3,BB,-1.5,3,14,762,13,2015,6,7
Group 3,BB,-1.5,3,14,763,6,2015,9,-3
Group 3,BB,-1.5,3,14,764,7,2015,10,-3
Group 3,BB,-1.5,3,14,765,4,2015,5,-1
Group 3,BB,-1.5,3,14,766,10,2015,7,3
Group 3,BB,-1.5,3,14,767,10,2015,4,6
Group 3,BB,-1.5,3,14,768,7,2015,6,1
Group 3,BB,-1.5,3,14,769,7,2015,10,-3
Group 3,BB,-1.5,3,14,770,2,2015,7,-5
Group 3,BB,-1.5,3,14,771,6,2015,7,-1
Group 3,BB,-1.5,3,14,772,7,2015,8,-1
Group 3,BB,-1.5,3,14,773,8,2015,5,3
Group 3,BB,-1.5,3,14,774,8,2015,5,3
Group 3,BB,-1.5,3,14,775,9,2015,6,3
Group 3,BB,-1.5,3,14,776,10,2015,8,2
Group 3,BB,-1.5,3,14,777,9,2015,7,2
Group 3,BB,-1.5,3,14,778,8,2015,5,3
Group 3,BB,-1.5,3,14,779,7,2015,4,3
Group 3,BB,-1.5,3,14,780,5,2015,5,0
Group 3,BB,-1.5,3,14,781,11,2015,10,1
Group 3,BB,-1.5,3,14,782,7,2015,8,-1
Group 3,BB,-1.5,3,14,783,8,2015,9,-1
Group 3,BB,-1.5,3,14,784,9,2015,7,2
Group 3,BB,-1.5,3,14,785,9,2015,5,4
Group 3,BB,-1.5,3,14,786,11,2015,7,4
Group 3,BB,-1.5,3,14,787,9,2015,9,0
Group 3,BB,-1.5,3,14,788,11,2015,9,2
Group 3,BB,-1.5,3,14,789,9,2015,7,2
Group 3,BB,-1.5,3,14,790,9,2015,5,4
Group 3,BB,-1.5,3,14,791,10,2015,8,2
Group 3,BB,-1.5,3,14,792,3,2015,7,-4
Group 3,BB,-1.5,3,14,793,8,2015,6,2
Group 3,BB,-1.5,3,14,794,10,2015,7,3
Group 3,BB,-1.5,3,14,795,10,2015,12,-2
Group 3,BB,-1.5,3,14,796,13,2015,10,3
Group 3,BB,-1.5,3,14,797,10,2015,8,2
Group 3,BB,-1.5,3,14,798,10,2015,10,0
Group 3,BB,-1.5,3,14,799,7,2015,6,1
Group 3,BB,-1.5,3,14,800,11,2015,8,3
Group 3,BB,-1.5,3,14,801,6,2015,6,0
Group 3,BB,-1.5,3,14,802,10,2015,7,3
Group 3,BB,-1.5,3,14,803,12,2015,5,7
Group 3,BB,-1.5,3,14,804,7,2015,5,2
Group 3,BB,-1.5,3,14,805,13,2015,6,7
Group 3,BB,-1.5,3,14,806,10,2015,8,2
Group 3,BB,-1.5,3,14,807,8,2015,5,3
Group 3,BB,-1.5,3,14,808,7,2015,7,0
Group 3,BB,-1.5,3,14,809,3,2015,7,-4
Group 3,BB,-1.5,3,14,810,13,2015,6,7
Group 3,BB,-1.5,3,14,811,5,2015,5,0
Group 3,BB,-1.5,3,14,812,8,2015,5,3
Group 3,BB,-1.5,3,14,813,5,2015,5,0
Group 3,BB,-1.5,3,14,814,8,2015,6,2
Group 3,BB,-1.5,3,14,815,11,2015,7,4
Group 3,BB,-1.5,3,14,816,6,2015,9,-3
Group 3,BB,-1.5,3,14,817,7,2015,8,-1
Group 3,BB,-1.5,3,14,818,8,2015,10,-2
Group 3,BB,-1.5,3,14,819,7,2015,9,-2
Group 3,BB,-1.5,3,14,820,9,2015,3,6
Group 3,BB,-1.5,3,14,821,6,2015,6,0
Group 3,BB,-1.5,3,14,822,10,2015,7,3
Group 3,BB,-1.5,3,14,823,14,2015,6,8
Group 3,BB,-1.5,3,14,824,8,2015,7,1
Group 3,BB,-1.5,3,14,825,6,2015,5,1
Group 3,BB,-1.5,3,14,826,8,2015,8,0
Group 3,BB,-1.5,3,14,827,10,2015,7,3
Group 3,BB,-1.5,3,14,828,8,2015,8,0
Group 3,BB,-1.5,3,14,829,10,2015,7,3
Group 3,BB,-1.5,3,14,830,12,2015,7,5
Group 3,BB,-1.5,3,14,831,11,2015,7,4
Group 3,BB,-1.5,3,14,832,7,2015,12,-5
Group 3,BB,-1.5,3,14,833,9,2015,4,5
Group 3,BB,-1.5,3,14,834,11,2015,7,4
Group 3,BB,-1.5,3,14,835,4,2015,3,1
Group 3,BB,-1.5,3,14,836,12,2015,5,7
Group 3,BB,-1.5,3,14,837,11,2015,6,5
Group 3,BB,-1.5,3,14,838,6,2015,7,-1
Group 3,BB,-1.5,3,14,839,13,2015,8,5
Group 3,BB,-1.5,3,14,840,5,2015,9,-4
Group 3,BB,-1.5,3,14,841,6,2015,4,2
Group 3,BB,-1.5,3,14,842,6,2015,8,-2
Group 3,BB,-1.5,3,14,843,4,2015,8,-4
Group 3,BB,-1.5,3,14,844,9,2015,10,-1
Group 3,BB,-1.5,3,14,845,8,2015,8,0
Group 3,BB,-1.5,3,14,846,13,2015,6,7
Group 3,BB,-1.5,3,14,847,8,2015,9,-1
Group 3,BB,-1.5,3,14,848,10,2015,6,4
Group 3,BB,-1.5,3,14,849,6,2015,7,-1
Group 3,BB,-1.5,3,14,850,5,2015,12,-7
Group 3,BB,-1.5,3,14,851,8,2015,7,1
Group 3,BB,-1.5,3,14,852,9,2015,6,3
Group 3,BB,-1.5,3,14,853,10,2015,4,6
Group 3,BB,-1.5,3,14,854,5,2015,6,-1
Group 3,BB,-1.5,3,14,855,4,2015,8,-4
Group 3,BB,-1.5,3,14,856,7,2015,4,3
Group 3,BB,-1.5,3,14,857,9,2015,9,0
Group 3,BB,-1.5,3,14,858,10,2015,8,2
Group 3,BB,-1.5,3,14,859,11,2015,6,5
Group 3,BB,-1.5,3,14,860,9,2015,5,4
Group 3,BB,-1.5,3,14,861,8,2015,9,-1
Group 3,BB,-1.5,3,14,862,11,2015,6,5
Group 3,BB,-1.5,3,14,863,11,2015,6,5
Group 3,BB,-1.5,3,14,864,5,2015,3,2
Group 3,BB,-1.5,3,14,865,7,2015,5,2
Group 3,BB,-1.5,3,14,866,11,2015,9,2
Group 3,BB,-1.5,3,14,867,9,2015,9,0
Group 3,BB,-1.5,3,14,868,9,2015,7,2
Group 3,BB,-1.5,3,14,869,7,2015,10,-3
Group 3,BB,-1.5,3,14,870,8,2015,8,0
Group 3,BB,-1.5,3,14,871,9,2015,10,-1
Group 3,BB,-1.5,3,14,872,7,2015,4,3
Group 3,BB,-1.5,3,14,873,8,2015,9,-1
Group 3,BB,-1.5,3,14,874,5,2015,5,0
Group 3,BB,-1.5,3,14,875,8,2015,8,0
Group 3,BB,-1.5,3,14,876,11,2015,7,4
Group 3,BB,-1.5,3,14,877,9,2015,6,3
Group 3,BB,-1.5,3,14,878,7,2015,6,1
Group 3,BB,-1.5,3,14,879,11,2015,8,3
Group 3,BB,-1.5,3,14,880,8,2015,5,3
Group 3,BB,-1.5,3,14,881,9,2015,8,1
Group 3,BB,-1.5,3,14,882,9,2015,6,3
Group 3,BB,-1.5,3,14,883,6,2015,3,3
Group 3,BB,-1.5,3,14,884,8,2015,7,1
Group 3,BB,-1.5,3,14,885,11,2015,9,2
Group 3,BB,-1.5,3,14,886,7,2015,11,-4
Group 3,BB,-1.5,3,14,887,7,2015,5,2
Group 3,BB,-1.5,3,14,888,11,2015,9,2
Group 3,BB,-1.5,3,14,889,5,2015,7,-2
Group 3,BB,-1.5,3,14,890,10,2015,8,2
Group 3,BB,-1.5,3,14,891,9,2015,8,1
Group 3,BB,-1.5,3,14,892,12,2015,6,6
Group 3,BB,-1.5,3,14,893,6,2015,3,3
Group 3,BB,-1.5,3,14,894,10,2015,8,2
Group 3,BB,-1.5,3,14,895,12,2015,3,9
Group 3,BB,-1.5,3,14,896,9,2015,12,-3
Group 3,BB,-1.5,3,14,897,9,2015,4,5
Group 3,BB,-1.5,3,14,898,4,2015,11,-7
Group 3,BB,-1.5,3,14,899,7,2015,5,2
Group 3,BB,-1.5,3,14,900,8,2015,7,1
Group 3,BB,-1.5,3,14,901,9,2015,7,2
Group 3,BB,-1.5,3,14,902,8,2015,6,2
Group 3,BB,-1.5,3,14,903,9,2015,7,2
Group 3,BB,-1.5,3,14,904,10,2015,7,3
Group 3,BB,-1.5,3,14,905,7,2015,5,2
Group 3,BB,-1.5,3,14,906,9,2015,6,3
Group 3,BB,-1.5,3,14,907,6,2015,9,-3
Group 3,BB,-1.5,3,14,908,9,2015,7,2
Group 3,BB,-1.5,3,14,909,7,2015,10,-3
Group 3,BB,-1.5,3,14,910,7,2015,9,-2
Group 3,BB,-1.5,3,14,911,12,2015,10,2
Group 3,BB,-1.5,3,14,912,6,2015,6,0
Group 3,BB,-1.5,3,14,913,6,2015,3,3
Group 3,BB,-1.5,3,14,914,9,2015,7,2
Group 3,BB,-1.5,3,14,915,9,2015,4,5
Group 3,BB,-1.5,3,14,916,6,2015,4,2
Group 3,BB,-1.5,3,14,917,12,2015,8,4
Group 3,BB,-1.5,3,14,918,12,2015,7,5
Group 3,BB,-1.5,3,14,919,11,2015,7,4
Group 3,BB,-1.5,3,14,920,6,2015,5,1
Group 3,BB,-1.5,3,14,921,11,2015,8,3
Group 3,BB,-1.5,3,14,922,6,2015,6,0
Group 3,BB,-1.5,3,14,923,10,2015,12,-2
Group 3,BB,-1.5,3,14,924,4,2015,6,-2
Group 3,BB,-1.5,3,14,925,11,2015,4,7
Group 3,BB,-1.5,3,14,926,7,2015,6,1
Group 3,BB,-1.5,3,14,927,5,2015,5,0
Group 3,BB,-1.5,3,14,928,11,2015,7,4
Group 3,BB,-1.5,3,14,929,11,2015,8,3
Group 3,BB,-1.5,3,14,930,6,2015,8,-2
Group 3,BB,-1.5,3,14,931,10,2015,10,0
Group 3,BB,-1.5,3,14,932,11,2015,5,6
Group 3,BB,-1.5,3,14,933,10,2015,8,2
Group 3,BB,-1.5,3,14,934,9,2015,7,2
Group 3,BB,-1.5,3,14,935,10,2015,6,4
Group 3,BB,-1.5,3,14,936,10,2015,3,7
Group 3,BB,-1.5,3,14,937,4,2015,7,-3
Group 3,BB,-1.5,3,14,938,6,2015,6,0
Group 3,BB,-1.5,3,14,939,11,2015,5,6
Group 3,BB,-1.5,3,14,940,9,2015,8,1
Group 3,BB,-1.5,3,14,941,8,2015,6,2
Group 3,BB,-1.5,3,14,942,7,2015,6,1
Group 3,BB,-1.5,3,14,943,7,2015,8,-1
Group 3,BB,-1.5,3,14,944,4,2015,5,-1
Group 3,BB,-1.5,3,14,945,11,2015,8,3
Group 3,BB,-1.5,3,14,946,6,2015,11,-5
Group 3,BB,-1.5,3,14,947,8,2015,10,-2
Group 3,BB,-1.5,3,14,948,9,2015,5,4
Group 3,BB,-1.5,3,14,949,8,2015,7,1
Group 3,BB,-1.5,3,14,950,9,2015,6,3
Group 3,BB,-1.5,3,14,951,6,2015,8,-2
Group 3,BB,-1.5,3,14,952,8,2015,7,1
Group 3,BB,-1.5,3,14,953,10,2015,5,5
Group 3,BB,-1.5,3,14,954,4,2015,7,-3
Group 3,BB,-1.5,3,14,955,11,2015,8,3
Group 3,BB,-1.5,3,14,956,10,2015,11,-1
Group 3,BB,-1.5,3,14,957,7,2015,7,0
Group 3,BB,-1.5,3,14,958,5,2015,5,0
Group 3,BB,-1.5,3,14,959,5,2015,10,-5
Group 3,BB,-1.5,3,14,960,8,2015,5,3
Group 3,BB,-1.5,3,14,961,12,2015,9,3
Group 3,BB,-1.5,3,14,962,9,2015,9,0
Group 3,BB,-1.5,3,14,963,8,2015,7,1
Group 3,BB,-1.5,3,14,964,7,2015,7,0
Group 3,BB,-1.5,3,14,965,7,2015,5,2
Group 3,BB,-1.5,3,14,966,7,2015,6,1
Group 3,BB,-1.5,3,14,967,8,2015,7,1
Group 3,BB,-1.5,3,14,968,5,2015,11,-6
Group 3,BB,-1.5,3,14,969,7,2015,3,4
Group 3,BB,-1.5,3,14,970,10,2015,5,5
Group 3,BB,-1.5,3,14,971,10,2015,9,1
Group 3,BB,-1.5,3,14,972,7,2015,8,-1
Group 3,BB,-1.5,3,14,973,6,2015,6,0
Group 3,BB,-1.5,3,14,974,11,2015,8,3
Group 3,BB,-1.5,3,14,975,9,2015,7,2
Group 3,BB,-1.5,3,14,976,9,2015,5,4
Group 3,BB,-1.5,3,14,977,7,2015,5,2
Group 3,BB,-1.5,3,14,978,8,2015,5,3
Group 3,BB,-1.5,3,14,979,9,2015,7,2
Group 3,BB,-1.5,3,14,980,9,2015,11,-2
Group 3,BB,-1.5,3,14,981,6,2015,4,2
Group 3,BB,-1.5,3,14,982,3,2015,3,0
Group 3,BB,-1.5,3,14,983,11,2015,6,5
Group 3,BB,-1.5,3,14,984,10,2015,5,5
Group 3,BB,-1.5,3,14,985,8,2015,6,2
Group 3,BB,-1.5,3,14,986,8,2015,7,1
Group 3,BB,-1.5,3,14,987,7,2015,8,-1
Group 3,BB,-1.5,3,14,988,10,2015,7,3
Group 3,BB,-1.5,3,14,989,7,2015,6,1
Group 3,BB,-1.5,3,14,990,8,2015,5,3
Group 3,BB,-1.5,3,14,991,10,2015,7,3
Group 3,BB,-1.5,3,14,992,7,2015,11,-4
Group 3,BB,-1.5,3,14,993,7,2015,9,-2
Group 3,BB,-1.5,3,14,994,9,2015,6,3
Group 3,BB,-1.5,3,14,995,7,2015,6,1
Group 3,BB,-1.5,3,14,996,12,2015,8,4
Group 3,BB,-1.5,3,14,997,8,2015,10,-2
Group 3,BB,-1.5,3,14,998,8,2015,5,3
Group 3,BB,-1.5,3,14,999,6,2015,8,-2
Group 3,BB,-1.5,3,14,1000,9,2015,10,-1
Group 3,BB,-1.5,3,14,1001,10,2015,10,0
Group 3,BB,-1.5,3,14,1002,6,2015,8,-2
Group 3,BB,-1.5,3,14,1003,7,2015,7,0
Group 3,BB,-1.5,3,14,1004,12,2015,8,4
Group 3,BB,-1.5,3,14,1005,5,2015,9,-4
Group 3,BB,-1.5,3,14,1006,9,2015,5,4
Group 3,BB,-1.5,3,14,1007,9,2015,5,4
Group 3,BB,-1.5,3,14,1008,9,2015,8,1
Group 3,BB,-1.5,3,14,1009,11,2015,8,3
Group 3,BB,-1.5,3,14,1010,10,2015,6,4
Group 3,BB,-1.5,3,14,1011,7,2015,8,-1
Group 3,BB,-1.5,3,14,1012,7,2015,8,-1
Group 3,BB,-1.5,3,14,1013,12,2015,1,11
Group 3,BB,-1.5,3,14,1014,13,2015,7,6
Group 3,BB,-1.5,3,14,1015,12,2015,9,3
Group 3,BB,-1.5,3,14,1016,14,2015,7,7
Group 3,BB,-1.5,3,14,1017,10,2015,5,5
Group 3,BB,-1.5,3,14,1018,8,2015,10,-2
Group 3,BB,-1.5,3,14,1019,7,2015,7,0
Group 3,BB,-1.5,3,14,1020,9,2015,8,1
Group 3,BB,-1.5,3,14,1021,8,2015,8,0
Group 3,BB,-1.5,3,14,1022,8,2015,7,1
Group 3,BB,-1.5,3,14,1023,9,2015,9,0
Group 3,BB,-1.5,3,14,1024,10,2015,7,3
Group 3,BB,-1.5,3,14,1025,7,2015,4,3
Group 3,BB,-1.5,3,14,1026,6,2015,5,1
Group 3,BB,-1.5,3,14,1027,10,2015,4,6
Group 3,BB,-1.5,3,14,1028,8,2015,4,4
Group 3,BB,-1.5,3,14,1029,8,2015,9,-1
Group 3,BB,-1.5,3,14,1030,9,2015,9,0
Group 3,BB,-1.5,3,14,1031,8,2015,6,2
Group 3,BB,-1.5,3,14,1032,7,2015,5,2
Group 3,BB,-1.5,3,14,1033,9,2015,3,6
Group 3,BB,-1.5,3,14,1034,8,2015,6,2
Group 3,BB,-1.5,3,14,1035,5,2015,6,-1
Group 3,BB,-1.5,3,14,1036,8,2015,5,3
Group 3,BB,-1.5,3,14,1037,9,2015,8,1
Group 3,BB,-1.5,3,14,1038,7,2015,10,-3
Group 3,BB,-1.5,3,14,1039,8,2015,6,2
Group 3,BB,-1.5,3,14,1040,10,2015,4,6
Group 3,BB,-1.5,3,14,1041,8,2015,8,0
Group 3,BB,-1.5,3,14,1042,6,2015,9,-3
Group 3,BB,-1.5,3,14,1043,9,2015,6,3
Group 3,BB,-1.5,3,14,1044,5,2015,6,-1
Group 3,BB,-1.5,3,14,1045,7,2015,6,1
Group 3,BB,-1.5,3,14,1046,6,2015,6,0
Group 3,BB,-1.5,3,14,1047,8,2015,6,2
Group 3,BB,-1.5,3,14,1048,9,2015,8,1
Group 3,BB,-1.5,3,14,1049,5,2015,9,-4
Group 3,BB,-1.5,3,14,1050,9,2015,6,3
Group 3,BB,-1.5,3,14,1051,9,2015,9,0
Group 3,BB,-1.5,3,14,1052,9,2015,9,0
Group 3,BB,-1.5,3,14,1053,12,2015,8,4
Group 3,BB,-1.5,3,14,1054,12,2015,11,1
Group 3,BB,-1.5,3,14,1055,6,2015,4,2
Group 3,BB,-1.5,3,14,1056,7,2015,5,2
Group 3,BB,-1.5,3,14,1057,10,2015,8,2
Group 3,BB,-1.5,3,14,1058,10,2015,8,2
Group 3,BB,-1.5,3,14,1059,13,2015,11,2
Group 3,BB,-1.5,3,14,1060,10,2015,7,3
Group 3,BB,-1.5,3,14,1061,5,2015,6,-1
Group 3,BB,-1.5,3,14,1062,7,2015,8,-1
Group 3,BB,-1.5,3,14,1063,9,2015,8,1
Group 3,BB,-1.5,3,14,1064,11,2015,6,5
Group 3,BB,-1.5,3,14,1065,9,2015,10,-1
Group 3,BB,-1.5,3,14,1066,10,2015,7,3
Group 3,BB,-1.5,3,14,1067,7,2015,9,-2
Group 3,BB,-1.5,3,14,1068,8,2015,10,-2
Group 3,BB,-1.5,3,14,1069,6,2015,5,1
Group 3,BB,-1.5,3,14,1070,8,2015,9,-1
Group 3,BB,-1.5,3,14,1071,9,2015,8,1
Group 3,BB,-1.5,3,14,1072,8,2015,8,0
Group 3,BB,-1.5,3,14,1073,8,2015,7,1
Group 3,BB,-1.5,3,14,1074,12,2015,7,5
Group 3,BB,-1.5,3,14,1075,9,2015,7,2
Group 3,BB,-1.5,3,14,1076,9,2015,8,1
Group 3,BB,-1.5,3,14,1077,7,2015,9,-2
Group 3,BB,-1.5,3,14,1078,6,2015,9,-3
Group 3,BB,-1.5,3,14,1079,6,2015,5,1
Group 3,BB,-1.5,3,14,1080,11,2015,9,2
Group 3,BB,-1.5,3,14,1081,6,2015,5,1
Group 3,BB,-1.5,3,14,1082,7,2015,10,-3
Group 3,BB,-1.5,3,14,1083,7,2015,9,-2
Group 3,BB,-1.5,3,14,1084,8,2015,6,2
Group 3,BB,-1.5,3,14,1085,10,2015,9,1
Group 3,BB,-1.5,3,14,1086,7,2015,8,-1
Group 3,BB,-1.5,3,14,1087,9,2015,9,0
Group 3,BB,-1.5,3,14,1088,10,2015,9,1
Group 3,BB,-1.5,3,14,1089,8,2015,7,1
Group 3,BB,-1.5,3,14,1090,11,2015,9,2
Group 3,BB,-1.5,3,14,1091,7,2015,4,3
Group 3,BB,-1.5,3,14,1092,5,2015,8,-3
Group 3,BB,-1.5,3,14,1093,7,2015,2,5
Group 3,BB,-1.5,3,14,1094,10,2015,7,3
Group 3,BB,-1.5,3,14,1095,5,2015,7,-2
Group 3,BB,-1.5,3,14,1096,6,2015,7,-1
Group 3,BB,-1.5,3,14,1097,10,2015,6,4
Group 3,BB,-1.5,3,14,1098,9,2015,7,2
Group 3,BB,-1.5,3,14,1099,4,2015,7,-3
Group 3,BB,-1.5,3,14,1100,5,2015,11,-6
Group 3,BB,-1.5,3,14,1101,4,2015,7,-3
Group 3,BB,-1.5,3,14,1102,11,2015,8,3
Group 3,BB,-1.5,3,14,1103,7,2015,9,-2
Group 3,BB,-1.5,3,14,1104,11,2015,9,2
Group 3,BB,-1.5,3,14,1105,9,2015,7,2
Group 3,BB,-1.5,3,14,1106,11,2015,9,2
Group 3,BB,-1.5,3,14,1107,11,2015,6,5
Group 3,BB,-1.5,3,14,1108,8,2015,6,2
Group 3,BB,-1.5,3,14,1109,12,2015,6,6
Group 3,BB,-1.5,3,14,1110,7,2015,10,-3
Group 3,BB,-1.5,3,14,1111,7,2015,9,-2
Group 3,BB,-1.5,3,14,1112,4,2015,8,-4
Group 3,BB,-1.5,3,14,1113,11,2015,6,5
Group 3,BB,-1.5,3,14,1114,12,2015,4,8
Group 3,BB,-1.5,3,14,1115,10,2015,5,5
Group 3,BB,-1.5,3,14,1116,9,2015,6,3
Group 3,BB,-1.5,3,14,1117,9,2015,7,2
Group 3,BB,-1.5,3,14,1118,7,2015,6,1
Group 3,BB,-1.5,3,14,1119,9,2015,7,2
Group 3,BB,-1.5,3,14,1120,4,2015,7,-3
Group 3,BB,-1.5,3,14,1121,6,2015,8,-2
Group 3,BB,-1.5,3,14,1122,2,2015,5,-3
Group 3,BB,-1.5,3,14,1123,10,2015,10,0
Group 3,BB,-1.5,3,14,1124,11,2015,11,0
Group 3,BB,-1.5,3,14,1125,9,2015,9,0
Group 3,BB,-1.5,3,14,1126,6,2015,7,-1
Group 3,BB,-1.5,3,14,1127,11,2015,6,5
Group 3,BB,-1.5,3,14,1128,8,2015,9,-1
Group 3,BB,-1.5,3,14,1129,6,2015,5,1
Group 3,BB,-1.5,3,14,1130,10,2015,6,4
Group 3,BB,-1.5,3,14,1131,7,2015,1,6
Group 3,BB,-1.5,3,14,1132,7,2015,4,3
Group 3,BB,-1.5,3,14,1133,4,2015,9,-5
Group 3,BB,-1.5,3,14,1134,10,2015,7,3
Group 3,BB,-1.5,3,14,1135,10,2015,7,3
Group 3,BB,-1.5,3,14,1136,6,2015,9,-3
Group 3,BB,-1.5,3,14,1137,3,2015,5,-2
Group 3,BB,-1.5,3,14,1138,7,2015,8,-1
Group 3,BB,-1.5,3,14,1139,8,2015,5,3
Group 3,BB,-1.5,3,14,1140,7,2015,9,-2
Group 3,BB,-1.5,3,14,1141,4,2015,10,-6
Group 3,BB,-1.5,3,14,1142,10,2015,9,1
Group 3,BB,-1.5,3,14,1143,9,2015,7,2
Group 3,BB,-1.5,3,14,1144,10,2015,9,1
Group 3,BB,-1.5,3,14,1145,7,2015,8,-1
Group 3,BB,-1.5,3,14,1146,8,2015,4,4
Group 3,BB,-1.5,3,14,1147,10,2015,5,5
Group 3,BB,-1.5,3,14,1148,7,2015,8,-1
Group 3,BB,-1.5,3,14,1149,5,2015,6,-1
Group 3,BB,-1.5,3,14,1150,10,2015,6,4
Group 3,BB,-1.5,3,14,1151,9,2015,8,1
Group 3,BB,-1.5,3,14,1152,5,2015,6,-1
Group 3,BB,-1.5,3,14,1153,12,2015,6,6
Group 3,BB,-1.5,3,14,1154,6,2015,7,-1
Group 3,BB,-1.5,3,14,1155,8,2015,7,1
Group 3,BB,-1.5,3,14,1156,7,2015,5,2
Group 3,BB,-1.5,3,14,1157,10,2015,10,0
Group 3,BB,-1.5,3,14,1158,9,2015,9,0
Group 3,BB,-1.5,3,14,1159,5,2015,7,-2
Group 3,BB,-1.5,3,14,1160,11,2015,8,3
Group 3,BB,-1.5,3,14,1161,11,2015,7,4
Group 3,BB,-1.5,3,14,1162,9,2015,7,2
Group 3,BB,-1.5,3,14,1163,9,2015,8,1
Group 3,BB,-1.5,3,14,1164,8,2015,8,0
Group 3,BB,-1.5,3,14,1165,9,2015,6,3
Group 3,BB,-1.5,3,14,1166,10,2015,5,5
Group 3,BB,-1.5,3,14,1167,7,2015,8,-1
Group 3,BB,-1.5,3,14,1168,6,2015,8,-2
Group 3,BB,-1.5,3,14,1169,9,2015,9,0
Group 3,BB,-1.5,3,14,1170,10,2015,6,4
Group 3,BB,-1.5,3,14,1171,8,2015,11,-3
Group 3,BB,-1.5,3,14,1172,4,2015,8,-4
Group 3,BB,-1.5,3,14,1173,6,2015,6,0
Group 3,BB,-1.5,3,14,1174,5,2015,6,-1
Group 3,BB,-1.5,3,14,1175,7,2015,8,-1
Group 3,BB,-1.5,3,14,1176,4,2015,6,-2
Group 3,BB,-1.5,3,14,1177,9,2015,8,1
Group 3,BB,-1.5,3,14,1178,9,2015,9,0
Group 3,BB,-1.5,3,14,1179,10,2015,3,7
Group 3,BB,-1.5,3,14,1180,8,2015,7,1
Group 3,BB,-1.5,3,14,1181,10,2015,6,4
Group 3,BB,-1.5,3,14,1182,8,2015,5,3
Group 3,BB,-1.5,3,14,1183,7,2015,5,2
Group 3,BB,-1.5,3,14,1184,8,2015,7,1
Group 3,BB,-1.5,3,14,1185,10,2015,7,3
Group 3,BB,-1.5,3,14,1186,10,2015,4,6
Group 3,BB,-1.5,3,14,1187,5,2015,7,-2
Group 3,BB,-1.5,3,14,1188,10,2015,6,4
Group 3,BB,-1.5,3,14,1189,8,2015,6,2
Group 3,BB,-1.5,3,14,1190,5,2015,7,-2
Group 3,BB,-1.5,3,14,1191,11,2015,5,6
Group 3,BB,-1.5,3,14,1192,11,2015,10,1
Group 3,BB,-1.5,3,14,1193,6,2015,10,-4
Group 3,BB,-1.5,3,14,1194,7,2015,6,1
Group 3,BB,-1.5,3,14,1195,10,2015,9,1
Group 3,BB,-1.5,3,14,1196,5,2015,7,-2
Group 3,BB,-1.5,3,14,1197,5,2015,9,-4
Group 3,BB,-1.5,3,14,1198,6,2015,5,1
Group 3,BB,-1.5,3,14,1199,10,2015,5,5
Group 3,BB,-1.5,3,14,1200,8,2015,4,4
Group 3,BB,-1.5,3,14,1201,8,2015,10,-2
Group 3,BB,-1.5,3,14,1202,7,2015,8,-1
Group 3,BB,-1.5,3,14,1203,8,2015,7,1
Group 3,BB,-1.5,3,14,1204,13,2015,4,9
Group 3,BB,-1.5,3,14,1205,8,2015,6,2
Group 3,BB,-1.5,3,14,1206,9,2015,9,0
Group 3,BB,-1.5,3,14,1207,11,2015,9,2
Group 3,BB,-1.5,3,14,1208,5,2015,3,2
Group 3,BB,-1.5,3,14,1209,10,2015,3,7
Group 3,BB,-1.5,3,14,1210,11,2015,4,7
Group 3,BB,-1.5,3,14,1211,10,2015,10,0
Group 3,BB,-1.5,3,14,1212,9,2015,5,4
Group 3,BB,-1.5,3,14,1213,10,2015,9,1
Group 3,BB,-1.5,3,14,1214,10,2015,9,1
Group 3,BB,-1.5,3,14,1215,5,2015,5,0
Group 3,BB,-1.5,3,14,1216,9,2015,8,1
Group 3,BB,-1.5,3,14,1217,9,2015,8,1
Group 3,BB,-1.5,3,14,1218,12,2015,4,8
Group 3,BB,-1.5,3,14,1219,11,2015,6,5
Group 3,BB,-1.5,3,14,1220,13,2015,6,7
Group 3,BB,-1.5,3,14,1221,8,2015,5,3
Group 3,BB,-1.5,3,14,1222,7,2015,7,0
Group 3,BB,-1.5,3,14,1223,7,2015,9,-2
Group 3,BB,-1.5,3,14,1224,8,2015,10,-2
Group 3,BB,-1.5,3,14,1225,8,2015,6,2
Group 3,BB,-1.5,3,14,1226,7,2015,8,-1
Group 3,BB,-1.5,3,14,1227,7,2015,7,0
Group 3,BB,-1.5,3,14,1228,9,2015,10,-1
Group 3,BB,-1.5,3,14,1229,7,2015,7,0
Group 3,BB,-1.5,3,14,1230,10,2015,5,5
Group 3,BB,-1.5,3,14,1231,11,2015,6,5
Group 3,BB,-1.5,3,14,1232,11,2015,9,2
Group 3,BB,-1.5,3,14,1233,9,2015,7,2
Group 3,BB,-1.5,3,14,1234,5,2015,10,-5
Group 3,BB,-1.5,3,14,1235,7,2015,3,4
Group 3,BB,-1.5,3,14,1236,13,2015,7,6
Group 3,BB,-1.5,3,14,1237,10,2015,9,1
Group 3,BB,-1.5,3,14,1238,10,2015,10,0
Group 3,BB,-1.5,3,14,1239,8,2015,9,-1
Group 3,BB,-1.5,3,14,1240,11,2015,5,6
Group 3,BB,-1.5,3,14,1241,11,2015,9,2
Group 3,BB,-1.5,3,14,1242,6,2015,5,1
Group 3,BB,-1.5,3,14,1243,4,2015,2,2
Group 3,BB,-1.5,3,14,1244,12,2015,11,1
Group 3,BB,-1.5,3,14,1245,12,2015,8,4
Group 3,BB,-1.5,3,14,1246,10,2015,9,1
Group 3,BB,-1.5,3,14,1247,10,2015,9,1
Group 3,BB,-1.5,3,14,1248,9,2015,8,1
Group 3,BB,-1.5,3,14,1249,10,2015,6,4
Group 3,BB,-1.5,3,14,1250,12,2015,7,5
Group 3,BB,-1.5,3,14,1251,6,2015,9,-3
Group 3,BB,-1.5,3,14,1252,2,2015,8,-6
Group 3,BB,-1.5,3,14,1253,8,2015,4,4
Group 3,BB,-1.5,3,14,1254,8,2015,8,0
Group 3,BB,-1.5,3,14,1255,8,2015,3,5
Group 3,BB,-1.5,3,14,1256,8,2015,7,1
Group 3,BB,-1.5,3,14,1257,8,2015,8,0
Group 3,BB,-1.5,3,14,1258,11,2015,6,5
Group 3,BB,-1.5,3,14,1259,6,2015,4,2
Group 3,BB,-1.5,3,14,1260,10,2015,9,1
Group 3,BB,-1.5,3,14,1261,8,2015,4,4
Group 3,BB,-1.5,3,14,1262,10,2015,6,4
Group 3,BB,-1.5,3,14,1263,4,2015,6,-2
Group 3,BB,-1.5,3,14,1264,7,2015,11,-4
Group 3,BB,-1.5,3,14,1265,9,2015,4,5
Group 3,BB,-1.5,3,14,1266,7,2015,9,-2
Group 3,BB,-1.5,3,14,1267,4,2015,8,-4
Group 3,BB,-1.5,3,14,1268,8,2015,6,2
Group 3,BB,-1.5,3,14,1269,9,2015,2,7
Group 3,BB,-1.5,3,14,1270,9,2015,3,6
Group 3,BB,-1.5,3,14,1271,5,2015,8,-3
Group 3,BB,-1.5,3,14,1272,11,2015,9,2
Group 3,BB,-1.5,3,14,1273,5,2015,7,-2
Group 3,BB,-1.5,3,14,1274,6,2015,7,-1
Group 3,BB,-1.5,3,14,1275,6,2015,8,-2
Group 3,BB,-1.5,3,14,1276,8,2015,8,0
Group 3,BB,-1.5,3,14,1277,2,2015,8,-6
Group 3,BB,-1.5,3,14,1278,8,2015,9,-1
Group 3,BB,-1.5,3,14,1279,11,2015,8,3
Group 3,BB,-1.5,3,14,1280,7,2015,8,-1
Group 3,BB,-1.5,3,14,1281,11,2015,6,5
Group 3,BB,-1.5,3,14,1282,12,2015,7,5
Group 3,BB,-1.5,3,14,1283,6,2015,8,-2
Group 3,BB,-1.5,3,14,1284,7,2015,6,1
Group 3,BB,-1.5,3,14,1285,10,2015,5,5
Group 3,BB,-1.5,3,14,1286,5,2015,8,-3
Group 3,BB,-1.5,3,14,1287,7,2015,3,4
Group 3,BB,-1.5,3,14,1288,6,2015,7,-1
Group 3,BB,-1.5,3,14,1289,11,2015,5,6
Group 3,BB,-1.5,3,14,1290,11,2015,5,6
Group 3,BB,-1.5,3,14,1291,9,2015,4,5
Group 3,BB,-1.5,3,14,1292,9,2015,6,3
Group 3,BB,-1.5,3,14,1293,7,2015,4,3
Group 3,BB,-1.5,3,14,1294,11,2015,7,4
Group 3,BB,-1.5,3,14,1295,11,2015,6,5
Group 3,BB,-1.5,3,14,1296,6,2015,8,-2
Group 3,BB,-1.5,3,14,1297,7,2015,7,0
Group 3,BB,-1.5,3,14,1298,9,2015,8,1
Group 3,BB,-1.5,3,14,1299,11,2015,7,4
Group 3,BB,-1.5,3,14,1300,10,2015,6,4
Group 3,BB,-1.5,3,14,1301,10,2015,11,-1
Group 3,BB,-1.5,3,14,1302,6,2015,4,2
Group 3,BB,-1.5,3,14,1303,5,2015,5,0
Group 3,BB,-1.5,3,14,1304,3,2015,5,-2
Group 3,BB,-1.5,3,14,1305,11,2015,8,3
Group 3,BB,-1.5,3,14,1306,9,2015,9,0
Group 3,BB,-1.5,3,14,1307,8,2015,5,3
Group 3,BB,-1.5,3,14,1308,13,2015,9,4
Group 3,BB,-1.5,3,14,1309,10,2015,13,-3
Group 3,BB,-1.5,3,14,1310,8,2015,9,-1
Group 3,BB,-1.5,3,14,1311,7,2015,8,-1
Group 3,BB,-1.5,3,14,1312,9,2015,10,-1
Group 3,BB,-1.5,3,14,1313,9,2015,7,2
Group 3,BB,-1.5,3,14,1314,8,2015,4,4
Group 3,BB,-1.5,3,14,1315,10,2015,5,5
Group 3,BB,-1.5,3,14,1316,9,2015,2,7
Group 3,BB,-1.5,3,14,1317,6,2015,4,2
Group 3,BB,-1.5,3,14,1318,11,2015,6,5
Group 3,BB,-1.5,3,14,1319,6,2015,8,-2
Group 3,BB,-1.5,3,14,1320,3,2015,12,-9
Group 3,BB,-1.5,3,14,1321,11,2015,5,6
Group 3,BB,-1.5,3,14,1322,7,2015,7,0
Group 3,BB,-1.5,3,14,1323,11,2015,6,5
Group 3,BB,-1.5,3,14,1324,12,2015,3,9
Group 3,BB,-1.5,3,14,1325,9,2015,3,6
Group 3,BB,-1.5,3,14,1326,8,2015,6,2
Group 3,BB,-1.5,3,14,1327,11,2015,6,5
Group 3,BB,-1.5,3,14,1328,10,2015,6,4
Group 3,BB,-1.5,3,14,1329,9,2015,8,1
Group 3,BB,-1.5,3,14,1330,7,2015,5,2
Group 3,BB,-1.5,3,14,1331,6,2015,7,-1
Group 3,BB,-1.5,3,14,1332,7,2015,8,-1
Group 3,BB,-1.5,3,14,1333,6,2015,3,3
Group 3,BB,-1.5,3,14,1334,9,2015,3,6
Group 3,BB,-1.5,3,14,1335,6,2015,5,1
Group 3,BB,-1.5,3,14,1336,11,2015,9,2
Group 3,BB,-1.5,3,14,1337,9,2015,5,4
Group 3,BB,-1.5,3,14,1338,9,2015,10,-1
Group 3,BB,-1.5,3,14,1339,11,2015,7,4
Group 3,BB,-1.5,3,14,1340,7,2015,6,1
Group 3,BB,-1.5,3,14,1341,7,2015,9,-2
Group 3,BB,-1.5,3,14,1342,8,2015,7,1
Group 3,BB,-1.5,3,14,1343,10,2015,5,5
Group 3,BB,-1.5,3,14,1344,5,2015,8,-3
Group 3,BB,-1.5,3,14,1345,7,2015,7,0
Group 3,BB,-1.5,3,14,1346,9,2015,6,3
Group 3,BB,-1.5,3,14,1347,7,2015,7,0
Group 3,BB,-1.5,3,14,1348,9,2015,9,0
Group 3,BB,-1.5,3,14,1349,5,2015,6,-1
Group 3,BB,-1.5,3,14,1350,5,2015,6,-1
Group 3,BB,-1.5,3,14,1351,9,2015,5,4
Group 3,BB,-1.5,3,14,1352,10,2015,7,3
Group 3,BB,-1.5,3,14,1353,10,2015,8,2
Group 3,BB,-1.5,3,14,1354,7,2015,6,1
Group 3,BB,-1.5,3,14,1355,10,2015,9,1
Group 3,BB,-1.5,3,14,1356,9,2015,6,3
Group 3,BB,-1.5,3,14,1357,5,2015,7,-2
Group 3,BB,-1.5,3,14,1358,4,2015,9,-5
Group 3,BB,-1.5,3,14,1359,8,2015,8,0
Group 3,BB,-1.5,3,14,1360,10,2015,4,6
Group 3,BB,-1.5,3,14,1361,5,2015,7,-2
Group 3,BB,-1.5,3,14,1362,4,2015,6,-2
Group 3,BB,-1.5,3,14,1363,5,2015,8,-3
Group 3,BB,-1.5,3,14,1364,8,2015,7,1
Group 3,BB,-1.5,3,14,1365,10,2015,9,1
Group 3,BB,-1.5,3,14,1366,8,2015,10,-2
Group 3,BB,-1.5,3,14,1367,10,2015,8,2
Group 3,BB,-1.5,3,14,1368,5,2015,9,-4
Group 3,BB,-1.5,3,14,1369,10,2015,12,-2
Group 3,BB,-1.5,3,14,1370,4,2015,8,-4
Group 3,BB,-1.5,3,14,1371,8,2015,5,3
Group 3,BB,-1.5,3,14,1372,8,2015,12,-4
Group 3,BB,-1.5,3,14,1373,8,2015,6,2
Group 3,BB,-1.5,3,14,1374,4,2015,4,0
Group 3,BB,-1.5,3,14,1375,11,2015,5,6
Group 3,BB,-1.5,3,14,1376,7,2015,7,0
Group 3,BB,-1.5,3,14,1377,6,2015,6,0
Group 3,BB,-1.5,3,14,1378,9,2015,7,2
Group 3,BB,-1.5,3,14,1379,7,2015,6,1
Group 3,BB,-1.5,3,14,1380,7,2015,8,-1
Group 3,BB,-1.5,3,14,1381,10,2015,6,4
Group 3,BB,-1.5,3,14,1382,8,2015,8,0
Group 3,BB,-1.5,3,14,1383,10,2015,8,2
Group 3,BB,-1.5,3,14,1384,5,2015,10,-5
Group 3,BB,-1.5,3,14,1385,10,2015,10,0
Group 3,BB,-1.5,3,14,1386,8,2015,9,-1
Group 3,BB,-1.5,3,14,1387,7,2015,10,-3
Group 3,BB,-1.5,3,14,1388,7,2015,4,3
Group 3,BB,-1.5,3,14,1389,5,2015,9,-4
Group 3,BB,-1.5,3,14,1390,8,2015,10,-2
Group 3,BB,-1.5,3,14,1391,6,2015,8,-2
Group 3,BB,-1.5,3,14,1392,13,2015,4,9
Group 3,BB,-1.5,3,14,1393,8,2015,7,1
Group 3,BB,-1.5,3,14,1394,8,2015,11,-3
Group 3,BB,-1.5,3,14,1395,7,2015,8,-1
Group 3,BB,-1.5,3,14,1396,11,2015,9,2
Group 3,BB,-1.5,3,14,1397,8,2015,5,3
Group 3,BB,-1.5,3,14,1398,9,2015,6,3
Group 3,BB,-1.5,3,14,1399,7,2015,7,0
Group 3,BB,-1.5,3,14,1400,7,2015,6,1
Group 3,BB,-1.5,3,14,1401,9,2015,5,4
Group 3,BB,-1.5,3,14,1402,8,2015,8,0
Group 3,BB,-1.5,3,14,1403,9,2015,10,-1
Group 3,BB,-1.5,3,14,1404,13,2015,6,7
Group 3,BB,-1.5,3,14,1405,8,2015,5,3
Group 3,BB,-1.5,3,14,1406,7,2015,5,2
Group 3,BB,-1.5,3,14,1407,7,2015,8,-1
Group 3,BB,-1.5,3,14,1408,8,2015,5,3
Group 3,BB,-1.5,3,14,1409,10,2015,5,5
Group 3,BB,-1.5,3,14,1410,3,2015,4,-1
Group 3,BB,-1.5,3,14,1411,13,2015,7,6
Group 3,BB,-1.5,3,14,1412,10,2015,8,2
Group 3,BB,-1.5,3,14,1413,7,2015,7,0
Group 3,BB,-1.5,3,14,1414,11,2015,7,4
Group 3,BB,-1.5,3,14,1415,9,2015,7,2
Group 3,BB,-1.5,3,14,1416,9,2015,7,2
Group 3,BB,-1.5,3,14,1417,11,2015,9,2
Group 3,BB,-1.5,3,14,1418,8,2015,9,-1
Group 3,BB,-1.5,3,14,1419,11,2015,10,1
Group 3,BB,-1.5,3,14,1420,7,2015,12,-5
Group 3,BB,-1.5,3,14,1421,10,2015,10,0
Group 3,BB,-1.5,3,14,1422,8,2015,8,0
Group 3,BB,-1.5,3,14,1423,7,2015,3,4
Group 3,BB,-1.5,3,14,1424,10,2015,5,5
Group 3,BB,-1.5,3,14,1425,10,2015,8,2
Group 3,BB,-1.5,3,14,1426,5,2015,7,-2
Group 3,BB,-1.5,3,14,1427,6,2015,10,-4
Group 3,BB,-1.5,3,14,1428,8,2015,12,-4
Group 3,BB,-1.5,3,14,1429,7,2015,5,2
Group 3,BB,-1.5,3,14,1430,4,2015,8,-4
Group 3,BB,-1.5,3,14,1431,9,2015,7,2
Group 3,BB,-1.5,3,14,1432,9,2015,6,3
Group 3,BB,-1.5,3,14,1433,10,2015,10,0
Group 3,BB,-1.5,3,14,1434,8,2015,6,2
Group 3,BB,-1.5,3,14,1435,8,2015,8,0
Group 3,BB,-1.5,3,14,1436,11,2015,5,6
Group 3,BB,-1.5,3,14,1437,9,2015,9,0
Group 3,BB,-1.5,3,14,1438,12,2015,7,5
Group 3,BB,-1.5,3,14,1439,6,2015,11,-5
Group 3,BB,-1.5,3,14,1440,9,2015,7,2
Group 3,BB,-1.5,3,14,1441,13,2015,9,4
Group 3,BB,-1.5,3,14,1442,10,2015,8,2
Group 3,BB,-1.5,3,14,1443,9,2015,9,0
Group 3,BB,-1.5,3,14,1444,6,2015,5,1
Group 3,BB,-1.5,3,14,1445,9,2015,10,-1
Group 3,BB,-1.5,3,14,1446,7,2015,7,0
Group 3,BB,-1.5,3,14,1447,6,2015,8,-2
Group 3,BB,-1.5,3,14,1448,9,2015,5,4
Group 3,BB,-1.5,3,14,1449,9,2015,7,2
Group 3,BB,-1.5,3,14,1450,8,2015,11,-3
Group 3,BB,-1.5,3,14,1451,2,2015,6,-4
Group 3,BB,-1.5,3,14,1452,8,2015,8,0
Group 3,BB,-1.5,3,14,1453,6,2015,8,-2
Group 3,BB,-1.5,3,14,1454,6,2015,7,-1
Group 3,BB,-1.5,3,14,1455,7,2015,8,-1
Group 3,BB,-1.5,3,14,1456,12,2015,7,5
Group 3,BB,-1.5,3,14,1457,8,2015,4,4
Group 3,BB,-1.5,3,14,1458,9,2015,6,3
Group 3,BB,-1.5,3,14,1459,8,2015,7,1
Group 3,BB,-1.5,3,14,1460,9,2015,3,6
Group 3,BB,-1.5,3,14,1461,10,2015,10,0
Group 3,BB,-1.5,3,14,1462,8,2015,8,0
Group 3,BB,-1.5,3,14,1463,6,2015,5,1
Group 3,BB,-1.5,3,14,1464,8,2015,10,-2
Group 3,BB,-1.5,3,14,1465,10,2015,9,1
Group 3,BB,-1.5,3,14,1466,9,2015,10,-1
Group 3,BB,-1.5,3,14,1467,10,2015,4,6
Group 3,BB,-1.5,3,14,1468,9,2015,6,3
Group 3,BB,-1.5,3,14,1469,10,2015,5,5
Group 3,BB,-1.5,3,14,1470,11,2015,6,5
Group 3,BB,-1.5,3,14,1471,9,2015,9,0
Group 3,BB,-1.5,3,14,1472,9,2015,8,1
Group 3,BB,-1.5,3,14,1473,12,2015,7,5
Group 3,BB,-1.5,3,14,1474,11,2015,8,3
Group 3,BB,-1.5,3,14,1475,13,2015,9,4
Group 3,BB,-1.5,3,14,1476,8,2015,10,-2
Group 3,BB,-1.5,3,14,1477,9,2015,6,3
Group 3,BB,-1.5,3,14,1478,8,2015,6,2
Group 3,BB,-1.5,3,14,1479,7,2015,4,3
Group 3,BB,-1.5,3,14,1480,12,2015,7,5
Group 3,BB,-1.5,3,14,1481,8,2015,8,0
Group 3,BB,-1.5,3,14,1482,12,2015,6,6
Group 3,BB,-1.5,3,14,1483,12,2015,10,2
Group 3,BB,-1.5,3,14,1484,10,2015,6,4
Group 3,BB,-1.5,3,14,1485,10,2015,3,7
Group 3,BB,-1.5,3,14,1486,12,2015,4,8
Group 3,BB,-1.5,3,14,1487,11,2015,4,7
Group 3,BB,-1.5,3,14,1488,8,2015,4,4
Group 3,BB,-1.5,3,14,1489,11,2015,9,2
Group 3,BB,-1.5,3,14,1490,10,2015,5,5
Group 3,BB,-1.5,3,14,1491,8,2015,4,4
Group 3,BB,-1.5,3,14,1492,6,2015,3,3
Group 3,BB,-1.5,3,14,1493,8,2015,7,1
Group 3,BB,-1.5,3,14,1494,9,2015,7,2
Group 3,BB,-1.5,3,14,1495,11,2015,10,1
Group 3,BB,-1.5,3,14,1496,8,2015,5,3
Group 3,BB,-1.5,3,14,1497,6,2015,3,3
Group 3,BB,-1.5,3,14,1498,8,2015,2,6
Group 3,BB,-1.5,3,14,1499,8,2015,4,4
Group 3,BB,-1.5,3,14,1500,10,2015,6,4
Group 3,BB,-1.5,3,14,1501,9,2015,7,2
Group 3,BB,-1.5,3,14,1502,8,2015,7,1
Group 3,BB,-1.5,3,14,1503,4,2015,10,-6
Group 3,BB,-1.5,3,14,1504,6,2015,6,0
Group 3,BB,-1.5,3,14,1505,9,2015,5,4
Group 3,BB,-1.5,3,14,1506,8,2015,3,5
Group 3,BB,-1.5,3,14,1507,8,2015,10,-2
Group 3,BB,-1.5,3,14,1508,10,2015,7,3
Group 3,BB,-1.5,3,14,1509,11,2015,10,1
Group 3,BB,-1.5,3,14,1510,8,2015,6,2
Group 3,BB,-1.5,3,14,1511,11,2015,13,-2
Group 3,BB,-1.5,3,14,1512,8,2015,7,1
Group 3,BB,-1.5,3,14,1513,8,2015,7,1
Group 3,BB,-1.5,3,14,1514,10,2015,8,2
Group 3,BB,-1.5,3,14,1515,6,2015,11,-5
Group 3,BB,-1.5,3,14,1516,7,2015,5,2
Group 3,BB,-1.5,3,14,1517,11,2015,9,2
Group 3,BB,-1.5,3,14,1518,8,2015,6,2
Group 3,BB,-1.5,3,14,1519,10,2015,9,1
Group 3,BB,-1.5,3,14,1520,8,2015,10,-2
Group 3,BB,-1.5,3,14,1521,8,2015,10,-2
Group 3,BB,-1.5,3,14,1522,11,2015,7,4
Group 3,BB,-1.5,3,14,1523,9,2015,4,5
Group 3,BB,-1.5,3,14,1524,9,2015,6,3
Group 3,BB,-1.5,3,14,1525,11,2015,6,5
Group 3,BB,-1.5,3,14,1526,8,2015,7,1
Group 3,BB,-1.5,3,14,1527,9,2015,8,1
Group 3,BB,-1.5,3,14,1528,7,2015,8,-1
Group 3,BB,-1.5,3,14,1529,9,2015,7,2
Group 3,BB,-1.5,3,14,1530,9,2015,7,2
Group 3,BB,-1.5,3,14,1531,9,2015,7,2
Group 3,BB,-1.5,3,14,1532,5,2015,7,-2
Group 3,BB,-1.5,3,14,1533,10,2015,10,0
Group 3,BB,-1.5,3,14,1534,8,2015,9,-1
Group 3,BB,-1.5,3,14,1535,7,2015,3,4
Group 3,BB,-1.5,3,14,1536,8,2015,11,-3
Group 3,BB,-1.5,3,14,1537,9,2015,8,1
Group 3,BB,-1.5,3,14,1538,6,2015,7,-1
Group 3,BB,-1.5,3,14,1539,6,2015,7,-1
Group 3,BB,-1.5,3,14,1540,8,2015,10,-2
Group 3,BB,-1.5,3,14,1541,12,2015,7,5
Group 3,BB,-1.5,3,14,1542,11,2015,7,4
Group 3,BB,-1.5,3,14,1543,10,2015,5,5
Group 3,BB,-1.5,3,14,1544,8,2015,7,1
Group 3,BB,-1.5,3,14,1545,9,2015,6,3
Group 3,BB,-1.5,3,14,1546,8,2015,5,3
Group 3,BB,-1.5,3,14,1547,8,2015,6,2
Group 3,BB,-1.5,3,14,1548,8,2015,4,4
Group 3,BB,-1.5,3,14,1549,8,2015,12,-4
Group 3,BB,-1.5,3,14,1550,3,2015,8,-5
Group 3,BB,-1.5,3,14,1551,7,2015,10,-3
Group 3,BB,-1.5,3,14,1552,10,2015,4,6
Group 3,BB,-1.5,3,14,1553,7,2015,4,3
Group 3,BB,-1.5,3,14,1554,8,2015,6,2
Group 3,BB,-1.5,3,14,1555,8,2015,8,0
Group 3,BB,-1.5,3,14,1556,13,2015,2,11
Group 3,BB,-1.5,3,14,1557,7,2015,6,1
Group 3,BB,-1.5,3,14,1558,8,2015,7,1
Group 3,BB,-1.5,3,14,1559,10,2015,6,4
Group 3,BB,-1.5,3,14,1560,6,2015,9,-3
Group 3,BB,-1.5,3,14,1561,13,2015,10,3
Group 3,BB,-1.5,3,14,1562,8,2015,9,-1
Group 3,BB,-1.5,3,14,1563,8,2015,4,4
Group 3,BB,-1.5,3,14,1564,8,2015,6,2
Group 3,BB,-1.5,3,14,1565,10,2015,8,2
Group 3,BB,-1.5,3,14,1566,9,2015,4,5
Group 3,BB,-1.5,3,14,1567,7,2015,7,0
Group 3,BB,-1.5,3,14,1568,4,2015,4,0
Group 3,BB,-1.5,3,14,1569,12,2015,7,5
Group 3,BB,-1.5,3,14,1570,9,2015,3,6
Group 3,BB,-1.5,3,14,1571,12,2015,7,5
Group 3,BB,-1.5,3,14,1572,6,2015,8,-2
Group 3,BB,-1.5,3,14,1573,9,2015,4,5
Group 3,BB,-1.5,3,14,1574,6,2015,9,-3
Group 3,BB,-1.5,3,14,1575,9,2015,11,-2
Group 3,BB,-1.5,3,14,1576,4,2015,12,-8
Group 3,BB,-1.5,3,14,1577,11,2015,6,5
Group 3,BB,-1.5,3,14,1578,10,2015,9,1
Group 3,BB,-1.5,3,14,1579,7,2015,9,-2
Group 3,BB,-1.5,3,14,1580,8,2015,7,1
Group 3,BB,-1.5,3,14,1581,14,2015,5,9
Group 3,BB,-1.5,3,14,1582,6,2015,8,-2
Group 3,BB,-1.5,3,14,1583,8,2015,7,1
Group 3,BB,-1.5,3,14,1584,9,2015,11,-2
Group 3,BB,-1.5,3,14,1585,7,2015,7,0
Group 3,BB,-1.5,3,14,1586,8,2015,4,4
Group 3,BB,-1.5,3,14,1587,9,2015,8,1
Group 3,BB,-1.5,3,14,1588,6,2015,10,-4
Group 3,BB,-1.5,3,14,1589,6,2015,6,0
Group 3,BB,-1.5,3,14,1590,8,2015,4,4
Group 3,BB,-1.5,3,14,1591,13,2015,8,5
Group 3,BB,-1.5,3,14,1592,8,2015,7,1
Group 3,BB,-1.5,3,14,1593,10,2015,5,5
Group 3,BB,-1.5,3,14,1594,5,2015,3,2
Group 3,BB,-1.5,3,14,1595,6,2015,7,-1
Group 3,BB,-1.5,3,14,1596,5,2015,7,-2
Group 3,BB,-1.5,3,14,1597,8,2015,7,1
Group 3,BB,-1.5,3,14,1598,6,2015,3,3
Group 3,BB,-1.5,3,14,1599,6,2015,5,1
Group 3,BB,-1.5,3,14,1600,5,2015,3,2
Group 3,BB,-1.5,3,14,1601,7,2015,6,1
Group 3,BB,-1.5,3,14,1602,10,2015,5,5
Group 3,BB,-1.5,3,14,1603,10,2015,10,0
Group 3,BB,-1.5,3,14,1604,13,2015,7,6
Group 3,BB,-1.5,3,14,1605,7,2015,9,-2
Group 3,BB,-1.5,3,14,1606,7,2015,11,-4
Group 3,BB,-1.5,3,14,1607,7,2015,7,0
Group 3,BB,-1.5,3,14,1608,11,2015,5,6
Group 3,BB,-1.5,3,14,1609,5,2015,11,-6
Group 3,BB,-1.5,3,14,1610,6,2015,9,-3
Group 3,BB,-1.5,3,14,1611,6,2015,8,-2
Group 3,BB,-1.5,3,14,1612,6,2015,10,-4
Group 3,BB,-1.5,3,14,1613,10,2015,6,4
Group 3,BB,-1.5,3,14,1614,5,2015,9,-4
Group 3,BB,-1.5,3,14,1615,4,2015,7,-3
Group 3,BB,-1.5,3,14,1616,11,2015,3,8
Group 3,BB,-1.5,3,14,1617,9,2015,8,1
Group 3,BB,-1.5,3,14,1618,6,2015,5,1
Group 3,BB,-1.5,3,14,1619,7,2015,6,1
Group 3,BB,-1.5,3,14,1620,8,2015,9,-1
Group 3,BB,-1.5,3,14,1621,11,2015,6,5
Group 3,BB,-1.5,3,14,1622,11,2015,6,5
Group 3,BB,-1.5,3,14,1623,9,2015,6,3
Group 3,BB,-1.5,3,14,1624,9,2015,7,2
Group 3,BB,-1.5,3,14,1625,8,2015,7,1
Group 3,BB,-1.5,3,14,1626,9,2015,5,4
Group 3,BB,-1.5,3,14,1627,8,2015,5,3
Group 3,BB,-1.5,3,14,1628,6,2015,11,-5
Group 3,BB,-1.5,3,14,1629,7,2015,11,-4
Group 3,BB,-1.5,3,14,1630,8,2015,8,0
Group 3,BB,-1.5,3,14,1631,9,2015,7,2
Group 3,BB,-1.5,3,14,1632,9,2015,11,-2
Group 3,BB,-1.5,3,14,1633,4,2015,8,-4
Group 3,BB,-1.5,3,14,1634,9,2015,7,2
Group 3,BB,-1.5,3,14,1635,5,2015,7,-2
Group 3,BB,-1.5,3,14,1636,9,2015,4,5
Group 3,BB,-1.5,3,14,1637,10,2015,5,5
Group 3,BB,-1.5,3,14,1638,7,2015,7,0
Group 3,BB,-1.5,3,14,1639,10,2015,7,3
Group 3,BB,-1.5,3,14,1640,11,2015,9,2
Group 3,BB,-1.5,3,14,1641,7,2015,8,-1
Group 3,BB,-1.5,3,14,1642,10,2015,4,6
Group 3,BB,-1.5,3,14,1643,10,2015,7,3
Group 3,BB,-1.5,3,14,1644,7,2015,7,0
Group 3,BB,-1.5,3,14,1645,8,2015,7,1
Group 3,BB,-1.5,3,14,1646,12,2015,7,5
Group 3,BB,-1.5,3,14,1647,10,2015,4,6
Group 3,BB,-1.5,3,14,1648,9,2015,8,1
Group 3,BB,-1.5,3,14,1649,9,2015,6,3
Group 3,BB,-1.5,3,14,1650,7,2015,7,0
Group 3,BB,-1.5,3,14,1651,9,2015,8,1
Group 3,BB,-1.5,3,14,1652,9,2015,7,2
Group 3,BB,-1.5,3,14,1653,9,2015,8,1
Group 3,BB,-1.5,3,14,1654,7,2015,5,2
Group 3,BB,-1.5,3,14,1655,7,2015,10,-3
Group 3,BB,-1.5,3,14,1656,5,2015,6,-1
Group 3,BB,-1.5,3,14,1657,10,2015,8,2
Group 3,BB,-1.5,3,14,1658,8,2015,11,-3
Group 3,BB,-1.5,3,14,1659,7,2015,7,0
Group 3,BB,-1.5,3,14,1660,9,2015,9,0
Group 3,BB,-1.5,3,14,1661,10,2015,8,2
Group 3,BB,-1.5,3,14,1662,10,2015,10,0
Group 3,BB,-1.5,3,14,1663,8,2015,11,-3
Group 3,BB,-1.5,3,14,1664,9,2015,5,4
Group 3,BB,-1.5,3,14,1665,9,2015,6,3
Group 3,BB,-1.5,3,14,1666,7,2015,1,6
Group 3,BB,-1.5,3,14,1667,10,2015,8,2
Group 3,BB,-1.5,3,14,1668,10,2015,8,2
Group 3,BB,-1.5,3,14,1669,4,2015,9,-5
Group 3,BB,-1.5,3,14,1670,8,2015,5,3
Group 3,BB,-1.5,3,14,1671,13,2015,6,7
Group 3,BB,-1.5,3,14,1672,8,2015,5,3
Group 3,BB,-1.5,3,14,1673,9,2015,7,2
Group 3,BB,-1.5,3,14,1674,7,2015,8,-1
Group 3,BB,-1.5,3,14,1675,6,2015,7,-1
Group 3,BB,-1.5,3,14,1676,10,2015,7,3
Group 3,BB,-1.5,3,14,1677,10,2015,6,4
Group 3,BB,-1.5,3,14,1678,12,2015,7,5
Group 3,BB,-1.5,3,14,1679,12,2015,7,5
Group 3,BB,-1.5,3,14,1680,9,2015,6,3
Group 3,BB,-1.5,3,14,1681,7,2015,8,-1
Group 3,BB,-1.5,3,14,1682,9,2015,7,2
Group 3,BB,-1.5,3,14,1683,11,2015,8,3
Group 3,BB,-1.5,3,14,1684,12,2015,9,3
Group 3,BB,-1.5,3,14,1685,10,2015,8,2
Group 3,BB,-1.5,3,14,1686,8,2015,5,3
Group 3,BB,-1.5,3,14,1687,9,2015,6,3
Group 3,BB,-1.5,3,14,1688,8,2015,7,1
Group 3,BB,-1.5,3,14,1689,11,2015,6,5
Group 3,BB,-1.5,3,14,1690,8,2015,8,0
Group 3,BB,-1.5,3,14,1691,5,2015,8,-3
Group 3,BB,-1.5,3,14,1692,9,2015,6,3
Group 3,BB,-1.5,3,14,1693,6,2015,6,0
Group 3,BB,-1.5,3,14,1694,12,2015,8,4
Group 3,BB,-1.5,3,14,1695,9,2015,10,-1
Group 3,BB,-1.5,3,14,1696,10,2015,7,3
Group 3,BB,-1.5,3,14,1697,6,2015,7,-1
Group 3,BB,-1.5,3,14,1698,11,2015,11,0
Group 3,BB,-1.5,3,14,1699,6,2015,4,2
Group 3,BB,-1.5,3,14,1700,10,2015,8,2
Group 3,BB,-1.5,3,14,1701,12,2015,3,9
Group 3,BB,-1.5,3,14,1702,10,2015,7,3
Group 3,BB,-1.5,3,14,1703,5,2015,5,0
Group 3,BB,-1.5,3,14,1704,10,2015,6,4
Group 3,BB,-1.5,3,14,1705,4,2015,8,-4
Group 3,BB,-1.5,3,14,1706,4,2015,6,-2
Group 3,BB,-1.5,3,14,1707,11,2015,6,5
Group 3,BB,-1.5,3,14,1708,8,2015,5,3
Group 3,BB,-1.5,3,14,1709,7,2015,5,2
Group 3,BB,-1.5,3,14,1710,10,2015,8,2
Group 3,BB,-1.5,3,14,1711,9,2015,7,2
Group 3,BB,-1.5,3,14,1712,3,2015,9,-6
Group 3,BB,-1.5,3,14,1713,3,2015,9,-6
Group 3,BB,-1.5,3,14,1714,8,2015,7,1
Group 3,BB,-1.5,3,14,1715,10,2015,10,0
Group 3,BB,-1.5,3,14,1716,10,2015,9,1
Group 3,BB,-1.5,3,14,1717,8,2015,7,1
Group 3,BB,-1.5,3,14,1718,8,2015,5,3
Group 3,BB,-1.5,3,14,1719,10,2015,5,5
Group 3,BB,-1.5,3,14,1720,12,2015,6,6
Group 3,BB,-1.5,3,14,1721,8,2015,5,3
Group 3,BB,-1.5,3,14,1722,7,2015,7,0
Group 3,BB,-1.5,3,14,1723,9,2015,6,3
Group 3,BB,-1.5,3,14,1724,10,2015,7,3
Group 3,BB,-1.5,3,14,1725,10,2015,6,4
Group 3,BB,-1.5,3,14,1726,10,2015,8,2
Group 3,BB,-1.5,3,14,1727,9,2015,8,1
Group 3,BB,-1.5,3,14,1728,9,2015,8,1
Group 3,BB,-1.5,3,14,1729,12,2015,6,6
Group 3,BB,-1.5,3,14,1730,9,2015,8,1
Group 3,BB,-1.5,3,14,1731,8,2015,6,2
Group 3,BB,-1.5,3,14,1732,8,2015,9,-1
Group 3,BB,-1.5,3,14,1733,7,2015,9,-2
Group 3,BB,-1.5,3,14,1734,6,2015,7,-1
Group 3,BB,-1.5,3,14,1735,7,2015,6,1
Group 3,BB,-1.5,3,14,1736,5,2015,2,3
Group 3,BB,-1.5,3,14,1737,10,2015,8,2
Group 3,BB,-1.5,3,14,1738,10,2015,7,3
Group 3,BB,-1.5,3,14,1739,13,2015,7,6
Group 3,BB,-1.5,3,14,1740,9,2015,5,4
Group 3,BB,-1.5,3,14,1741,9,2015,7,2
Group 3,BB,-1.5,3,14,1742,9,2015,4,5
Group 3,BB,-1.5,3,14,1743,11,2015,2,9
Group 3,BB,-1.5,3,14,1744,7,2015,8,-1
Group 3,BB,-1.5,3,14,1745,11,2015,5,6
Group 3,BB,-1.5,3,14,1746,8,2015,12,-4
Group 3,BB,-1.5,3,14,1747,10,2015,7,3
Group 3,BB,-1.5,3,14,1748,12,2015,8,4
Group 3,BB,-1.5,3,14,1749,6,2015,6,0
Group 3,BB,-1.5,3,14,1750,11,2015,5,6
Group 3,BB,-1.5,3,14,1751,6,2015,7,-1
Group 3,BB,-1.5,3,14,1752,5,2015,10,-5
Group 3,BB,-1.5,3,14,1753,5,2015,9,-4
Group 3,BB,-1.5,3,14,1754,7,2015,4,3
Group 3,BB,-1.5,3,14,1755,7,2015,9,-2
Group 3,BB,-1.5,3,14,1756,8,2015,6,2
Group 3,BB,-1.5,3,14,1757,7,2015,9,-2
Group 3,BB,-1.5,3,14,1758,8,2015,5,3
Group 3,BB,-1.5,3,14,1759,13,2015,0,13
Group 3,BB,-1.5,3,14,1760,6,2015,11,-5
Group 3,BB,-1.5,3,14,1761,10,2015,8,2
Group 3,BB,-1.5,3,14,1762,10,2015,5,5
Group 3,BB,-1.5,3,14,1763,9,2015,12,-3
Group 3,BB,-1.5,3,14,1764,9,2015,7,2
Group 3,BB,-1.5,3,14,1765,8,2015,6,2
Group 3,BB,-1.5,3,14,1766,7,2015,10,-3
Group 3,BB,-1.5,3,14,1767,9,2015,5,4
Group 3,BB,-1.5,3,14,1768,6,2015,9,-3
Group 3,BB,-1.5,3,14,1769,8,2015,4,4
Group 3,BB,-1.5,3,14,1770,10,2015,8,2
Group 3,BB,-1.5,3,14,1771,8,2015,7,1
Group 3,BB,-1.5,3,14,1772,9,2015,6,3
Group 3,BB,-1.5,3,14,1773,5,2015,6,-1
Group 3,BB,-1.5,3,14,1774,10,2015,8,2
Group 3,BB,-1.5,3,14,1775,10,2015,8,2
Group 3,BB,-1.5,3,14,1776,4,2015,8,-4
Group 3,BB,-1.5,3,14,1777,9,2015,6,3
Group 3,BB,-1.5,3,14,1778,5,2015,7,-2
Group 3,BB,-1.5,3,14,1779,5,2015,9,-4
Group 3,BB,-1.5,3,14,1780,8,2015,4,4
Group 3,BB,-1.5,3,14,1781,9,2015,7,2
Group 3,BB,-1.5,3,14,1782,11,2015,8,3
Group 3,BB,-1.5,3,14,1783,8,2015,8,0
Group 3,BB,-1.5,3,14,1784,7,2015,10,-3
Group 3,BB,-1.5,3,14,1785,11,2015,7,4
Group 3,BB,-1.5,3,14,1786,7,2015,7,0
Group 3,BB,-1.5,3,14,1787,5,2015,3,2
Group 3,BB,-1.5,3,14,1788,9,2015,3,6
Group 3,BB,-1.5,3,14,1789,11,2015,7,4
Group 3,BB,-1.5,3,14,1790,10,2015,7,3
Group 3,BB,-1.5,3,14,1791,13,2015,7,6
Group 3,BB,-1.5,3,14,1792,9,2015,6,3
Group 3,BB,-1.5,3,14,1793,8,2015,5,3
Group 3,BB,-1.5,3,14,1794,7,2015,8,-1
Group 3,BB,-1.5,3,14,1795,4,2015,8,-4
Group 3,BB,-1.5,3,14,1796,7,2015,3,4
Group 3,BB,-1.5,3,14,1797,7,2015,6,1
Group 3,BB,-1.5,3,14,1798,7,2015,10,-3
Group 3,BB,-1.5,3,14,1799,6,2015,10,-4
Group 3,BB,-1.5,3,14,1800,11,2015,6,5
Group 3,BB,-1.5,3,14,1801,8,2015,3,5
Group 3,BB,-1.5,3,14,1802,10,2015,8,2
Group 3,BB,-1.5,3,14,1803,4,2015,5,-1
Group 3,BB,-1.5,3,14,1804,5,2015,6,-1
Group 3,BB,-1.5,3,14,1805,8,2015,4,4
Group 3,BB,-1.5,3,14,1806,9,2015,4,5
Group 3,BB,-1.5,3,14,1807,7,2015,3,4
Group 3,BB,-1.5,3,14,1808,11,2015,5,6
Group 3,BB,-1.5,3,14,1809,11,2015,7,4
Group 3,BB,-1.5,3,14,1810,10,2015,7,3
Group 3,BB,-1.5,3,14,1811,7,2015,7,0
Group 3,BB,-1.5,3,14,1812,6,2015,9,-3
Group 3,BB,-1.5,3,14,1813,6,2015,4,2
Group 3,BB,-1.5,3,14,1814,9,2015,8,1
Group 3,BB,-1.5,3,14,1815,10,2015,5,5
Group 3,BB,-1.5,3,14,1816,9,2015,8,1
Group 3,BB,-1.5,3,14,1817,8,2015,6,2
Group 3,BB,-1.5,3,14,1818,13,2015,11,2
Group 3,BB,-1.5,3,14,1819,7,2015,5,2
Group 3,BB,-1.5,3,14,1820,9,2015,7,2
Group 3,BB,-1.5,3,14,1821,8,2015,5,3
Group 3,BB,-1.5,3,14,1822,9,2015,5,4
Group 3,BB,-1.5,3,14,1823,9,2015,7,2
Group 3,BB,-1.5,3,14,1824,6,2015,4,2
Group 3,BB,-1.5,3,14,1825,9,2015,7,2
Group 3,BB,-1.5,3,14,1826,3,2015,5,-2
Group 3,BB,-1.5,3,14,1827,8,2015,3,5
Group 3,BB,-1.5,3,14,1828,9,2015,7,2
Group 3,BB,-1.5,3,14,1829,7,2015,7,0
Group 3,BB,-1.5,3,14,1830,9,2015,7,2
Group 3,BB,-1.5,3,14,1831,4,2015,7,-3
Group 3,BB,-1.5,3,14,1832,6,2015,6,0
Group 3,BB,-1.5,3,14,1833,6,2015,3,3
Group 3,BB,-1.5,3,14,1834,5,2015,9,-4
Group 3,BB,-1.5,3,14,1835,9,2015,7,2
Group 3,BB,-1.5,3,14,1836,5,2015,9,-4
Group 3,BB,-1.5,3,14,1837,9,2015,5,4
Group 3,BB,-1.5,3,14,1838,5,2015,6,-1
Group 3,BB,-1.5,3,14,1839,12,2015,10,2
Group 3,BB,-1.5,3,14,1840,11,2015,7,4
Group 3,BB,-1.5,3,14,1841,3,2015,8,-5
Group 3,BB,-1.5,3,14,1842,5,2015,7,-2
Group 3,BB,-1.5,3,14,1843,10,2015,8,2
Group 3,BB,-1.5,3,14,1844,9,2015,6,3
Group 3,BB,-1.5,3,14,1845,11,2015,6,5
Group 3,BB,-1.5,3,14,1846,8,2015,10,-2
Group 3,BB,-1.5,3,14,1847,8,2015,4,4
Group 3,BB,-1.5,3,14,1848,10,2015,5,5
Group 3,BB,-1.5,3,14,1849,9,2015,6,3
Group 3,BB,-1.5,3,14,1850,8,2015,3,5
Group 3,BB,-1.5,3,14,1851,11,2015,9,2
Group 3,BB,-1.5,3,14,1852,9,2015,6,3
Group 3,BB,-1.5,3,14,1853,9,2015,9,0
Group 3,BB,-1.5,3,14,1854,8,2015,10,-2
Group 3,BB,-1.5,3,14,1855,6,2015,6,0
Group 3,BB,-1.5,3,14,1856,10,2015,6,4
Group 3,BB,-1.5,3,14,1857,9,2015,3,6
Group 3,BB,-1.5,3,14,1858,8,2015,3,5
Group 3,BB,-1.5,3,14,1859,6,2015,5,1
Group 3,BB,-1.5,3,14,1860,9,2015,8,1
Group 3,BB,-1.5,3,14,1861,8,2015,11,-3
Group 3,BB,-1.5,3,14,1862,9,2015,7,2
Group 3,BB,-1.5,3,14,1863,7,2015,4,3
Group 3,BB,-1.5,3,14,1864,7,2015,7,0
Group 3,BB,-1.5,3,14,1865,10,2015,5,5
Group 3,BB,-1.5,3,14,1866,10,2015,6,4
Group 3,BB,-1.5,3,14,1867,10,2015,7,3
Group 3,BB,-1.5,3,14,1868,4,2015,10,-6
Group 3,BB,-1.5,3,14,1869,6,2015,8,-2
Group 3,BB,-1.5,3,14,1870,9,2015,9,0
Group 3,BB,-1.5,3,14,1871,9,2015,5,4
Group 3,BB,-1.5,3,14,1872,12,2015,7,5
Group 3,BB,-1.5,3,14,1873,12,2015,7,5
Group 3,BB,-1.5,3,14,1874,10,2015,10,0
Group 3,BB,-1.5,3,14,1875,11,2015,5,6
Group 3,BB,-1.5,3,14,1876,6,2015,8,-2
Group 3,BB,-1.5,3,14,1877,8,2015,9,-1
Group 3,BB,-1.5,3,14,1878,9,2015,6,3
Group 3,BB,-1.5,3,14,1879,11,2015,9,2
Group 3,BB,-1.5,3,14,1880,8,2015,5,3
Group 3,BB,-1.5,3,14,1881,7,2015,11,-4
Group 3,BB,-1.5,3,14,1882,11,2015,3,8
Group 3,BB,-1.5,3,14,1883,10,2015,8,2
Group 3,BB,-1.5,3,14,1884,9,2015,8,1
Group 3,BB,-1.5,3,14,1885,7,2015,5,2
Group 3,BB,-1.5,3,14,1886,10,2015,6,4
Group 3,BB,-1.5,3,14,1887,9,2015,7,2
Group 3,BB,-1.5,3,14,1888,10,2015,6,4
Group 3,BB,-1.5,3,14,1889,10,2015,8,2
Group 3,BB,-1.5,3,14,1890,6,2015,9,-3
Group 3,BB,-1.5,3,14,1891,12,2015,9,3
Group 3,BB,-1.5,3,14,1892,7,2015,3,4
Group 3,BB,-1.5,3,14,1893,11,2015,5,6
Group 3,BB,-1.5,3,14,1894,7,2015,3,4
Group 3,BB,-1.5,3,14,1895,10,2015,5,5
Group 3,BB,-1.5,3,14,1896,9,2015,5,4
Group 3,BB,-1.5,3,14,1897,7,2015,7,0
Group 3,BB,-1.5,3,14,1898,8,2015,6,2
Group 3,BB,-1.5,3,14,1899,9,2015,3,6
Group 3,BB,-1.5,3,14,1900,10,2015,4,6
Group 3,BB,-1.5,3,14,1901,11,2015,9,2
Group 3,BB,-1.5,3,14,1902,12,2015,5,7
Group 3,BB,-1.5,3,14,1903,7,2015,5,2
Group 3,BB,-1.5,3,14,1904,8,2015,8,0
Group 3,BB,-1.5,3,14,1905,12,2015,6,6
Group 3,BB,-1.5,3,14,1906,7,2015,9,-2
Group 3,BB,-1.5,3,14,1907,9,2015,4,5
Group 3,BB,-1.5,3,14,1908,7,2015,9,-2
Group 3,BB,-1.5,3,14,1909,7,2015,5,2
Group 3,BB,-1.5,3,14,1910,10,2015,8,2
Group 3,BB,-1.5,3,14,1911,9,2015,6,3
Group 3,BB,-1.5,3,14,1912,8,2015,2,6
Group 3,BB,-1.5,3,14,1913,7,2015,7,0
Group 3,BB,-1.5,3,14,1914,6,2015,6,0
Group 3,BB,-1.5,3,14,1915,6,2015,9,-3
Group 3,BB,-1.5,3,14,1916,8,2015,9,-1
Group 3,BB,-1.5,3,14,1917,7,2015,9,-2
Group 3,BB,-1.5,3,14,1918,9,2015,8,1
Group 3,BB,-1.5,3,14,1919,7,2015,9,-2
Group 3,BB,-1.5,3,14,1920,8,2015,7,1
Group 3,BB,-1.5,3,14,1921,10,2015,4,6
Group 3,BB,-1.5,3,14,1922,6,2015,5,1
Group 3,BB,-1.5,3,14,1923,9,2015,9,0
Group 3,BB,-1.5,3,14,1924,6,2015,5,1
Group 3,BB,-1.5,3,14,1925,8,2015,8,0
Group 3,BB,-1.5,3,14,1926,6,2015,7,-1
Group 3,BB,-1.5,3,14,1927,8,2015,8,0
Group 3,BB,-1.5,3,14,1928,6,2015,6,0
Group 3,BB,-1.5,3,14,1929,8,2015,8,0
Group 3,BB,-1.5,3,14,1930,7,2015,7,0
Group 3,BB,-1.5,3,14,1931,10,2015,9,1
Group 3,BB,-1.5,3,14,1932,8,2015,4,4
Group 3,BB,-1.5,3,14,1933,8,2015,7,1
Group 3,BB,-1.5,3,14,1934,9,2015,10,-1
Group 3,BB,-1.5,3,14,1935,11,2015,7,4
Group 3,BB,-1.5,3,14,1936,10,2015,7,3
Group 3,BB,-1.5,3,14,1937,5,2015,8,-3
Group 3,BB,-1.5,3,14,1938,8,2015,10,-2
Group 3,BB,-1.5,3,14,1939,7,2015,8,-1
Group 3,BB,-1.5,3,14,1940,7,2015,7,0
Group 3,BB,-1.5,3,14,1941,8,2015,8,0
Group 3,BB,-1.5,3,14,1942,5,2015,8,-3
Group 3,BB,-1.5,3,14,1943,10,2015,6,4
Group 3,BB,-1.5,3,14,1944,12,2015,10,2
Group 3,BB,-1.5,3,14,1945,9,2015,8,1
Group 3,BB,-1.5,3,14,1946,6,2015,10,-4
Group 3,BB,-1.5,3,14,1947,10,2015,2,8
Group 3,BB,-1.5,3,14,1948,5,2015,8,-3
Group 3,BB,-1.5,3,14,1949,10,2015,4,6
Group 3,BB,-1.5,3,14,1950,8,2015,9,-1
Group 3,BB,-1.5,3,14,1951,10,2015,7,3
Group 3,BB,-1.5,3,14,1952,5,2015,9,-4
Group 3,BB,-1.5,3,14,1953,4,2015,8,-4
Group 3,BB,-1.5,3,14,1954,12,2015,8,4
Group 3,BB,-1.5,3,14,1955,4,2015,8,-4
Group 3,BB,-1.5,3,14,1956,11,2015,10,1
Group 3,BB,-1.5,3,14,1957,8,2015,9,-1
Group 3,BB,-1.5,3,14,1958,9,2015,7,2
Group 3,BB,-1.5,3,14,1959,7,2015,6,1
Group 3,BB,-1.5,3,14,1960,9,2015,8,1
Group 3,BB,-1.5,3,14,1961,11,2015,8,3
Group 3,BB,-1.5,3,14,1962,7,2015,6,1
Group 3,BB,-1.5,3,14,1963,4,2015,8,-4
Group 3,BB,-1.5,3,14,1964,9,2015,5,4
Group 3,BB,-1.5,3,14,1965,4,2015,6,-2
Group 3,BB,-1.5,3,14,1966,7,2015,6,1
Group 3,BB,-1.5,3,14,1967,8,2015,7,1
Group 3,BB,-1.5,3,14,1968,8,2015,8,0
Group 3,BB,-1.5,3,14,1969,4,2015,9,-5
Group 3,BB,-1.5,3,14,1970,7,2015,8,-1
Group 3,BB,-1.5,3,14,1971,5,2015,2,3
Group 3,BB,-1.5,3,14,1972,4,2015,4,0
Group 3,BB,-1.5,3,14,1973,13,2015,8,5
Group 3,BB,-1.5,3,14,1974,11,2015,4,7
Group 3,BB,-1.5,3,14,1975,8,2015,6,2
Group 3,BB,-1.5,3,14,1976,9,2015,5,4
Group 3,BB,-1.5,3,14,1977,12,2015,2,10
Group 3,BB,-1.5,3,14,1978,8,2015,11,-3
Group 3,BB,-1.5,3,14,1979,4,2015,11,-7
Group 3,BB,-1.5,3,14,1980,9,2015,8,1
Group 3,BB,-1.5,3,14,1981,8,2015,9,-1
Group 3,BB,-1.5,3,14,1982,8,2015,6,2
Group 3,BB,-1.5,3,14,1983,12,2015,4,8
Group 3,BB,-1.5,3,14,1984,6,2015,8,-2
Group 3,BB,-1.5,3,14,1985,7,2015,8,-1
Group 3,BB,-1.5,3,14,1986,9,2015,5,4
Group 3,BB,-1.5,3,14,1987,6,2015,12,-6
Group 3,BB,-1.5,3,14,1988,7,2015,10,-3
Group 3,BB,-1.5,3,14,1989,9,2015,1,8
Group 3,BB,-1.5,3,14,1990,10,2015,6,4
Group 3,BB,-1.5,3,14,1991,10,2015,6,4
Group 3,BB,-1.5,3,14,1992,6,2015,7,-1
Group 3,BB,-1.5,3,14,1993,10,2015,5,5
Group 3,BB,-1.5,3,14,1994,10,2015,9,1
Group 3,BB,-1.5,3,14,1995,7,2015,8,-1
Group 3,BB,-1.5,3,14,1996,8,2015,12,-4
Group 3,BB,-1.5,3,14,1997,8,2015,8,0
Group 3,BB,-1.5,3,14,1998,7,2015,6,1
Group 3,BB,-1.5,3,14,1999,7,2015,8,-1
Group 3,BB,-1.5,3,14,2000,11,2015,10,1
Group 3,BB,-1.5,3,14,2001,6,2015,6,0
Group 3,BB,-1.5,3,14,2002,6,2015,7,-1
Group 3,BB,-1.5,3,14,2003,9,2015,7,2
Group 3,BB,-1.5,3,14,2004,7,2015,8,-1
Group 3,BB,-1.5,3,14,2005,12,2015,7,5
Group 3,BB,-1.5,3,14,2006,9,2015,11,-2
Group 3,BB,-1.5,3,14,2007,7,2015,7,0
Group 3,BB,-1.5,3,14,2008,9,2015,10,-1
Group 3,BB,-1.5,3,14,2009,11,2015,5,6
Group 3,BB,-1.5,3,14,2010,11,2015,11,0
Group 3,BB,-1.5,3,14,2011,10,2015,10,0
Group 3,BB,-1.5,3,14,2012,8,2015,8,0
Group 3,BB,-1.5,3,14,2013,10,2015,6,4
Group 3,BB,-1.5,3,14,2014,9,2015,8,1
Group 3,BB,-1.5,3,14,2015,8,2015,9,-1
Group 3,BB,-1.5,3,14,2016,11,2015,10,1
Group 3,BB,-1.5,3,14,2017,9,2015,5,4
Group 3,BB,-1.5,3,14,2018,9,2015,7,2
Group 3,BB,-1.5,3,14,2019,8,2015,9,-1
Group 3,BB,-1.5,3,14,2020,8,2015,3,5
Group 3,BB,-1.5,3,14,2021,9,2015,4,5
Group 3,BB,-1.5,3,14,2022,11,2015,6,5
Group 3,BB,-1.5,3,14,2023,5,2015,6,-1
Group 3,BB,-1.5,3,14,2024,8,2015,6,2
Group 3,BB,-1.5,3,14,2025,5,2015,9,-4
Group 3,BB,-1.5,3,14,2026,6,2015,8,-2
Group 3,BB,-1.5,3,14,2027,11,2015,7,4
Group 3,BB,-1.5,3,14,2028,7,2015,8,-1
Group 3,BB,-1.5,3,14,2029,8,2015,7,1
Group 3,BB,-1.5,3,14,2030,8,2015,10,-2
Group 3,BB,-1.5,3,14,2031,9,2015,7,2
Group 3,BB,-1.5,3,14,2032,7,2015,13,-6
Group 3,BB,-1.5,3,14,2033,7,2015,10,-3
Group 3,BB,-1.5,3,14,2034,7,2015,6,1
Group 3,BB,-1.5,3,14,2035,7,2015,12,-5
Group 3,BB,-1.5,3,14,2036,10,2015,6,4
Group 3,BB,-1.5,3,14,2037,10,2015,9,1
Group 3,BB,-1.5,3,14,2038,9,2015,8,1
Group 3,BB,-1.5,3,14,2039,9,2015,10,-1
Group 3,BB,-1.5,3,14,2040,8,2015,6,2
Group 3,BB,-1.5,3,14,2041,10,2015,8,2
Group 3,BB,-1.5,3,14,2042,9,2015,3,6
Group 3,BB,-1.5,3,14,2043,7,2015,4,3
Group 3,BB,-1.5,3,14,2044,10,2015,6,4
Group 3,BB,-1.5,3,14,2045,5,2015,7,-2
Group 3,BB,-1.5,3,14,2046,10,2015,7,3
Group 3,BB,-1.5,3,14,2047,8,2015,9,-1
Group 3,BB,-1.5,3,14,2048,9,2015,9,0
Group 3,BB,-1.5,3,14,2049,9,2015,5,4
Group 3,BB,-1.5,3,14,2050,12,2015,8,4
Group 3,BB,-1.5,3,14,2051,10,2015,4,6
Group 3,BB,-1.5,3,14,2052,5,2015,9,-4
Group 3,BB,-1.5,3,14,2053,6,2015,7,-1
Group 3,BB,-1.5,3,14,2054,6,2015,8,-2
Group 3,BB,-1.5,3,14,2055,8,2015,8,0
Group 3,BB,-1.5,3,14,2056,8,2015,3,5
Group 3,BB,-1.5,3,14,2057,9,2015,7,2
Group 3,BB,-1.5,3,14,2058,7,2015,12,-5
Group 3,BB,-1.5,3,14,2059,10,2015,6,4
Group 3,BB,-1.5,3,14,2060,10,2015,6,4
Group 3,BB,-1.5,3,14,2061,6,2015,8,-2
Group 3,BB,-1.5,3,14,2062,9,2015,5,4
Group 3,BB,-1.5,3,14,2063,9,2015,12,-3
Group 3,BB,-1.5,3,14,2064,8,2015,5,3
Group 3,BB,-1.5,3,14,2065,10,2015,5,5
Group 3,BB,-1.5,3,14,2066,8,2015,5,3
Group 3,BB,-1.5,3,14,2067,11,2015,9,2
Group 3,BB,-1.5,3,14,2068,10,2015,4,6
Group 3,BB,-1.5,3,14,2069,7,2015,8,-1
Group 3,BB,-1.5,3,14,2070,9,2015,7,2
Group 3,BB,-1.5,3,14,2071,8,2015,8,0
Group 3,BB,-1.5,3,14,2072,10,2015,5,5
Group 3,BB,-1.5,3,14,2073,9,2015,8,1
Group 3,BB,-1.5,3,14,2074,5,2015,4,1
Group 3,BB,-1.5,3,14,2075,6,2015,6,0
Group 3,BB,-1.5,3,14,2076,7,2015,8,-1
Group 3,BB,-1.5,3,14,2077,8,2015,7,1
Group 3,BB,-1.5,3,14,2078,12,2015,9,3
Group 3,BB,-1.5,3,14,2079,5,2015,5,0
Group 3,BB,-1.5,3,14,2080,6,2015,1,5
Group 3,BB,-1.5,3,14,2081,6,2015,4,2
Group 3,BB,-1.5,3,14,2082,9,2015,6,3
Group 3,BB,-1.5,3,14,2083,7,2015,8,-1
Group 3,BB,-1.5,3,14,2084,8,2015,7,1
Group 3,BB,-1.5,3,14,2085,6,2015,7,-1
Group 3,BB,-1.5,3,14,2086,5,2015,6,-1
Group 3,BB,-1.5,3,14,2087,8,2015,11,-3
Group 3,BB,-1.5,3,14,2088,8,2015,8,0
Group 3,BB,-1.5,3,14,2089,8,2015,6,2
Group 3,BB,-1.5,3,14,2090,13,2015,4,9
Group 3,BB,-1.5,3,14,2091,9,2015,7,2
Group 3,BB,-1.5,3,14,2092,3,2015,6,-3
Group 3,BB,-1.5,3,14,2093,12,2015,10,2
Group 3,BB,-1.5,3,14,2094,11,2015,11,0
Group 3,BB,-1.5,3,14,2095,3,2015,6,-3
Group 3,BB,-1.5,3,14,2096,9,2015,9,0
Group 3,BB,-1.5,3,14,2097,7,2015,10,-3
Group 3,BB,-1.5,3,14,2098,12,2015,7,5
Group 3,BB,-1.5,3,14,2099,9,2015,6,3
Group 3,BB,-1.5,3,14,2100,8,2015,7,1
Group 3,BB,-1.5,3,14,2101,8,2015,8,0
Group 3,BB,-1.5,3,14,2102,9,2015,7,2
Group 3,BB,-1.5,3,14,2103,11,2015,7,4
Group 3,BB,-1.5,3,14,2104,11,2015,8,3
Group 3,BB,-1.5,3,14,2105,9,2015,9,0
Group 3,BB,-1.5,3,14,2106,10,2015,8,2
Group 3,BB,-1.5,3,14,2107,9,2015,7,2
Group 3,BB,-1.5,3,14,2108,7,2015,8,-1
Group 3,BB,-1.5,3,14,2109,6,2015,7,-1
Group 3,BB,-1.5,3,14,2110,7,2015,6,1
Group 3,BB,-1.5,3,14,2111,9,2015,8,1
Group 3,BB,-1.5,3,14,2112,2,2015,9,-7
Group 3,BB,-1.5,3,14,2113,10,2015,7,3
Group 3,BB,-1.5,3,14,2114,8,2015,5,3
Group 3,BB,-1.5,3,14,2115,7,2015,6,1
Group 3,BB,-1.5,3,14,2116,6,2015,5,1
Group 3,BB,-1.5,3,14,2117,10,2015,8,2
Group 3,BB,-1.5,3,14,2118,9,2015,10,-1
Group 3,BB,-1.5,3,14,2119,9,2015,10,-1
Group 3,BB,-1.5,3,14,2120,10,2015,9,1
Group 3,BB,-1.5,3,14,2121,9,2015,11,-2
Group 3,BB,-1.5,3,14,2122,9,2015,11,-2
Group 3,BB,-1.5,3,14,2123,8,2015,7,1
Group 3,BB,-1.5,3,14,2124,8,2015,5,3
Group 3,BB,-1.5,3,14,2125,9,2015,10,-1
Group 3,BB,-1.5,3,14,2126,13,2015,11,2
Group 3,BB,-1.5,3,14,2127,9,2015,7,2
Group 3,BB,-1.5,3,14,2128,9,2015,6,3
Group 3,BB,-1.5,3,14,2129,7,2015,7,0
Group 3,BB,-1.5,3,14,2130,11,2015,6,5
Group 3,BB,-1.5,3,14,2131,8,2015,2,6
Group 3,BB,-1.5,3,14,2132,9,2015,2,7
Group 3,BB,-1.5,3,14,2133,6,2015,2,4
Group 3,BB,-1.5,3,14,2134,10,2015,4,6
Group 3,BB,-1.5,3,14,2135,8,2015,3,5
Group 3,BB,-1.5,3,14,2136,10,2015,8,2
Group 3,BB,-1.5,3,14,2137,8,2015,3,5
Group 3,BB,-1.5,3,14,2138,7,2015,8,-1
Group 3,BB,-1.5,3,14,2139,10,2015,3,7
Group 3,BB,-1.5,3,14,2140,8,2015,6,2
Group 3,BB,-1.5,3,14,2141,5,2015,9,-4
Group 3,BB,-1.5,3,14,2142,7,2015,8,-1
Group 3,BB,-1.5,3,14,2143,9,2015,5,4
Group 3,BB,-1.5,3,14,2144,9,2015,10,-1
Group 3,BB,-1.5,3,14,2145,6,2015,4,2
Group 3,BB,-1.5,3,14,2146,7,2015,6,1
Group 3,BB,-1.5,3,14,2147,6,2015,7,-1
Group 3,BB,-1.5,3,14,2148,6,2015,8,-2
Group 3,BB,-1.5,3,14,2149,2,2015,8,-6
Group 3,BB,-1.5,3,14,2150,13,2015,7,6
Group 3,BB,-1.5,3,14,2151,11,2015,8,3
Group 3,BB,-1.5,3,14,2152,10,2015,10,0
Group 3,BB,-1.5,3,14,2153,9,2015,7,2
Group 3,BB,-1.5,3,14,2154,6,2015,4,2
Group 3,BB,-1.5,3,14,2155,8,2015,3,5
Group 3,BB,-1.5,3,14,2156,9,2015,8,1
Group 3,BB,-1.5,3,14,2157,10,2015,6,4
Group 3,BB,-1.5,3,14,2158,14,2015,6,8
Group 3,BB,-1.5,3,14,2159,8,2015,4,4
Group 3,BB,-1.5,3,14,2160,8,2015,6,2
Group 3,BB,-1.5,3,14,2161,5,2015,9,-4
Group 3,BB,-1.5,3,14,2162,8,2015,7,1
Group 3,BB,-1.5,3,14,2163,10,2015,6,4
Group 3,BB,-1.5,3,14,2164,8,2015,8,0
Group 3,BB,-1.5,3,14,2165,6,2015,4,2
Group 3,BB,-1.5,3,14,2166,9,2015,10,-1
Group 3,BB,-1.5,3,14,2167,6,2015,5,1
Group 3,BB,-1.5,3,14,2168,9,2015,5,4
Group 3,BB,-1.5,3,14,2169,12,2015,1,11
Group 3,BB,-1.5,3,14,2170,11,2015,4,7
Group 3,BB,-1.5,3,14,2171,11,2015,5,6
Group 3,BB,-1.5,3,14,2172,8,2015,2,6
Group 3,BB,-1.5,3,14,2173,10,2015,11,-1
Group 3,BB,-1.5,3,14,2174,7,2015,9,-2
Group 3,BB,-1.5,3,14,2175,6,2015,9,-3
Group 3,BB,-1.5,3,14,2176,7,2015,8,-1
Group 3,BB,-1.5,3,14,2177,9,2015,7,2
Group 3,BB,-1.5,3,14,2178,11,2015,8,3
Group 3,BB,-1.5,3,14,2179,8,2015,10,-2
Group 3,BB,-1.5,3,14,2180,8,2015,7,1
Group 3,BB,-1.5,3,14,2181,8,2015,7,1
Group 3,BB,-1.5,3,14,2182,6,2015,4,2
Group 3,BB,-1.5,3,14,2183,9,2015,7,2
Group 3,BB,-1.5,3,14,2184,6,2015,7,-1
Group 3,BB,-1.5,3,14,2185,8,2015,8,0
Group 3,BB,-1.5,3,14,2186,6,2015,5,1
Group 3,BB,-1.5,3,14,2187,6,2015,4,2
Group 3,BB,-1.5,3,14,2188,7,2015,6,1
Group 3,BB,-1.5,3,14,2189,11,2015,8,3
Group 3,BB,-1.5,3,14,2190,9,2015,11,-2
Group 3,BB,-1.5,3,14,2191,10,2015,12,-2
Group 3,BB,-1.5,3,14,2192,7,2015,7,0
Group 3,BB,-1.5,3,14,2193,10,2015,8,2
Group 3,BB,-1.5,3,14,2194,6,2015,8,-2
Group 3,BB,-1.5,3,14,2195,9,2015,6,3
Group 3,BB,-1.5,3,14,2196,8,2015,7,1
Group 3,BB,-1.5,3,14,2197,6,2015,6,0
Group 3,BB,-1.5,3,14,2198,7,2015,6,1
Group 3,BB,-1.5,3,14,2199,11,2015,6,5
Group 3,BB,-1.5,3,14,2200,7,2015,5,2
Group 3,BB,-1.5,3,14,2201,8,2015,3,5
Group 3,BB,-1.5,3,14,2202,6,2015,8,-2
Group 3,BB,-1.5,3,14,2203,10,2015,7,3
Group 3,BB,-1.5,3,14,2204,9,2015,9,0
Group 3,BB,-1.5,3,14,2205,9,2015,9,0
Group 3,BB,-1.5,3,14,2206,7,2015,11,-4
Group 3,BB,-1.5,3,14,2207,6,2015,9,-3
Group 3,BB,-1.5,3,14,2208,2,2015,4,-2
Group 3,BB,-1.5,3,14,2209,10,2015,8,2
Group 3,BB,-1.5,3,14,2210,12,2015,6,6
Group 3,BB,-1.5,3,14,2211,5,2015,8,-3
Group 3,BB,-1.5,3,14,2212,9,2015,10,-1
Group 3,BB,-1.5,3,14,2213,9,2015,9,0
Group 3,BB,-1.5,3,14,2214,8,2015,6,2
Group 3,BB,-1.5,3,14,2215,6,2015,6,0
Group 3,BB,-1.5,3,14,2216,7,2015,8,-1
Group 3,BB,-1.5,3,14,2217,8,2015,6,2
Group 3,BB,-1.5,3,14,2218,6,2015,9,-3
Group 3,BB,-1.5,3,14,2219,9,2015,8,1
Group 3,BB,-1.5,3,14,2220,7,2015,7,0
Group 3,BB,-1.5,3,14,2221,7,2015,9,-2
Group 3,BB,-1.5,3,14,2222,5,2015,8,-3
Group 3,BB,-1.5,3,14,2223,8,2015,7,1
Group 3,BB,-1.5,3,14,2224,9,2015,12,-3
Group 3,BB,-1.5,3,14,2225,6,2015,6,0
Group 3,BB,-1.5,3,14,2226,9,2015,7,2
Group 3,BB,-1.5,3,14,2227,8,2015,6,2
Group 3,BB,-1.5,3,14,2228,13,2015,10,3
Group 3,BB,-1.5,3,14,2229,9,2015,8,1
Group 3,BB,-1.5,3,14,2230,10,2015,9,1
Group 3,BB,-1.5,3,14,2231,9,2015,7,2
Group 3,BB,-1.5,3,14,2232,5,2015,7,-2
Group 3,BB,-1.5,3,14,2233,8,2015,5,3
Group 3,BB,-1.5,3,14,2234,9,2015,7,2
Group 3,BB,-1.5,3,14,2235,9,2015,7,2
Group 3,BB,-1.5,3,14,2236,8,2015,7,1
Group 3,BB,-1.5,3,14,2237,10,2015,9,1
Group 3,BB,-1.5,3,14,2238,10,2015,9,1
Group 3,BB,-1.5,3,14,2239,13,2015,7,6
Group 3,BB,-1.5,3,14,2240,9,2015,9,0
Group 3,BB,-1.5,3,14,2241,11,2015,6,5
Group 3,BB,-1.5,3,14,2242,6,2015,10,-4
Group 3,BB,-1.5,3,14,2243,6,2015,7,-1
Group 3,BB,-1.5,3,14,2244,8,2015,8,0
Group 3,BB,-1.5,3,14,2245,11,2015,6,5
Group 3,BB,-1.5,3,14,2246,8,2015,5,3
Group 3,BB,-1.5,3,14,2247,13,2015,6,7
Group 3,BB,-1.5,3,14,2248,8,2015,7,1
Group 3,BB,-1.5,3,14,2249,11,2015,3,8
Group 3,BB,-1.5,3,14,2250,9,2015,4,5
Group 3,BB,-1.5,3,14,2251,13,2015,5,8
Group 3,BB,-1.5,3,14,2252,8,2015,4,4
Group 3,BB,-1.5,3,14,2253,10,2015,3,7
Group 3,BB,-1.5,3,14,2254,8,2015,7,1
Group 3,BB,-1.5,3,14,2255,8,2015,3,5
Group 3,BB,-1.5,3,14,2256,11,2015,9,2
Group 3,BB,-1.5,3,14,2257,8,2015,10,-2
Group 3,BB,-1.5,3,14,2258,7,2015,8,-1
Group 3,BB,-1.5,3,14,2259,11,2015,6,5
Group 3,BB,-1.5,3,14,2260,6,2015,7,-1
Group 3,BB,-1.5,3,14,2261,7,2015,4,3
Group 3,BB,-1.5,3,14,2262,5,2015,4,1
Group 3,BB,-1.5,3,14,2263,6,2015,9,-3
Group 3,BB,-1.5,3,14,2264,5,2015,7,-2
Group 3,BB,-1.5,3,14,2265,5,2015,9,-4
Group 3,BB,-1.5,3,14,2266,8,2015,8,0
Group 3,BB,-1.5,3,14,2267,10,2015,9,1
Group 3,BB,-1.5,3,14,2268,9,2015,11,-2
Group 3,BB,-1.5,3,14,2269,10,2015,5,5
Group 3,BB,-1.5,3,14,2270,7,2015,4,3
Group 3,BB,-1.5,3,14,2271,9,2015,4,5
Group 3,BB,-1.5,3,14,2272,10,2015,7,3
Group 3,BB,-1.5,3,14,2273,8,2015,9,-1
Group 3,BB,-1.5,3,14,2274,11,2015,9,2
Group 3,BB,-1.5,3,14,2275,5,2015,8,-3
Group 3,BB,-1.5,3,14,2276,8,2015,8,0
Group 3,BB,-1.5,3,14,2277,7,2015,10,-3
Group 3,BB,-1.5,3,14,2278,5,2015,7,-2
Group 3,BB,-1.5,3,14,2279,10,2015,7,3
Group 3,BB,-1.5,3,14,2280,6,2015,8,-2
Group 3,BB,-1.5,3,14,2281,8,2015,4,4
Group 3,BB,-1.5,3,14,2282,9,2015,11,-2
Group 3,BB,-1.5,3,14,2283,9,2015,4,5
Group 3,BB,-1.5,3,14,2284,6,2015,8,-2
Group 3,BB,-1.5,3,14,2285,8,2015,7,1
Group 3,BB,-1.5,3,14,2286,10,2015,6,4
Group 3,BB,-1.5,3,14,2287,5,2015,6,-1
Group 3,BB,-1.5,3,14,2288,8,2015,10,-2
Group 3,BB,-1.5,3,14,2289,11,2015,10,1
Group 3,BB,-1.5,3,14,2290,8,2015,6,2
Group 3,BB,-1.5,3,14,2291,9,2015,6,3
Group 3,BB,-1.5,3,14,2292,9,2015,6,3
Group 3,BB,-1.5,3,14,2293,6,2015,10,-4
Group 3,BB,-1.5,3,14,2294,9,2015,6,3
Group 3,BB,-1.5,3,14,2295,7,2015,7,0
Group 3,BB,-1.5,3,14,2296,10,2015,10,0
Group 3,BB,-1.5,3,14,2297,9,2015,11,-2
Group 3,BB,-1.5,3,14,2298,9,2015,6,3
Group 3,BB,-1.5,3,14,2299,5,2015,4,1
Group 3,BB,-1.5,3,14,2300,8,2015,8,0
Group 3,BB,-1.5,3,14,2301,2,2015,10,-8
Group 3,BB,-1.5,3,14,2302,12,2015,11,1
Group 3,BB,-1.5,3,14,2303,9,2015,9,0
Group 3,BB,-1.5,3,14,2304,9,2015,10,-1
Group 3,BB,-1.5,3,14,2305,7,2015,8,-1
Group 3,BB,-1.5,3,14,2306,7,2015,6,1
Group 3,BB,-1.5,3,14,2307,7,2015,8,-1
Group 3,BB,-1.5,3,14,2308,9,2015,11,-2
Group 3,BB,-1.5,3,14,2309,6,2015,8,-2
Group 3,BB,-1.5,3,14,2310,8,2015,5,3
Group 3,BB,-1.5,3,14,2311,11,2015,5,6
Group 3,BB,-1.5,3,14,2312,8,2015,8,0
Group 3,BB,-1.5,3,14,2313,11,2015,10,1
Group 3,BB,-1.5,3,14,2314,7,2015,6,1
Group 3,BB,-1.5,3,14,2315,11,2015,6,5
Group 3,BB,-1.5,3,14,2316,11,2015,7,4
Group 3,BB,-1.5,3,14,2317,6,2015,7,-1
Group 3,BB,-1.5,3,14,2318,9,2015,8,1
Group 3,BB,-1.5,3,14,2319,9,2015,6,3
Group 3,BB,-1.5,3,14,2320,7,2015,6,1
Group 3,BB,-1.5,3,14,2321,9,2015,5,4
Group 3,BB,-1.5,3,14,2322,9,2015,7,2
Group 3,BB,-1.5,3,14,2323,10,2015,11,-1
Group 3,BB,-1.5,3,14,2324,9,2015,11,-2
Group 3,BB,-1.5,3,14,2325,7,2015,8,-1
Group 3,BB,-1.5,3,14,2326,11,2015,8,3
Group 3,BB,-1.5,3,14,2327,9,2015,9,0
Group 3,BB,-1.5,3,14,2328,8,2015,9,-1
Group 3,BB,-1.5,3,14,2329,7,2015,5,2
Group 3,BB,-1.5,3,14,2330,8,2015,8,0
Group 3,BB,-1.5,3,14,2331,9,2015,6,3
Group 3,BB,-1.5,3,14,2332,9,2015,7,2
Group 3,BB,-1.5,3,14,2333,8,2015,9,-1
Group 3,BB,-1.5,3,14,2334,10,2015,4,6
Group 3,BB,-1.5,3,14,2335,10,2015,4,6
Group 3,BB,-1.5,3,14,2336,8,2015,7,1
Group 3,BB,-1.5,3,14,2337,10,2015,9,1
Group 3,BB,-1.5,3,14,2338,8,2015,9,-1
Group 3,BB,-1.5,3,14,2339,5,2015,6,-1
Group 3,BB,-1.5,3,14,2340,8,2015,3,5
Group 3,BB,-1.5,3,14,2341,7,2015,6,1
Group 3,BB,-1.5,3,14,2342,7,2015,7,0
Group 3,BB,-1.5,3,14,2343,11,2015,7,4
Group 3,BB,-1.5,3,14,2344,8,2015,5,3
Group 3,BB,-1.5,3,14,2345,9,2015,7,2
Group 3,BB,-1.5,3,14,2346,7,2015,6,1
Group 3,BB,-1.5,3,14,2347,6,2015,9,-3
Group 3,BB,-1.5,3,14,2348,11,2015,6,5
Group 3,BB,-1.5,3,14,2349,9,2015,6,3
Group 3,BB,-1.5,3,14,2350,9,2015,10,-1
Group 3,BB,-1.5,3,14,2351,5,2015,4,1
Group 3,BB,-1.5,3,14,2352,8,2015,7,1
Group 3,BB,-1.5,3,14,2353,8,2015,5,3
Group 3,BB,-1.5,3,14,2354,7,2015,9,-2
Group 3,BB,-1.5,3,14,2355,7,2015,8,-1
Group 3,BB,-1.5,3,14,2356,10,2015,10,0
Group 3,BB,-1.5,3,14,2357,9,2015,6,3
Group 3,BB,-1.5,3,14,2358,7,2015,11,-4
Group 3,BB,-1.5,3,14,2359,9,2015,7,2
Group 3,BB,-1.5,3,14,2360,7,2015,7,0
Group 3,BB,-1.5,3,14,2361,8,2015,6,2
Group 3,BB,-1.5,3,14,2362,10,2015,8,2
Group 3,BB,-1.5,3,14,2363,7,2015,7,0
Group 3,BB,-1.5,3,14,2364,10,2015,8,2
Group 3,BB,-1.5,3,14,2365,9,2015,6,3
Group 3,BB,-1.5,3,14,2366,7,2015,6,1
Group 3,BB,-1.5,3,14,2367,10,2015,7,3
Group 3,BB,-1.5,3,14,2368,7,2015,12,-5
Group 3,BB,-1.5,3,14,2369,7,2015,8,-1
Group 3,BB,-1.5,3,14,2370,9,2015,9,0
Group 3,BB,-1.5,3,14,2371,8,2015,6,2
Group 3,BB,-1.5,3,14,2372,10,2015,10,0
Group 3,BB,-1.5,3,14,2373,9,2015,10,-1
Group 3,BB,-1.5,3,14,2374,4,2015,6,-2
Group 3,BB,-1.5,3,14,2375,10,2015,8,2
Group 3,BB,-1.5,3,14,2376,10,2015,4,6
Group 3,BB,-1.5,3,14,2377,10,2015,10,0
Group 3,BB,-1.5,3,14,2378,9,2015,2,7
Group 3,BB,-1.5,3,14,2379,8,2015,5,3
Group 3,BB,-1.5,3,14,2380,7,2015,9,-2
Group 3,BB,-1.5,3,14,2381,10,2015,6,4
Group 3,BB,-1.5,3,14,2382,10,2015,5,5
Group 3,BB,-1.5,3,14,2383,10,2015,5,5
Group 3,BB,-1.5,3,14,2384,11,2015,6,5
Group 3,BB,-1.5,3,14,2385,5,2015,7,-2
Group 3,BB,-1.5,3,14,2386,8,2015,5,3
Group 3,BB,-1.5,3,14,2387,8,2015,9,-1
Group 3,BB,-1.5,3,14,2388,11,2015,5,6
Group 3,BB,-1.5,3,14,2389,11,2015,9,2
Group 3,BB,-1.5,3,14,2390,11,2015,5,6
Group 3,BB,-1.5,3,14,2391,14,2015,9,5
Group 3,BB,-1.5,3,14,2392,8,2015,8,0
Group 3,BB,-1.5,3,14,2393,8,2015,8,0
Group 3,BB,-1.5,3,14,2394,11,2015,1,10
Group 3,BB,-1.5,3,14,2395,10,2015,13,-3
Group 3,BB,-1.5,3,14,2396,7,2015,5,2
Group 3,BB,-1.5,3,14,2397,8,2015,7,1
Group 3,BB,-1.5,3,14,2398,8,2015,10,-2
Group 3,BB,-1.5,3,14,2399,13,2015,6,7
Group 3,BB,-1.5,3,14,2400,7,2015,7,0
Group 3,BB,-1.5,3,14,2401,9,2015,5,4
Group 3,BB,-1.5,3,14,2402,10,2015,5,5
Group 3,BB,-1.5,3,14,2403,7,2015,6,1
Group 3,BB,-1.5,3,14,2404,12,2015,8,4
Group 3,BB,-1.5,3,14,2405,9,2015,4,5
Group 3,BB,-1.5,3,14,2406,9,2015,8,1
Group 3,BB,-1.5,3,14,2407,11,2015,8,3
Group 3,BB,-1.5,3,14,2408,4,2015,10,-6
Group 3,BB,-1.5,3,14,2409,12,2015,7,5
Group 3,BB,-1.5,3,14,2410,10,2015,6,4
Group 3,BB,-1.5,3,14,2411,10,2015,5,5
Group 3,BB,-1.5,3,14,2412,7,2015,6,1
Group 3,BB,-1.5,3,14,2413,8,2015,7,1
Group 3,BB,-1.5,3,14,2414,9,2015,10,-1
Group 3,BB,-1.5,3,14,2415,7,2015,5,2
Group 3,BB,-1.5,3,14,2416,9,2015,10,-1
Group 3,BB,-1.5,3,14,2417,12,2015,10,2
Group 3,BB,-1.5,3,14,2418,10,2015,5,5
Group 3,BB,-1.5,3,14,2419,7,2015,8,-1
Group 3,BB,-1.5,3,14,2420,11,2015,2,9
Group 3,BB,-1.5,3,14,2421,8,2015,7,1
Group 3,BB,-1.5,3,14,2422,6,2015,7,-1
Group 3,BB,-1.5,3,14,2423,7,2015,9,-2
Group 3,BB,-1.5,3,14,2424,9,2015,10,-1
Group 3,BB,-1.5,3,14,2425,9,2015,6,3
Group 3,BB,-1.5,3,14,2426,12,2015,11,1
Group 3,BB,-1.5,3,14,2427,6,2015,8,-2
Group 3,BB,-1.5,3,14,2428,7,2015,5,2
Group 3,BB,-1.5,3,14,2429,12,2015,5,7
Group 3,BB,-1.5,3,14,2430,9,2015,2,7
Group 3,BB,-1.5,3,14,2431,8,2015,7,1
Group 3,BB,-1.5,3,14,2432,7,2015,8,-1
Group 3,BB,-1.5,3,14,2433,11,2015,3,8
Group 3,BB,-1.5,3,14,2434,9,2015,7,2
Group 3,BB,-1.5,3,14,2435,11,2015,8,3
Group 3,BB,-1.5,3,14,2436,6,2015,11,-5
Group 3,BB,-1.5,3,14,2437,9,2015,7,2
Group 3,BB,-1.5,3,14,2438,7,2015,7,0
Group 3,BB,-1.5,3,14,2439,7,2015,5,2
Group 3,BB,-1.5,3,14,2440,8,2015,7,1
Group 3,BB,-1.5,3,14,2441,7,2015,5,2
Group 3,BB,-1.5,3,14,2442,8,2015,5,3
Group 3,BB,-1.5,3,14,2443,6,2015,7,-1
Group 3,BB,-1.5,3,14,2444,7,2015,9,-2
Group 3,BB,-1.5,3,14,2445,10,2015,9,1
Group 3,BB,-1.5,3,14,2446,9,2015,7,2
Group 3,BB,-1.5,3,14,2447,11,2015,5,6
Group 3,BB,-1.5,3,14,2448,10,2015,8,2
Group 3,BB,-1.5,3,14,2449,6,2015,9,-3
Group 3,BB,-1.5,3,14,2450,6,2015,7,-1
Group 3,BB,-1.5,3,14,2451,8,2015,6,2
Group 3,BB,-1.5,3,14,2452,5,2015,11,-6
Group 3,BB,-1.5,3,14,2453,7,2015,7,0
Group 3,BB,-1.5,3,14,2454,7,2015,12,-5
Group 3,BB,-1.5,3,14,2455,12,2015,4,8
Group 3,BB,-1.5,3,14,2456,10,2015,8,2
Group 3,BB,-1.5,3,14,2457,11,2015,8,3
Group 3,BB,-1.5,3,14,2458,13,2015,5,8
Group 3,BB,-1.5,3,14,2459,8,2015,9,-1
Group 3,BB,-1.5,3,14,2460,9,2015,5,4
Group 3,BB,-1.5,3,14,2461,9,2015,9,0
Group 3,BB,-1.5,3,14,2462,7,2015,3,4
Group 3,BB,-1.5,3,14,2463,10,2015,9,1
Group 3,BB,-1.5,3,14,2464,6,2015,9,-3
Group 3,BB,-1.5,3,14,2465,10,2015,5,5
Group 3,BB,-1.5,3,14,2466,9,2015,7,2
Group 3,BB,-1.5,3,14,2467,9,2015,9,0
Group 3,BB,-1.5,3,14,2468,9,2015,8,1
Group 3,BB,-1.5,3,14,2469,9,2015,7,2
Group 3,BB,-1.5,3,14,2470,7,2015,4,3
Group 3,BB,-1.5,3,14,2471,10,2015,6,4
Group 3,BB,-1.5,3,14,2472,7,2015,3,4
Group 3,BB,-1.5,3,14,2473,7,2015,6,1
Group 3,BB,-1.5,3,14,2474,9,2015,9,0
Group 3,BB,-1.5,3,14,2475,11,2015,6,5
Group 3,BB,-1.5,3,14,2476,6,2015,6,0
Group 3,BB,-1.5,3,14,2477,10,2015,9,1
Group 3,BB,-1.5,3,14,2478,9,2015,8,1
Group 3,BB,-1.5,3,14,2479,11,2015,9,2
Group 3,BB,-1.5,3,14,2480,8,2015,8,0
Group 3,BB,-1.5,3,14,2481,9,2015,5,4
Group 3,BB,-1.5,3,14,2482,8,2015,6,2
Group 3,BB,-1.5,3,14,2483,8,2015,8,0
Group 3,BB,-1.5,3,14,2484,7,2015,7,0
Group 3,BB,-1.5,3,14,2485,9,2015,9,0
Group 3,BB,-1.5,3,14,2486,7,2015,7,0
Group 3,BB,-1.5,3,14,2487,6,2015,7,-1
Group 3,BB,-1.5,3,14,2488,7,2015,5,2
Group 3,BB,-1.5,3,14,2489,9,2015,7,2
Group 3,BB,-1.5,3,14,2490,8,2015,8,0
Group 3,BB,-1.5,3,14,2491,7,2015,10,-3
Group 3,BB,-1.5,3,14,2492,7,2015,7,0
Group 3,BB,-1.5,3,14,2493,3,2015,6,-3
Group 3,BB,-1.5,3,14,2494,7,2015,9,-2
Group 3,BB,-1.5,3,14,2495,7,2015,7,0
Group 3,BB,-1.5,3,14,2496,8,2015,4,4
Group 3,BB,-1.5,3,14,2497,9,2015,10,-1
Group 3,BB,-1.5,3,14,2498,4,2015,4,0
Group 3,BB,-1.5,3,14,2499,7,2015,3,4
Group 3,BB,-1.5,3,14,2500,8,2015,5,3
Group 3,BB,-1.5,3,14,2501,8,2015,8,0
Group 3,BB,-1.5,3,14,2502,11,2015,10,1
Group 3,BB,-1.5,3,14,2503,9,2015,7,2
Group 3,BB,-1.5,3,14,2504,8,2015,10,-2
Group 3,BB,-1.5,3,14,2505,9,2015,4,5
Group 3,BB,-1.5,3,14,2506,8,2015,5,3
Group 3,BB,-1.5,3,14,2507,6,2015,8,-2
Group 3,BB,-1.5,3,14,2508,8,2015,10,-2
Group 3,BB,-1.5,3,14,2509,6,2015,13,-7
Group 3,BB,-1.5,3,14,2510,8,2015,8,0
Group 3,BB,-1.5,3,14,2511,9,2015,10,-1
Group 3,BB,-1.5,3,14,2512,7,2015,12,-5
Group 3,BB,-1.5,3,14,2513,8,2015,9,-1
Group 3,BB,-1.5,3,14,2514,10,2015,5,5
Group 3,BB,-1.5,3,14,2515,5,2015,6,-1
Group 3,BB,-1.5,3,14,2516,7,2015,7,0
Group 3,BB,-1.5,3,14,2517,8,2015,7,1
Group 3,BB,-1.5,3,14,2518,4,2015,8,-4
Group 3,BB,-1.5,3,14,2519,12,2015,5,7
Group 3,BB,-1.5,3,14,2520,7,2015,3,4
Group 3,BB,-1.5,3,14,2521,9,2015,6,3
Group 3,BB,-1.5,3,14,2522,7,2015,5,2
Group 3,BB,-1.5,3,14,2523,6,2015,5,1
Group 3,BB,-1.5,3,14,2524,8,2015,4,4
Group 3,BB,-1.5,3,14,2525,5,2015,10,-5
Group 3,BB,-1.5,3,14,2526,5,2015,6,-1
Group 3,BB,-1.5,3,14,2527,9,2015,6,3
Group 3,BB,-1.5,3,14,2528,6,2015,5,1
Group 3,BB,-1.5,3,14,2529,3,2015,4,-1
Group 3,BB,-1.5,3,14,2530,11,2015,6,5
Group 3,BB,-1.5,3,14,2531,11,2015,4,7
Group 3,BB,-1.5,3,14,2532,8,2015,6,2
Group 3,BB,-1.5,3,14,2533,5,2015,3,2
Group 3,BB,-1.5,3,14,2534,8,2015,6,2
Group 3,BB,-1.5,3,14,2535,9,2015,7,2
Group 3,BB,-1.5,3,14,2536,6,2015,3,3
Group 3,BB,-1.5,3,14,2537,11,2015,7,4
Group 3,BB,-1.5,3,14,2538,5,2015,9,-4
Group 3,BB,-1.5,3,14,2539,9,2015,9,0
Group 3,BB,-1.5,3,14,2540,9,2015,8,1
Group 3,BB,-1.5,3,14,2541,8,2015,6,2
Group 3,BB,-1.5,3,14,2542,9,2015,7,2
Group 3,BB,-1.5,3,14,2543,9,2015,6,3
Group 3,BB,-1.5,3,14,2544,8,2015,5,3
Group 3,BB,-1.5,3,14,2545,2,2015,7,-5
Group 3,BB,-1.5,3,14,2546,5,2015,8,-3
Group 3,BB,-1.5,3,14,2547,11,2015,9,2
Group 3,BB,-1.5,3,14,2548,5,2015,10,-5
Group 3,BB,-1.5,3,14,2549,10,2015,10,0
Group 3,BB,-1.5,3,14,2550,12,2015,8,4
Group 3,BB,-1.5,3,14,2551,6,2015,7,-1
Group 3,BB,-1.5,3,14,2552,8,2015,7,1
Group 3,BB,-1.5,3,14,2553,8,2015,6,2
Group 3,BB,-1.5,3,14,2554,10,2015,9,1
Group 3,BB,-1.5,3,14,2555,9,2015,5,4
Group 3,BB,-1.5,3,14,2556,7,2015,6,1
Group 3,BB,-1.5,3,14,2557,8,2015,6,2
Group 3,BB,-1.5,3,14,2558,9,2015,5,4
Group 3,BB,-1.5,3,14,2559,3,2015,12,-9
Group 3,BB,-1.5,3,14,2560,8,2015,7,1
Group 3,BB,-1.5,3,14,2561,9,2015,4,5
Group 3,BB,-1.5,3,14,2562,8,2015,12,-4
Group 3,BB,-1.5,3,14,2563,13,2015,7,6
Group 3,BB,-1.5,3,14,2564,9,2015,5,4
Group 3,BB,-1.5,3,14,2565,8,2015,9,-1
Group 3,BB,-1.5,3,14,2566,9,2015,7,2
Group 3,BB,-1.5,3,14,2567,12,2015,7,5
Group 3,BB,-1.5,3,14,2568,7,2015,13,-6
Group 3,BB,-1.5,3,14,2569,3,2015,4,-1
Group 3,BB,-1.5,3,14,2570,9,2015,3,6
Group 3,BB,-1.5,3,14,2571,10,2015,6,4
Group 3,BB,-1.5,3,14,2572,5,2015,7,-2
Group 3,BB,-1.5,3,14,2573,10,2015,7,3
Group 3,BB,-1.5,3,14,2574,10,2015,11,-1
Group 3,BB,-1.5,3,14,2575,8,2015,5,3
Group 3,BB,-1.5,3,14,2576,9,2015,8,1
Group 3,BB,-1.5,3,14,2577,9,2015,7,2
Group 3,BB,-1.5,3,14,2578,6,2015,7,-1
Group 3,BB,-1.5,3,14,2579,6,2015,6,0
Group 3,BB,-1.5,3,14,2580,10,2015,9,1
Group 3,BB,-1.5,3,14,2581,10,2015,9,1
Group 3,BB,-1.5,3,14,2582,7,2015,8,-1
Group 3,BB,-1.5,3,14,2583,9,2015,6,3
Group 3,BB,-1.5,3,14,2584,8,2015,8,0
Group 3,BB,-1.5,3,14,2585,8,2015,10,-2
Group 3,BB,-1.5,3,14,2586,8,2015,7,1
Group 3,BB,-1.5,3,14,2587,6,2015,8,-2
Group 3,BB,-1.5,3,14,2588,10,2015,8,2
Group 3,BB,-1.5,3,14,2589,7,2015,9,-2
Group 3,BB,-1.5,3,14,2590,12,2015,11,1
Group 3,BB,-1.5,3,14,2591,10,2015,10,0
Group 3,BB,-1.5,3,14,2592,7,2015,9,-2
Group 3,BB,-1.5,3,14,2593,10,2015,7,3
Group 3,BB,-1.5,3,14,2594,4,2015,8,-4
Group 3,BB,-1.5,3,14,2595,7,2015,10,-3
Group 3,BB,-1.5,3,14,2596,12,2015,10,2
Group 3,BB,-1.5,3,14,2597,7,2015,11,-4
Group 3,BB,-1.5,3,14,2598,6,2015,7,-1
Group 3,BB,-1.5,3,14,2599,7,2015,5,2
Group 3,BB,-1.5,3,14,2600,4,2015,8,-4
Group 3,BB,-1.5,3,14,2601,10,2015,10,0
Group 3,BB,-1.5,3,14,2602,5,2015,6,-1
Group 3,BB,-1.5,3,14,2603,4,2015,9,-5
Group 3,BB,-1.5,3,14,2604,8,2015,8,0
Group 3,BB,-1.5,3,14,2605,12,2015,9,3
Group 3,BB,-1.5,3,14,2606,9,2015,8,1
Group 3,BB,-1.5,3,14,2607,10,2015,2,8
Group 3,BB,-1.5,3,14,2608,4,2015,9,-5
Group 3,BB,-1.5,3,14,2609,9,2015,10,-1
Group 3,BB,-1.5,3,14,2610,9,2015,6,3
Group 3,BB,-1.5,3,14,2611,11,2015,9,2
Group 3,BB,-1.5,3,14,2612,8,2015,6,2
Group 3,BB,-1.5,3,14,2613,9,2015,7,2
Group 3,BB,-1.5,3,14,2614,8,2015,8,0
Group 3,BB,-1.5,3,14,2615,8,2015,3,5
Group 3,BB,-1.5,3,14,2616,9,2015,5,4
Group 3,BB,-1.5,3,14,2617,11,2015,4,7
Group 3,BB,-1.5,3,14,2618,8,2015,9,-1
Group 3,BB,-1.5,3,14,2619,7,2015,7,0
Group 3,BB,-1.5,3,14,2620,6,2015,7,-1
Group 3,BB,-1.5,3,14,2621,8,2015,7,1
Group 3,BB,-1.5,3,14,2622,12,2015,9,3
Group 3,BB,-1.5,3,14,2623,10,2015,5,5
Group 3,BB,-1.5,3,14,2624,9,2015,5,4
Group 3,BB,-1.5,3,14,2625,8,2015,8,0
Group 3,BB,-1.5,3,14,2626,9,2015,10,-1
Group 3,BB,-1.5,3,14,2627,10,2015,11,-1
Group 3,BB,-1.5,3,14,2628,6,2015,12,-6
Group 3,BB,-1.5,3,14,2629,10,2015,4,6
Group 3,BB,-1.5,3,14,2630,13,2015,10,3
Group 3,BB,-1.5,3,14,2631,12,2015,6,6
Group 3,BB,-1.5,3,14,2632,5,2015,8,-3
Group 3,BB,-1.5,3,14,2633,8,2015,4,4
Group 3,BB,-1.5,3,14,2634,9,2015,5,4
Group 3,BB,-1.5,3,14,2635,7,2015,7,0
Group 3,BB,-1.5,3,14,2636,7,2015,6,1
Group 3,BB,-1.5,3,14,2637,10,2015,4,6
Group 3,BB,-1.5,3,14,2638,10,2015,9,1
Group 3,BB,-1.5,3,14,2639,7,2015,7,0
Group 3,BB,-1.5,3,14,2640,10,2015,4,6
Group 3,BB,-1.5,3,14,2641,7,2015,8,-1
Group 3,BB,-1.5,3,14,2642,10,2015,10,0
Group 3,BB,-1.5,3,14,2643,10,2015,5,5
Group 3,BB,-1.5,3,14,2644,11,2015,4,7
Group 3,BB,-1.5,3,14,2645,7,2015,6,1
Group 3,BB,-1.5,3,14,2646,8,2015,9,-1
Group 3,BB,-1.5,3,14,2647,8,2015,7,1
Group 3,BB,-1.5,3,14,2648,10,2015,6,4
Group 3,BB,-1.5,3,14,2649,6,2015,11,-5
Group 3,BB,-1.5,3,14,2650,6,2015,8,-2
Group 3,BB,-1.5,3,14,2651,6,2015,7,-1
Group 3,BB,-1.5,3,14,2652,10,2015,9,1
Group 3,BB,-1.5,3,14,2653,8,2015,5,3
Group 3,BB,-1.5,3,14,2654,6,2015,7,-1
Group 3,BB,-1.5,3,14,2655,9,2015,10,-1
Group 3,BB,-1.5,3,14,2656,9,2015,5,4
Group 3,BB,-1.5,3,14,2657,6,2015,7,-1
Group 3,BB,-1.5,3,14,2658,8,2015,3,5
Group 3,BB,-1.5,3,14,2659,13,2015,5,8
Group 3,BB,-1.5,3,14,2660,4,2015,6,-2
Group 3,BB,-1.5,3,14,2661,10,2015,11,-1
Group 3,BB,-1.5,3,14,2662,12,2015,6,6
Group 3,BB,-1.5,3,14,2663,8,2015,8,0
Group 3,BB,-1.5,3,14,2664,13,2015,7,6
Group 3,BB,-1.5,3,14,2665,8,2015,6,2
Group 3,BB,-1.5,3,14,2666,8,2015,6,2
Group 3,BB,-1.5,3,14,2667,9,2015,5,4
Group 3,BB,-1.5,3,14,2668,8,2015,8,0
Group 3,BB,-1.5,3,14,2669,11,2015,4,7
Group 3,BB,-1.5,3,14,2670,10,2015,9,1
Group 3,BB,-1.5,3,14,2671,9,2015,8,1
Group 3,BB,-1.5,3,14,2672,6,2015,8,-2
Group 3,BB,-1.5,3,14,2673,8,2015,3,5
Group 3,BB,-1.5,3,14,2674,7,2015,7,0
Group 3,BB,-1.5,3,14,2675,8,2015,6,2
Group 3,BB,-1.5,3,14,2676,7,2015,5,2
Group 3,BB,-1.5,3,14,2677,6,2015,8,-2
Group 3,BB,-1.5,3,14,2678,10,2015,4,6
Group 3,BB,-1.5,3,14,2679,11,2015,8,3
Group 3,BB,-1.5,3,14,2680,7,2015,8,-1
Group 3,BB,-1.5,3,14,2681,5,2015,5,0
Group 3,BB,-1.5,3,14,2682,12,2015,9,3
Group 3,BB,-1.5,3,14,2683,8,2015,3,5
Group 3,BB,-1.5,3,14,2684,5,2015,7,-2
Group 3,BB,-1.5,3,14,2685,10,2015,11,-1
Group 3,BB,-1.5,3,14,2686,8,2015,5,3
Group 3,BB,-1.5,3,14,2687,11,2015,5,6
Group 3,BB,-1.5,3,14,2688,9,2015,3,6
Group 3,BB,-1.5,3,14,2689,7,2015,7,0
Group 3,BB,-1.5,3,14,2690,8,2015,7,1
Group 3,BB,-1.5,3,14,2691,8,2015,8,0
Group 3,BB,-1.5,3,14,2692,9,2015,6,3
Group 3,BB,-1.5,3,14,2693,8,2015,3,5
Group 3,BB,-1.5,3,14,2694,7,2015,5,2
Group 3,BB,-1.5,3,14,2695,5,2015,7,-2
Group 3,BB,-1.5,3,14,2696,10,2015,5,5
Group 3,BB,-1.5,3,14,2697,7,2015,6,1
Group 3,BB,-1.5,3,14,2698,10,2015,10,0
Group 3,BB,-1.5,3,14,2699,6,2015,11,-5
Group 3,BB,-1.5,3,14,2700,5,2015,12,-7
Group 3,BB,-1.5,3,14,2701,9,2015,9,0
Group 3,BB,-1.5,3,14,2702,10,2015,4,6
Group 3,BB,-1.5,3,14,2703,8,2015,5,3
Group 3,BB,-1.5,3,14,2704,10,2015,5,5
Group 3,BB,-1.5,3,14,2705,8,2015,7,1
Group 3,BB,-1.5,3,14,2706,6,2015,10,-4
Group 3,BB,-1.5,3,14,2707,5,2015,8,-3
Group 3,BB,-1.5,3,14,2708,4,2015,10,-6
Group 3,BB,-1.5,3,14,2709,11,2015,10,1
Group 3,BB,-1.5,3,14,2710,6,2015,9,-3
Group 3,BB,-1.5,3,14,2711,7,2015,7,0
Group 3,BB,-1.5,3,14,2712,7,2015,7,0
Group 3,BB,-1.5,3,14,2713,6,2015,5,1
Group 3,BB,-1.5,3,14,2714,3,2015,12,-9
Group 3,BB,-1.5,3,14,2715,10,2015,10,0
Group 3,BB,-1.5,3,14,2716,8,2015,5,3
Group 3,BB,-1.5,3,14,2717,8,2015,9,-1
Group 3,BB,-1.5,3,14,2718,9,2015,8,1
Group 3,BB,-1.5,3,14,2719,9,2015,6,3
Group 3,BB,-1.5,3,14,2720,8,2015,3,5
Group 3,BB,-1.5,3,14,2721,10,2015,8,2
Group 3,BB,-1.5,3,14,2722,8,2015,11,-3
Group 3,BB,-1.5,3,14,2723,9,2015,5,4
Group 3,BB,-1.5,3,14,2724,9,2015,7,2
Group 3,BB,-1.5,3,14,2725,10,2015,12,-2
Group 3,BB,-1.5,3,14,2726,11,2015,9,2
Group 3,BB,-1.5,3,14,2727,7,2015,10,-3
Group 3,BB,-1.5,3,14,2728,4,2015,9,-5
Group 3,BB,-1.5,3,14,2729,8,2015,8,0
Group 3,BB,-1.5,3,14,2730,10,2015,3,7
Group 3,BB,-1.5,3,14,2731,9,2015,11,-2
Group 3,BB,-1.5,3,14,2732,8,2015,6,2
Group 3,BB,-1.5,3,14,2733,7,2015,4,3
Group 3,BB,-1.5,3,14,2734,7,2015,7,0
Group 3,BB,-1.5,3,14,2735,5,2015,8,-3
Group 3,BB,-1.5,3,14,2736,9,2015,4,5
Group 3,BB,-1.5,3,14,2737,11,2015,7,4
Group 3,BB,-1.5,3,14,2738,9,2015,10,-1
Group 3,BB,-1.5,3,14,2739,12,2015,6,6
Group 3,BB,-1.5,3,14,2740,12,2015,5,7
Group 3,BB,-1.5,3,14,2741,6,2015,2,4
Group 3,BB,-1.5,3,14,2742,6,2015,6,0
Group 3,BB,-1.5,3,14,2743,7,2015,8,-1
Group 3,BB,-1.5,3,14,2744,8,2015,1,7
Group 3,BB,-1.5,3,14,2745,6,2015,9,-3
Group 3,BB,-1.5,3,14,2746,12,2015,6,6
Group 3,BB,-1.5,3,14,2747,8,2015,9,-1
Group 3,BB,-1.5,3,14,2748,8,2015,6,2
Group 3,BB,-1.5,3,14,2749,12,2015,10,2
Group 3,BB,-1.5,3,14,2750,7,2015,7,0
Group 3,BB,-1.5,3,14,2751,7,2015,8,-1
Group 3,BB,-1.5,3,14,2752,11,2015,6,5
Group 3,BB,-1.5,3,14,2753,9,2015,6,3
Group 3,BB,-1.5,3,14,2754,5,2015,8,-3
Group 3,BB,-1.5,3,14,2755,7,2015,6,1
Group 3,BB,-1.5,3,14,2756,10,2015,6,4
Group 3,BB,-1.5,3,14,2757,8,2015,11,-3
Group 3,BB,-1.5,3,14,2758,4,2015,10,-6
Group 3,BB,-1.5,3,14,2759,8,2015,3,5
Group 3,BB,-1.5,3,14,2760,9,2015,5,4
Group 3,BB,-1.5,3,14,2761,11,2015,7,4
Group 3,BB,-1.5,3,14,2762,5,2015,9,-4
Group 3,BB,-1.5,3,14,2763,7,2015,9,-2
Group 3,BB,-1.5,3,14,2764,8,2015,4,4
Group 3,BB,-1.5,3,14,2765,13,2015,4,9
Group 3,BB,-1.5,3,14,2766,6,2015,7,-1
Group 3,BB,-1.5,3,14,2767,7,2015,5,2
Group 3,BB,-1.5,3,14,2768,11,2015,8,3
Group 3,BB,-1.5,3,14,2769,8,2015,8,0
Group 3,BB,-1.5,3,14,2770,9,2015,2,7
Group 3,BB,-1.5,3,14,2771,9,2015,8,1
Group 3,BB,-1.5,3,14,2772,12,2015,9,3
Group 3,BB,-1.5,3,14,2773,11,2015,8,3
Group 3,BB,-1.5,3,14,2774,8,2015,9,-1
Group 3,BB,-1.5,3,14,2775,6,2015,9,-3
Group 3,BB,-1.5,3,14,2776,7,2015,6,1
Group 3,BB,-1.5,3,14,2777,6,2015,10,-4
Group 3,BB,-1.5,3,14,2778,10,2015,7,3
Group 3,BB,-1.5,3,14,2779,8,2015,8,0
Group 3,BB,-1.5,3,14,2780,9,2015,10,-1
Group 3,BB,-1.5,3,14,2781,9,2015,6,3
Group 3,BB,-1.5,3,14,2782,11,2015,9,2
Group 3,BB,-1.5,3,14,2783,6,2015,8,-2
Group 3,BB,-1.5,3,14,2784,9,2015,8,1
Group 3,BB,-1.5,3,14,2785,8,2015,6,2
Group 3,BB,-1.5,3,14,2786,10,2015,4,6
Group 3,BB,-1.5,3,14,2787,6,2015,8,-2
Group 3,BB,-1.5,3,14,2788,11,2015,11,0
Group 3,BB,-1.5,3,14,2789,6,2015,12,-6
Group 3,BB,-1.5,3,14,2790,4,2015,8,-4
Group 3,BB,-1.5,3,14,2791,8,2015,7,1
Group 3,BB,-1.5,3,14,2792,4,2015,7,-3
Group 3,BB,-1.5,3,14,2793,4,2015,5,-1
Group 3,BB,-1.5,3,14,2794,5,2015,7,-2
Group 3,BB,-1.5,3,14,2795,7,2015,2,5
Group 3,BB,-1.5,3,14,2796,8,2015,5,3
Group 3,BB,-1.5,3,14,2797,9,2015,4,5
Group 3,BB,-1.5,3,14,2798,8,2015,11,-3
Group 3,BB,-1.5,3,14,2799,8,2015,2,6
Group 3,BB,-1.5,3,14,2800,6,2015,5,1
Group 3,BB,-1.5,3,14,2801,10,2015,9,1
Group 3,BB,-1.5,3,14,2802,8,2015,8,0
Group 3,BB,-1.5,3,14,2803,6,2015,7,-1
Group 3,BB,-1.5,3,14,2804,8,2015,9,-1
Group 3,BB,-1.5,3,14,2805,6,2015,8,-2
Group 3,BB,-1.5,3,14,2806,10,2015,9,1
Group 3,BB,-1.5,3,14,2807,12,2015,10,2
Group 3,BB,-1.5,3,14,2808,7,2015,9,-2
Group 3,BB,-1.5,3,14,2809,11,2015,5,6
Group 3,BB,-1.5,3,14,2810,9,2015,5,4
Group 3,BB,-1.5,3,14,2811,7,2015,9,-2
Group 3,BB,-1.5,3,14,2812,9,2015,6,3
Group 3,BB,-1.5,3,14,2813,6,2015,11,-5
Group 3,BB,-1.5,3,14,2814,6,2015,8,-2
Group 3,BB,-1.5,3,14,2815,7,2015,8,-1
Group 3,BB,-1.5,3,14,2816,9,2015,8,1
Group 3,BB,-1.5,3,14,2817,9,2015,8,1
Group 3,BB,-1.5,3,14,2818,7,2015,7,0
Group 3,BB,-1.5,3,14,2819,13,2015,9,4
Group 3,BB,-1.5,3,14,2820,7,2015,9,-2
Group 3,BB,-1.5,3,14,2821,9,2015,9,0
Group 3,BB,-1.5,3,14,2822,7,2015,8,-1
Group 3,BB,-1.5,3,14,2823,12,2015,9,3
Group 3,BB,-1.5,3,14,2824,12,2015,5,7
Group 3,BB,-1.5,3,14,2825,10,2015,7,3
Group 3,BB,-1.5,3,14,2826,8,2015,3,5
Group 3,BB,-1.5,3,14,2827,8,2015,7,1
Group 3,BB,-1.5,3,14,2828,8,2015,8,0
Group 3,BB,-1.5,3,14,2829,9,2015,7,2
Group 3,BB,-1.5,3,14,2830,7,2015,9,-2
Group 3,BB,-1.5,3,14,2831,8,2015,4,4
Group 3,BB,-1.5,3,14,2832,10,2015,7,3
Group 3,BB,-1.5,3,14,2833,11,2015,6,5
Group 3,BB,-1.5,3,14,2834,10,2015,10,0
Group 3,BB,-1.5,3,14,2835,11,2015,3,8
Group 3,BB,-1.5,3,14,2836,9,2015,6,3
Group 3,BB,-1.5,3,14,2837,12,2015,8,4
Group 3,BB,-1.5,3,14,2838,11,2015,11,0
Group 3,BB,-1.5,3,14,2839,7,2015,7,0
Group 3,BB,-1.5,3,14,2840,3,2015,4,-1
Group 3,BB,-1.5,3,14,2841,7,2015,8,-1
Group 3,BB,-1.5,3,14,2842,9,2015,5,4
Group 3,BB,-1.5,3,14,2843,11,2015,5,6
Group 3,BB,-1.5,3,14,2844,8,2015,6,2
Group 3,BB,-1.5,3,14,2845,5,2015,8,-3
Group 3,BB,-1.5,3,14,2846,6,2015,9,-3
Group 3,BB,-1.5,3,14,2847,9,2015,6,3
Group 3,BB,-1.5,3,14,2848,9,2015,8,1
Group 3,BB,-1.5,3,14,2849,12,2015,7,5
Group 3,BB,-1.5,3,14,2850,7,2015,7,0
Group 3,BB,-1.5,3,14,2851,6,2015,5,1
Group 3,BB,-1.5,3,14,2852,9,2015,9,0
Group 3,BB,-1.5,3,14,2853,10,2015,10,0
Group 3,BB,-1.5,3,14,2854,9,2015,6,3
Group 3,BB,-1.5,3,14,2855,8,2015,10,-2
Group 3,BB,-1.5,3,14,2856,12,2015,7,5
Group 3,BB,-1.5,3,14,2857,10,2015,4,6
Group 3,BB,-1.5,3,14,2858,10,2015,9,1
Group 3,BB,-1.5,3,14,2859,8,2015,8,0
Group 3,BB,-1.5,3,14,2860,8,2015,7,1
Group 3,BB,-1.5,3,14,2861,10,2015,6,4
Group 3,BB,-1.5,3,14,2862,7,2015,7,0
Group 3,BB,-1.5,3,14,2863,9,2015,3,6
Group 3,BB,-1.5,3,14,2864,10,2015,6,4
Group 3,BB,-1.5,3,14,2865,6,2015,6,0
Group 3,BB,-1.5,3,14,2866,8,2015,7,1
Group 3,BB,-1.5,3,14,2867,9,2015,5,4
Group 3,BB,-1.5,3,14,2868,7,2015,6,1
Group 3,BB,-1.5,3,14,2869,9,2015,4,5
Group 3,BB,-1.5,3,14,2870,5,2015,6,-1
Group 3,BB,-1.5,3,14,2871,5,2015,9,-4
Group 3,BB,-1.5,3,14,2872,6,2015,12,-6
Group 3,BB,-1.5,3,14,2873,7,2015,13,-6
Group 3,BB,-1.5,3,14,2874,6,2015,5,1
Group 3,BB,-1.5,3,14,2875,5,2015,7,-2
Group 3,BB,-1.5,3,14,2876,9,2015,8,1
Group 3,BB,-1.5,3,14,2877,7,2015,8,-1
Group 3,BB,-1.5,3,14,2878,11,2015,7,4
Group 3,BB,-1.5,3,14,2879,10,2015,7,3
Group 3,BB,-1.5,3,14,2880,11,2015,3,8
Group 3,BB,-1.5,3,14,2881,6,2015,3,3
Group 3,BB,-1.5,3,14,2882,13,2015,7,6
Group 3,BB,-1.5,3,14,2883,6,2015,8,-2
Group 3,BB,-1.5,3,14,2884,11,2015,10,1
Group 3,BB,-1.5,3,14,2885,9,2015,4,5
Group 3,BB,-1.5,3,14,2886,9,2015,4,5
Group 3,BB,-1.5,3,14,2887,8,2015,4,4
Group 3,BB,-1.5,3,14,2888,9,2015,6,3
Group 3,BB,-1.5,3,14,2889,10,2015,9,1
Group 3,BB,-1.5,3,14,2890,7,2015,8,-1
Group 3,BB,-1.5,3,14,2891,9,2015,7,2
Group 3,BB,-1.5,3,14,2892,10,2015,12,-2
Group 3,BB,-1.5,3,14,2893,8,2015,8,0
Group 3,BB,-1.5,3,14,2894,10,2015,6,4
Group 3,BB,-1.5,3,14,2895,12,2015,7,5
Group 3,BB,-1.5,3,14,2896,11,2015,7,4
Group 3,BB,-1.5,3,14,2897,9,2015,10,-1
Group 3,BB,-1.5,3,14,2898,3,2015,4,-1
Group 3,BB,-1.5,3,14,2899,8,2015,7,1
Group 3,BB,-1.5,3,14,2900,8,2015,5,3
Group 3,BB,-1.5,3,14,2901,9,2015,6,3
Group 3,BB,-1.5,3,14,2902,10,2015,6,4
Group 3,BB,-1.5,3,14,2903,7,2015,6,1
Group 3,BB,-1.5,3,14,2904,11,2015,6,5
Group 3,BB,-1.5,3,14,2905,13,2015,10,3
Group 3,BB,-1.5,3,14,2906,7,2015,6,1
Group 3,BB,-1.5,3,14,2907,7,2015,2,5
Group 3,BB,-1.5,3,14,2908,8,2015,5,3
Group 3,BB,-1.5,3,14,2909,4,2015,4,0
Group 3,BB,-1.5,3,14,2910,10,2015,8,2
Group 3,BB,-1.5,3,14,2911,7,2015,11,-4
Group 3,BB,-1.5,3,14,2912,10,2015,6,4
Group 3,BB,-1.5,3,14,2913,12,2015,7,5
Group 3,BB,-1.5,3,14,2914,9,2015,4,5
Group 3,BB,-1.5,3,14,2915,11,2015,8,3
Group 3,BB,-1.5,3,14,2916,8,2015,7,1
Group 3,BB,-1.5,3,14,2917,8,2015,5,3
Group 3,BB,-1.5,3,14,2918,5,2015,9,-4
Group 3,BB,-1.5,3,14,2919,8,2015,8,0
Group 3,BB,-1.5,3,14,2920,10,2015,8,2
Group 3,BB,-1.5,3,14,2921,10,2015,5,5
Group 3,BB,-1.5,3,14,2922,6,2015,9,-3
Group 3,BB,-1.5,3,14,2923,10,2015,7,3
Group 3,BB,-1.5,3,14,2924,9,2015,6,3
Group 3,BB,-1.5,3,14,2925,9,2015,5,4
Group 3,BB,-1.5,3,14,2926,9,2015,11,-2
Group 3,BB,-1.5,3,14,2927,5,2015,10,-5
Group 3,BB,-1.5,3,14,2928,8,2015,6,2
Group 3,BB,-1.5,3,14,2929,12,2015,3,9
Group 3,BB,-1.5,3,14,2930,9,2015,7,2
Group 3,BB,-1.5,3,14,2931,9,2015,5,4
Group 3,BB,-1.5,3,14,2932,7,2015,10,-3
Group 3,BB,-1.5,3,14,2933,7,2015,8,-1
Group 3,BB,-1.5,3,14,2934,8,2015,10,-2
Group 3,BB,-1.5,3,14,2935,6,2015,9,-3
Group 3,BB,-1.5,3,14,2936,8,2015,8,0
Group 3,BB,-1.5,3,14,2937,11,2015,7,4
Group 3,BB,-1.5,3,14,2938,8,2015,4,4
Group 3,BB,-1.5,3,14,2939,9,2015,7,2
Group 3,BB,-1.5,3,14,2940,10,2015,9,1
Group 3,BB,-1.5,3,14,2941,6,2015,10,-4
Group 3,BB,-1.5,3,14,2942,10,2015,6,4
Group 3,BB,-1.5,3,14,2943,7,2015,8,-1
Group 3,BB,-1.5,3,14,2944,8,2015,6,2
Group 3,BB,-1.5,3,14,2945,6,2015,6,0
Group 3,BB,-1.5,3,14,2946,5,2015,8,-3
Group 3,BB,-1.5,3,14,2947,7,2015,7,0
Group 3,BB,-1.5,3,14,2948,6,2015,5,1
Group 3,BB,-1.5,3,14,2949,11,2015,7,4
Group 3,BB,-1.5,3,14,2950,7,2015,6,1
Group 3,BB,-1.5,3,14,2951,7,2015,2,5
Group 3,BB,-1.5,3,14,2952,10,2015,8,2
Group 3,BB,-1.5,3,14,2953,3,2015,6,-3
Group 3,BB,-1.5,3,14,2954,10,2015,8,2
Group 3,BB,-1.5,3,14,2955,9,2015,4,5
Group 3,BB,-1.5,3,14,2956,10,2015,7,3
Group 3,BB,-1.5,3,14,2957,5,2015,10,-5
Group 3,BB,-1.5,3,14,2958,4,2015,9,-5
Group 3,BB,-1.5,3,14,2959,6,2015,7,-1
Group 3,BB,-1.5,3,14,2960,8,2015,11,-3
Group 3,BB,-1.5,3,14,2961,8,2015,8,0
Group 3,BB,-1.5,3,14,2962,12,2015,6,6
Group 3,BB,-1.5,3,14,2963,9,2015,8,1
Group 3,BB,-1.5,3,14,2964,10,2015,6,4
Group 3,BB,-1.5,3,14,2965,10,2015,7,3
Group 3,BB,-1.5,3,14,2966,8,2015,9,-1
Group 3,BB,-1.5,3,14,2967,8,2015,4,4
Group 3,BB,-1.5,3,14,2968,12,2015,8,4
Group 3,BB,-1.5,3,14,2969,10,2015,6,4
Group 3,BB,-1.5,3,14,2970,7,2015,7,0
Group 3,BB,-1.5,3,14,2971,6,2015,9,-3
Group 3,BB,-1.5,3,14,2972,10,2015,9,1
Group 3,BB,-1.5,3,14,2973,8,2015,9,-1
Group 3,BB,-1.5,3,14,2974,10,2015,9,1
Group 3,BB,-1.5,3,14,2975,6,2015,6,0
Group 3,BB,-1.5,3,14,2976,11,2015,8,3
Group 3,BB,-1.5,3,14,2977,10,2015,8,2
Group 3,BB,-1.5,3,14,2978,10,2015,8,2
Group 3,BB,-1.5,3,14,2979,10,2015,8,2
Group 3,BB,-1.5,3,14,2980,10,2015,6,4
Group 3,BB,-1.5,3,14,2981,11,2015,8,3
Group 3,BB,-1.5,3,14,2982,7,2015,9,-2
Group 3,BB,-1.5,3,14,2983,5,2015,4,1
Group 3,BB,-1.5,3,14,2984,7,2015,4,3
Group 3,BB,-1.5,3,14,2985,11,2015,7,4
Group 3,BB,-1.5,3,14,2986,7,2015,7,0
Group 3,BB,-1.5,3,14,2987,8,2015,8,0
Group 3,BB,-1.5,3,14,2988,10,2015,8,2
Group 3,BB,-1.5,3,14,2989,8,2015,5,3
Group 3,BB,-1.5,3,14,2990,11,2015,6,5
Group 3,BB,-1.5,3,14,2991,9,2015,7,2
Group 3,BB,-1.5,3,14,2992,11,2015,6,5
Group 3,BB,-1.5,3,14,2993,8,2015,8,0
Group 3,BB,-1.5,3,14,2994,7,2015,1,6
Group 3,BB,-1.5,3,14,2995,10,2015,5,5
Group 3,BB,-1.5,3,14,2996,5,2015,6,-1
Group 3,BB,-1.5,3,14,2997,10,2015,9,1
Group 3,BB,-1.5,3,14,2998,9,2015,5,4
Group 3,BB,-1.5,3,14,2999,8,2015,6,2
Group 3,BB,-1.5,3,14,3000,6,2015,12,-6
Group 3,BB,-1.5,3,14,3001,10,2015,7,3
Group 3,BB,-1.5,3,14,3002,9,2015,5,4
Group 3,BB,-1.5,3,14,3003,10,2015,10,0
Group 3,BB,-1.5,3,14,3004,7,2015,6,1
Group 3,BB,-1.5,3,14,3005,11,2015,4,7
Group 3,BB,-1.5,3,14,3006,7,2015,5,2
Group 3,BB,-1.5,3,14,3007,6,2015,3,3
Group 3,BB,-1.5,3,14,3008,10,2015,9,1
Group 3,BB,-1.5,3,14,3009,8,2015,9,-1
Group 3,BB,-1.5,3,14,3010,9,2015,8,1
Group 3,BB,-1.5,3,14,3011,9,2015,6,3
Group 3,BB,-1.5,3,14,3012,6,2015,7,-1
Group 3,BB,-1.5,3,14,3013,7,2015,9,-2
Group 3,BB,-1.5,3,14,3014,6,2015,4,2
Group 3,BB,-1.5,3,14,3015,11,2015,8,3
Group 3,BB,-1.5,3,14,3016,13,2015,6,7
Group 3,BB,-1.5,3,14,3017,9,2015,7,2
Group 3,BB,-1.5,3,14,3018,6,2015,6,0
Group 3,BB,-1.5,3,14,3019,8,2015,13,-5
Group 3,BB,-1.5,3,14,3020,6,2015,7,-1
Group 3,BB,-1.5,3,14,3021,11,2015,4,7
Group 3,BB,-1.5,3,14,3022,10,2015,8,2
Group 3,BB,-1.5,3,14,3023,8,2015,5,3
Group 3,BB,-1.5,3,14,3024,10,2015,7,3
Group 3,BB,-1.5,3,14,3025,5,2015,8,-3
Group 3,BB,-1.5,3,14,3026,8,2015,6,2
Group 3,BB,-1.5,3,14,3027,11,2015,9,2
Group 3,BB,-1.5,3,14,3028,7,2015,10,-3
Group 3,BB,-1.5,3,14,3029,6,2015,10,-4
Group 3,BB,-1.5,3,14,3030,7,2015,12,-5
Group 3,BB,-1.5,3,14,3031,8,2015,6,2
Group 3,BB,-1.5,3,14,3032,10,2015,4,6
Group 3,BB,-1.5,3,14,3033,9,2015,8,1
Group 3,BB,-1.5,3,14,3034,10,2015,7,3
Group 3,BB,-1.5,3,14,3035,10,2015,6,4
Group 3,BB,-1.5,3,14,3036,6,2015,8,-2
Group 3,BB,-1.5,3,14,3037,8,2015,7,1
Group 3,BB,-1.5,3,14,3038,13,2015,8,5
Group 3,BB,-1.5,3,14,3039,9,2015,5,4
Group 3,BB,-1.5,3,14,3040,8,2015,7,1
Group 3,BB,-1.5,3,14,3041,5,2015,6,-1
Group 3,BB,-1.5,3,14,3042,10,2015,9,1
Group 3,BB,-1.5,3,14,3043,7,2015,8,-1
Group 3,BB,-1.5,3,14,3044,11,2015,4,7
Group 3,BB,-1.5,3,14,3045,5,2015,8,-3
Group 3,BB,-1.5,3,14,3046,7,2015,9,-2
Group 3,BB,-1.5,3,14,3047,10,2015,6,4
Group 3,BB,-1.5,3,14,3048,8,2015,6,2
Group 3,BB,-1.5,3,14,3049,8,2015,8,0
Group 3,BB,-1.5,3,14,3050,9,2015,11,-2
Group 3,BB,-1.5,3,14,3051,7,2015,9,-2
Group 3,BB,-1.5,3,14,3052,8,2015,8,0
Group 3,BB,-1.5,3,14,3053,5,2015,7,-2
Group 3,BB,-1.5,3,14,3054,11,2015,6,5
Group 3,BB,-1.5,3,14,3055,12,2015,5,7
Group 3,BB,-1.5,3,14,3056,9,2015,7,2
Group 3,BB,-1.5,3,14,3057,9,2015,7,2
Group 3,BB,-1.5,3,14,3058,12,2015,4,8
Group 3,BB,-1.5,3,14,3059,10,2015,9,1
Group 3,BB,-1.5,3,14,3060,8,2015,7,1
Group 3,BB,-1.5,3,14,3061,7,2015,5,2
Group 3,BB,-1.5,3,14,3062,6,2015,9,-3
Group 3,BB,-1.5,3,14,3063,6,2015,10,-4
Group 3,BB,-1.5,3,14,3064,8,2015,10,-2
Group 3,BB,-1.5,3,14,3065,7,2015,6,1
Group 3,BB,-1.5,3,14,3066,6,2015,5,1
Group 3,BB,-1.5,3,14,3067,7,2015,4,3
Group 3,BB,-1.5,3,14,3068,9,2015,7,2
Group 3,BB,-1.5,3,14,3069,6,2015,7,-1
Group 3,BB,-1.5,3,14,3070,7,2015,2,5
Group 3,BB,-1.5,3,14,3071,9,2015,7,2
Group 3,BB,-1.5,3,14,3072,4,2015,7,-3
Group 3,BB,-1.5,3,14,3073,10,2015,8,2
Group 3,BB,-1.5,3,14,3074,11,2015,6,5
Group 3,BB,-1.5,3,14,3075,8,2015,8,0
Group 3,BB,-1.5,3,14,3076,9,2015,8,1
Group 3,BB,-1.5,3,14,3077,6,2015,5,1
Group 3,BB,-1.5,3,14,3078,8,2015,6,2
Group 3,BB,-1.5,3,14,3079,7,2015,6,1
Group 3,BB,-1.5,3,14,3080,9,2015,7,2
Group 3,BB,-1.5,3,14,3081,8,2015,12,-4
Group 3,BB,-1.5,3,14,3082,10,2015,4,6
Group 3,BB,-1.5,3,14,3083,10,2015,5,5
Group 3,BB,-1.5,3,14,3084,5,2015,5,0
Group 3,BB,-1.5,3,14,3085,10,2015,8,2
Group 3,BB,-1.5,3,14,3086,9,2015,12,-3
Group 3,BB,-1.5,3,14,3087,11,2015,9,2
Group 3,BB,-1.5,3,14,3088,6,2015,5,1
Group 3,BB,-1.5,3,14,3089,8,2015,7,1
Group 3,BB,-1.5,3,14,3090,4,2015,8,-4
Group 3,BB,-1.5,3,14,3091,11,2015,10,1
Group 3,BB,-1.5,3,14,3092,9,2015,8,1
Group 3,BB,-1.5,3,14,3093,12,2015,0,12
Group 3,BB,-1.5,3,14,3094,6,2015,10,-4
Group 3,BB,-1.5,3,14,3095,6,2015,6,0
Group 3,BB,-1.5,3,14,3096,8,2015,9,-1
Group 3,BB,-1.5,3,14,3097,8,2015,8,0
Group 3,BB,-1.5,3,14,3098,8,2015,3,5
Group 3,BB,-1.5,3,14,3099,6,2015,3,3
Group 3,BB,-1.5,3,14,3100,5,2015,4,1
Group 3,BB,-1.5,3,14,3101,10,2015,8,2
Group 3,BB,-1.5,3,14,3102,8,2015,5,3
Group 3,BB,-1.5,3,14,3103,11,2015,5,6
Group 3,BB,-1.5,3,14,3104,9,2015,12,-3
Group 3,BB,-1.5,3,14,3105,10,2015,4,6
Group 3,BB,-1.5,3,14,3106,10,2015,8,2
Group 3,BB,-1.5,3,14,3107,8,2015,7,1
Group 3,BB,-1.5,3,14,3108,9,2015,7,2
Group 3,BB,-1.5,3,14,3109,10,2015,4,6
Group 3,BB,-1.5,3,14,3110,8,2015,10,-2
Group 3,BB,-1.5,3,14,3111,4,2015,8,-4
Group 3,BB,-1.5,3,14,3112,5,2015,6,-1
Group 3,BB,-1.5,3,14,3113,10,2015,8,2
Group 3,BB,-1.5,3,14,3114,5,2015,5,0
Group 3,BB,-1.5,3,14,3115,7,2015,7,0
Group 3,BB,-1.5,3,14,3116,8,2015,4,4
Group 3,BB,-1.5,3,14,3117,12,2015,10,2
Group 3,BB,-1.5,3,14,3118,6,2015,4,2
Group 3,BB,-1.5,3,14,3119,8,2015,11,-3
Group 3,BB,-1.5,3,14,3120,9,2015,3,6
Group 3,BB,-1.5,3,14,3121,5,2015,3,2
Group 3,BB,-1.5,3,14,3122,9,2015,7,2
Group 3,BB,-1.5,3,14,3123,10,2015,9,1
Group 3,BB,-1.5,3,14,3124,12,2015,6,6
Group 3,BB,-1.5,3,14,3125,8,2015,5,3
Group 3,BB,-1.5,3,14,3126,10,2015,8,2
Group 3,BB,-1.5,3,14,3127,11,2015,6,5
Group 3,BB,-1.5,3,14,3128,11,2015,10,1
Group 3,BB,-1.5,3,14,3129,12,2015,10,2
Group 3,BB,-1.5,3,14,3130,7,2015,11,-4
Group 3,BB,-1.5,3,14,3131,6,2015,9,-3
Group 3,BB,-1.5,3,14,3132,12,2015,5,7
Group 3,BB,-1.5,3,14,3133,10,2015,10,0
Group 3,BB,-1.5,3,14,3134,11,2015,8,3
Group 3,BB,-1.5,3,14,3135,10,2015,9,1
Group 3,BB,-1.5,3,14,3136,6,2015,6,0
Group 3,BB,-1.5,3,14,3137,9,2015,6,3
Group 3,BB,-1.5,3,14,3138,9,2015,7,2
Group 3,BB,-1.5,3,14,3139,6,2015,11,-5
Group 3,BB,-1.5,3,14,3140,6,2015,9,-3
Group 3,BB,-1.5,3,14,3141,11,2015,8,3
Group 3,BB,-1.5,3,14,3142,5,2015,6,-1
Group 3,BB,-1.5,3,14,3143,11,2015,13,-2
Group 3,BB,-1.5,3,14,3144,5,2015,3,2
Group 3,BB,-1.5,3,14,3145,6,2015,2,4
Group 3,BB,-1.5,3,14,3146,7,2015,2,5
Group 3,BB,-1.5,3,14,3147,10,2015,10,0
Group 3,BB,-1.5,3,14,3148,4,2015,8,-4
Group 3,BB,-1.5,3,14,3149,6,2015,9,-3
Group 3,BB,-1.5,3,14,3150,10,2015,7,3
Group 3,BB,-1.5,3,14,3151,5,2015,7,-2
Group 3,BB,-1.5,3,14,3152,7,2015,5,2
Group 3,BB,-1.5,3,14,3153,12,2015,6,6
Group 3,BB,-1.5,3,14,3154,9,2015,4,5
Group 3,BB,-1.5,3,14,3155,8,2015,8,0
Group 3,BB,-1.5,3,14,3156,11,2015,6,5
Group 3,BB,-1.5,3,14,3157,5,2015,7,-2
Group 3,BB,-1.5,3,14,3158,5,2015,7,-2
Group 3,BB,-1.5,3,14,3159,11,2015,5,6
Group 3,BB,-1.5,3,14,3160,10,2015,11,-1
Group 3,BB,-1.5,3,14,3161,6,2015,10,-4
Group 3,BB,-1.5,3,14,3162,10,2015,9,1
Group 3,BB,-1.5,3,14,3163,8,2015,7,1
Group 3,BB,-1.5,3,14,3164,10,2015,5,5
Group 3,BB,-1.5,3,14,3165,10,2015,11,-1
Group 3,BB,-1.5,3,14,3166,7,2015,11,-4
Group 3,BB,-1.5,3,14,3167,8,2015,8,0
Group 3,BB,-1.5,3,14,3168,9,2015,8,1
Group 3,BB,-1.5,3,14,3169,10,2015,11,-1
Group 3,BB,-1.5,3,14,3170,6,2015,9,-3
Group 3,BB,-1.5,3,14,3171,9,2015,5,4
Group 3,BB,-1.5,3,14,3172,9,2015,7,2
Group 3,BB,-1.5,3,14,3173,9,2015,6,3
Group 3,BB,-1.5,3,14,3174,8,2015,9,-1
Group 3,BB,-1.5,3,14,3175,12,2015,6,6
Group 3,BB,-1.5,3,14,3176,10,2015,4,6
Group 3,BB,-1.5,3,14,3177,8,2015,6,2
Group 3,BB,-1.5,3,14,3178,10,2015,10,0
Group 3,BB,-1.5,3,14,3179,10,2015,7,3
Group 3,BB,-1.5,3,14,3180,13,2015,10,3
Group 3,BB,-1.5,3,14,3181,8,2015,5,3
Group 3,BB,-1.5,3,14,3182,8,2015,8,0
Group 3,BB,-1.5,3,14,3183,8,2015,10,-2
Group 3,BB,-1.5,3,14,3184,7,2015,3,4
Group 3,BB,-1.5,3,14,3185,7,2015,4,3
Group 3,BB,-1.5,3,14,3186,5,2015,7,-2
Group 3,BB,-1.5,3,14,3187,8,2015,5,3
Group 3,BB,-1.5,3,14,3188,8,2015,5,3
Group 3,BB,-1.5,3,14,3189,10,2015,5,5
Group 3,BB,-1.5,3,14,3190,8,2015,2,6
Group 3,BB,-1.5,3,14,3191,8,2015,4,4
Group 3,BB,-1.5,3,14,3192,8,2015,2,6
Group 3,BB,-1.5,3,14,3193,10,2015,7,3
Group 3,BB,-1.5,3,14,3194,7,2015,7,0
Group 3,BB,-1.5,3,14,3195,6,2015,5,1
Group 3,BB,-1.5,3,14,3196,8,2015,4,4
Group 3,BB,-1.5,3,14,3197,8,2015,3,5
Group 3,BB,-1.5,3,14,3198,9,2015,7,2
Group 3,BB,-1.5,3,14,3199,9,2015,11,-2
Group 3,BB,-1.5,3,14,3200,6,2015,10,-4
Group 3,BB,-1.5,3,14,3201,10,2015,7,3
Group 3,BB,-1.5,3,14,3202,10,2015,6,4
Group 3,BB,-1.5,3,14,3203,11,2015,9,2
Group 3,BB,-1.5,3,14,3204,10,2015,7,3
Group 3,BB,-1.5,3,14,3205,9,2015,8,1
Group 3,BB,-1.5,3,14,3206,7,2015,6,1
Group 3,BB,-1.5,3,14,3207,6,2015,6,0
Group 3,BB,-1.5,3,14,3208,6,2015,4,2
Group 3,BB,-1.5,3,14,3209,7,2015,2,5
Group 3,BB,-1.5,3,14,3210,10,2015,8,2
Group 3,BB,-1.5,3,14,3211,9,2015,6,3
Group 3,BB,-1.5,3,14,3212,11,2015,9,2
Group 3,BB,-1.5,3,14,3213,6,2015,7,-1
Group 3,BB,-1.5,3,14,3214,10,2015,10,0
Group 3,BB,-1.5,3,14,3215,8,2015,6,2
Group 3,BB,-1.5,3,14,3216,7,2015,6,1
Group 3,BB,-1.5,3,14,3217,12,2015,9,3
Group 3,BB,-1.5,3,14,3218,7,2015,7,0
Group 3,BB,-1.5,3,14,3219,7,2015,7,0
Group 3,BB,-1.5,3,14,3220,6,2015,8,-2
Group 3,BB,-1.5,3,14,3221,11,2015,9,2
Group 3,BB,-1.5,3,14,3222,5,2015,7,-2
Group 3,BB,-1.5,3,14,3223,7,2015,7,0
Group 3,BB,-1.5,3,14,3224,8,2015,8,0
Group 3,BB,-1.5,3,14,3225,10,2015,10,0
Group 3,BB,-1.5,3,14,3226,9,2015,5,4
Group 3,BB,-1.5,3,14,3227,7,2015,4,3
Group 3,BB,-1.5,3,14,3228,6,2015,6,0
Group 3,BB,-1.5,3,14,3229,11,2015,11,0
Group 3,BB,-1.5,3,14,3230,9,2015,9,0
Group 3,BB,-1.5,3,14,3231,10,2015,9,1
Group 3,BB,-1.5,3,14,3232,6,2015,8,-2
Group 3,BB,-1.5,3,14,3233,10,2015,11,-1
Group 3,BB,-1.5,3,14,3234,8,2015,7,1
Group 3,BB,-1.5,3,14,3235,8,2015,6,2
Group 3,BB,-1.5,3,14,3236,9,2015,7,2
Group 3,BB,-1.5,3,14,3237,10,2015,8,2
Group 3,BB,-1.5,3,14,3238,8,2015,5,3
Group 3,BB,-1.5,3,14,3239,7,2015,6,1
Group 3,BB,-1.5,3,14,3240,7,2015,4,3
Group 3,BB,-1.5,3,14,3241,8,2015,6,2
Group 3,BB,-1.5,3,14,3242,7,2015,8,-1
Group 3,BB,-1.5,3,14,3243,7,2015,9,-2
Group 3,BB,-1.5,3,14,3244,8,2015,6,2
Group 3,BB,-1.5,3,14,3245,8,2015,7,1
Group 3,BB,-1.5,3,14,3246,9,2015,4,5
Group 3,BB,-1.5,3,14,3247,7,2015,7,0
Group 3,BB,-1.5,3,14,3248,11,2015,7,4
Group 3,BB,-1.5,3,14,3249,8,2015,11,-3
Group 3,BB,-1.5,3,14,3250,10,2015,6,4
Group 3,BB,-1.5,3,14,3251,7,2015,9,-2
Group 3,BB,-1.5,3,14,3252,8,2015,4,4
Group 3,BB,-1.5,3,14,3253,6,2015,9,-3
Group 3,BB,-1.5,3,14,3254,9,2015,7,2
Group 3,BB,-1.5,3,14,3255,6,2015,7,-1
Group 3,BB,-1.5,3,14,3256,8,2015,6,2
Group 3,BB,-1.5,3,14,3257,6,2015,9,-3
Group 3,BB,-1.5,3,14,3258,8,2015,4,4
Group 3,BB,-1.5,3,14,3259,8,2015,7,1
Group 3,BB,-1.5,3,14,3260,8,2015,9,-1
Group 3,BB,-1.5,3,14,3261,8,2015,10,-2
Group 3,BB,-1.5,3,14,3262,8,2015,7,1
Group 3,BB,-1.5,3,14,3263,10,2015,9,1
Group 3,BB,-1.5,3,14,3264,9,2015,9,0
Group 3,BB,-1.5,3,14,3265,7,2015,5,2
Group 3,BB,-1.5,3,14,3266,7,2015,5,2
Group 3,BB,-1.5,3,14,3267,6,2015,8,-2
Group 3,BB,-1.5,3,14,3268,10,2015,4,6
Group 3,BB,-1.5,3,14,3269,8,2015,7,1
Group 3,BB,-1.5,3,14,3270,8,2015,10,-2
Group 3,BB,-1.5,3,14,3271,8,2015,7,1
Group 3,BB,-1.5,3,14,3272,10,2015,5,5
Group 3,BB,-1.5,3,14,3273,11,2015,5,6
Group 3,BB,-1.5,3,14,3274,8,2015,10,-2
Group 3,BB,-1.5,3,14,3275,8,2015,7,1
Group 3,BB,-1.5,3,14,3276,6,2015,9,-3
Group 3,BB,-1.5,3,14,3277,7,2015,8,-1
Group 3,BB,-1.5,3,14,3278,9,2015,7,2
Group 3,BB,-1.5,3,14,3279,8,2015,9,-1
Group 3,BB,-1.5,3,14,3280,7,2015,10,-3
Group 3,BB,-1.5,3,14,3281,9,2015,5,4
Group 3,BB,-1.5,3,14,3282,10,2015,9,1
Group 3,BB,-1.5,3,14,3283,10,2015,7,3
Group 3,BB,-1.5,3,14,3284,8,2015,6,2
Group 3,BB,-1.5,3,14,3285,7,2015,6,1
Group 3,BB,-1.5,3,14,3286,12,2015,4,8
Group 3,BB,-1.5,3,14,3287,8,2015,5,3
Group 3,BB,-1.5,3,14,3288,9,2015,6,3
Group 3,BB,-1.5,3,14,3289,9,2015,8,1
Group 3,BB,-1.5,3,14,3290,6,2015,9,-3
Group 3,BB,-1.5,3,14,3291,7,2015,8,-1
Group 3,BB,-1.5,3,14,3292,9,2015,6,3
Group 3,BB,-1.5,3,14,3293,9,2015,9,0
Group 3,BB,-1.5,3,14,3294,11,2015,9,2
Group 3,BB,-1.5,3,14,3295,9,2015,11,-2
Group 3,BB,-1.5,3,14,3296,9,2015,6,3
Group 3,BB,-1.5,3,14,3297,8,2015,5,3
Group 3,BB,-1.5,3,14,3298,10,2015,7,3
Group 3,BB,-1.5,3,14,3299,7,2015,6,1
Group 3,BB,-1.5,3,14,3300,8,2015,10,-2
Group 3,BB,-1.5,3,14,3301,4,2015,6,-2
Group 3,BB,-1.5,3,14,3302,8,2015,8,0
Group 3,BB,-1.5,3,14,3303,8,2015,5,3
Group 3,BB,-1.5,3,14,3304,8,2015,5,3
Group 3,BB,-1.5,3,14,3305,11,2015,7,4
Group 3,BB,-1.5,3,14,3306,9,2015,4,5
Group 3,BB,-1.5,3,14,3307,7,2015,5,2
Group 3,BB,-1.5,3,14,3308,7,2015,7,0
Group 3,BB,-1.5,3,14,3309,10,2015,3,7
Group 3,BB,-1.5,3,14,3310,9,2015,5,4
Group 3,BB,-1.5,3,14,3311,9,2015,7,2
Group 3,BB,-1.5,3,14,3312,9,2015,7,2
Group 3,BB,-1.5,3,14,3313,4,2015,6,-2
Group 3,BB,-1.5,3,14,3314,6,2015,5,1
Group 3,BB,-1.5,3,14,3315,10,2015,8,2
Group 3,BB,-1.5,3,14,3316,4,2015,6,-2
Group 3,BB,-1.5,3,14,3317,8,2015,6,2
Group 3,BB,-1.5,3,14,3318,8,2015,8,0
Group 3,BB,-1.5,3,14,3319,6,2015,7,-1
Group 3,BB,-1.5,3,14,3320,7,2015,9,-2
Group 3,BB,-1.5,3,14,3321,8,2015,10,-2
Group 3,BB,-1.5,3,14,3322,8,2015,5,3
Group 3,BB,-1.5,3,14,3323,8,2015,5,3
Group 3,BB,-1.5,3,14,3324,9,2015,6,3
Group 3,BB,-1.5,3,14,3325,9,2015,4,5
Group 3,BB,-1.5,3,14,3326,10,2015,6,4
Group 3,BB,-1.5,3,14,3327,10,2015,5,5
Group 3,BB,-1.5,3,14,3328,7,2015,6,1
Group 3,BB,-1.5,3,14,3329,11,2015,6,5
Group 3,BB,-1.5,3,14,3330,10,2015,7,3
Group 3,BB,-1.5,3,14,3331,5,2015,7,-2
Group 3,BB,-1.5,3,14,3332,11,2015,5,6
Group 3,BB,-1.5,3,14,3333,9,2015,7,2
Group 3,BB,-1.5,3,14,3334,8,2015,7,1
Group 3,BB,-1.5,3,14,3335,10,2015,6,4
Group 3,BB,-1.5,3,14,3336,10,2015,8,2
Group 3,BB,-1.5,3,14,3337,7,2015,8,-1
Group 3,BB,-1.5,3,14,3338,13,2015,7,6
Group 3,BB,-1.5,3,14,3339,7,2015,5,2
Group 3,BB,-1.5,3,14,3340,9,2015,7,2
Group 3,BB,-1.5,3,14,3341,9,2015,5,4
Group 3,BB,-1.5,3,14,3342,12,2015,6,6
Group 3,BB,-1.5,3,14,3343,10,2015,6,4
Group 3,BB,-1.5,3,14,3344,6,2015,7,-1
Group 3,BB,-1.5,3,14,3345,10,2015,12,-2
Group 3,BB,-1.5,3,14,3346,7,2015,6,1
Group 3,BB,-1.5,3,14,3347,10,2015,8,2
Group 3,BB,-1.5,3,14,3348,6,2015,3,3
Group 3,BB,-1.5,3,14,3349,5,2015,7,-2
Group 3,BB,-1.5,3,14,3350,5,2015,2,3
Group 3,BB,-1.5,3,14,3351,8,2015,4,4
Group 3,BB,-1.5,3,14,3352,7,2015,11,-4
Group 3,BB,-1.5,3,14,3353,9,2015,8,1
Group 3,BB,-1.5,3,14,3354,6,2015,8,-2
Group 3,BB,-1.5,3,14,3355,11,2015,9,2
Group 3,BB,-1.5,3,14,3356,6,2015,8,-2
Group 3,BB,-1.5,3,14,3357,7,2015,7,0
Group 3,BB,-1.5,3,14,3358,5,2015,4,1
Group 3,BB,-1.5,3,14,3359,8,2015,8,0
Group 3,BB,-1.5,3,14,3360,8,2015,3,5
Group 3,BB,-1.5,3,14,3361,8,2015,7,1
Group 3,BB,-1.5,3,14,3362,7,2015,9,-2
Group 3,BB,-1.5,3,14,3363,9,2015,5,4
Group 3,BB,-1.5,3,14,3364,8,2015,8,0
Group 3,BB,-1.5,3,14,3365,13,2015,10,3
Group 3,BB,-1.5,3,14,3366,8,2015,5,3
Group 3,BB,-1.5,3,14,3367,7,2015,8,-1
Group 3,BB,-1.5,3,14,3368,8,2015,4,4
Group 3,BB,-1.5,3,14,3369,8,2015,10,-2
Group 3,BB,-1.5,3,14,3370,10,2015,6,4
Group 3,BB,-1.5,3,14,3371,10,2015,6,4
Group 3,BB,-1.5,3,14,3372,9,2015,8,1
Group 3,BB,-1.5,3,14,3373,8,2015,9,-1
Group 3,BB,-1.5,3,14,3374,8,2015,5,3
Group 3,BB,-1.5,3,14,3375,9,2015,7,2
Group 3,BB,-1.5,3,14,3376,12,2015,6,6
Group 3,BB,-1.5,3,14,3377,7,2015,3,4
Group 3,BB,-1.5,3,14,3378,10,2015,6,4
Group 3,BB,-1.5,3,14,3379,8,2015,6,2
Group 3,BB,-1.5,3,14,3380,8,2015,11,-3
Group 3,BB,-1.5,3,14,3381,8,2015,5,3
Group 3,BB,-1.5,3,14,3382,4,2015,6,-2
Group 3,BB,-1.5,3,14,3383,7,2015,7,0
Group 3,BB,-1.5,3,14,3384,11,2015,9,2
Group 3,BB,-1.5,3,14,3385,10,2015,8,2
Group 3,BB,-1.5,3,14,3386,7,2015,7,0
Group 3,BB,-1.5,3,14,3387,7,2015,5,2
Group 3,BB,-1.5,3,14,3388,9,2015,5,4
Group 3,BB,-1.5,3,14,3389,11,2015,7,4
Group 3,BB,-1.5,3,14,3390,11,2015,7,4
Group 3,BB,-1.5,3,14,3391,10,2015,11,-1
Group 3,BB,-1.5,3,14,3392,8,2015,7,1
Group 3,BB,-1.5,3,14,3393,12,2015,8,4
Group 3,BB,-1.5,3,14,3394,10,2015,7,3
Group 3,BB,-1.5,3,14,3395,9,2015,3,6
Group 3,BB,-1.5,3,14,3396,9,2015,7,2
Group 3,BB,-1.5,3,14,3397,5,2015,5,0
Group 3,BB,-1.5,3,14,3398,9,2015,10,-1
Group 3,BB,-1.5,3,14,3399,9,2015,10,-1
Group 3,BB,-1.5,3,14,3400,6,2015,5,1
Group 3,BB,-1.5,3,14,3401,9,2015,9,0
Group 3,BB,-1.5,3,14,3402,9,2015,7,2
Group 3,BB,-1.5,3,14,3403,7,2015,6,1
Group 3,BB,-1.5,3,14,3404,11,2015,10,1
Group 3,BB,-1.5,3,14,3405,11,2015,9,2
Group 3,BB,-1.5,3,14,3406,7,2015,5,2
Group 3,BB,-1.5,3,14,3407,7,2015,4,3
Group 3,BB,-1.5,3,14,3408,6,2015,6,0
Group 3,BB,-1.5,3,14,3409,7,2015,8,-1
Group 3,BB,-1.5,3,14,3410,9,2015,10,-1
Group 3,BB,-1.5,3,14,3411,7,2015,5,2
Group 3,BB,-1.5,3,14,3412,11,2015,10,1
Group 3,BB,-1.5,3,14,3413,4,2015,9,-5
Group 3,BB,-1.5,3,14,3414,10,2015,6,4
Group 3,BB,-1.5,3,14,3415,10,2015,7,3
Group 3,BB,-1.5,3,14,3416,9,2015,9,0
Group 3,BB,-1.5,3,14,3417,6,2015,5,1
Group 3,BB,-1.5,3,14,3418,8,2015,4,4
Group 3,BB,-1.5,3,14,3419,11,2015,1,10
Group 3,BB,-1.5,3,14,3420,9,2015,4,5
Group 3,BB,-1.5,3,14,3421,12,2015,6,6
Group 3,BB,-1.5,3,14,3422,7,2015,7,0
Group 3,BB,-1.5,3,14,3423,11,2015,5,6
Group 3,BB,-1.5,3,14,3424,12,2015,2,10
Group 3,BB,-1.5,3,14,3425,10,2015,8,2
Group 3,BB,-1.5,3,14,3426,9,2015,7,2
Group 3,BB,-1.5,3,14,3427,10,2015,3,7
Group 3,BB,-1.5,3,14,3428,8,2015,6,2
Group 3,BB,-1.5,3,14,3429,6,2015,9,-3
Group 3,BB,-1.5,3,14,3430,10,2015,9,1
Group 3,BB,-1.5,3,14,3431,11,2015,8,3
Group 3,BB,-1.5,3,14,3432,8,2015,6,2
Group 3,BB,-1.5,3,14,3433,10,2015,9,1
Group 3,BB,-1.5,3,14,3434,9,2015,6,3
Group 3,BB,-1.5,3,14,3435,8,2015,5,3
Group 3,BB,-1.5,3,14,3436,7,2015,5,2
Group 3,BB,-1.5,3,14,3437,13,2015,5,8
Group 3,BB,-1.5,3,14,3438,9,2015,5,4
Group 3,BB,-1.5,3,14,3439,8,2015,6,2
Group 3,BB,-1.5,3,14,3440,9,2015,9,0
Group 3,BB,-1.5,3,14,3441,6,2015,4,2
Group 3,BB,-1.5,3,14,3442,11,2015,6,5
Group 3,BB,-1.5,3,14,3443,7,2015,8,-1
Group 3,BB,-1.5,3,14,3444,3,2015,7,-4
Group 3,BB,-1.5,3,14,3445,6,2015,9,-3
Group 3,BB,-1.5,3,14,3446,4,2015,10,-6
Group 3,BB,-1.5,3,14,3447,10,2015,6,4
Group 3,BB,-1.5,3,14,3448,10,2015,6,4
Group 3,BB,-1.5,3,14,3449,10,2015,7,3
Group 3,BB,-1.5,3,14,3450,6,2015,6,0
Group 3,BB,-1.5,3,14,3451,7,2015,14,-7
Group 3,BB,-1.5,3,14,3452,11,2015,7,4
Group 3,BB,-1.5,3,14,3453,9,2015,10,-1
Group 3,BB,-1.5,3,14,3454,10,2015,7,3
Group 3,BB,-1.5,3,14,3455,10,2015,8,2
Group 3,BB,-1.5,3,14,3456,9,2015,5,4
Group 3,BB,-1.5,3,14,3457,8,2015,10,-2
Group 3,BB,-1.5,3,14,3458,8,2015,9,-1
Group 3,BB,-1.5,3,14,3459,5,2015,9,-4
Group 3,BB,-1.5,3,14,3460,13,2015,7,6
Group 3,BB,-1.5,3,14,3461,9,2015,6,3
Group 3,BB,-1.5,3,14,3462,7,2015,8,-1
Group 3,BB,-1.5,3,14,3463,10,2015,9,1
Group 3,BB,-1.5,3,14,3464,9,2015,8,1
Group 3,BB,-1.5,3,14,3465,6,2015,10,-4
Group 3,BB,-1.5,3,14,3466,6,2015,6,0
Group 3,BB,-1.5,3,14,3467,7,2015,8,-1
Group 3,BB,-1.5,3,14,3468,9,2015,8,1
Group 3,BB,-1.5,3,14,3469,10,2015,7,3
Group 3,BB,-1.5,3,14,3470,4,2015,10,-6
Group 3,BB,-1.5,3,14,3471,8,2015,10,-2
Group 3,BB,-1.5,3,14,3472,10,2015,6,4
Group 3,BB,-1.5,3,14,3473,5,2015,7,-2
Group 3,BB,-1.5,3,14,3474,7,2015,9,-2
Group 3,BB,-1.5,3,14,3475,6,2015,11,-5
Group 3,BB,-1.5,3,14,3476,10,2015,7,3
Group 3,BB,-1.5,3,14,3477,10,2015,9,1
Group 3,BB,-1.5,3,14,3478,8,2015,4,4
Group 3,BB,-1.5,3,14,3479,5,2015,7,-2
Group 3,BB,-1.5,3,14,3480,8,2015,8,0
Group 3,BB,-1.5,3,14,3481,7,2015,6,1
Group 3,BB,-1.5,3,14,3482,10,2015,5,5
Group 3,BB,-1.5,3,14,3483,6,2015,8,-2
Group 3,BB,-1.5,3,14,3484,7,2015,4,3
Group 3,BB,-1.5,3,14,3485,9,2015,7,2
Group 3,BB,-1.5,3,14,3486,5,2015,4,1
Group 3,BB,-1.5,3,14,3487,10,2015,11,-1
Group 3,BB,-1.5,3,14,3488,8,2015,5,3
Group 3,BB,-1.5,3,14,3489,11,2015,6,5
Group 3,BB,-1.5,3,14,3490,7,2015,7,0
Group 3,BB,-1.5,3,14,3491,10,2015,8,2
Group 3,BB,-1.5,3,14,3492,7,2015,6,1
Group 3,BB,-1.5,3,14,3493,8,2015,4,4
Group 3,BB,-1.5,3,14,3494,9,2015,8,1
Group 3,BB,-1.5,3,14,3495,4,2015,8,-4
Group 3,BB,-1.5,3,14,3496,10,2015,12,-2
Group 3,BB,-1.5,3,14,3497,11,2015,8,3
Group 3,BB,-1.5,3,14,3498,11,2015,7,4
Group 3,BB,-1.5,3,14,3499,8,2015,8,0
Group 3,BB,-1.5,3,14,3500,10,2015,7,3
Group 3,BB,-1.5,3,14,3501,6,2015,6,0
Group 3,BB,-1.5,3,14,3502,8,2015,10,-2
Group 3,BB,-1.5,3,14,3503,11,2015,5,6
Group 3,BB,-1.5,3,14,3504,9,2015,6,3
Group 3,BB,-1.5,3,14,3505,9,2015,5,4
Group 3,BB,-1.5,3,14,3506,10,2015,7,3
Group 3,BB,-1.5,3,14,3507,10,2015,9,1
Group 3,BB,-1.5,3,14,3508,11,2015,8,3
Group 3,BB,-1.5,3,14,3509,10,2015,6,4
Group 3,BB,-1.5,3,14,3510,12,2015,7,5
Group 3,BB,-1.5,3,14,3511,7,2015,9,-2
Group 3,BB,-1.5,3,14,3512,6,2015,7,-1
Group 3,BB,-1.5,3,14,3513,11,2015,8,3
Group 3,BB,-1.5,3,14,3514,6,2015,8,-2
Group 3,BB,-1.5,3,14,3515,8,2015,10,-2
Group 3,BB,-1.5,3,14,3516,6,2015,5,1
Group 3,BB,-1.5,3,14,3517,5,2015,10,-5
Group 3,BB,-1.5,3,14,3518,10,2015,7,3
Group 3,BB,-1.5,3,14,3519,11,2015,3,8
Group 3,BB,-1.5,3,14,3520,9,2015,5,4
Group 3,BB,-1.5,3,14,3521,10,2015,7,3
Group 3,BB,-1.5,3,14,3522,9,2015,5,4
Group 3,BB,-1.5,3,14,3523,9,2015,3,6
Group 3,BB,-1.5,3,14,3524,9,2015,8,1
Group 3,BB,-1.5,3,14,3525,6,2015,11,-5
Group 3,BB,-1.5,3,14,3526,11,2015,11,0
Group 3,BB,-1.5,3,14,3527,8,2015,7,1
Group 3,BB,-1.5,3,14,3528,13,2015,7,6
Group 3,BB,-1.5,3,14,3529,9,2015,5,4
Group 3,BB,-1.5,3,14,3530,9,2015,6,3
Group 3,BB,-1.5,3,14,3531,12,2015,6,6
Group 3,BB,-1.5,3,14,3532,7,2015,8,-1
Group 3,BB,-1.5,3,14,3533,10,2015,7,3
Group 3,BB,-1.5,3,14,3534,5,2015,9,-4
Group 3,BB,-1.5,3,14,3535,7,2015,6,1
Group 3,BB,-1.5,3,14,3536,11,2015,7,4
Group 3,BB,-1.5,3,14,3537,10,2015,10,0
Group 3,BB,-1.5,3,14,3538,7,2015,9,-2
Group 3,BB,-1.5,3,14,3539,9,2015,10,-1
Group 3,BB,-1.5,3,14,3540,9,2015,8,1
Group 3,BB,-1.5,3,14,3541,9,2015,3,6
Group 3,BB,-1.5,3,14,3542,7,2015,10,-3
Group 3,BB,-1.5,3,14,3543,9,2015,9,0
Group 3,BB,-1.5,3,14,3544,6,2015,9,-3
Group 3,BB,-1.5,3,14,3545,9,2015,4,5
Group 3,BB,-1.5,3,14,3546,10,2015,9,1
Group 3,BB,-1.5,3,14,3547,9,2015,8,1
Group 3,BB,-1.5,3,14,3548,9,2015,4,5
Group 3,BB,-1.5,3,14,3549,9,2015,5,4
Group 3,BB,-1.5,3,14,3550,11,2015,6,5
Group 3,BB,-1.5,3,14,3551,13,2015,1,12
Group 3,BB,-1.5,3,14,3552,4,2015,6,-2
Group 3,BB,-1.5,3,14,3553,9,2015,4,5
Group 3,BB,-1.5,3,14,3554,8,2015,5,3
Group 3,BB,-1.5,3,14,3555,8,2015,4,4
Group 3,BB,-1.5,3,14,3556,6,2015,7,-1
Group 3,BB,-1.5,3,14,3557,10,2015,8,2
Group 3,BB,-1.5,3,14,3558,9,2015,9,0
Group 3,BB,-1.5,3,14,3559,10,2015,8,2
Group 3,BB,-1.5,3,14,3560,8,2015,13,-5
Group 3,BB,-1.5,3,14,3561,9,2015,9,0
Group 3,BB,-1.5,3,14,3562,13,2015,9,4
Group 3,BB,-1.5,3,14,3563,9,2015,9,0
Group 3,BB,-1.5,3,14,3564,7,2015,10,-3
Group 3,BB,-1.5,3,14,3565,7,2015,9,-2
Group 3,BB,-1.5,3,14,3566,12,2015,8,4
Group 3,BB,-1.5,3,14,3567,8,2015,8,0
Group 3,BB,-1.5,3,14,3568,8,2015,10,-2
Group 3,BB,-1.5,3,14,3569,10,2015,11,-1
Group 3,BB,-1.5,3,14,3570,9,2015,7,2
Group 3,BB,-1.5,3,14,3571,6,2015,5,1
Group 3,BB,-1.5,3,14,3572,8,2015,5,3
Group 3,BB,-1.5,3,14,3573,6,2015,8,-2
Group 3,BB,-1.5,3,14,3574,6,2015,7,-1
Group 3,BB,-1.5,3,14,3575,8,2015,8,0
Group 3,BB,-1.5,3,14,3576,7,2015,9,-2
Group 3,BB,-1.5,3,14,3577,3,2015,6,-3
Group 3,BB,-1.5,3,14,3578,6,2015,6,0
Group 3,BB,-1.5,3,14,3579,9,2015,6,3
Group 3,BB,-1.5,3,14,3580,9,2015,10,-1
Group 3,BB,-1.5,3,14,3581,10,2015,4,6
Group 3,BB,-1.5,3,14,3582,8,2015,9,-1
Group 3,BB,-1.5,3,14,3583,5,2015,9,-4
Group 3,BB,-1.5,3,14,3584,8,2015,5,3
Group 3,BB,-1.5,3,14,3585,9,2015,4,5
Group 3,BB,-1.5,3,14,3586,12,2015,6,6
Group 3,BB,-1.5,3,14,3587,8,2015,3,5
Group 3,BB,-1.5,3,14,3588,8,2015,8,0
Group 3,BB,-1.5,3,14,3589,9,2015,6,3
Group 3,BB,-1.5,3,14,3590,9,2015,5,4
Group 3,BB,-1.5,3,14,3591,9,2015,7,2
Group 3,BB,-1.5,3,14,3592,9,2015,6,3
Group 3,BB,-1.5,3,14,3593,11,2015,10,1
Group 3,BB,-1.5,3,14,3594,3,2015,5,-2
Group 3,BB,-1.5,3,14,3595,14,2015,4,10
Group 3,BB,-1.5,3,14,3596,7,2015,7,0
Group 3,BB,-1.5,3,14,3597,9,2015,5,4
Group 3,BB,-1.5,3,14,3598,4,2015,4,0
Group 3,BB,-1.5,3,14,3599,12,2015,3,9
Group 3,BB,-1.5,3,14,3600,10,2015,12,-2
Group 3,BB,-1.5,3,14,3601,11,2015,8,3
Group 3,BB,-1.5,3,14,3602,6,2015,6,0
Group 3,BB,-1.5,3,14,3603,11,2015,9,2
Group 3,BB,-1.5,3,14,3604,9,2015,5,4
Group 3,BB,-1.5,3,14,3605,8,2015,11,-3
Group 3,BB,-1.5,3,14,3606,8,2015,9,-1
Group 3,BB,-1.5,3,14,3607,6,2015,6,0
Group 3,BB,-1.5,3,14,3608,4,2015,8,-4
Group 3,BB,-1.5,3,14,3609,6,2015,11,-5
Group 3,BB,-1.5,3,14,3610,10,2015,5,5
Group 3,BB,-1.5,3,14,3611,8,2015,9,-1
Group 3,BB,-1.5,3,14,3612,8,2015,9,-1
Group 3,BB,-1.5,3,14,3613,11,2015,5,6
Group 3,BB,-1.5,3,14,3614,8,2015,4,4
Group 3,BB,-1.5,3,14,3615,7,2015,7,0
Group 3,BB,-1.5,3,14,3616,7,2015,7,0
Group 3,BB,-1.5,3,14,3617,11,2015,5,6
Group 3,BB,-1.5,3,14,3618,8,2015,8,0
Group 3,BB,-1.5,3,14,3619,5,2015,6,-1
Group 3,BB,-1.5,3,14,3620,8,2015,6,2
Group 3,BB,-1.5,3,14,3621,9,2015,6,3
Group 3,BB,-1.5,3,14,3622,11,2015,11,0
Group 3,BB,-1.5,3,14,3623,13,2015,8,5
Group 3,BB,-1.5,3,14,3624,12,2015,8,4
Group 3,BB,-1.5,3,14,3625,9,2015,10,-1
Group 3,BB,-1.5,3,14,3626,9,2015,9,0
Group 3,BB,-1.5,3,14,3627,10,2015,12,-2
Group 3,BB,-1.5,3,14,3628,9,2015,9,0
Group 3,BB,-1.5,3,14,3629,7,2015,6,1
Group 3,BB,-1.5,3,14,3630,9,2015,6,3
Group 3,BB,-1.5,3,14,3631,9,2015,3,6
Group 3,BB,-1.5,3,14,3632,12,2015,5,7
Group 3,BB,-1.5,3,14,3633,4,2015,4,0
Group 3,BB,-1.5,3,14,3634,5,2015,8,-3
Group 3,BB,-1.5,3,14,3635,10,2015,2,8
Group 3,BB,-1.5,3,14,3636,8,2015,6,2
Group 3,BB,-1.5,3,14,3637,5,2015,7,-2
Group 3,BB,-1.5,3,14,3638,7,2015,4,3
Group 3,BB,-1.5,3,14,3639,5,2015,9,-4
Group 3,BB,-1.5,3,14,3640,9,2015,8,1
Group 3,BB,-1.5,3,14,3641,7,2015,4,3
Group 3,BB,-1.5,3,14,3642,8,2015,8,0
Group 3,BB,-1.5,3,14,3643,9,2015,9,0
Group 3,BB,-1.5,3,14,3644,7,2015,6,1
Group 3,BB,-1.5,3,14,3645,7,2015,7,0
Group 3,BB,-1.5,3,14,3646,4,2015,8,-4
Group 3,BB,-1.5,3,14,3647,8,2015,8,0
Group 3,BB,-1.5,3,14,3648,8,2015,6,2
Group 3,BB,-1.5,3,14,3649,10,2015,6,4
Group 3,BB,-1.5,3,14,3650,8,2015,10,-2
Group 3,BB,-1.5,3,14,3651,6,2015,12,-6
Group 3,BB,-1.5,3,14,3652,7,2015,10,-3
Group 3,BB,-1.5,3,14,3653,10,2015,4,6
Group 3,BB,-1.5,3,14,3654,11,2015,9,2
Group 3,BB,-1.5,3,14,3655,10,2015,6,4
Group 3,BB,-1.5,3,14,3656,9,2015,7,2
Group 3,BB,-1.5,3,14,3657,11,2015,9,2
Group 3,BB,-1.5,3,14,3658,6,2015,8,-2
Group 3,BB,-1.5,3,14,3659,7,2015,7,0
Group 3,BB,-1.5,3,14,3660,2,2015,10,-8
Group 3,BB,-1.5,3,14,3661,11,2015,3,8
Group 3,BB,-1.5,3,14,3662,9,2015,7,2
Group 3,BB,-1.5,3,14,3663,6,2015,5,1
Group 3,BB,-1.5,3,14,3664,6,2015,6,0
Group 3,BB,-1.5,3,14,3665,6,2015,7,-1
Group 3,BB,-1.5,3,14,3666,11,2015,7,4
Group 3,BB,-1.5,3,14,3667,8,2015,8,0
Group 3,BB,-1.5,3,14,3668,5,2015,5,0
Group 3,BB,-1.5,3,14,3669,9,2015,9,0
Group 3,BB,-1.5,3,14,3670,11,2015,7,4
Group 3,BB,-1.5,3,14,3671,9,2015,8,1
Group 3,BB,-1.5,3,14,3672,6,2015,4,2
Group 3,BB,-1.5,3,14,3673,8,2015,7,1
Group 3,BB,-1.5,3,14,3674,8,2015,9,-1
Group 3,BB,-1.5,3,14,3675,2,2015,11,-9
Group 3,BB,-1.5,3,14,3676,6,2015,10,-4
Group 3,BB,-1.5,3,14,3677,8,2015,6,2
Group 3,BB,-1.5,3,14,3678,9,2015,7,2
Group 3,BB,-1.5,3,14,3679,7,2015,7,0
Group 3,BB,-1.5,3,14,3680,7,2015,5,2
Group 3,BB,-1.5,3,14,3681,12,2015,11,1
Group 3,BB,-1.5,3,14,3682,9,2015,8,1
Group 3,BB,-1.5,3,14,3683,7,2015,2,5
Group 3,BB,-1.5,3,14,3684,10,2015,8,2
Group 3,BB,-1.5,3,14,3685,10,2015,10,0
Group 3,BB,-1.5,3,14,3686,8,2015,6,2
Group 3,BB,-1.5,3,14,3687,9,2015,3,6
Group 3,BB,-1.5,3,14,3688,10,2015,7,3
Group 3,BB,-1.5,3,14,3689,8,2015,7,1
Group 3,BB,-1.5,3,14,3690,9,2015,4,5
Group 3,BB,-1.5,3,14,3691,8,2015,8,0
Group 3,BB,-1.5,3,14,3692,9,2015,10,-1
Group 3,BB,-1.5,3,14,3693,8,2015,9,-1
Group 3,BB,-1.5,3,14,3694,8,2015,10,-2
Group 3,BB,-1.5,3,14,3695,5,2015,11,-6
Group 3,BB,-1.5,3,14,3696,10,2015,8,2
Group 3,BB,-1.5,3,14,3697,7,2015,8,-1
Group 3,BB,-1.5,3,14,3698,13,2015,9,4
Group 3,BB,-1.5,3,14,3699,7,2015,8,-1
Group 3,BB,-1.5,3,14,3700,6,2015,10,-4
Group 3,BB,-1.5,3,14,3701,6,2015,10,-4
Group 3,BB,-1.5,3,14,3702,8,2015,6,2
Group 3,BB,-1.5,3,14,3703,7,2015,6,1
Group 3,BB,-1.5,3,14,3704,5,2015,6,-1
Group 3,BB,-1.5,3,14,3705,8,2015,10,-2
Group 3,BB,-1.5,3,14,3706,12,2015,7,5
Group 3,BB,-1.5,3,14,3707,6,2015,6,0
Group 3,BB,-1.5,3,14,3708,10,2015,8,2
Group 3,BB,-1.5,3,14,3709,9,2015,4,5
Group 3,BB,-1.5,3,14,3710,6,2015,9,-3
Group 3,BB,-1.5,3,14,3711,9,2015,11,-2
Group 3,BB,-1.5,3,14,3712,8,2015,6,2
Group 3,BB,-1.5,3,14,3713,7,2015,6,1
Group 3,BB,-1.5,3,14,3714,9,2015,3,6
Group 3,BB,-1.5,3,14,3715,10,2015,8,2
Group 3,BB,-1.5,3,14,3716,7,2015,3,4
Group 3,BB,-1.5,3,14,3717,8,2015,9,-1
Group 3,BB,-1.5,3,14,3718,7,2015,8,-1
Group 3,BB,-1.5,3,14,3719,7,2015,7,0
Group 3,BB,-1.5,3,14,3720,12,2015,6,6
Group 3,BB,-1.5,3,14,3721,8,2015,5,3
Group 3,BB,-1.5,3,14,3722,7,2015,5,2
Group 3,BB,-1.5,3,14,3723,9,2015,9,0
Group 3,BB,-1.5,3,14,3724,4,2015,8,-4
Group 3,BB,-1.5,3,14,3725,6,2015,7,-1
Group 3,BB,-1.5,3,14,3726,11,2015,10,1
Group 3,BB,-1.5,3,14,3727,9,2015,5,4
Group 3,BB,-1.5,3,14,3728,8,2015,3,5
Group 3,BB,-1.5,3,14,3729,7,2015,5,2
Group 3,BB,-1.5,3,14,3730,10,2015,4,6
Group 3,BB,-1.5,3,14,3731,8,2015,6,2
Group 3,BB,-1.5,3,14,3732,3,2015,7,-4
Group 3,BB,-1.5,3,14,3733,8,2015,6,2
Group 3,BB,-1.5,3,14,3734,8,2015,7,1
Group 3,BB,-1.5,3,14,3735,11,2015,11,0
Group 3,BB,-1.5,3,14,3736,8,2015,7,1
Group 3,BB,-1.5,3,14,3737,5,2015,11,-6
Group 3,BB,-1.5,3,14,3738,7,2015,2,5
Group 3,BB,-1.5,3,14,3739,9,2015,6,3
Group 3,BB,-1.5,3,14,3740,13,2015,8,5
Group 3,BB,-1.5,3,14,3741,8,2015,7,1
Group 3,BB,-1.5,3,14,3742,7,2015,7,0
Group 3,BB,-1.5,3,14,3743,11,2015,9,2
Group 3,BB,-1.5,3,14,3744,10,2015,7,3
Group 3,BB,-1.5,3,14,3745,6,2015,5,1
Group 3,BB,-1.5,3,14,3746,10,2015,7,3
Group 3,BB,-1.5,3,14,3747,5,2015,10,-5
Group 3,BB,-1.5,3,14,3748,11,2015,8,3
Group 3,BB,-1.5,3,14,3749,9,2015,6,3
Group 3,BB,-1.5,3,14,3750,11,2015,5,6
Group 3,BB,-1.5,3,14,3751,10,2015,9,1
Group 3,BB,-1.5,3,14,3752,10,2015,8,2
Group 3,BB,-1.5,3,14,3753,9,2015,6,3
Group 3,BB,-1.5,3,14,3754,10,2015,11,-1
Group 3,BB,-1.5,3,14,3755,10,2015,5,5
Group 3,BB,-1.5,3,14,3756,9,2015,7,2
Group 3,BB,-1.5,3,14,3757,11,2015,8,3
Group 3,BB,-1.5,3,14,3758,10,2015,5,5
Group 3,BB,-1.5,3,14,3759,4,2015,6,-2
Group 3,BB,-1.5,3,14,3760,7,2015,6,1
Group 3,BB,-1.5,3,14,3761,8,2015,7,1
Group 3,BB,-1.5,3,14,3762,7,2015,8,-1
Group 3,BB,-1.5,3,14,3763,12,2015,9,3
Group 3,BB,-1.5,3,14,3764,12,2015,7,5
Group 3,BB,-1.5,3,14,3765,5,2015,8,-3
Group 3,BB,-1.5,3,14,3766,10,2015,7,3
Group 3,BB,-1.5,3,14,3767,6,2015,11,-5
Group 3,BB,-1.5,3,14,3768,8,2015,7,1
Group 3,BB,-1.5,3,14,3769,11,2015,6,5
Group 3,BB,-1.5,3,14,3770,6,2015,8,-2
Group 3,BB,-1.5,3,14,3771,9,2015,10,-1
Group 3,BB,-1.5,3,14,3772,11,2015,8,3
Group 3,BB,-1.5,3,14,3773,4,2015,7,-3
Group 3,BB,-1.5,3,14,3774,4,2015,8,-4
Group 3,BB,-1.5,3,14,3775,5,2015,7,-2
Group 3,BB,-1.5,3,14,3776,10,2015,9,1
Group 3,BB,-1.5,3,14,3777,10,2015,11,-1
Group 3,BB,-1.5,3,14,3778,4,2015,6,-2
Group 3,BB,-1.5,3,14,3779,10,2015,8,2
Group 3,BB,-1.5,3,14,3780,9,2015,11,-2
Group 3,BB,-1.5,3,14,3781,8,2015,7,1
Group 3,BB,-1.5,3,14,3782,11,2015,5,6
Group 3,BB,-1.5,3,14,3783,7,2015,9,-2
Group 3,BB,-1.5,3,14,3784,10,2015,5,5
Group 3,BB,-1.5,3,14,3785,8,2015,9,-1
Group 3,BB,-1.5,3,14,3786,9,2015,5,4
Group 3,BB,-1.5,3,14,3787,4,2015,7,-3
Group 3,BB,-1.5,3,14,3788,6,2015,9,-3
Group 3,BB,-1.5,3,14,3789,10,2015,10,0
Group 3,BB,-1.5,3,14,3790,10,2015,8,2
Group 3,BB,-1.5,3,14,3791,8,2015,7,1
Group 3,BB,-1.5,3,14,3792,8,2015,7,1
Group 3,BB,-1.5,3,14,3793,10,2015,4,6
Group 3,BB,-1.5,3,14,3794,10,2015,2,8
Group 3,BB,-1.5,3,14,3795,9,2015,8,1
Group 3,BB,-1.5,3,14,3796,8,2015,6,2
Group 3,BB,-1.5,3,14,3797,6,2015,11,-5
Group 3,BB,-1.5,3,14,3798,4,2015,5,-1
Group 3,BB,-1.5,3,14,3799,6,2015,9,-3
Group 3,BB,-1.5,3,14,3800,6,2015,9,-3
Group 3,BB,-1.5,3,14,3801,7,2015,5,2
Group 3,BB,-1.5,3,14,3802,9,2015,10,-1
Group 3,BB,-1.5,3,14,3803,10,2015,8,2
Group 3,BB,-1.5,3,14,3804,7,2015,5,2
Group 3,BB,-1.5,3,14,3805,7,2015,8,-1
Group 3,BB,-1.5,3,14,3806,11,2015,8,3
Group 3,BB,-1.5,3,14,3807,6,2015,3,3
Group 3,BB,-1.5,3,14,3808,5,2015,12,-7
Group 3,BB,-1.5,3,14,3809,9,2015,8,1
Group 3,BB,-1.5,3,14,3810,11,2015,9,2
Group 3,BB,-1.5,3,14,3811,4,2015,6,-2
Group 3,BB,-1.5,3,14,3812,10,2015,3,7
Group 3,BB,-1.5,3,14,3813,9,2015,8,1
Group 3,BB,-1.5,3,14,3814,9,2015,9,0
Group 3,BB,-1.5,3,14,3815,7,2015,6,1
Group 3,BB,-1.5,3,14,3816,10,2015,8,2
Group 3,BB,-1.5,3,14,3817,10,2015,8,2
Group 3,BB,-1.5,3,14,3818,10,2015,9,1
Group 3,BB,-1.5,3,14,3819,5,2015,8,-3
Group 3,BB,-1.5,3,14,3820,8,2015,3,5
Group 3,BB,-1.5,3,14,3821,6,2015,11,-5
Group 3,BB,-1.5,3,14,3822,8,2015,7,1
Group 3,BB,-1.5,3,14,3823,6,2015,8,-2
Group 3,BB,-1.5,3,14,3824,9,2015,10,-1
Group 3,BB,-1.5,3,14,3825,7,2015,10,-3
Group 3,BB,-1.5,3,14,3826,6,2015,10,-4
Group 3,BB,-1.5,3,14,3827,5,2015,7,-2
Group 3,BB,-1.5,3,14,3828,10,2015,5,5
Group 3,BB,-1.5,3,14,3829,9,2015,2,7
Group 3,BB,-1.5,3,14,3830,9,2015,7,2
Group 3,BB,-1.5,3,14,3831,9,2015,7,2
Group 3,BB,-1.5,3,14,3832,13,2015,6,7
Group 3,BB,-1.5,3,14,3833,10,2015,6,4
Group 3,BB,-1.5,3,14,3834,7,2015,6,1
Group 3,BB,-1.5,3,14,3835,8,2015,7,1
Group 3,BB,-1.5,3,14,3836,9,2015,7,2
Group 3,BB,-1.5,3,14,3837,10,2015,6,4
Group 3,BB,-1.5,3,14,3838,7,2015,6,1
Group 3,BB,-1.5,3,14,3839,8,2015,7,1
Group 3,BB,-1.5,3,14,3840,5,2015,4,1
Group 3,BB,-1.5,3,14,3841,7,2015,7,0
Group 3,BB,-1.5,3,14,3842,9,2015,11,-2
Group 3,BB,-1.5,3,14,3843,10,2015,7,3
Group 3,BB,-1.5,3,14,3844,4,2015,10,-6
Group 3,BB,-1.5,3,14,3845,9,2015,8,1
Group 3,BB,-1.5,3,14,3846,12,2015,9,3
Group 3,BB,-1.5,3,14,3847,10,2015,8,2
Group 3,BB,-1.5,3,14,3848,8,2015,5,3
Group 3,BB,-1.5,3,14,3849,9,2015,8,1
Group 3,BB,-1.5,3,14,3850,7,2015,6,1
Group 3,BB,-1.5,3,14,3851,10,2015,3,7
Group 3,BB,-1.5,3,14,3852,8,2015,8,0
Group 3,BB,-1.5,3,14,3853,8,2015,10,-2
Group 3,BB,-1.5,3,14,3854,7,2015,9,-2
Group 3,BB,-1.5,3,14,3855,6,2015,8,-2
Group 3,BB,-1.5,3,14,3856,10,2015,3,7
Group 3,BB,-1.5,3,14,3857,10,2015,9,1
Group 3,BB,-1.5,3,14,3858,10,2015,5,5
Group 3,BB,-1.5,3,14,3859,4,2015,5,-1
Group 3,BB,-1.5,3,14,3860,8,2015,5,3
Group 3,BB,-1.5,3,14,3861,7,2015,8,-1
Group 3,BB,-1.5,3,14,3862,11,2015,10,1
Group 3,BB,-1.5,3,14,3863,11,2015,9,2
Group 3,BB,-1.5,3,14,3864,11,2015,8,3
Group 3,BB,-1.5,3,14,3865,10,2015,7,3
Group 3,BB,-1.5,3,14,3866,11,2015,4,7
Group 3,BB,-1.5,3,14,3867,7,2015,10,-3
Group 3,BB,-1.5,3,14,3868,8,2015,11,-3
Group 3,BB,-1.5,3,14,3869,7,2015,7,0
Group 3,BB,-1.5,3,14,3870,9,2015,7,2
Group 3,BB,-1.5,3,14,3871,10,2015,4,6
Group 3,BB,-1.5,3,14,3872,6,2015,9,-3
Group 3,BB,-1.5,3,14,3873,9,2015,9,0
Group 3,BB,-1.5,3,14,3874,7,2015,11,-4
Group 3,BB,-1.5,3,14,3875,6,2015,11,-5
Group 3,BB,-1.5,3,14,3876,13,2015,6,7
Group 3,BB,-1.5,3,14,3877,9,2015,6,3
Group 3,BB,-1.5,3,14,3878,9,2015,8,1
Group 3,BB,-1.5,3,14,3879,5,2015,8,-3
Group 3,BB,-1.5,3,14,3880,9,2015,5,4
Group 3,BB,-1.5,3,14,3881,10,2015,8,2
Group 3,BB,-1.5,3,14,3882,9,2015,7,2
Group 3,BB,-1.5,3,14,3883,7,2015,9,-2
Group 3,BB,-1.5,3,14,3884,5,2015,4,1
Group 3,BB,-1.5,3,14,3885,12,2015,8,4
Group 3,BB,-1.5,3,14,3886,6,2015,10,-4
Group 3,BB,-1.5,3,14,3887,6,2015,7,-1
Group 3,BB,-1.5,3,14,3888,9,2015,11,-2
Group 3,BB,-1.5,3,14,3889,8,2015,5,3
Group 3,BB,-1.5,3,14,3890,8,2015,7,1
Group 3,BB,-1.5,3,14,3891,8,2015,7,1
Group 3,BB,-1.5,3,14,3892,9,2015,9,0
Group 3,BB,-1.5,3,14,3893,9,2015,3,6
Group 3,BB,-1.5,3,14,3894,8,2015,5,3
Group 3,BB,-1.5,3,14,3895,11,2015,5,6
Group 3,BB,-1.5,3,14,3896,10,2015,5,5
Group 3,BB,-1.5,3,14,3897,8,2015,9,-1
Group 3,BB,-1.5,3,14,3898,8,2015,5,3
Group 3,BB,-1.5,3,14,3899,7,2015,11,-4
Group 3,BB,-1.5,3,14,3900,7,2015,8,-1
Group 3,BB,-1.5,3,14,3901,10,2015,6,4
Group 3,BB,-1.5,3,14,3902,13,2015,8,5
Group 3,BB,-1.5,3,14,3903,6,2015,7,-1
Group 3,BB,-1.5,3,14,3904,8,2015,6,2
Group 3,BB,-1.5,3,14,3905,8,2015,5,3
Group 3,BB,-1.5,3,14,3906,11,2015,8,3
Group 3,BB,-1.5,3,14,3907,8,2015,5,3
Group 3,BB,-1.5,3,14,3908,8,2015,5,3
Group 3,BB,-1.5,3,14,3909,7,2015,8,-1
Group 3,BB,-1.5,3,14,3910,8,2015,8,0
Group 3,BB,-1.5,3,14,3911,8,2015,7,1
Group 3,BB,-1.5,3,14,3912,11,2015,8,3
Group 3,BB,-1.5,3,14,3913,7,2015,3,4
Group 3,BB,-1.5,3,14,3914,10,2015,7,3
Group 3,BB,-1.5,3,14,3915,10,2015,6,4
Group 3,BB,-1.5,3,14,3916,8,2015,10,-2
Group 3,BB,-1.5,3,14,3917,8,2015,9,-1
Group 3,BB,-1.5,3,14,3918,10,2015,7,3
Group 3,BB,-1.5,3,14,3919,8,2015,6,2
Group 3,BB,-1.5,3,14,3920,13,2015,7,6
Group 3,BB,-1.5,3,14,3921,5,2015,5,0
Group 3,BB,-1.5,3,14,3922,8,2015,9,-1
Group 3,BB,-1.5,3,14,3923,6,2015,6,0
Group 3,BB,-1.5,3,14,3924,11,2015,8,3
Group 3,BB,-1.5,3,14,3925,9,2015,7,2
Group 3,BB,-1.5,3,14,3926,6,2015,11,-5
Group 3,BB,-1.5,3,14,3927,10,2015,12,-2
Group 3,BB,-1.5,3,14,3928,7,2015,5,2
Group 3,BB,-1.5,3,14,3929,8,2015,10,-2
Group 3,BB,-1.5,3,14,3930,10,2015,7,3
Group 3,BB,-1.5,3,14,3931,11,2015,5,6
Group 3,BB,-1.5,3,14,3932,6,2015,5,1
Group 3,BB,-1.5,3,14,3933,9,2015,8,1
Group 3,BB,-1.5,3,14,3934,9,2015,5,4
Group 3,BB,-1.5,3,14,3935,10,2015,5,5
Group 3,BB,-1.5,3,14,3936,6,2015,7,-1
Group 3,BB,-1.5,3,14,3937,5,2015,6,-1
Group 3,BB,-1.5,3,14,3938,9,2015,8,1
Group 3,BB,-1.5,3,14,3939,8,2015,4,4
Group 3,BB,-1.5,3,14,3940,11,2015,10,1
Group 3,BB,-1.5,3,14,3941,9,2015,6,3
Group 3,BB,-1.5,3,14,3942,8,2015,6,2
Group 3,BB,-1.5,3,14,3943,10,2015,5,5
Group 3,BB,-1.5,3,14,3944,8,2015,6,2
Group 3,BB,-1.5,3,14,3945,7,2015,6,1
Group 3,BB,-1.5,3,14,3946,6,2015,8,-2
Group 3,BB,-1.5,3,14,3947,8,2015,8,0
Group 3,BB,-1.5,3,14,3948,9,2015,6,3
Group 3,BB,-1.5,3,14,3949,6,2015,8,-2
Group 3,BB,-1.5,3,14,3950,8,2015,11,-3
Group 3,BB,-1.5,3,14,3951,6,2015,6,0
Group 3,BB,-1.5,3,14,3952,7,2015,12,-5
Group 3,BB,-1.5,3,14,3953,8,2015,7,1
Group 3,BB,-1.5,3,14,3954,9,2015,6,3
Group 3,BB,-1.5,3,14,3955,8,2015,7,1
Group 3,BB,-1.5,3,14,3956,7,2015,4,3
Group 3,BB,-1.5,3,14,3957,6,2015,10,-4
Group 3,BB,-1.5,3,14,3958,9,2015,3,6
Group 3,BB,-1.5,3,14,3959,8,2015,3,5
Group 3,BB,-1.5,3,14,3960,8,2015,5,3
Group 3,BB,-1.5,3,14,3961,7,2015,3,4
Group 3,BB,-1.5,3,14,3962,10,2015,12,-2
Group 3,BB,-1.5,3,14,3963,10,2015,11,-1
Group 3,BB,-1.5,3,14,3964,6,2015,6,0
Group 3,BB,-1.5,3,14,3965,5,2015,8,-3
Group 3,BB,-1.5,3,14,3966,7,2015,5,2
Group 3,BB,-1.5,3,14,3967,11,2015,10,1
Group 3,BB,-1.5,3,14,3968,11,2015,11,0
Group 3,BB,-1.5,3,14,3969,8,2015,6,2
Group 3,BB,-1.5,3,14,3970,5,2015,6,-1
Group 3,BB,-1.5,3,14,3971,4,2015,10,-6
Group 3,BB,-1.5,3,14,3972,10,2015,7,3
Group 3,BB,-1.5,3,14,3973,10,2015,11,-1
Group 3,BB,-1.5,3,14,3974,6,2015,5,1
Group 3,BB,-1.5,3,14,3975,9,2015,7,2
Group 3,BB,-1.5,3,14,3976,7,2015,4,3
Group 3,BB,-1.5,3,14,3977,4,2015,8,-4
Group 3,BB,-1.5,3,14,3978,9,2015,9,0
Group 3,BB,-1.5,3,14,3979,9,2015,5,4
Group 3,BB,-1.5,3,14,3980,9,2015,10,-1
Group 3,BB,-1.5,3,14,3981,8,2015,5,3
Group 3,BB,-1.5,3,14,3982,9,2015,9,0
Group 3,BB,-1.5,3,14,3983,8,2015,8,0
Group 3,BB,-1.5,3,14,3984,6,2015,6,0
Group 3,BB,-1.5,3,14,3985,7,2015,4,3
Group 3,BB,-1.5,3,14,3986,7,2015,9,-2
Group 3,BB,-1.5,3,14,3987,6,2015,6,0
Group 3,BB,-1.5,3,14,3988,5,2015,7,-2
Group 3,BB,-1.5,3,14,3989,8,2015,7,1
Group 3,BB,-1.5,3,14,3990,10,2015,6,4
Group 3,BB,-1.5,3,14,3991,8,2015,3,5
Group 3,BB,-1.5,3,14,3992,7,2015,7,0
Group 3,BB,-1.5,3,14,3993,7,2015,7,0
Group 3,BB,-1.5,3,14,3994,8,2015,9,-1
Group 3,BB,-1.5,3,14,3995,9,2015,6,3
Group 3,BB,-1.5,3,14,3996,8,2015,7,1
Group 3,BB,-1.5,3,14,3997,10,2015,8,2
Group 3,BB,-1.5,3,14,3998,7,2015,8,-1
Group 3,BB,-1.5,3,14,3999,6,2015,8,-2
Group 3,BB,-1.5,3,14,4000,9,2015,4,5
Group 3,RRG,-1.5,5,14,1,5,2015,5,0
Group 3,RRG,-1.5,5,14,2,9,2015,5,4
Group 3,RRG,-1.5,5,14,3,8,2015,4,4
Group 3,RRG,-1.5,5,14,4,13,2015,10,3
Group 3,RRG,-1.5,5,14,5,5,2015,8,-3
Group 3,RRG,-1.5,5,14,6,7,2015,12,-5
Group 3,RRG,-1.5,5,14,7,9,2015,5,4
Group 3,RRG,-1.5,5,14,8,4,2015,9,-5
Group 3,RRG,-1.5,5,14,9,10,2015,6,4
Group 3,RRG,-1.5,5,14,10,6,2015,8,-2
Group 3,RRG,-1.5,5,14,11,8,2015,8,0
Group 3,RRG,-1.5,5,14,12,9,2015,7,2
Group 3,RRG,-1.5,5,14,13,7,2015,9,-2
Group 3,RRG,-1.5,5,14,14,11,2015,8,3
Group 3,RRG,-1.5,5,14,15,8,2015,6,2
Group 3,RRG,-1.5,5,14,16,6,2015,6,0
Group 3,RRG,-1.5,5,14,17,8,2015,5,3
Group 3,RRG,-1.5,5,14,18,4,2015,7,-3
Group 3,RRG,-1.5,5,14,19,4,2015,6,-2
Group 3,RRG,-1.5,5,14,20,9,2015,4,5
Group 3,RRG,-1.5,5,14,21,4,2015,7,-3
Group 3,RRG,-1.5,5,14,22,5,2015,8,-3
Group 3,RRG,-1.5,5,14,23,6,2015,10,-4
Group 3,RRG,-1.5,5,14,24,6,2015,9,-3
Group 3,RRG,-1.5,5,14,25,5,2015,8,-3
Group 3,RRG,-1.5,5,14,26,5,2015,7,-2
Group 3,RRG,-1.5,5,14,27,7,2015,6,1
Group 3,RRG,-1.5,5,14,28,12,2015,10,2
Group 3,RRG,-1.5,5,14,29,5,2015,4,1
Group 3,RRG,-1.5,5,14,30,7,2015,7,0
Group 3,RRG,-1.5,5,14,31,8,2015,4,4
Group 3,RRG,-1.5,5,14,32,4,2015,5,-1
Group 3,RRG,-1.5,5,14,33,10,2015,10,0
Group 3,RRG,-1.5,5,14,34,10,2015,6,4
Group 3,RRG,-1.5,5,14,35,4,2015,5,-1
Group 3,RRG,-1.5,5,14,36,6,2015,10,-4
Group 3,RRG,-1.5,5,14,37,8,2015,8,0
Group 3,RRG,-1.5,5,14,38,4,2015,7,-3
Group 3,RRG,-1.5,5,14,39,12,2015,6,6
Group 3,RRG,-1.5,5,14,40,5,2015,7,-2
Group 3,RRG,-1.5,5,14,41,4,2015,4,0
Group 3,RRG,-1.5,5,14,42,8,2015,5,3
Group 3,RRG,-1.5,5,14,43,5,2015,6,-1
Group 3,RRG,-1.5,5,14,44,11,2015,8,3
Group 3,RRG,-1.5,5,14,45,11,2015,10,1
Group 3,RRG,-1.5,5,14,46,9,2015,9,0
Group 3,RRG,-1.5,5,14,47,8,2015,4,4
Group 3,RRG,-1.5,5,14,48,6,2015,7,-1
Group 3,RRG,-1.5,5,14,49,3,2015,6,-3
Group 3,RRG,-1.5,5,14,50,9,2015,8,1
Group 3,RRG,-1.5,5,14,51,8,2015,11,-3
Group 3,RRG,-1.5,5,14,52,5,2015,4,1
Group 3,RRG,-1.5,5,14,53,11,2015,5,6
Group 3,RRG,-1.5,5,14,54,7,2015,8,-1
Group 3,RRG,-1.5,5,14,55,11,2015,6,5
Group 3,RRG,-1.5,5,14,56,8,2015,11,-3
Group 3,RRG,-1.5,5,14,57,7,2015,7,0
Group 3,RRG,-1.5,5,14,58,5,2015,7,-2
Group 3,RRG,-1.5,5,14,59,5,2015,8,-3
Group 3,RRG,-1.5,5,14,60,3,2015,3,0
Group 3,RRG,-1.5,5,14,61,13,2015,13,0
Group 3,RRG,-1.5,5,14,62,13,2015,12,1
Group 3,RRG,-1.5,5,14,63,6,2015,8,-2
Group 3,RRG,-1.5,5,14,64,12,2015,9,3
Group 3,RRG,-1.5,5,14,65,13,2015,7,6
Group 3,RRG,-1.5,5,14,66,8,2015,12,-4
Group 3,RRG,-1.5,5,14,67,2,2015,4,-2
Group 3,RRG,-1.5,5,14,68,3,2015,2,1
Group 3,RRG,-1.5,5,14,69,3,2015,0,3
Group 3,RRG,-1.5,5,14,70,6,2015,5,1
Group 3,RRG,-1.5,5,14,71,6,2015,4,2
Group 3,RRG,-1.5,5,14,72,6,2015,9,-3
Group 3,RRG,-1.5,5,14,73,12,2015,9,3
Group 3,RRG,-1.5,5,14,74,8,2015,4,4
Group 3,RRG,-1.5,5,14,75,5,2015,7,-2
Group 3,RRG,-1.5,5,14,76,4,2015,0,4
Group 3,RRG,-1.5,5,14,77,9,2015,12,-3
Group 3,RRG,-1.5,5,14,78,2,2015,6,-4
Group 3,RRG,-1.5,5,14,79,5,2015,7,-2
Group 3,RRG,-1.5,5,14,80,7,2015,9,-2
Group 3,RRG,-1.5,5,14,81,6,2015,6,0
Group 3,RRG,-1.5,5,14,82,4,2015,8,-4
Group 3,RRG,-1.5,5,14,83,9,2015,5,4
Group 3,RRG,-1.5,5,14,84,3,2015,7,-4
Group 3,RRG,-1.5,5,14,85,9,2015,9,0
Group 3,RRG,-1.5,5,14,86,9,2015,2,7
Group 3,RRG,-1.5,5,14,87,5,2015,5,0
Group 3,RRG,-1.5,5,14,88,9,2015,8,1
Group 3,RRG,-1.5,5,14,89,8,2015,7,1
Group 3,RRG,-1.5,5,14,90,10,2015,5,5
Group 3,RRG,-1.5,5,14,91,11,2015,7,4
Group 3,RRG,-1.5,5,14,92,5,2015,8,-3
Group 3,RRG,-1.5,5,14,93,5,2015,2,3
Group 3,RRG,-1.5,5,14,94,6,2015,6,0
Group 3,RRG,-1.5,5,14,95,6,2015,7,-1
Group 3,RRG,-1.5,5,14,96,9,2015,6,3
Group 3,RRG,-1.5,5,14,97,2,2015,4,-2
Group 3,RRG,-1.5,5,14,98,4,2015,5,-1
Group 3,RRG,-1.5,5,14,99,4,2015,8,-4
Group 3,RRG,-1.5,5,14,100,5,2015,5,0
Group 3,RRG,-1.5,5,14,101,7,2015,7,0
Group 3,RRG,-1.5,5,14,102,6,2015,5,1
Group 3,RRG,-1.5,5,14,103,9,2015,10,-1
Group 3,RRG,-1.5,5,14,104,6,2015,2,4
Group 3,RRG,-1.5,5,14,105,6,2015,6,0
Group 3,RRG,-1.5,5,14,106,7,2015,9,-2
Group 3,RRG,-1.5,5,14,107,7,2015,10,-3
Group 3,RRG,-1.5,5,14,108,4,2015,5,-1
Group 3,RRG,-1.5,5,14,109,5,2015,5,0
Group 3,RRG,-1.5,5,14,110,8,2015,7,1
Group 3,RRG,-1.5,5,14,111,6,2015,5,1
Group 3,RRG,-1.5,5,14,112,3,2015,5,-2
Group 3,RRG,-1.5,5,14,113,7,2015,7,0
Group 3,RRG,-1.5,5,14,114,6,2015,10,-4
Group 3,RRG,-1.5,5,14,115,4,2015,0,4
Group 3,RRG,-1.5,5,14,116,5,2015,3,2
Group 3,RRG,-1.5,5,14,117,7,2015,6,1
Group 3,RRG,-1.5,5,14,118,7,2015,7,0
Group 3,RRG,-1.5,5,14,119,6,2015,10,-4
Group 3,RRG,-1.5,5,14,120,7,2015,9,-2
Group 3,RRG,-1.5,5,14,121,5,2015,10,-5
Group 3,RRG,-1.5,5,14,122,8,2015,5,3
Group 3,RRG,-1.5,5,14,123,8,2015,9,-1
Group 3,RRG,-1.5,5,14,124,10,2015,11,-1
Group 3,RRG,-1.5,5,14,125,6,2015,9,-3
Group 3,RRG,-1.5,5,14,126,7,2015,9,-2
Group 3,RRG,-1.5,5,14,127,7,2015,8,-1
Group 3,RRG,-1.5,5,14,128,10,2015,6,4
Group 3,RRG,-1.5,5,14,129,6,2015,4,2
Group 3,RRG,-1.5,5,14,130,6,2015,8,-2
Group 3,RRG,-1.5,5,14,131,9,2015,7,2
Group 3,RRG,-1.5,5,14,132,8,2015,5,3
Group 3,RRG,-1.5,5,14,133,9,2015,10,-1
Group 3,RRG,-1.5,5,14,134,12,2015,3,9
Group 3,RRG,-1.5,5,14,135,2,2015,9,-7
Group 3,RRG,-1.5,5,14,136,5,2015,8,-3
Group 3,RRG,-1.5,5,14,137,11,2015,7,4
Group 3,RRG,-1.5,5,14,138,5,2015,7,-2
Group 3,RRG,-1.5,5,14,139,4,2015,5,-1
Group 3,RRG,-1.5,5,14,140,12,2015,8,4
Group 3,RRG,-1.5,5,14,141,2,2015,5,-3
Group 3,RRG,-1.5,5,14,142,7,2015,8,-1
Group 3,RRG,-1.5,5,14,143,6,2015,12,-6
Group 3,RRG,-1.5,5,14,144,10,2015,10,0
Group 3,RRG,-1.5,5,14,145,5,2015,3,2
Group 3,RRG,-1.5,5,14,146,9,2015,6,3
Group 3,RRG,-1.5,5,14,147,2,2015,5,-3
Group 3,RRG,-1.5,5,14,148,8,2015,10,-2
Group 3,RRG,-1.5,5,14,149,7,2015,8,-1
Group 3,RRG,-1.5,5,14,150,9,2015,6,3
Group 3,RRG,-1.5,5,14,151,7,2015,4,3
Group 3,RRG,-1.5,5,14,152,5,2015,11,-6
Group 3,RRG,-1.5,5,14,153,8,2015,3,5
Group 3,RRG,-1.5,5,14,154,5,2015,5,0
Group 3,RRG,-1.5,5,14,155,5,2015,8,-3
Group 3,RRG,-1.5,5,14,156,5,2015,10,-5
Group 3,RRG,-1.5,5,14,157,13,2015,8,5
Group 3,RRG,-1.5,5,14,158,3,2015,4,-1
Group 3,RRG,-1.5,5,14,159,7,2015,7,0
Group 3,RRG,-1.5,5,14,160,6,2015,4,2
Group 3,RRG,-1.5,5,14,161,5,2015,6,-1
Group 3,RRG,-1.5,5,14,162,7,2015,9,-2
Group 3,RRG,-1.5,5,14,163,9,2015,6,3
Group 3,RRG,-1.5,5,14,164,7,2015,9,-2
Group 3,RRG,-1.5,5,14,165,6,2015,7,-1
Group 3,RRG,-1.5,5,14,166,6,2015,6,0
Group 3,RRG,-1.5,5,14,167,11,2015,7,4
Group 3,RRG,-1.5,5,14,168,4,2015,2,2
Group 3,RRG,-1.5,5,14,169,1,2015,8,-7
Group 3,RRG,-1.5,5,14,170,13,2015,9,4
Group 3,RRG,-1.5,5,14,171,11,2015,10,1
Group 3,RRG,-1.5,5,14,172,7,2015,3,4
Group 3,RRG,-1.5,5,14,173,1,2015,3,-2
Group 3,RRG,-1.5,5,14,174,5,2015,6,-1
Group 3,RRG,-1.5,5,14,175,4,2015,8,-4
Group 3,RRG,-1.5,5,14,176,3,2015,7,-4
Group 3,RRG,-1.5,5,14,177,6,2015,9,-3
Group 3,RRG,-1.5,5,14,178,4,2015,5,-1
Group 3,RRG,-1.5,5,14,179,9,2015,7,2
Group 3,RRG,-1.5,5,14,180,7,2015,7,0
Group 3,RRG,-1.5,5,14,181,5,2015,8,-3
Group 3,RRG,-1.5,5,14,182,4,2015,6,-2
Group 3,RRG,-1.5,5,14,183,7,2015,7,0
Group 3,RRG,-1.5,5,14,184,7,2015,10,-3
Group 3,RRG,-1.5,5,14,185,6,2015,7,-1
Group 3,RRG,-1.5,5,14,186,9,2015,7,2
Group 3,RRG,-1.5,5,14,187,6,2015,8,-2
Group 3,RRG,-1.5,5,14,188,7,2015,6,1
Group 3,RRG,-1.5,5,14,189,10,2015,4,6
Group 3,RRG,-1.5,5,14,190,9,2015,7,2
Group 3,RRG,-1.5,5,14,191,5,2015,6,-1
Group 3,RRG,-1.5,5,14,192,10,2015,2,8
Group 3,RRG,-1.5,5,14,193,4,2015,7,-3
Group 3,RRG,-1.5,5,14,194,7,2015,9,-2
Group 3,RRG,-1.5,5,14,195,6,2015,5,1
Group 3,RRG,-1.5,5,14,196,2,2015,5,-3
Group 3,RRG,-1.5,5,14,197,14,2015,12,2
Group 3,RRG,-1.5,5,14,198,4,2015,4,0
Group 3,RRG,-1.5,5,14,199,10,2015,6,4
Group 3,RRG,-1.5,5,14,200,4,2015,7,-3
Group 3,RRG,-1.5,5,14,201,6,2015,4,2
Group 3,RRG,-1.5,5,14,202,9,2015,6,3
Group 3,RRG,-1.5,5,14,203,6,2015,8,-2
Group 3,RRG,-1.5,5,14,204,13,2015,8,5
Group 3,RRG,-1.5,5,14,205,2,2015,6,-4
Group 3,RRG,-1.5,5,14,206,5,2015,10,-5
Group 3,RRG,-1.5,5,14,207,7,2015,4,3
Group 3,RRG,-1.5,5,14,208,9,2015,4,5
Group 3,RRG,-1.5,5,14,209,7,2015,5,2
Group 3,RRG,-1.5,5,14,210,8,2015,12,-4
Group 3,RRG,-1.5,5,14,211,3,2015,9,-6
Group 3,RRG,-1.5,5,14,212,6,2015,5,1
Group 3,RRG,-1.5,5,14,213,3,2015,4,-1
Group 3,RRG,-1.5,5,14,214,4,2015,3,1
Group 3,RRG,-1.5,5,14,215,2,2015,8,-6
Group 3,RRG,-1.5,5,14,216,10,2015,8,2
Group 3,RRG,-1.5,5,14,217,7,2015,7,0
Group 3,RRG,-1.5,5,14,218,7,2015,7,0
Group 3,RRG,-1.5,5,14,219,3,2015,7,-4
Group 3,RRG,-1.5,5,14,220,9,2015,10,-1
Group 3,RRG,-1.5,5,14,221,6,2015,9,-3
Group 3,RRG,-1.5,5,14,222,6,2015,10,-4
Group 3,RRG,-1.5,5,14,223,5,2015,2,3
Group 3,RRG,-1.5,5,14,224,7,2015,10,-3
Group 3,RRG,-1.5,5,14,225,3,2015,5,-2
Group 3,RRG,-1.5,5,14,226,4,2015,6,-2
Group 3,RRG,-1.5,5,14,227,8,2015,6,2
Group 3,RRG,-1.5,5,14,228,10,2015,9,1
Group 3,RRG,-1.5,5,14,229,9,2015,7,2
Group 3,RRG,-1.5,5,14,230,7,2015,10,-3
Group 3,RRG,-1.5,5,14,231,6,2015,7,-1
Group 3,RRG,-1.5,5,14,232,2,2015,7,-5
Group 3,RRG,-1.5,5,14,233,5,2015,6,-1
Group 3,RRG,-1.5,5,14,234,5,2015,8,-3
Group 3,RRG,-1.5,5,14,235,11,2015,9,2
Group 3,RRG,-1.5,5,14,236,8,2015,10,-2
Group 3,RRG,-1.5,5,14,237,9,2015,9,0
Group 3,RRG,-1.5,5,14,238,8,2015,6,2
Group 3,RRG,-1.5,5,14,239,7,2015,6,1
Group 3,RRG,-1.5,5,14,240,11,2015,8,3
Group 3,RRG,-1.5,5,14,241,3,2015,8,-5
Group 3,RRG,-1.5,5,14,242,8,2015,9,-1
Group 3,RRG,-1.5,5,14,243,4,2015,7,-3
Group 3,RRG,-1.5,5,14,244,6,2015,7,-1
Group 3,RRG,-1.5,5,14,245,3,2015,8,-5
Group 3,RRG,-1.5,5,14,246,9,2015,6,3
Group 3,RRG,-1.5,5,14,247,8,2015,9,-1
Group 3,RRG,-1.5,5,14,248,6,2015,3,3
Group 3,RRG,-1.5,5,14,249,7,2015,5,2
Group 3,RRG,-1.5,5,14,250,7,2015,9,-2
Group 3,RRG,-1.5,5,14,251,6,2015,2,4
Group 3,RRG,-1.5,5,14,252,5,2015,8,-3
Group 3,RRG,-1.5,5,14,253,6,2015,6,0
Group 3,RRG,-1.5,5,14,254,3,2015,6,-3
Group 3,RRG,-1.5,5,14,255,8,2015,7,1
Group 3,RRG,-1.5,5,14,256,8,2015,7,1
Group 3,RRG,-1.5,5,14,257,7,2015,3,4
Group 3,RRG,-1.5,5,14,258,4,2015,9,-5
Group 3,RRG,-1.5,5,14,259,5,2015,6,-1
Group 3,RRG,-1.5,5,14,260,7,2015,6,1
Group 3,RRG,-1.5,5,14,261,9,2015,7,2
Group 3,RRG,-1.5,5,14,262,11,2015,8,3
Group 3,RRG,-1.5,5,14,263,1,2015,3,-2
Group 3,RRG,-1.5,5,14,264,12,2015,8,4
Group 3,RRG,-1.5,5,14,265,4,2015,4,0
Group 3,RRG,-1.5,5,14,266,1,2015,7,-6
Group 3,RRG,-1.5,5,14,267,9,2015,7,2
Group 3,RRG,-1.5,5,14,268,8,2015,3,5
Group 3,RRG,-1.5,5,14,269,3,2015,6,-3
Group 3,RRG,-1.5,5,14,270,13,2015,8,5
Group 3,RRG,-1.5,5,14,271,13,2015,8,5
Group 3,RRG,-1.5,5,14,272,9,2015,11,-2
Group 3,RRG,-1.5,5,14,273,8,2015,8,0
Group 3,RRG,-1.5,5,14,274,4,2015,6,-2
Group 3,RRG,-1.5,5,14,275,6,2015,10,-4
Group 3,RRG,-1.5,5,14,276,4,2015,3,1
Group 3,RRG,-1.5,5,14,277,8,2015,6,2
Group 3,RRG,-1.5,5,14,278,6,2015,3,3
Group 3,RRG,-1.5,5,14,279,10,2015,11,-1
Group 3,RRG,-1.5,5,14,280,8,2015,10,-2
Group 3,RRG,-1.5,5,14,281,10,2015,10,0
Group 3,RRG,-1.5,5,14,282,6,2015,9,-3
Group 3,RRG,-1.5,5,14,283,5,2015,5,0
Group 3,RRG,-1.5,5,14,284,9,2015,7,2
Group 3,RRG,-1.5,5,14,285,6,2015,4,2
Group 3,RRG,-1.5,5,14,286,10,2015,7,3
Group 3,RRG,-1.5,5,14,287,6,2015,6,0
Group 3,RRG,-1.5,5,14,288,6,2015,8,-2
Group 3,RRG,-1.5,5,14,289,5,2015,5,0
Group 3,RRG,-1.5,5,14,290,4,2015,9,-5
Group 3,RRG,-1.5,5,14,291,11,2015,5,6
Group 3,RRG,-1.5,5,14,292,1,2015,7,-6
Group 3,RRG,-1.5,5,14,293,11,2015,9,2
Group 3,RRG,-1.5,5,14,294,2,2015,8,-6
Group 3,RRG,-1.5,5,14,295,9,2015,4,5
Group 3,RRG,-1.5,5,14,296,12,2015,12,0
Group 3,RRG,-1.5,5,14,297,11,2015,7,4
Group 3,RRG,-1.5,5,14,298,5,2015,6,-1
Group 3,RRG,-1.5,5,14,299,0,2015,8,-8
Group 3,RRG,-1.5,5,14,300,7,2015,6,1
Group 3,RRG,-1.5,5,14,301,8,2015,11,-3
Group 3,RRG,-1.5,5,14,302,7,2015,10,-3
Group 3,RRG,-1.5,5,14,303,5,2015,7,-2
Group 3,RRG,-1.5,5,14,304,6,2015,5,1
Group 3,RRG,-1.5,5,14,305,7,2015,4,3
Group 3,RRG,-1.5,5,14,306,7,2015,7,0
Group 3,RRG,-1.5,5,14,307,5,2015,8,-3
Group 3,RRG,-1.5,5,14,308,7,2015,5,2
Group 3,RRG,-1.5,5,14,309,6,2015,9,-3
Group 3,RRG,-1.5,5,14,310,13,2015,9,4
Group 3,RRG,-1.5,5,14,311,6,2015,9,-3
Group 3,RRG,-1.5,5,14,312,8,2015,8,0
Group 3,RRG,-1.5,5,14,313,5,2015,6,-1
Group 3,RRG,-1.5,5,14,314,4,2015,11,-7
Group 3,RRG,-1.5,5,14,315,10,2015,8,2
Group 3,RRG,-1.5,5,14,316,5,2015,4,1
Group 3,RRG,-1.5,5,14,317,7,2015,7,0
Group 3,RRG,-1.5,5,14,318,3,2015,3,0
Group 3,RRG,-1.5,5,14,319,7,2015,7,0
Group 3,RRG,-1.5,5,14,320,4,2015,8,-4
Group 3,RRG,-1.5,5,14,321,6,2015,7,-1
Group 3,RRG,-1.5,5,14,322,6,2015,9,-3
Group 3,RRG,-1.5,5,14,323,7,2015,9,-2
Group 3,RRG,-1.5,5,14,324,5,2015,5,0
Group 3,RRG,-1.5,5,14,325,5,2015,8,-3
Group 3,RRG,-1.5,5,14,326,6,2015,6,0
Group 3,RRG,-1.5,5,14,327,7,2015,6,1
Group 3,RRG,-1.5,5,14,328,7,2015,8,-1
Group 3,RRG,-1.5,5,14,329,1,2015,5,-4
Group 3,RRG,-1.5,5,14,330,9,2015,7,2
Group 3,RRG,-1.5,5,14,331,4,2015,8,-4
Group 3,RRG,-1.5,5,14,332,8,2015,1,7
Group 3,RRG,-1.5,5,14,333,9,2015,5,4
Group 3,RRG,-1.5,5,14,334,3,2015,6,-3
Group 3,RRG,-1.5,5,14,335,12,2015,11,1
Group 3,RRG,-1.5,5,14,336,7,2015,7,0
Group 3,RRG,-1.5,5,14,337,7,2015,5,2
Group 3,RRG,-1.5,5,14,338,7,2015,7,0
Group 3,RRG,-1.5,5,14,339,7,2015,8,-1
Group 3,RRG,-1.5,5,14,340,8,2015,9,-1
Group 3,RRG,-1.5,5,14,341,1,2015,4,-3
Group 3,RRG,-1.5,5,14,342,5,2015,9,-4
Group 3,RRG,-1.5,5,14,343,5,2015,7,-2
Group 3,RRG,-1.5,5,14,344,10,2015,7,3
Group 3,RRG,-1.5,5,14,345,5,2015,4,1
Group 3,RRG,-1.5,5,14,346,3,2015,7,-4
Group 3,RRG,-1.5,5,14,347,2,2015,9,-7
Group 3,RRG,-1.5,5,14,348,2,2015,4,-2
Group 3,RRG,-1.5,5,14,349,6,2015,6,0
Group 3,RRG,-1.5,5,14,350,9,2015,8,1
Group 3,RRG,-1.5,5,14,351,3,2015,6,-3
Group 3,RRG,-1.5,5,14,352,8,2015,8,0
Group 3,RRG,-1.5,5,14,353,6,2015,2,4
Group 3,RRG,-1.5,5,14,354,12,2015,6,6
Group 3,RRG,-1.5,5,14,355,6,2015,8,-2
Group 3,RRG,-1.5,5,14,356,9,2015,12,-3
Group 3,RRG,-1.5,5,14,357,6,2015,10,-4
Group 3,RRG,-1.5,5,14,358,7,2015,7,0
Group 3,RRG,-1.5,5,14,359,4,2015,7,-3
Group 3,RRG,-1.5,5,14,360,7,2015,4,3
Group 3,RRG,-1.5,5,14,361,6,2015,6,0
Group 3,RRG,-1.5,5,14,362,7,2015,5,2
Group 3,RRG,-1.5,5,14,363,12,2015,9,3
Group 3,RRG,-1.5,5,14,364,3,2015,8,-5
Group 3,RRG,-1.5,5,14,365,11,2015,8,3
Group 3,RRG,-1.5,5,14,366,8,2015,9,-1
Group 3,RRG,-1.5,5,14,367,6,2015,10,-4
Group 3,RRG,-1.5,5,14,368,7,2015,6,1
Group 3,RRG,-1.5,5,14,369,8,2015,10,-2
Group 3,RRG,-1.5,5,14,370,9,2015,5,4
Group 3,RRG,-1.5,5,14,371,6,2015,9,-3
Group 3,RRG,-1.5,5,14,372,9,2015,7,2
Group 3,RRG,-1.5,5,14,373,4,2015,10,-6
Group 3,RRG,-1.5,5,14,374,1,2015,12,-11
Group 3,RRG,-1.5,5,14,375,6,2015,6,0
Group 3,RRG,-1.5,5,14,376,3,2015,11,-8
Group 3,RRG,-1.5,5,14,377,2,2015,3,-1
Group 3,RRG,-1.5,5,14,378,4,2015,8,-4
Group 3,RRG,-1.5,5,14,379,4,2015,4,0
Group 3,RRG,-1.5,5,14,380,7,2015,4,3
Group 3,RRG,-1.5,5,14,381,5,2015,9,-4
Group 3,RRG,-1.5,5,14,382,10,2015,7,3
Group 3,RRG,-1.5,5,14,383,11,2015,7,4
Group 3,RRG,-1.5,5,14,384,7,2015,9,-2
Group 3,RRG,-1.5,5,14,385,12,2015,8,4
Group 3,RRG,-1.5,5,14,386,1,2015,5,-4
Group 3,RRG,-1.5,5,14,387,3,2015,6,-3
Group 3,RRG,-1.5,5,14,388,5,2015,7,-2
Group 3,RRG,-1.5,5,14,389,8,2015,11,-3
Group 3,RRG,-1.5,5,14,390,4,2015,2,2
Group 3,RRG,-1.5,5,14,391,7,2015,5,2
Group 3,RRG,-1.5,5,14,392,4,2015,5,-1
Group 3,RRG,-1.5,5,14,393,5,2015,10,-5
Group 3,RRG,-1.5,5,14,394,9,2015,2,7
Group 3,RRG,-1.5,5,14,395,6,2015,4,2
Group 3,RRG,-1.5,5,14,396,8,2015,9,-1
Group 3,RRG,-1.5,5,14,397,7,2015,7,0
Group 3,RRG,-1.5,5,14,398,3,2015,5,-2
Group 3,RRG,-1.5,5,14,399,6,2015,8,-2
Group 3,RRG,-1.5,5,14,400,3,2015,6,-3
Group 3,RRG,-1.5,5,14,401,8,2015,7,1
Group 3,RRG,-1.5,5,14,402,10,2015,5,5
Group 3,RRG,-1.5,5,14,403,10,2015,6,4
Group 3,RRG,-1.5,5,14,404,6,2015,9,-3
Group 3,RRG,-1.5,5,14,405,11,2015,9,2
Group 3,RRG,-1.5,5,14,406,6,2015,4,2
Group 3,RRG,-1.5,5,14,407,9,2015,5,4
Group 3,RRG,-1.5,5,14,408,4,2015,7,-3
Group 3,RRG,-1.5,5,14,409,10,2015,10,0
Group 3,RRG,-1.5,5,14,410,10,2015,11,-1
Group 3,RRG,-1.5,5,14,411,3,2015,3,0
Group 3,RRG,-1.5,5,14,412,1,2015,5,-4
Group 3,RRG,-1.5,5,14,413,4,2015,9,-5
Group 3,RRG,-1.5,5,14,414,9,2015,5,4
Group 3,RRG,-1.5,5,14,415,8,2015,10,-2
Group 3,RRG,-1.5,5,14,416,9,2015,6,3
Group 3,RRG,-1.5,5,14,417,9,2015,5,4
Group 3,RRG,-1.5,5,14,418,8,2015,9,-1
Group 3,RRG,-1.5,5,14,419,6,2015,5,1
Group 3,RRG,-1.5,5,14,420,7,2015,3,4
Group 3,RRG,-1.5,5,14,421,7,2015,8,-1
Group 3,RRG,-1.5,5,14,422,6,2015,5,1
Group 3,RRG,-1.5,5,14,423,7,2015,13,-6
Group 3,RRG,-1.5,5,14,424,11,2015,9,2
Group 3,RRG,-1.5,5,14,425,10,2015,9,1
Group 3,RRG,-1.5,5,14,426,4,2015,3,1
Group 3,RRG,-1.5,5,14,427,6,2015,6,0
Group 3,RRG,-1.5,5,14,428,3,2015,5,-2
Group 3,RRG,-1.5,5,14,429,8,2015,5,3
Group 3,RRG,-1.5,5,14,430,8,2015,11,-3
Group 3,RRG,-1.5,5,14,431,8,2015,9,-1
Group 3,RRG,-1.5,5,14,432,12,2015,4,8
Group 3,RRG,-1.5,5,14,433,10,2015,5,5
Group 3,RRG,-1.5,5,14,434,8,2015,5,3
Group 3,RRG,-1.5,5,14,435,6,2015,8,-2
Group 3,RRG,-1.5,5,14,436,8,2015,8,0
Group 3,RRG,-1.5,5,14,437,8,2015,10,-2
Group 3,RRG,-1.5,5,14,438,5,2015,3,2
Group 3,RRG,-1.5,5,14,439,7,2015,9,-2
Group 3,RRG,-1.5,5,14,440,6,2015,7,-1
Group 3,RRG,-1.5,5,14,441,9,2015,7,2
Group 3,RRG,-1.5,5,14,442,5,2015,4,1
Group 3,RRG,-1.5,5,14,443,6,2015,11,-5
Group 3,RRG,-1.5,5,14,444,7,2015,5,2
Group 3,RRG,-1.5,5,14,445,5,2015,6,-1
Group 3,RRG,-1.5,5,14,446,2,2015,5,-3
Group 3,RRG,-1.5,5,14,447,10,2015,12,-2
Group 3,RRG,-1.5,5,14,448,8,2015,10,-2
Group 3,RRG,-1.5,5,14,449,10,2015,8,2
Group 3,RRG,-1.5,5,14,450,5,2015,8,-3
Group 3,RRG,-1.5,5,14,451,5,2015,9,-4
Group 3,RRG,-1.5,5,14,452,12,2015,7,5
Group 3,RRG,-1.5,5,14,453,3,2015,4,-1
Group 3,RRG,-1.5,5,14,454,11,2015,12,-1
Group 3,RRG,-1.5,5,14,455,7,2015,5,2
Group 3,RRG,-1.5,5,14,456,7,2015,6,1
Group 3,RRG,-1.5,5,14,457,8,2015,7,1
Group 3,RRG,-1.5,5,14,458,9,2015,8,1
Group 3,RRG,-1.5,5,14,459,5,2015,7,-2
Group 3,RRG,-1.5,5,14,460,6,2015,9,-3
Group 3,RRG,-1.5,5,14,461,5,2015,2,3
Group 3,RRG,-1.5,5,14,462,3,2015,7,-4
Group 3,RRG,-1.5,5,14,463,5,2015,9,-4
Group 3,RRG,-1.5,5,14,464,4,2015,8,-4
Group 3,RRG,-1.5,5,14,465,7,2015,10,-3
Group 3,RRG,-1.5,5,14,466,6,2015,3,3
Group 3,RRG,-1.5,5,14,467,13,2015,9,4
Group 3,RRG,-1.5,5,14,468,4,2015,3,1
Group 3,RRG,-1.5,5,14,469,9,2015,9,0
Group 3,RRG,-1.5,5,14,470,6,2015,3,3
Group 3,RRG,-1.5,5,14,471,8,2015,6,2
Group 3,RRG,-1.5,5,14,472,7,2015,4,3
Group 3,RRG,-1.5,5,14,473,7,2015,13,-6
Group 3,RRG,-1.5,5,14,474,4,2015,5,-1
Group 3,RRG,-1.5,5,14,475,3,2015,6,-3
Group 3,RRG,-1.5,5,14,476,7,2015,8,-1
Group 3,RRG,-1.5,5,14,477,6,2015,7,-1
Group 3,RRG,-1.5,5,14,478,2,2015,4,-2
Group 3,RRG,-1.5,5,14,479,8,2015,8,0
Group 3,RRG,-1.5,5,14,480,6,2015,7,-1
Group 3,RRG,-1.5,5,14,481,4,2015,8,-4
Group 3,RRG,-1.5,5,14,482,3,2015,7,-4
Group 3,RRG,-1.5,5,14,483,9,2015,11,-2
Group 3,RRG,-1.5,5,14,484,6,2015,8,-2
Group 3,RRG,-1.5,5,14,485,4,2015,7,-3
Group 3,RRG,-1.5,5,14,486,8,2015,10,-2
Group 3,RRG,-1.5,5,14,487,10,2015,11,-1
Group 3,RRG,-1.5,5,14,488,4,2015,7,-3
Group 3,RRG,-1.5,5,14,489,13,2015,9,4
Group 3,RRG,-1.5,5,14,490,7,2015,9,-2
Group 3,RRG,-1.5,5,14,491,14,2015,6,8
Group 3,RRG,-1.5,5,14,492,0,2015,5,-5
Group 3,RRG,-1.5,5,14,493,8,2015,8,0
Group 3,RRG,-1.5,5,14,494,7,2015,9,-2
Group 3,RRG,-1.5,5,14,495,6,2015,6,0
Group 3,RRG,-1.5,5,14,496,9,2015,3,6
Group 3,RRG,-1.5,5,14,497,6,2015,3,3
Group 3,RRG,-1.5,5,14,498,12,2015,9,3
Group 3,RRG,-1.5,5,14,499,13,2015,9,4
Group 3,RRG,-1.5,5,14,500,13,2015,4,9
Group 3,RRG,-1.5,5,14,501,11,2015,7,4
Group 3,RRG,-1.5,5,14,502,10,2015,12,-2
Group 3,RRG,-1.5,5,14,503,6,2015,8,-2
Group 3,RRG,-1.5,5,14,504,10,2015,10,0
Group 3,RRG,-1.5,5,14,505,11,2015,6,5
Group 3,RRG,-1.5,5,14,506,6,2015,10,-4
Group 3,RRG,-1.5,5,14,507,11,2015,8,3
Group 3,RRG,-1.5,5,14,508,5,2015,9,-4
Group 3,RRG,-1.5,5,14,509,6,2015,7,-1
Group 3,RRG,-1.5,5,14,510,10,2015,9,1
Group 3,RRG,-1.5,5,14,511,10,2015,5,5
Group 3,RRG,-1.5,5,14,512,4,2015,5,-1
Group 3,RRG,-1.5,5,14,513,7,2015,5,2
Group 3,RRG,-1.5,5,14,514,12,2015,9,3
Group 3,RRG,-1.5,5,14,515,11,2015,10,1
Group 3,RRG,-1.5,5,14,516,2,2015,4,-2
Group 3,RRG,-1.5,5,14,517,2,2015,7,-5
Group 3,RRG,-1.5,5,14,518,3,2015,6,-3
Group 3,RRG,-1.5,5,14,519,10,2015,6,4
Group 3,RRG,-1.5,5,14,520,9,2015,6,3
Group 3,RRG,-1.5,5,14,521,9,2015,5,4
Group 3,RRG,-1.5,5,14,522,4,2015,4,0
Group 3,RRG,-1.5,5,14,523,8,2015,6,2
Group 3,RRG,-1.5,5,14,524,3,2015,5,-2
Group 3,RRG,-1.5,5,14,525,4,2015,5,-1
Group 3,RRG,-1.5,5,14,526,6,2015,8,-2
Group 3,RRG,-1.5,5,14,527,7,2015,4,3
Group 3,RRG,-1.5,5,14,528,9,2015,5,4
Group 3,RRG,-1.5,5,14,529,8,2015,7,1
Group 3,RRG,-1.5,5,14,530,6,2015,6,0
Group 3,RRG,-1.5,5,14,531,6,2015,7,-1
Group 3,RRG,-1.5,5,14,532,4,2015,10,-6
Group 3,RRG,-1.5,5,14,533,4,2015,7,-3
Group 3,RRG,-1.5,5,14,534,6,2015,6,0
Group 3,RRG,-1.5,5,14,535,8,2015,5,3
Group 3,RRG,-1.5,5,14,536,7,2015,6,1
Group 3,RRG,-1.5,5,14,537,8,2015,9,-1
Group 3,RRG,-1.5,5,14,538,9,2015,6,3
Group 3,RRG,-1.5,5,14,539,9,2015,11,-2
Group 3,RRG,-1.5,5,14,540,5,2015,4,1
Group 3,RRG,-1.5,5,14,541,5,2015,7,-2
Group 3,RRG,-1.5,5,14,542,5,2015,8,-3
Group 3,RRG,-1.5,5,14,543,6,2015,5,1
Group 3,RRG,-1.5,5,14,544,5,2015,6,-1
Group 3,RRG,-1.5,5,14,545,8,2015,8,0
Group 3,RRG,-1.5,5,14,546,7,2015,10,-3
Group 3,RRG,-1.5,5,14,547,3,2015,2,1
Group 3,RRG,-1.5,5,14,548,6,2015,3,3
Group 3,RRG,-1.5,5,14,549,9,2015,8,1
Group 3,RRG,-1.5,5,14,550,4,2015,4,0
Group 3,RRG,-1.5,5,14,551,9,2015,4,5
Group 3,RRG,-1.5,5,14,552,6,2015,5,1
Group 3,RRG,-1.5,5,14,553,9,2015,7,2
Group 3,RRG,-1.5,5,14,554,8,2015,4,4
Group 3,RRG,-1.5,5,14,555,7,2015,5,2
Group 3,RRG,-1.5,5,14,556,5,2015,5,0
Group 3,RRG,-1.5,5,14,557,11,2015,12,-1
Group 3,RRG,-1.5,5,14,558,0,2015,4,-4
Group 3,RRG,-1.5,5,14,559,10,2015,13,-3
Group 3,RRG,-1.5,5,14,560,2,2015,3,-1
Group 3,RRG,-1.5,5,14,561,9,2015,10,-1
Group 3,RRG,-1.5,5,14,562,6,2015,5,1
Group 3,RRG,-1.5,5,14,563,7,2015,8,-1
Group 3,RRG,-1.5,5,14,564,6,2015,9,-3
Group 3,RRG,-1.5,5,14,565,6,2015,3,3
Group 3,RRG,-1.5,5,14,566,6,2015,4,2
Group 3,RRG,-1.5,5,14,567,8,2015,7,1
Group 3,RRG,-1.5,5,14,568,3,2015,9,-6
Group 3,RRG,-1.5,5,14,569,8,2015,12,-4
Group 3,RRG,-1.5,5,14,570,3,2015,6,-3
Group 3,RRG,-1.5,5,14,571,3,2015,6,-3
Group 3,RRG,-1.5,5,14,572,6,2015,2,4
Group 3,RRG,-1.5,5,14,573,9,2015,6,3
Group 3,RRG,-1.5,5,14,574,5,2015,4,1
Group 3,RRG,-1.5,5,14,575,6,2015,2,4
Group 3,RRG,-1.5,5,14,576,8,2015,7,1
Group 3,RRG,-1.5,5,14,577,5,2015,8,-3
Group 3,RRG,-1.5,5,14,578,6,2015,3,3
Group 3,RRG,-1.5,5,14,579,5,2015,11,-6
Group 3,RRG,-1.5,5,14,580,8,2015,7,1
Group 3,RRG,-1.5,5,14,581,12,2015,8,4
Group 3,RRG,-1.5,5,14,582,12,2015,9,3
Group 3,RRG,-1.5,5,14,583,6,2015,9,-3
Group 3,RRG,-1.5,5,14,584,12,2015,5,7
Group 3,RRG,-1.5,5,14,585,1,2015,5,-4
Group 3,RRG,-1.5,5,14,586,2,2015,5,-3
Group 3,RRG,-1.5,5,14,587,1,2015,8,-7
Group 3,RRG,-1.5,5,14,588,4,2015,3,1
Group 3,RRG,-1.5,5,14,589,4,2015,6,-2
Group 3,RRG,-1.5,5,14,590,5,2015,9,-4
Group 3,RRG,-1.5,5,14,591,7,2015,7,0
Group 3,RRG,-1.5,5,14,592,11,2015,5,6
Group 3,RRG,-1.5,5,14,593,12,2015,10,2
Group 3,RRG,-1.5,5,14,594,5,2015,6,-1
Group 3,RRG,-1.5,5,14,595,10,2015,5,5
Group 3,RRG,-1.5,5,14,596,6,2015,6,0
Group 3,RRG,-1.5,5,14,597,9,2015,7,2
Group 3,RRG,-1.5,5,14,598,4,2015,8,-4
Group 3,RRG,-1.5,5,14,599,5,2015,6,-1
Group 3,RRG,-1.5,5,14,600,12,2015,7,5
Group 3,RRG,-1.5,5,14,601,3,2015,5,-2
Group 3,RRG,-1.5,5,14,602,6,2015,6,0
Group 3,RRG,-1.5,5,14,603,4,2015,5,-1
Group 3,RRG,-1.5,5,14,604,4,2015,11,-7
Group 3,RRG,-1.5,5,14,605,6,2015,4,2
Group 3,RRG,-1.5,5,14,606,6,2015,8,-2
Group 3,RRG,-1.5,5,14,607,7,2015,7,0
Group 3,RRG,-1.5,5,14,608,9,2015,9,0
Group 3,RRG,-1.5,5,14,609,6,2015,7,-1
Group 3,RRG,-1.5,5,14,610,11,2015,7,4
Group 3,RRG,-1.5,5,14,611,12,2015,10,2
Group 3,RRG,-1.5,5,14,612,6,2015,7,-1
Group 3,RRG,-1.5,5,14,613,1,2015,3,-2
Group 3,RRG,-1.5,5,14,614,1,2015,7,-6
Group 3,RRG,-1.5,5,14,615,7,2015,8,-1
Group 3,RRG,-1.5,5,14,616,5,2015,9,-4
Group 3,RRG,-1.5,5,14,617,10,2015,9,1
Group 3,RRG,-1.5,5,14,618,7,2015,7,0
Group 3,RRG,-1.5,5,14,619,5,2015,6,-1
Group 3,RRG,-1.5,5,14,620,10,2015,5,5
Group 3,RRG,-1.5,5,14,621,2,2015,8,-6
Group 3,RRG,-1.5,5,14,622,5,2015,6,-1
Group 3,RRG,-1.5,5,14,623,10,2015,6,4
Group 3,RRG,-1.5,5,14,624,6,2015,2,4
Group 3,RRG,-1.5,5,14,625,11,2015,11,0
Group 3,RRG,-1.5,5,14,626,7,2015,9,-2
Group 3,RRG,-1.5,5,14,627,7,2015,5,2
Group 3,RRG,-1.5,5,14,628,6,2015,10,-4
Group 3,RRG,-1.5,5,14,629,11,2015,7,4
Group 3,RRG,-1.5,5,14,630,12,2015,8,4
Group 3,RRG,-1.5,5,14,631,11,2015,10,1
Group 3,RRG,-1.5,5,14,632,10,2015,6,4
Group 3,RRG,-1.5,5,14,633,9,2015,5,4
Group 3,RRG,-1.5,5,14,634,12,2015,3,9
Group 3,RRG,-1.5,5,14,635,7,2015,6,1
Group 3,RRG,-1.5,5,14,636,11,2015,5,6
Group 3,RRG,-1.5,5,14,637,13,2015,10,3
Group 3,RRG,-1.5,5,14,638,8,2015,7,1
Group 3,RRG,-1.5,5,14,639,7,2015,5,2
Group 3,RRG,-1.5,5,14,640,8,2015,8,0
Group 3,RRG,-1.5,5,14,641,4,2015,5,-1
Group 3,RRG,-1.5,5,14,642,3,2015,6,-3
Group 3,RRG,-1.5,5,14,643,3,2015,11,-8
Group 3,RRG,-1.5,5,14,644,1,2015,6,-5
Group 3,RRG,-1.5,5,14,645,8,2015,7,1
Group 3,RRG,-1.5,5,14,646,8,2015,3,5
Group 3,RRG,-1.5,5,14,647,10,2015,6,4
Group 3,RRG,-1.5,5,14,648,9,2015,3,6
Group 3,RRG,-1.5,5,14,649,8,2015,2,6
Group 3,RRG,-1.5,5,14,650,6,2015,6,0
Group 3,RRG,-1.5,5,14,651,7,2015,8,-1
Group 3,RRG,-1.5,5,14,652,9,2015,5,4
Group 3,RRG,-1.5,5,14,653,4,2015,7,-3
Group 3,RRG,-1.5,5,14,654,5,2015,6,-1
Group 3,RRG,-1.5,5,14,655,9,2015,6,3
Group 3,RRG,-1.5,5,14,656,7,2015,8,-1
Group 3,RRG,-1.5,5,14,657,9,2015,8,1
Group 3,RRG,-1.5,5,14,658,3,2015,5,-2
Group 3,RRG,-1.5,5,14,659,9,2015,7,2
Group 3,RRG,-1.5,5,14,660,7,2015,7,0
Group 3,RRG,-1.5,5,14,661,9,2015,6,3
Group 3,RRG,-1.5,5,14,662,8,2015,6,2
Group 3,RRG,-1.5,5,14,663,7,2015,6,1
Group 3,RRG,-1.5,5,14,664,10,2015,8,2
Group 3,RRG,-1.5,5,14,665,8,2015,7,1
Group 3,RRG,-1.5,5,14,666,4,2015,8,-4
Group 3,RRG,-1.5,5,14,667,10,2015,9,1
Group 3,RRG,-1.5,5,14,668,12,2015,13,-1
Group 3,RRG,-1.5,5,14,669,12,2015,11,1
Group 3,RRG,-1.5,5,14,670,5,2015,7,-2
Group 3,RRG,-1.5,5,14,671,6,2015,10,-4
Group 3,RRG,-1.5,5,14,672,1,2015,4,-3
Group 3,RRG,-1.5,5,14,673,12,2015,7,5
Group 3,RRG,-1.5,5,14,674,0,2015,3,-3
Group 3,RRG,-1.5,5,14,675,8,2015,9,-1
Group 3,RRG,-1.5,5,14,676,5,2015,9,-4
Group 3,RRG,-1.5,5,14,677,7,2015,7,0
Group 3,RRG,-1.5,5,14,678,7,2015,11,-4
Group 3,RRG,-1.5,5,14,679,3,2015,4,-1
Group 3,RRG,-1.5,5,14,680,2,2015,4,-2
Group 3,RRG,-1.5,5,14,681,11,2015,8,3
Group 3,RRG,-1.5,5,14,682,5,2015,8,-3
Group 3,RRG,-1.5,5,14,683,7,2015,3,4
Group 3,RRG,-1.5,5,14,684,14,2015,9,5
Group 3,RRG,-1.5,5,14,685,11,2015,7,4
Group 3,RRG,-1.5,5,14,686,3,2015,3,0
Group 3,RRG,-1.5,5,14,687,3,2015,8,-5
Group 3,RRG,-1.5,5,14,688,4,2015,9,-5
Group 3,RRG,-1.5,5,14,689,10,2015,10,0
Group 3,RRG,-1.5,5,14,690,12,2015,10,2
Group 3,RRG,-1.5,5,14,691,4,2015,8,-4
Group 3,RRG,-1.5,5,14,692,9,2015,5,4
Group 3,RRG,-1.5,5,14,693,5,2015,4,1
Group 3,RRG,-1.5,5,14,694,8,2015,7,1
Group 3,RRG,-1.5,5,14,695,9,2015,10,-1
Group 3,RRG,-1.5,5,14,696,7,2015,5,2
Group 3,RRG,-1.5,5,14,697,5,2015,8,-3
Group 3,RRG,-1.5,5,14,698,7,2015,4,3
Group 3,RRG,-1.5,5,14,699,1,2015,6,-5
Group 3,RRG,-1.5,5,14,700,11,2015,7,4
Group 3,RRG,-1.5,5,14,701,2,2015,4,-2
Group 3,RRG,-1.5,5,14,702,3,2015,5,-2
Group 3,RRG,-1.5,5,14,703,9,2015,12,-3
Group 3,RRG,-1.5,5,14,704,8,2015,5,3
Group 3,RRG,-1.5,5,14,705,10,2015,7,3
Group 3,RRG,-1.5,5,14,706,6,2015,5,1
Group 3,RRG,-1.5,5,14,707,3,2015,4,-1
Group 3,RRG,-1.5,5,14,708,12,2015,10,2
Group 3,RRG,-1.5,5,14,709,8,2015,7,1
Group 3,RRG,-1.5,5,14,710,7,2015,8,-1
Group 3,RRG,-1.5,5,14,711,12,2015,6,6
Group 3,RRG,-1.5,5,14,712,5,2015,5,0
Group 3,RRG,-1.5,5,14,713,6,2015,4,2
Group 3,RRG,-1.5,5,14,714,6,2015,4,2
Group 3,RRG,-1.5,5,14,715,5,2015,5,0
Group 3,RRG,-1.5,5,14,716,5,2015,2,3
Group 3,RRG,-1.5,5,14,717,10,2015,10,0
Group 3,RRG,-1.5,5,14,718,2,2015,0,2
Group 3,RRG,-1.5,5,14,719,10,2015,12,-2
Group 3,RRG,-1.5,5,14,720,7,2015,9,-2
Group 3,RRG,-1.5,5,14,721,4,2015,9,-5
Group 3,RRG,-1.5,5,14,722,4,2015,7,-3
Group 3,RRG,-1.5,5,14,723,7,2015,7,0
Group 3,RRG,-1.5,5,14,724,5,2015,6,-1
Group 3,RRG,-1.5,5,14,725,6,2015,9,-3
Group 3,RRG,-1.5,5,14,726,3,2015,6,-3
Group 3,RRG,-1.5,5,14,727,13,2015,12,1
Group 3,RRG,-1.5,5,14,728,11,2015,10,1
Group 3,RRG,-1.5,5,14,729,5,2015,7,-2
Group 3,RRG,-1.5,5,14,730,11,2015,11,0
Group 3,RRG,-1.5,5,14,731,12,2015,8,4
Group 3,RRG,-1.5,5,14,732,8,2015,8,0
Group 3,RRG,-1.5,5,14,733,8,2015,4,4
Group 3,RRG,-1.5,5,14,734,9,2015,7,2
Group 3,RRG,-1.5,5,14,735,8,2015,5,3
Group 3,RRG,-1.5,5,14,736,10,2015,7,3
Group 3,RRG,-1.5,5,14,737,4,2015,6,-2
Group 3,RRG,-1.5,5,14,738,5,2015,8,-3
Group 3,RRG,-1.5,5,14,739,7,2015,9,-2
Group 3,RRG,-1.5,5,14,740,2,2015,4,-2
Group 3,RRG,-1.5,5,14,741,6,2015,11,-5
Group 3,RRG,-1.5,5,14,742,6,2015,7,-1
Group 3,RRG,-1.5,5,14,743,4,2015,10,-6
Group 3,RRG,-1.5,5,14,744,5,2015,11,-6
Group 3,RRG,-1.5,5,14,745,9,2015,8,1
Group 3,RRG,-1.5,5,14,746,9,2015,9,0
Group 3,RRG,-1.5,5,14,747,9,2015,6,3
Group 3,RRG,-1.5,5,14,748,6,2015,7,-1
Group 3,RRG,-1.5,5,14,749,4,2015,4,0
Group 3,RRG,-1.5,5,14,750,12,2015,5,7
Group 3,RRG,-1.5,5,14,751,6,2015,7,-1
Group 3,RRG,-1.5,5,14,752,9,2015,6,3
Group 3,RRG,-1.5,5,14,753,6,2015,8,-2
Group 3,RRG,-1.5,5,14,754,7,2015,6,1
Group 3,RRG,-1.5,5,14,755,9,2015,6,3
Group 3,RRG,-1.5,5,14,756,7,2015,9,-2
Group 3,RRG,-1.5,5,14,757,5,2015,6,-1
Group 3,RRG,-1.5,5,14,758,3,2015,3,0
Group 3,RRG,-1.5,5,14,759,11,2015,11,0
Group 3,RRG,-1.5,5,14,760,5,2015,3,2
Group 3,RRG,-1.5,5,14,761,9,2015,7,2
Group 3,RRG,-1.5,5,14,762,5,2015,7,-2
Group 3,RRG,-1.5,5,14,763,1,2015,4,-3
Group 3,RRG,-1.5,5,14,764,3,2015,6,-3
Group 3,RRG,-1.5,5,14,765,4,2015,8,-4
Group 3,RRG,-1.5,5,14,766,6,2015,5,1
Group 3,RRG,-1.5,5,14,767,13,2015,6,7
Group 3,RRG,-1.5,5,14,768,1,2015,6,-5
Group 3,RRG,-1.5,5,14,769,13,2015,8,5
Group 3,RRG,-1.5,5,14,770,0,2015,4,-4
Group 3,RRG,-1.5,5,14,771,5,2015,3,2
Group 3,RRG,-1.5,5,14,772,11,2015,8,3
Group 3,RRG,-1.5,5,14,773,6,2015,11,-5
Group 3,RRG,-1.5,5,14,774,4,2015,9,-5
Group 3,RRG,-1.5,5,14,775,4,2015,2,2
Group 3,RRG,-1.5,5,14,776,7,2015,8,-1
Group 3,RRG,-1.5,5,14,777,3,2015,10,-7
Group 3,RRG,-1.5,5,14,778,7,2015,8,-1
Group 3,RRG,-1.5,5,14,779,11,2015,8,3
Group 3,RRG,-1.5,5,14,780,8,2015,10,-2
Group 3,RRG,-1.5,5,14,781,2,2015,1,1
Group 3,RRG,-1.5,5,14,782,2,2015,3,-1
Group 3,RRG,-1.5,5,14,783,4,2015,7,-3
Group 3,RRG,-1.5,5,14,784,4,2015,5,-1
Group 3,RRG,-1.5,5,14,785,5,2015,6,-1
Group 3,RRG,-1.5,5,14,786,3,2015,4,-1
Group 3,RRG,-1.5,5,14,787,5,2015,5,0
Group 3,RRG,-1.5,5,14,788,4,2015,4,0
Group 3,RRG,-1.5,5,14,789,2,2015,7,-5
Group 3,RRG,-1.5,5,14,790,10,2015,9,1
Group 3,RRG,-1.5,5,14,791,5,2015,5,0
Group 3,RRG,-1.5,5,14,792,2,2015,2,0
Group 3,RRG,-1.5,5,14,793,9,2015,6,3
Group 3,RRG,-1.5,5,14,794,9,2015,7,2
Group 3,RRG,-1.5,5,14,795,4,2015,9,-5
Group 3,RRG,-1.5,5,14,796,7,2015,5,2
Group 3,RRG,-1.5,5,14,797,5,2015,2,3
Group 3,RRG,-1.5,5,14,798,8,2015,3,5
Group 3,RRG,-1.5,5,14,799,8,2015,8,0
Group 3,RRG,-1.5,5,14,800,7,2015,2,5
Group 3,RRG,-1.5,5,14,801,4,2015,4,0
Group 3,RRG,-1.5,5,14,802,5,2015,3,2
Group 3,RRG,-1.5,5,14,803,6,2015,7,-1
Group 3,RRG,-1.5,5,14,804,7,2015,4,3
Group 3,RRG,-1.5,5,14,805,8,2015,1,7
Group 3,RRG,-1.5,5,14,806,9,2015,8,1
Group 3,RRG,-1.5,5,14,807,11,2015,7,4
Group 3,RRG,-1.5,5,14,808,3,2015,6,-3
Group 3,RRG,-1.5,5,14,809,9,2015,7,2
Group 3,RRG,-1.5,5,14,810,7,2015,8,-1
Group 3,RRG,-1.5,5,14,811,5,2015,8,-3
Group 3,RRG,-1.5,5,14,812,9,2015,10,-1
Group 3,RRG,-1.5,5,14,813,12,2015,6,6
Group 3,RRG,-1.5,5,14,814,4,2015,8,-4
Group 3,RRG,-1.5,5,14,815,8,2015,8,0
Group 3,RRG,-1.5,5,14,816,7,2015,8,-1
Group 3,RRG,-1.5,5,14,817,6,2015,4,2
Group 3,RRG,-1.5,5,14,818,7,2015,10,-3
Group 3,RRG,-1.5,5,14,819,4,2015,7,-3
Group 3,RRG,-1.5,5,14,820,9,2015,7,2
Group 3,RRG,-1.5,5,14,821,2,2015,6,-4
Group 3,RRG,-1.5,5,14,822,6,2015,8,-2
Group 3,RRG,-1.5,5,14,823,9,2015,4,5
Group 3,RRG,-1.5,5,14,824,6,2015,5,1
Group 3,RRG,-1.5,5,14,825,5,2015,6,-1
Group 3,RRG,-1.5,5,14,826,5,2015,7,-2
Group 3,RRG,-1.5,5,14,827,8,2015,4,4
Group 3,RRG,-1.5,5,14,828,9,2015,8,1
Group 3,RRG,-1.5,5,14,829,11,2015,4,7
Group 3,RRG,-1.5,5,14,830,12,2015,9,3
Group 3,RRG,-1.5,5,14,831,9,2015,10,-1
Group 3,RRG,-1.5,5,14,832,4,2015,4,0
Group 3,RRG,-1.5,5,14,833,12,2015,9,3
Group 3,RRG,-1.5,5,14,834,7,2015,9,-2
Group 3,RRG,-1.5,5,14,835,6,2015,8,-2
Group 3,RRG,-1.5,5,14,836,9,2015,9,0
Group 3,RRG,-1.5,5,14,837,12,2015,7,5
Group 3,RRG,-1.5,5,14,838,2,2015,7,-5
Group 3,RRG,-1.5,5,14,839,3,2015,7,-4
Group 3,RRG,-1.5,5,14,840,8,2015,5,3
Group 3,RRG,-1.5,5,14,841,9,2015,5,4
Group 3,RRG,-1.5,5,14,842,8,2015,9,-1
Group 3,RRG,-1.5,5,14,843,6,2015,6,0
Group 3,RRG,-1.5,5,14,844,5,2015,6,-1
Group 3,RRG,-1.5,5,14,845,7,2015,9,-2
Group 3,RRG,-1.5,5,14,846,9,2015,7,2
Group 3,RRG,-1.5,5,14,847,6,2015,7,-1
Group 3,RRG,-1.5,5,14,848,11,2015,9,2
Group 3,RRG,-1.5,5,14,849,4,2015,7,-3
Group 3,RRG,-1.5,5,14,850,8,2015,9,-1
Group 3,RRG,-1.5,5,14,851,9,2015,8,1
Group 3,RRG,-1.5,5,14,852,9,2015,6,3
Group 3,RRG,-1.5,5,14,853,3,2015,7,-4
Group 3,RRG,-1.5,5,14,854,4,2015,8,-4
Group 3,RRG,-1.5,5,14,855,9,2015,13,-4
Group 3,RRG,-1.5,5,14,856,10,2015,7,3
Group 3,RRG,-1.5,5,14,857,3,2015,9,-6
Group 3,RRG,-1.5,5,14,858,9,2015,7,2
Group 3,RRG,-1.5,5,14,859,8,2015,5,3
Group 3,RRG,-1.5,5,14,860,12,2015,12,0
Group 3,RRG,-1.5,5,14,861,4,2015,7,-3
Group 3,RRG,-1.5,5,14,862,8,2015,6,2
Group 3,RRG,-1.5,5,14,863,7,2015,8,-1
Group 3,RRG,-1.5,5,14,864,5,2015,7,-2
Group 3,RRG,-1.5,5,14,865,7,2015,7,0
Group 3,RRG,-1.5,5,14,866,9,2015,10,-1
Group 3,RRG,-1.5,5,14,867,4,2015,6,-2
Group 3,RRG,-1.5,5,14,868,5,2015,7,-2
Group 3,RRG,-1.5,5,14,869,5,2015,5,0
Group 3,RRG,-1.5,5,14,870,3,2015,7,-4
Group 3,RRG,-1.5,5,14,871,4,2015,7,-3
Group 3,RRG,-1.5,5,14,872,9,2015,9,0
Group 3,RRG,-1.5,5,14,873,10,2015,7,3
Group 3,RRG,-1.5,5,14,874,7,2015,7,0
Group 3,RRG,-1.5,5,14,875,5,2015,9,-4
Group 3,RRG,-1.5,5,14,876,7,2015,6,1
Group 3,RRG,-1.5,5,14,877,9,2015,7,2
Group 3,RRG,-1.5,5,14,878,4,2015,5,-1
Group 3,RRG,-1.5,5,14,879,6,2015,12,-6
Group 3,RRG,-1.5,5,14,880,6,2015,6,0
Group 3,RRG,-1.5,5,14,881,13,2015,6,7
Group 3,RRG,-1.5,5,14,882,8,2015,9,-1
Group 3,RRG,-1.5,5,14,883,12,2015,5,7
Group 3,RRG,-1.5,5,14,884,5,2015,7,-2
Group 3,RRG,-1.5,5,14,885,10,2015,8,2
Group 3,RRG,-1.5,5,14,886,13,2015,10,3
Group 3,RRG,-1.5,5,14,887,7,2015,6,1
Group 3,RRG,-1.5,5,14,888,3,2015,5,-2
Group 3,RRG,-1.5,5,14,889,9,2015,7,2
Group 3,RRG,-1.5,5,14,890,8,2015,5,3
Group 3,RRG,-1.5,5,14,891,6,2015,7,-1
Group 3,RRG,-1.5,5,14,892,1,2015,7,-6
Group 3,RRG,-1.5,5,14,893,9,2015,8,1
Group 3,RRG,-1.5,5,14,894,8,2015,11,-3
Group 3,RRG,-1.5,5,14,895,10,2015,7,3
Group 3,RRG,-1.5,5,14,896,8,2015,4,4
Group 3,RRG,-1.5,5,14,897,5,2015,3,2
Group 3,RRG,-1.5,5,14,898,4,2015,11,-7
Group 3,RRG,-1.5,5,14,899,8,2015,2,6
Group 3,RRG,-1.5,5,14,900,6,2015,4,2
Group 3,RRG,-1.5,5,14,901,7,2015,7,0
Group 3,RRG,-1.5,5,14,902,5,2015,6,-1
Group 3,RRG,-1.5,5,14,903,1,2015,7,-6
Group 3,RRG,-1.5,5,14,904,5,2015,6,-1
Group 3,RRG,-1.5,5,14,905,5,2015,7,-2
Group 3,RRG,-1.5,5,14,906,8,2015,2,6
Group 3,RRG,-1.5,5,14,907,5,2015,5,0
Group 3,RRG,-1.5,5,14,908,4,2015,2,2
Group 3,RRG,-1.5,5,14,909,7,2015,8,-1
Group 3,RRG,-1.5,5,14,910,3,2015,2,1
Group 3,RRG,-1.5,5,14,911,9,2015,9,0
Group 3,RRG,-1.5,5,14,912,4,2015,2,2
Group 3,RRG,-1.5,5,14,913,2,2015,3,-1
Group 3,RRG,-1.5,5,14,914,10,2015,5,5
Group 3,RRG,-1.5,5,14,915,4,2015,1,3
Group 3,RRG,-1.5,5,14,916,2,2015,3,-1
Group 3,RRG,-1.5,5,14,917,11,2015,5,6
Group 3,RRG,-1.5,5,14,918,11,2015,8,3
Group 3,RRG,-1.5,5,14,919,10,2015,8,2
Group 3,RRG,-1.5,5,14,920,6,2015,9,-3
Group 3,RRG,-1.5,5,14,921,9,2015,6,3
Group 3,RRG,-1.5,5,14,922,7,2015,7,0
Group 3,RRG,-1.5,5,14,923,1,2015,6,-5
Group 3,RRG,-1.5,5,14,924,5,2015,6,-1
Group 3,RRG,-1.5,5,14,925,8,2015,4,4
Group 3,RRG,-1.5,5,14,926,8,2015,10,-2
Group 3,RRG,-1.5,5,14,927,12,2015,10,2
Group 3,RRG,-1.5,5,14,928,10,2015,10,0
Group 3,RRG,-1.5,5,14,929,10,2015,9,1
Group 3,RRG,-1.5,5,14,930,10,2015,9,1
Group 3,RRG,-1.5,5,14,931,9,2015,6,3
Group 3,RRG,-1.5,5,14,932,13,2015,10,3
Group 3,RRG,-1.5,5,14,933,2,2015,5,-3
Group 3,RRG,-1.5,5,14,934,6,2015,7,-1
Group 3,RRG,-1.5,5,14,935,5,2015,2,3
Group 3,RRG,-1.5,5,14,936,6,2015,8,-2
Group 3,RRG,-1.5,5,14,937,2,2015,5,-3
Group 3,RRG,-1.5,5,14,938,12,2015,10,2
Group 3,RRG,-1.5,5,14,939,6,2015,3,3
Group 3,RRG,-1.5,5,14,940,5,2015,6,-1
Group 3,RRG,-1.5,5,14,941,9,2015,10,-1
Group 3,RRG,-1.5,5,14,942,10,2015,8,2
Group 3,RRG,-1.5,5,14,943,8,2015,5,3
Group 3,RRG,-1.5,5,14,944,6,2015,5,1
Group 3,RRG,-1.5,5,14,945,2,2015,1,1
Group 3,RRG,-1.5,5,14,946,7,2015,12,-5
Group 3,RRG,-1.5,5,14,947,9,2015,11,-2
Group 3,RRG,-1.5,5,14,948,8,2015,7,1
Group 3,RRG,-1.5,5,14,949,7,2015,6,1
Group 3,RRG,-1.5,5,14,950,8,2015,7,1
Group 3,RRG,-1.5,5,14,951,6,2015,4,2
Group 3,RRG,-1.5,5,14,952,6,2015,8,-2
Group 3,RRG,-1.5,5,14,953,8,2015,6,2
Group 3,RRG,-1.5,5,14,954,7,2015,6,1
Group 3,RRG,-1.5,5,14,955,10,2015,10,0
Group 3,RRG,-1.5,5,14,956,9,2015,6,3
Group 3,RRG,-1.5,5,14,957,6,2015,8,-2
Group 3,RRG,-1.5,5,14,958,6,2015,5,1
Group 3,RRG,-1.5,5,14,959,3,2015,4,-1
Group 3,RRG,-1.5,5,14,960,5,2015,8,-3
Group 3,RRG,-1.5,5,14,961,4,2015,2,2
Group 3,RRG,-1.5,5,14,962,4,2015,7,-3
Group 3,RRG,-1.5,5,14,963,6,2015,5,1
Group 3,RRG,-1.5,5,14,964,5,2015,7,-2
Group 3,RRG,-1.5,5,14,965,4,2015,2,2
Group 3,RRG,-1.5,5,14,966,6,2015,5,1
Group 3,RRG,-1.5,5,14,967,11,2015,8,3
Group 3,RRG,-1.5,5,14,968,5,2015,8,-3
Group 3,RRG,-1.5,5,14,969,8,2015,5,3
Group 3,RRG,-1.5,5,14,970,11,2015,7,4
Group 3,RRG,-1.5,5,14,971,9,2015,5,4
Group 3,RRG,-1.5,5,14,972,4,2015,6,-2
Group 3,RRG,-1.5,5,14,973,8,2015,7,1
Group 3,RRG,-1.5,5,14,974,6,2015,5,1
Group 3,RRG,-1.5,5,14,975,8,2015,9,-1
Group 3,RRG,-1.5,5,14,976,4,2015,10,-6
Group 3,RRG,-1.5,5,14,977,8,2015,9,-1
Group 3,RRG,-1.5,5,14,978,9,2015,3,6
Group 3,RRG,-1.5,5,14,979,10,2015,9,1
Group 3,RRG,-1.5,5,14,980,6,2015,1,5
Group 3,RRG,-1.5,5,14,981,8,2015,11,-3
Group 3,RRG,-1.5,5,14,982,4,2015,10,-6
Group 3,RRG,-1.5,5,14,983,11,2015,10,1
Group 3,RRG,-1.5,5,14,984,10,2015,4,6
Group 3,RRG,-1.5,5,14,985,9,2015,8,1
Group 3,RRG,-1.5,5,14,986,5,2015,6,-1
Group 3,RRG,-1.5,5,14,987,9,2015,10,-1
Group 3,RRG,-1.5,5,14,988,4,2015,7,-3
Group 3,RRG,-1.5,5,14,989,8,2015,7,1
Group 3,RRG,-1.5,5,14,990,12,2015,7,5
Group 3,RRG,-1.5,5,14,991,4,2015,8,-4
Group 3,RRG,-1.5,5,14,992,3,2015,8,-5
Group 3,RRG,-1.5,5,14,993,2,2015,10,-8
Group 3,RRG,-1.5,5,14,994,11,2015,2,9
Group 3,RRG,-1.5,5,14,995,2,2015,4,-2
Group 3,RRG,-1.5,5,14,996,10,2015,10,0
Group 3,RRG,-1.5,5,14,997,6,2015,13,-7
Group 3,RRG,-1.5,5,14,998,3,2015,6,-3
Group 3,RRG,-1.5,5,14,999,9,2015,5,4
Group 3,RRG,-1.5,5,14,1000,12,2015,11,1
Group 3,RRG,-1.5,5,14,1001,12,2015,8,4
Group 3,RRG,-1.5,5,14,1002,8,2015,11,-3
Group 3,RRG,-1.5,5,14,1003,10,2015,10,0
Group 3,RRG,-1.5,5,14,1004,13,2015,10,3
Group 3,RRG,-1.5,5,14,1005,6,2015,3,3
Group 3,RRG,-1.5,5,14,1006,7,2015,8,-1
Group 3,RRG,-1.5,5,14,1007,9,2015,10,-1
Group 3,RRG,-1.5,5,14,1008,10,2015,7,3
Group 3,RRG,-1.5,5,14,1009,7,2015,9,-2
Group 3,RRG,-1.5,5,14,1010,11,2015,9,2
Group 3,RRG,-1.5,5,14,1011,5,2015,8,-3
Group 3,RRG,-1.5,5,14,1012,8,2015,8,0
Group 3,RRG,-1.5,5,14,1013,5,2015,7,-2
Group 3,RRG,-1.5,5,14,1014,9,2015,10,-1
Group 3,RRG,-1.5,5,14,1015,6,2015,4,2
Group 3,RRG,-1.5,5,14,1016,6,2015,5,1
Group 3,RRG,-1.5,5,14,1017,3,2015,9,-6
Group 3,RRG,-1.5,5,14,1018,3,2015,5,-2
Group 3,RRG,-1.5,5,14,1019,4,2015,2,2
Group 3,RRG,-1.5,5,14,1020,9,2015,6,3
Group 3,RRG,-1.5,5,14,1021,7,2015,7,0
Group 3,RRG,-1.5,5,14,1022,5,2015,7,-2
Group 3,RRG,-1.5,5,14,1023,5,2015,7,-2
Group 3,RRG,-1.5,5,14,1024,7,2015,8,-1
Group 3,RRG,-1.5,5,14,1025,10,2015,5,5
Group 3,RRG,-1.5,5,14,1026,6,2015,9,-3
Group 3,RRG,-1.5,5,14,1027,11,2015,11,0
Group 3,RRG,-1.5,5,14,1028,11,2015,5,6
Group 3,RRG,-1.5,5,14,1029,4,2015,5,-1
Group 3,RRG,-1.5,5,14,1030,7,2015,4,3
Group 3,RRG,-1.5,5,14,1031,6,2015,6,0
Group 3,RRG,-1.5,5,14,1032,9,2015,4,5
Group 3,RRG,-1.5,5,14,1033,4,2015,4,0
Group 3,RRG,-1.5,5,14,1034,10,2015,2,8
Group 3,RRG,-1.5,5,14,1035,6,2015,5,1
Group 3,RRG,-1.5,5,14,1036,1,2015,10,-9
Group 3,RRG,-1.5,5,14,1037,2,2015,10,-8
Group 3,RRG,-1.5,5,14,1038,1,2015,3,-2
Group 3,RRG,-1.5,5,14,1039,5,2015,9,-4
Group 3,RRG,-1.5,5,14,1040,9,2015,5,4
Group 3,RRG,-1.5,5,14,1041,10,2015,6,4
Group 3,RRG,-1.5,5,14,1042,9,2015,6,3
Group 3,RRG,-1.5,5,14,1043,9,2015,5,4
Group 3,RRG,-1.5,5,14,1044,9,2015,10,-1
Group 3,RRG,-1.5,5,14,1045,7,2015,7,0
Group 3,RRG,-1.5,5,14,1046,6,2015,5,1
Group 3,RRG,-1.5,5,14,1047,10,2015,9,1
Group 3,RRG,-1.5,5,14,1048,4,2015,5,-1
Group 3,RRG,-1.5,5,14,1049,7,2015,9,-2
Group 3,RRG,-1.5,5,14,1050,5,2015,5,0
Group 3,RRG,-1.5,5,14,1051,0,2015,4,-4
Group 3,RRG,-1.5,5,14,1052,5,2015,5,0
Group 3,RRG,-1.5,5,14,1053,6,2015,5,1
Group 3,RRG,-1.5,5,14,1054,4,2015,3,1
Group 3,RRG,-1.5,5,14,1055,9,2015,6,3
Group 3,RRG,-1.5,5,14,1056,8,2015,10,-2
Group 3,RRG,-1.5,5,14,1057,1,2015,3,-2
Group 3,RRG,-1.5,5,14,1058,5,2015,2,3
Group 3,RRG,-1.5,5,14,1059,3,2015,6,-3
Group 3,RRG,-1.5,5,14,1060,13,2015,7,6
Group 3,RRG,-1.5,5,14,1061,7,2015,7,0
Group 3,RRG,-1.5,5,14,1062,6,2015,8,-2
Group 3,RRG,-1.5,5,14,1063,5,2015,5,0
Group 3,RRG,-1.5,5,14,1064,6,2015,7,-1
Group 3,RRG,-1.5,5,14,1065,6,2015,6,0
Group 3,RRG,-1.5,5,14,1066,7,2015,1,6
Group 3,RRG,-1.5,5,14,1067,6,2015,7,-1
Group 3,RRG,-1.5,5,14,1068,9,2015,10,-1
Group 3,RRG,-1.5,5,14,1069,3,2015,5,-2
Group 3,RRG,-1.5,5,14,1070,9,2015,8,1
Group 3,RRG,-1.5,5,14,1071,8,2015,6,2
Group 3,RRG,-1.5,5,14,1072,11,2015,8,3
Group 3,RRG,-1.5,5,14,1073,10,2015,8,2
Group 3,RRG,-1.5,5,14,1074,4,2015,6,-2
Group 3,RRG,-1.5,5,14,1075,13,2015,9,4
Group 3,RRG,-1.5,5,14,1076,13,2015,12,1
Group 3,RRG,-1.5,5,14,1077,13,2015,9,4
Group 3,RRG,-1.5,5,14,1078,12,2015,13,-1
Group 3,RRG,-1.5,5,14,1079,11,2015,10,1
Group 3,RRG,-1.5,5,14,1080,12,2015,7,5
Group 3,RRG,-1.5,5,14,1081,2,2015,6,-4
Group 3,RRG,-1.5,5,14,1082,4,2015,4,0
Group 3,RRG,-1.5,5,14,1083,7,2015,8,-1
Group 3,RRG,-1.5,5,14,1084,4,2015,8,-4
Group 3,RRG,-1.5,5,14,1085,5,2015,8,-3
Group 3,RRG,-1.5,5,14,1086,4,2015,7,-3
Group 3,RRG,-1.5,5,14,1087,5,2015,7,-2
Group 3,RRG,-1.5,5,14,1088,3,2015,1,2
Group 3,RRG,-1.5,5,14,1089,11,2015,10,1
Group 3,RRG,-1.5,5,14,1090,5,2015,5,0
Group 3,RRG,-1.5,5,14,1091,7,2015,8,-1
Group 3,RRG,-1.5,5,14,1092,4,2015,9,-5
Group 3,RRG,-1.5,5,14,1093,8,2015,5,3
Group 3,RRG,-1.5,5,14,1094,11,2015,5,6
Group 3,RRG,-1.5,5,14,1095,8,2015,7,1
Group 3,RRG,-1.5,5,14,1096,5,2015,6,-1
Group 3,RRG,-1.5,5,14,1097,5,2015,4,1
Group 3,RRG,-1.5,5,14,1098,7,2015,10,-3
Group 3,RRG,-1.5,5,14,1099,0,2015,1,-1
Group 3,RRG,-1.5,5,14,1100,2,2015,3,-1
Group 3,RRG,-1.5,5,14,1101,0,2015,5,-5
Group 3,RRG,-1.5,5,14,1102,10,2015,6,4
Group 3,RRG,-1.5,5,14,1103,8,2015,7,1
Group 3,RRG,-1.5,5,14,1104,6,2015,5,1
Group 3,RRG,-1.5,5,14,1105,8,2015,7,1
Group 3,RRG,-1.5,5,14,1106,9,2015,6,3
Group 3,RRG,-1.5,5,14,1107,6,2015,6,0
Group 3,RRG,-1.5,5,14,1108,4,2015,6,-2
Group 3,RRG,-1.5,5,14,1109,7,2015,11,-4
Group 3,RRG,-1.5,5,14,1110,3,2015,4,-1
Group 3,RRG,-1.5,5,14,1111,6,2015,3,3
Group 3,RRG,-1.5,5,14,1112,2,2015,6,-4
Group 3,RRG,-1.5,5,14,1113,8,2015,5,3
Group 3,RRG,-1.5,5,14,1114,13,2015,9,4
Group 3,RRG,-1.5,5,14,1115,6,2015,9,-3
Group 3,RRG,-1.5,5,14,1116,9,2015,6,3
Group 3,RRG,-1.5,5,14,1117,11,2015,7,4
Group 3,RRG,-1.5,5,14,1118,10,2015,10,0
Group 3,RRG,-1.5,5,14,1119,7,2015,12,-5
Group 3,RRG,-1.5,5,14,1120,2,2015,7,-5
Group 3,RRG,-1.5,5,14,1121,0,2015,3,-3
Group 3,RRG,-1.5,5,14,1122,6,2015,2,4
Group 3,RRG,-1.5,5,14,1123,11,2015,11,0
Group 3,RRG,-1.5,5,14,1124,7,2015,8,-1
Group 3,RRG,-1.5,5,14,1125,11,2015,3,8
Group 3,RRG,-1.5,5,14,1126,6,2015,9,-3
Group 3,RRG,-1.5,5,14,1127,7,2015,5,2
Group 3,RRG,-1.5,5,14,1128,5,2015,10,-5
Group 3,RRG,-1.5,5,14,1129,6,2015,4,2
Group 3,RRG,-1.5,5,14,1130,3,2015,6,-3
Group 3,RRG,-1.5,5,14,1131,12,2015,11,1
Group 3,RRG,-1.5,5,14,1132,12,2015,9,3
Group 3,RRG,-1.5,5,14,1133,13,2015,12,1
Group 3,RRG,-1.5,5,14,1134,9,2015,7,2
Group 3,RRG,-1.5,5,14,1135,11,2015,11,0
Group 3,RRG,-1.5,5,14,1136,5,2015,5,0
Group 3,RRG,-1.5,5,14,1137,0,2015,3,-3
Group 3,RRG,-1.5,5,14,1138,3,2015,5,-2
Group 3,RRG,-1.5,5,14,1139,10,2015,3,7
Group 3,RRG,-1.5,5,14,1140,5,2015,8,-3
Group 3,RRG,-1.5,5,14,1141,4,2015,6,-2
Group 3,RRG,-1.5,5,14,1142,9,2015,9,0
Group 3,RRG,-1.5,5,14,1143,6,2015,3,3
Group 3,RRG,-1.5,5,14,1144,4,2015,7,-3
Group 3,RRG,-1.5,5,14,1145,8,2015,9,-1
Group 3,RRG,-1.5,5,14,1146,6,2015,5,1
Group 3,RRG,-1.5,5,14,1147,9,2015,5,4
Group 3,RRG,-1.5,5,14,1148,1,2015,5,-4
Group 3,RRG,-1.5,5,14,1149,4,2015,6,-2
Group 3,RRG,-1.5,5,14,1150,10,2015,6,4
Group 3,RRG,-1.5,5,14,1151,6,2015,8,-2
Group 3,RRG,-1.5,5,14,1152,2,2015,8,-6
Group 3,RRG,-1.5,5,14,1153,10,2015,12,-2
Group 3,RRG,-1.5,5,14,1154,8,2015,3,5
Group 3,RRG,-1.5,5,14,1155,8,2015,6,2
Group 3,RRG,-1.5,5,14,1156,10,2015,11,-1
Group 3,RRG,-1.5,5,14,1157,4,2015,5,-1
Group 3,RRG,-1.5,5,14,1158,7,2015,7,0
Group 3,RRG,-1.5,5,14,1159,11,2015,10,1
Group 3,RRG,-1.5,5,14,1160,10,2015,5,5
Group 3,RRG,-1.5,5,14,1161,9,2015,11,-2
Group 3,RRG,-1.5,5,14,1162,6,2015,8,-2
Group 3,RRG,-1.5,5,14,1163,7,2015,8,-1
Group 3,RRG,-1.5,5,14,1164,3,2015,6,-3
Group 3,RRG,-1.5,5,14,1165,10,2015,8,2
Group 3,RRG,-1.5,5,14,1166,9,2015,10,-1
Group 3,RRG,-1.5,5,14,1167,2,2015,5,-3
Group 3,RRG,-1.5,5,14,1168,5,2015,6,-1
Group 3,RRG,-1.5,5,14,1169,5,2015,5,0
Group 3,RRG,-1.5,5,14,1170,5,2015,8,-3
Group 3,RRG,-1.5,5,14,1171,6,2015,9,-3
Group 3,RRG,-1.5,5,14,1172,7,2015,9,-2
Group 3,RRG,-1.5,5,14,1173,9,2015,3,6
Group 3,RRG,-1.5,5,14,1174,9,2015,6,3
Group 3,RRG,-1.5,5,14,1175,9,2015,8,1
Group 3,RRG,-1.5,5,14,1176,10,2015,8,2
Group 3,RRG,-1.5,5,14,1177,6,2015,8,-2
Group 3,RRG,-1.5,5,14,1178,10,2015,9,1
Group 3,RRG,-1.5,5,14,1179,7,2015,7,0
Group 3,RRG,-1.5,5,14,1180,7,2015,8,-1
Group 3,RRG,-1.5,5,14,1181,4,2015,8,-4
Group 3,RRG,-1.5,5,14,1182,9,2015,7,2
Group 3,RRG,-1.5,5,14,1183,8,2015,3,5
Group 3,RRG,-1.5,5,14,1184,7,2015,7,0
Group 3,RRG,-1.5,5,14,1185,9,2015,7,2
Group 3,RRG,-1.5,5,14,1186,5,2015,7,-2
Group 3,RRG,-1.5,5,14,1187,11,2015,6,5
Group 3,RRG,-1.5,5,14,1188,10,2015,9,1
Group 3,RRG,-1.5,5,14,1189,9,2015,7,2
Group 3,RRG,-1.5,5,14,1190,9,2015,9,0
Group 3,RRG,-1.5,5,14,1191,14,2015,9,5
Group 3,RRG,-1.5,5,14,1192,0,2015,4,-4
Group 3,RRG,-1.5,5,14,1193,4,2015,6,-2
Group 3,RRG,-1.5,5,14,1194,6,2015,6,0
Group 3,RRG,-1.5,5,14,1195,4,2015,4,0
Group 3,RRG,-1.5,5,14,1196,3,2015,6,-3
Group 3,RRG,-1.5,5,14,1197,5,2015,9,-4
Group 3,RRG,-1.5,5,14,1198,6,2015,6,0
Group 3,RRG,-1.5,5,14,1199,4,2015,3,1
Group 3,RRG,-1.5,5,14,1200,6,2015,4,2
Group 3,RRG,-1.5,5,14,1201,7,2015,9,-2
Group 3,RRG,-1.5,5,14,1202,4,2015,4,0
Group 3,RRG,-1.5,5,14,1203,7,2015,4,3
Group 3,RRG,-1.5,5,14,1204,7,2015,8,-1
Group 3,RRG,-1.5,5,14,1205,3,2015,4,-1
Group 3,RRG,-1.5,5,14,1206,13,2015,6,7
Group 3,RRG,-1.5,5,14,1207,10,2015,7,3
Group 3,RRG,-1.5,5,14,1208,1,2015,5,-4
Group 3,RRG,-1.5,5,14,1209,5,2015,6,-1
Group 3,RRG,-1.5,5,14,1210,5,2015,3,2
Group 3,RRG,-1.5,5,14,1211,10,2015,9,1
Group 3,RRG,-1.5,5,14,1212,6,2015,6,0
Group 3,RRG,-1.5,5,14,1213,6,2015,2,4
Group 3,RRG,-1.5,5,14,1214,8,2015,8,0
Group 3,RRG,-1.5,5,14,1215,2,2015,2,0
Group 3,RRG,-1.5,5,14,1216,7,2015,7,0
Group 3,RRG,-1.5,5,14,1217,4,2015,10,-6
Group 3,RRG,-1.5,5,14,1218,5,2015,3,2
Group 3,RRG,-1.5,5,14,1219,10,2015,11,-1
Group 3,RRG,-1.5,5,14,1220,4,2015,5,-1
Group 3,RRG,-1.5,5,14,1221,10,2015,8,2
Group 3,RRG,-1.5,5,14,1222,5,2015,8,-3
Group 3,RRG,-1.5,5,14,1223,8,2015,11,-3
Group 3,RRG,-1.5,5,14,1224,8,2015,9,-1
Group 3,RRG,-1.5,5,14,1225,3,2015,7,-4
Group 3,RRG,-1.5,5,14,1226,9,2015,7,2
Group 3,RRG,-1.5,5,14,1227,8,2015,8,0
Group 3,RRG,-1.5,5,14,1228,7,2015,10,-3
Group 3,RRG,-1.5,5,14,1229,10,2015,5,5
Group 3,RRG,-1.5,5,14,1230,8,2015,7,1
Group 3,RRG,-1.5,5,14,1231,10,2015,7,3
Group 3,RRG,-1.5,5,14,1232,12,2015,6,6
Group 3,RRG,-1.5,5,14,1233,5,2015,8,-3
Group 3,RRG,-1.5,5,14,1234,3,2015,6,-3
Group 3,RRG,-1.5,5,14,1235,6,2015,4,2
Group 3,RRG,-1.5,5,14,1236,6,2015,4,2
Group 3,RRG,-1.5,5,14,1237,2,2015,5,-3
Group 3,RRG,-1.5,5,14,1238,3,2015,4,-1
Group 3,RRG,-1.5,5,14,1239,2,2015,2,0
Group 3,RRG,-1.5,5,14,1240,7,2015,5,2
Group 3,RRG,-1.5,5,14,1241,7,2015,4,3
Group 3,RRG,-1.5,5,14,1242,8,2015,7,1
Group 3,RRG,-1.5,5,14,1243,6,2015,6,0
Group 3,RRG,-1.5,5,14,1244,12,2015,8,4
Group 3,RRG,-1.5,5,14,1245,10,2015,9,1
Group 3,RRG,-1.5,5,14,1246,11,2015,9,2
Group 3,RRG,-1.5,5,14,1247,12,2015,9,3
Group 3,RRG,-1.5,5,14,1248,11,2015,7,4
Group 3,RRG,-1.5,5,14,1249,11,2015,9,2
Group 3,RRG,-1.5,5,14,1250,9,2015,11,-2
Group 3,RRG,-1.5,5,14,1251,10,2015,10,0
Group 3,RRG,-1.5,5,14,1252,1,2015,7,-6
Group 3,RRG,-1.5,5,14,1253,9,2015,6,3
Group 3,RRG,-1.5,5,14,1254,7,2015,6,1
Group 3,RRG,-1.5,5,14,1255,11,2015,7,4
Group 3,RRG,-1.5,5,14,1256,7,2015,4,3
Group 3,RRG,-1.5,5,14,1257,6,2015,5,1
Group 3,RRG,-1.5,5,14,1258,9,2015,6,3
Group 3,RRG,-1.5,5,14,1259,5,2015,7,-2
Group 3,RRG,-1.5,5,14,1260,6,2015,6,0
Group 3,RRG,-1.5,5,14,1261,6,2015,7,-1
Group 3,RRG,-1.5,5,14,1262,6,2015,7,-1
Group 3,RRG,-1.5,5,14,1263,5,2015,9,-4
Group 3,RRG,-1.5,5,14,1264,2,2015,10,-8
Group 3,RRG,-1.5,5,14,1265,9,2015,7,2
Group 3,RRG,-1.5,5,14,1266,7,2015,9,-2
Group 3,RRG,-1.5,5,14,1267,5,2015,4,1
Group 3,RRG,-1.5,5,14,1268,11,2015,9,2
Group 3,RRG,-1.5,5,14,1269,5,2015,7,-2
Group 3,RRG,-1.5,5,14,1270,8,2015,6,2
Group 3,RRG,-1.5,5,14,1271,5,2015,5,0
Group 3,RRG,-1.5,5,14,1272,5,2015,4,1
Group 3,RRG,-1.5,5,14,1273,9,2015,4,5
Group 3,RRG,-1.5,5,14,1274,6,2015,6,0
Group 3,RRG,-1.5,5,14,1275,5,2015,6,-1
Group 3,RRG,-1.5,5,14,1276,2,2015,3,-1
Group 3,RRG,-1.5,5,14,1277,4,2015,7,-3
Group 3,RRG,-1.5,5,14,1278,4,2015,9,-5
Group 3,RRG,-1.5,5,14,1279,9,2015,6,3
Group 3,RRG,-1.5,5,14,1280,6,2015,9,-3
Group 3,RRG,-1.5,5,14,1281,10,2015,7,3
Group 3,RRG,-1.5,5,14,1282,6,2015,2,4
Group 3,RRG,-1.5,5,14,1283,5,2015,7,-2
Group 3,RRG,-1.5,5,14,1284,8,2015,7,1
Group 3,RRG,-1.5,5,14,1285,5,2015,8,-3
Group 3,RRG,-1.5,5,14,1286,7,2015,10,-3
Group 3,RRG,-1.5,5,14,1287,9,2015,5,4
Group 3,RRG,-1.5,5,14,1288,3,2015,3,0
Group 3,RRG,-1.5,5,14,1289,3,2015,7,-4
Group 3,RRG,-1.5,5,14,1290,7,2015,10,-3
Group 3,RRG,-1.5,5,14,1291,7,2015,8,-1
Group 3,RRG,-1.5,5,14,1292,12,2015,9,3
Group 3,RRG,-1.5,5,14,1293,11,2015,10,1
Group 3,RRG,-1.5,5,14,1294,9,2015,11,-2
Group 3,RRG,-1.5,5,14,1295,12,2015,10,2
Group 3,RRG,-1.5,5,14,1296,6,2015,4,2
Group 3,RRG,-1.5,5,14,1297,4,2015,6,-2
Group 3,RRG,-1.5,5,14,1298,5,2015,5,0
Group 3,RRG,-1.5,5,14,1299,5,2015,7,-2
Group 3,RRG,-1.5,5,14,1300,7,2015,7,0
Group 3,RRG,-1.5,5,14,1301,3,2015,5,-2
Group 3,RRG,-1.5,5,14,1302,3,2015,0,3
Group 3,RRG,-1.5,5,14,1303,2,2015,2,0
Group 3,RRG,-1.5,5,14,1304,4,2015,5,-1
Group 3,RRG,-1.5,5,14,1305,7,2015,5,2
Group 3,RRG,-1.5,5,14,1306,5,2015,7,-2
Group 3,RRG,-1.5,5,14,1307,9,2015,9,0
Group 3,RRG,-1.5,5,14,1308,8,2015,6,2
Group 3,RRG,-1.5,5,14,1309,4,2015,9,-5
Group 3,RRG,-1.5,5,14,1310,8,2015,9,-1
Group 3,RRG,-1.5,5,14,1311,11,2015,6,5
Group 3,RRG,-1.5,5,14,1312,9,2015,4,5
Group 3,RRG,-1.5,5,14,1313,9,2015,8,1
Group 3,RRG,-1.5,5,14,1314,4,2015,4,0
Group 3,RRG,-1.5,5,14,1315,8,2015,10,-2
Group 3,RRG,-1.5,5,14,1316,8,2015,5,3
Group 3,RRG,-1.5,5,14,1317,9,2015,8,1
Group 3,RRG,-1.5,5,14,1318,8,2015,8,0
Group 3,RRG,-1.5,5,14,1319,2,2015,4,-2
Group 3,RRG,-1.5,5,14,1320,3,2015,5,-2
Group 3,RRG,-1.5,5,14,1321,12,2015,10,2
Group 3,RRG,-1.5,5,14,1322,5,2015,4,1
Group 3,RRG,-1.5,5,14,1323,12,2015,9,3
Group 3,RRG,-1.5,5,14,1324,13,2015,9,4
Group 3,RRG,-1.5,5,14,1325,8,2015,5,3
Group 3,RRG,-1.5,5,14,1326,13,2015,7,6
Group 3,RRG,-1.5,5,14,1327,12,2015,10,2
Group 3,RRG,-1.5,5,14,1328,10,2015,5,5
Group 3,RRG,-1.5,5,14,1329,7,2015,6,1
Group 3,RRG,-1.5,5,14,1330,7,2015,6,1
Group 3,RRG,-1.5,5,14,1331,7,2015,6,1
Group 3,RRG,-1.5,5,14,1332,8,2015,8,0
Group 3,RRG,-1.5,5,14,1333,12,2015,7,5
Group 3,RRG,-1.5,5,14,1334,4,2015,5,-1
Group 3,RRG,-1.5,5,14,1335,11,2015,9,2
Group 3,RRG,-1.5,5,14,1336,8,2015,6,2
Group 3,RRG,-1.5,5,14,1337,10,2015,5,5
Group 3,RRG,-1.5,5,14,1338,4,2015,4,0
Group 3,RRG,-1.5,5,14,1339,9,2015,10,-1
Group 3,RRG,-1.5,5,14,1340,9,2015,10,-1
Group 3,RRG,-1.5,5,14,1341,2,2015,4,-2
Group 3,RRG,-1.5,5,14,1342,6,2015,6,0
Group 3,RRG,-1.5,5,14,1343,4,2015,4,0
Group 3,RRG,-1.5,5,14,1344,3,2015,8,-5
Group 3,RRG,-1.5,5,14,1345,9,2015,9,0
Group 3,RRG,-1.5,5,14,1346,8,2015,8,0
Group 3,RRG,-1.5,5,14,1347,4,2015,8,-4
Group 3,RRG,-1.5,5,14,1348,7,2015,3,4
Group 3,RRG,-1.5,5,14,1349,8,2015,3,5
Group 3,RRG,-1.5,5,14,1350,2,2015,6,-4
Group 3,RRG,-1.5,5,14,1351,8,2015,6,2
Group 3,RRG,-1.5,5,14,1352,3,2015,5,-2
Group 3,RRG,-1.5,5,14,1353,3,2015,4,-1
Group 3,RRG,-1.5,5,14,1354,7,2015,6,1
Group 3,RRG,-1.5,5,14,1355,9,2015,4,5
Group 3,RRG,-1.5,5,14,1356,7,2015,7,0
Group 3,RRG,-1.5,5,14,1357,9,2015,10,-1
Group 3,RRG,-1.5,5,14,1358,10,2015,10,0
Group 3,RRG,-1.5,5,14,1359,12,2015,5,7
Group 3,RRG,-1.5,5,14,1360,10,2015,6,4
Group 3,RRG,-1.5,5,14,1361,5,2015,9,-4
Group 3,RRG,-1.5,5,14,1362,6,2015,7,-1
Group 3,RRG,-1.5,5,14,1363,5,2015,8,-3
Group 3,RRG,-1.5,5,14,1364,8,2015,12,-4
Group 3,RRG,-1.5,5,14,1365,8,2015,11,-3
Group 3,RRG,-1.5,5,14,1366,3,2015,11,-8
Group 3,RRG,-1.5,5,14,1367,6,2015,8,-2
Group 3,RRG,-1.5,5,14,1368,5,2015,6,-1
Group 3,RRG,-1.5,5,14,1369,2,2015,7,-5
Group 3,RRG,-1.5,5,14,1370,5,2015,6,-1
Group 3,RRG,-1.5,5,14,1371,7,2015,7,0
Group 3,RRG,-1.5,5,14,1372,4,2015,8,-4
Group 3,RRG,-1.5,5,14,1373,5,2015,5,0
Group 3,RRG,-1.5,5,14,1374,4,2015,4,0
Group 3,RRG,-1.5,5,14,1375,7,2015,8,-1
Group 3,RRG,-1.5,5,14,1376,7,2015,6,1
Group 3,RRG,-1.5,5,14,1377,9,2015,6,3
Group 3,RRG,-1.5,5,14,1378,8,2015,6,2
Group 3,RRG,-1.5,5,14,1379,9,2015,9,0
Group 3,RRG,-1.5,5,14,1380,4,2015,8,-4
Group 3,RRG,-1.5,5,14,1381,10,2015,5,5
Group 3,RRG,-1.5,5,14,1382,7,2015,9,-2
Group 3,RRG,-1.5,5,14,1383,10,2015,5,5
Group 3,RRG,-1.5,5,14,1384,4,2015,6,-2
Group 3,RRG,-1.5,5,14,1385,6,2015,4,2
Group 3,RRG,-1.5,5,14,1386,3,2015,6,-3
Group 3,RRG,-1.5,5,14,1387,7,2015,7,0
Group 3,RRG,-1.5,5,14,1388,8,2015,8,0
Group 3,RRG,-1.5,5,14,1389,5,2015,10,-5
Group 3,RRG,-1.5,5,14,1390,4,2015,6,-2
Group 3,RRG,-1.5,5,14,1391,10,2015,6,4
Group 3,RRG,-1.5,5,14,1392,7,2015,7,0
Group 3,RRG,-1.5,5,14,1393,9,2015,7,2
Group 3,RRG,-1.5,5,14,1394,12,2015,10,2
Group 3,RRG,-1.5,5,14,1395,7,2015,5,2
Group 3,RRG,-1.5,5,14,1396,2,2015,4,-2
Group 3,RRG,-1.5,5,14,1397,9,2015,10,-1
Group 3,RRG,-1.5,5,14,1398,4,2015,7,-3
Group 3,RRG,-1.5,5,14,1399,5,2015,6,-1
Group 3,RRG,-1.5,5,14,1400,8,2015,7,1
Group 3,RRG,-1.5,5,14,1401,4,2015,5,-1
Group 3,RRG,-1.5,5,14,1402,6,2015,6,0
Group 3,RRG,-1.5,5,14,1403,6,2015,9,-3
Group 3,RRG,-1.5,5,14,1404,10,2015,8,2
Group 3,RRG,-1.5,5,14,1405,5,2015,8,-3
Group 3,RRG,-1.5,5,14,1406,11,2015,6,5
Group 3,RRG,-1.5,5,14,1407,6,2015,8,-2
Group 3,RRG,-1.5,5,14,1408,2,2015,8,-6
Group 3,RRG,-1.5,5,14,1409,10,2015,3,7
Group 3,RRG,-1.5,5,14,1410,7,2015,8,-1
Group 3,RRG,-1.5,5,14,1411,6,2015,6,0
Group 3,RRG,-1.5,5,14,1412,9,2015,8,1
Group 3,RRG,-1.5,5,14,1413,10,2015,9,1
Group 3,RRG,-1.5,5,14,1414,6,2015,6,0
Group 3,RRG,-1.5,5,14,1415,2,2015,5,-3
Group 3,RRG,-1.5,5,14,1416,12,2015,13,-1
Group 3,RRG,-1.5,5,14,1417,2,2015,2,0
Group 3,RRG,-1.5,5,14,1418,0,2015,6,-6
Group 3,RRG,-1.5,5,14,1419,6,2015,1,5
Group 3,RRG,-1.5,5,14,1420,9,2015,9,0
Group 3,RRG,-1.5,5,14,1421,2,2015,5,-3
Group 3,RRG,-1.5,5,14,1422,9,2015,9,0
Group 3,RRG,-1.5,5,14,1423,7,2015,5,2
Group 3,RRG,-1.5,5,14,1424,11,2015,9,2
Group 3,RRG,-1.5,5,14,1425,6,2015,6,0
Group 3,RRG,-1.5,5,14,1426,3,2015,7,-4
Group 3,RRG,-1.5,5,14,1427,6,2015,5,1
Group 3,RRG,-1.5,5,14,1428,6,2015,8,-2
Group 3,RRG,-1.5,5,14,1429,12,2015,9,3
Group 3,RRG,-1.5,5,14,1430,5,2015,10,-5
Group 3,RRG,-1.5,5,14,1431,6,2015,9,-3
Group 3,RRG,-1.5,5,14,1432,6,2015,7,-1
Group 3,RRG,-1.5,5,14,1433,6,2015,7,-1
Group 3,RRG,-1.5,5,14,1434,4,2015,4,0
Group 3,RRG,-1.5,5,14,1435,4,2015,6,-2
Group 3,RRG,-1.5,5,14,1436,6,2015,5,1
Group 3,RRG,-1.5,5,14,1437,5,2015,6,-1
Group 3,RRG,-1.5,5,14,1438,5,2015,6,-1
Group 3,RRG,-1.5,5,14,1439,1,2015,3,-2
Group 3,RRG,-1.5,5,14,1440,10,2015,10,0
Group 3,RRG,-1.5,5,14,1441,13,2015,9,4
Group 3,RRG,-1.5,5,14,1442,13,2015,8,5
Group 3,RRG,-1.5,5,14,1443,5,2015,9,-4
Group 3,RRG,-1.5,5,14,1444,5,2015,5,0
Group 3,RRG,-1.5,5,14,1445,7,2015,7,0
Group 3,RRG,-1.5,5,14,1446,9,2015,9,0
Group 3,RRG,-1.5,5,14,1447,6,2015,7,-1
Group 3,RRG,-1.5,5,14,1448,9,2015,8,1
Group 3,RRG,-1.5,5,14,1449,8,2015,9,-1
Group 3,RRG,-1.5,5,14,1450,7,2015,4,3
Group 3,RRG,-1.5,5,14,1451,5,2015,8,-3
Group 3,RRG,-1.5,5,14,1452,3,2015,9,-6
Group 3,RRG,-1.5,5,14,1453,3,2015,6,-3
Group 3,RRG,-1.5,5,14,1454,4,2015,6,-2
Group 3,RRG,-1.5,5,14,1455,5,2015,5,0
Group 3,RRG,-1.5,5,14,1456,9,2015,4,5
Group 3,RRG,-1.5,5,14,1457,5,2015,9,-4
Group 3,RRG,-1.5,5,14,1458,8,2015,12,-4
Group 3,RRG,-1.5,5,14,1459,5,2015,5,0
Group 3,RRG,-1.5,5,14,1460,4,2015,5,-1
Group 3,RRG,-1.5,5,14,1461,6,2015,10,-4
Group 3,RRG,-1.5,5,14,1462,5,2015,6,-1
Group 3,RRG,-1.5,5,14,1463,6,2015,5,1
Group 3,RRG,-1.5,5,14,1464,8,2015,10,-2
Group 3,RRG,-1.5,5,14,1465,4,2015,5,-1
Group 3,RRG,-1.5,5,14,1466,2,2015,7,-5
Group 3,RRG,-1.5,5,14,1467,7,2015,5,2
Group 3,RRG,-1.5,5,14,1468,4,2015,6,-2
Group 3,RRG,-1.5,5,14,1469,6,2015,5,1
Group 3,RRG,-1.5,5,14,1470,8,2015,9,-1
Group 3,RRG,-1.5,5,14,1471,10,2015,5,5
Group 3,RRG,-1.5,5,14,1472,9,2015,10,-1
Group 3,RRG,-1.5,5,14,1473,3,2015,5,-2
Group 3,RRG,-1.5,5,14,1474,7,2015,6,1
Group 3,RRG,-1.5,5,14,1475,6,2015,9,-3
Group 3,RRG,-1.5,5,14,1476,9,2015,5,4
Group 3,RRG,-1.5,5,14,1477,3,2015,7,-4
Group 3,RRG,-1.5,5,14,1478,3,2015,5,-2
Group 3,RRG,-1.5,5,14,1479,3,2015,6,-3
Group 3,RRG,-1.5,5,14,1480,7,2015,2,5
Group 3,RRG,-1.5,5,14,1481,12,2015,7,5
Group 3,RRG,-1.5,5,14,1482,11,2015,5,6
Group 3,RRG,-1.5,5,14,1483,7,2015,9,-2
Group 3,RRG,-1.5,5,14,1484,14,2015,11,3
Group 3,RRG,-1.5,5,14,1485,11,2015,7,4
Group 3,RRG,-1.5,5,14,1486,7,2015,9,-2
Group 3,RRG,-1.5,5,14,1487,7,2015,8,-1
Group 3,RRG,-1.5,5,14,1488,3,2015,2,1
Group 3,RRG,-1.5,5,14,1489,12,2015,10,2
Group 3,RRG,-1.5,5,14,1490,7,2015,12,-5
Group 3,RRG,-1.5,5,14,1491,2,2015,2,0
Group 3,RRG,-1.5,5,14,1492,8,2015,6,2
Group 3,RRG,-1.5,5,14,1493,4,2015,6,-2
Group 3,RRG,-1.5,5,14,1494,5,2015,5,0
Group 3,RRG,-1.5,5,14,1495,3,2015,2,1
Group 3,RRG,-1.5,5,14,1496,11,2015,10,1
Group 3,RRG,-1.5,5,14,1497,8,2015,8,0
Group 3,RRG,-1.5,5,14,1498,4,2015,8,-4
Group 3,RRG,-1.5,5,14,1499,1,2015,5,-4
Group 3,RRG,-1.5,5,14,1500,6,2015,5,1
Group 3,RRG,-1.5,5,14,1501,8,2015,8,0
Group 3,RRG,-1.5,5,14,1502,4,2015,9,-5
Group 3,RRG,-1.5,5,14,1503,6,2015,7,-1
Group 3,RRG,-1.5,5,14,1504,5,2015,8,-3
Group 3,RRG,-1.5,5,14,1505,11,2015,5,6
Group 3,RRG,-1.5,5,14,1506,13,2015,9,4
Group 3,RRG,-1.5,5,14,1507,4,2015,3,1
Group 3,RRG,-1.5,5,14,1508,6,2015,5,1
Group 3,RRG,-1.5,5,14,1509,8,2015,6,2
Group 3,RRG,-1.5,5,14,1510,1,2015,6,-5
Group 3,RRG,-1.5,5,14,1511,9,2015,13,-4
Group 3,RRG,-1.5,5,14,1512,4,2015,12,-8
Group 3,RRG,-1.5,5,14,1513,3,2015,4,-1
Group 3,RRG,-1.5,5,14,1514,8,2015,8,0
Group 3,RRG,-1.5,5,14,1515,9,2015,6,3
Group 3,RRG,-1.5,5,14,1516,3,2015,5,-2
Group 3,RRG,-1.5,5,14,1517,3,2015,6,-3
Group 3,RRG,-1.5,5,14,1518,5,2015,4,1
Group 3,RRG,-1.5,5,14,1519,6,2015,6,0
Group 3,RRG,-1.5,5,14,1520,4,2015,5,-1
Group 3,RRG,-1.5,5,14,1521,3,2015,7,-4
Group 3,RRG,-1.5,5,14,1522,8,2015,8,0
Group 3,RRG,-1.5,5,14,1523,8,2015,6,2
Group 3,RRG,-1.5,5,14,1524,4,2015,8,-4
Group 3,RRG,-1.5,5,14,1525,9,2015,12,-3
Group 3,RRG,-1.5,5,14,1526,7,2015,4,3
Group 3,RRG,-1.5,5,14,1527,6,2015,5,1
Group 3,RRG,-1.5,5,14,1528,9,2015,8,1
Group 3,RRG,-1.5,5,14,1529,4,2015,7,-3
Group 3,RRG,-1.5,5,14,1530,10,2015,8,2
Group 3,RRG,-1.5,5,14,1531,7,2015,7,0
Group 3,RRG,-1.5,5,14,1532,10,2015,8,2
Group 3,RRG,-1.5,5,14,1533,6,2015,5,1
Group 3,RRG,-1.5,5,14,1534,10,2015,4,6
Group 3,RRG,-1.5,5,14,1535,5,2015,5,0
Group 3,RRG,-1.5,5,14,1536,4,2015,11,-7
Group 3,RRG,-1.5,5,14,1537,5,2015,6,-1
Group 3,RRG,-1.5,5,14,1538,12,2015,10,2
Group 3,RRG,-1.5,5,14,1539,11,2015,8,3
Group 3,RRG,-1.5,5,14,1540,2,2015,8,-6
Group 3,RRG,-1.5,5,14,1541,3,2015,9,-6
Group 3,RRG,-1.5,5,14,1542,8,2015,7,1
Group 3,RRG,-1.5,5,14,1543,9,2015,3,6
Group 3,RRG,-1.5,5,14,1544,6,2015,4,2
Group 3,RRG,-1.5,5,14,1545,6,2015,5,1
Group 3,RRG,-1.5,5,14,1546,5,2015,5,0
Group 3,RRG,-1.5,5,14,1547,9,2015,11,-2
Group 3,RRG,-1.5,5,14,1548,6,2015,7,-1
Group 3,RRG,-1.5,5,14,1549,5,2015,5,0
Group 3,RRG,-1.5,5,14,1550,2,2015,7,-5
Group 3,RRG,-1.5,5,14,1551,4,2015,9,-5
Group 3,RRG,-1.5,5,14,1552,10,2015,7,3
Group 3,RRG,-1.5,5,14,1553,8,2015,9,-1
Group 3,RRG,-1.5,5,14,1554,7,2015,2,5
Group 3,RRG,-1.5,5,14,1555,6,2015,3,3
Group 3,RRG,-1.5,5,14,1556,10,2015,4,6
Group 3,RRG,-1.5,5,14,1557,7,2015,5,2
Group 3,RRG,-1.5,5,14,1558,4,2015,11,-7
Group 3,RRG,-1.5,5,14,1559,7,2015,4,3
Group 3,RRG,-1.5,5,14,1560,9,2015,10,-1
Group 3,RRG,-1.5,5,14,1561,7,2015,6,1
Group 3,RRG,-1.5,5,14,1562,4,2015,6,-2
Group 3,RRG,-1.5,5,14,1563,7,2015,9,-2
Group 3,RRG,-1.5,5,14,1564,7,2015,7,0
Group 3,RRG,-1.5,5,14,1565,7,2015,5,2
Group 3,RRG,-1.5,5,14,1566,4,2015,3,1
Group 3,RRG,-1.5,5,14,1567,4,2015,6,-2
Group 3,RRG,-1.5,5,14,1568,3,2015,6,-3
Group 3,RRG,-1.5,5,14,1569,12,2015,10,2
Group 3,RRG,-1.5,5,14,1570,5,2015,6,-1
Group 3,RRG,-1.5,5,14,1571,6,2015,6,0
Group 3,RRG,-1.5,5,14,1572,2,2015,6,-4
Group 3,RRG,-1.5,5,14,1573,11,2015,10,1
Group 3,RRG,-1.5,5,14,1574,7,2015,7,0
Group 3,RRG,-1.5,5,14,1575,12,2015,8,4
Group 3,RRG,-1.5,5,14,1576,4,2015,9,-5
Group 3,RRG,-1.5,5,14,1577,5,2015,2,3
Group 3,RRG,-1.5,5,14,1578,10,2015,6,4
Group 3,RRG,-1.5,5,14,1579,2,2015,2,0
Group 3,RRG,-1.5,5,14,1580,13,2015,11,2
Group 3,RRG,-1.5,5,14,1581,9,2015,7,2
Group 3,RRG,-1.5,5,14,1582,3,2015,6,-3
Group 3,RRG,-1.5,5,14,1583,5,2015,7,-2
Group 3,RRG,-1.5,5,14,1584,8,2015,8,0
Group 3,RRG,-1.5,5,14,1585,3,2015,8,-5
Group 3,RRG,-1.5,5,14,1586,12,2015,8,4
Group 3,RRG,-1.5,5,14,1587,11,2015,10,1
Group 3,RRG,-1.5,5,14,1588,7,2015,12,-5
Group 3,RRG,-1.5,5,14,1589,3,2015,6,-3
Group 3,RRG,-1.5,5,14,1590,8,2015,9,-1
Group 3,RRG,-1.5,5,14,1591,6,2015,6,0
Group 3,RRG,-1.5,5,14,1592,8,2015,8,0
Group 3,RRG,-1.5,5,14,1593,7,2015,2,5
Group 3,RRG,-1.5,5,14,1594,7,2015,3,4
Group 3,RRG,-1.5,5,14,1595,9,2015,5,4
Group 3,RRG,-1.5,5,14,1596,6,2015,8,-2
Group 3,RRG,-1.5,5,14,1597,4,2015,8,-4
Group 3,RRG,-1.5,5,14,1598,6,2015,9,-3
Group 3,RRG,-1.5,5,14,1599,4,2015,6,-2
Group 3,RRG,-1.5,5,14,1600,13,2015,7,6
Group 3,RRG,-1.5,5,14,1601,10,2015,7,3
Group 3,RRG,-1.5,5,14,1602,9,2015,11,-2
Group 3,RRG,-1.5,5,14,1603,4,2015,5,-1
Group 3,RRG,-1.5,5,14,1604,3,2015,4,-1
Group 3,RRG,-1.5,5,14,1605,3,2015,5,-2
Group 3,RRG,-1.5,5,14,1606,1,2015,1,0
Group 3,RRG,-1.5,5,14,1607,5,2015,9,-4
Group 3,RRG,-1.5,5,14,1608,12,2015,8,4
Group 3,RRG,-1.5,5,14,1609,6,2015,8,-2
Group 3,RRG,-1.5,5,14,1610,5,2015,3,2
Group 3,RRG,-1.5,5,14,1611,3,2015,8,-5
Group 3,RRG,-1.5,5,14,1612,3,2015,2,1
Group 3,RRG,-1.5,5,14,1613,5,2015,6,-1
Group 3,RRG,-1.5,5,14,1614,6,2015,8,-2
Group 3,RRG,-1.5,5,14,1615,7,2015,7,0
Group 3,RRG,-1.5,5,14,1616,6,2015,2,4
Group 3,RRG,-1.5,5,14,1617,1,2015,7,-6
Group 3,RRG,-1.5,5,14,1618,2,2015,4,-2
Group 3,RRG,-1.5,5,14,1619,1,2015,5,-4
Group 3,RRG,-1.5,5,14,1620,7,2015,11,-4
Group 3,RRG,-1.5,5,14,1621,11,2015,10,1
Group 3,RRG,-1.5,5,14,1622,10,2015,6,4
Group 3,RRG,-1.5,5,14,1623,9,2015,7,2
Group 3,RRG,-1.5,5,14,1624,3,2015,6,-3
Group 3,RRG,-1.5,5,14,1625,5,2015,11,-6
Group 3,RRG,-1.5,5,14,1626,12,2015,10,2
Group 3,RRG,-1.5,5,14,1627,12,2015,10,2
Group 3,RRG,-1.5,5,14,1628,6,2015,5,1
Group 3,RRG,-1.5,5,14,1629,7,2015,5,2
Group 3,RRG,-1.5,5,14,1630,5,2015,2,3
Group 3,RRG,-1.5,5,14,1631,5,2015,4,1
Group 3,RRG,-1.5,5,14,1632,7,2015,11,-4
Group 3,RRG,-1.5,5,14,1633,6,2015,8,-2
Group 3,RRG,-1.5,5,14,1634,6,2015,5,1
Group 3,RRG,-1.5,5,14,1635,5,2015,7,-2
Group 3,RRG,-1.5,5,14,1636,9,2015,9,0
Group 3,RRG,-1.5,5,14,1637,9,2015,7,2
Group 3,RRG,-1.5,5,14,1638,4,2015,8,-4
Group 3,RRG,-1.5,5,14,1639,4,2015,2,2
Group 3,RRG,-1.5,5,14,1640,3,2015,3,0
Group 3,RRG,-1.5,5,14,1641,11,2015,4,7
Group 3,RRG,-1.5,5,14,1642,7,2015,6,1
Group 3,RRG,-1.5,5,14,1643,7,2015,4,3
Group 3,RRG,-1.5,5,14,1644,7,2015,4,3
Group 3,RRG,-1.5,5,14,1645,6,2015,8,-2
Group 3,RRG,-1.5,5,14,1646,8,2015,6,2
Group 3,RRG,-1.5,5,14,1647,9,2015,6,3
Group 3,RRG,-1.5,5,14,1648,10,2015,4,6
Group 3,RRG,-1.5,5,14,1649,9,2015,9,0
Group 3,RRG,-1.5,5,14,1650,2,2015,6,-4
Group 3,RRG,-1.5,5,14,1651,4,2015,7,-3
Group 3,RRG,-1.5,5,14,1652,7,2015,7,0
Group 3,RRG,-1.5,5,14,1653,6,2015,7,-1
Group 3,RRG,-1.5,5,14,1654,10,2015,8,2
Group 3,RRG,-1.5,5,14,1655,4,2015,4,0
Group 3,RRG,-1.5,5,14,1656,9,2015,9,0
Group 3,RRG,-1.5,5,14,1657,4,2015,2,2
Group 3,RRG,-1.5,5,14,1658,3,2015,7,-4
Group 3,RRG,-1.5,5,14,1659,6,2015,5,1
Group 3,RRG,-1.5,5,14,1660,4,2015,6,-2
Group 3,RRG,-1.5,5,14,1661,1,2015,4,-3
Group 3,RRG,-1.5,5,14,1662,3,2015,9,-6
Group 3,RRG,-1.5,5,14,1663,7,2015,7,0
Group 3,RRG,-1.5,5,14,1664,8,2015,8,0
Group 3,RRG,-1.5,5,14,1665,6,2015,6,0
Group 3,RRG,-1.5,5,14,1666,8,2015,5,3
Group 3,RRG,-1.5,5,14,1667,12,2015,8,4
Group 3,RRG,-1.5,5,14,1668,6,2015,10,-4
Group 3,RRG,-1.5,5,14,1669,5,2015,5,0
Group 3,RRG,-1.5,5,14,1670,8,2015,6,2
Group 3,RRG,-1.5,5,14,1671,4,2015,6,-2
Group 3,RRG,-1.5,5,14,1672,11,2015,9,2
Group 3,RRG,-1.5,5,14,1673,8,2015,7,1
Group 3,RRG,-1.5,5,14,1674,4,2015,7,-3
Group 3,RRG,-1.5,5,14,1675,5,2015,9,-4
Group 3,RRG,-1.5,5,14,1676,6,2015,9,-3
Group 3,RRG,-1.5,5,14,1677,5,2015,7,-2
Group 3,RRG,-1.5,5,14,1678,8,2015,4,4
Group 3,RRG,-1.5,5,14,1679,5,2015,8,-3
Group 3,RRG,-1.5,5,14,1680,4,2015,6,-2
Group 3,RRG,-1.5,5,14,1681,6,2015,6,0
Group 3,RRG,-1.5,5,14,1682,6,2015,7,-1
Group 3,RRG,-1.5,5,14,1683,6,2015,7,-1
Group 3,RRG,-1.5,5,14,1684,9,2015,7,2
Group 3,RRG,-1.5,5,14,1685,6,2015,8,-2
Group 3,RRG,-1.5,5,14,1686,7,2015,7,0
Group 3,RRG,-1.5,5,14,1687,6,2015,6,0
Group 3,RRG,-1.5,5,14,1688,8,2015,8,0
Group 3,RRG,-1.5,5,14,1689,5,2015,3,2
Group 3,RRG,-1.5,5,14,1690,6,2015,11,-5
Group 3,RRG,-1.5,5,14,1691,7,2015,10,-3
Group 3,RRG,-1.5,5,14,1692,8,2015,6,2
Group 3,RRG,-1.5,5,14,1693,2,2015,6,-4
Group 3,RRG,-1.5,5,14,1694,5,2015,6,-1
Group 3,RRG,-1.5,5,14,1695,4,2015,3,1
Group 3,RRG,-1.5,5,14,1696,7,2015,5,2
Group 3,RRG,-1.5,5,14,1697,5,2015,7,-2
Group 3,RRG,-1.5,5,14,1698,7,2015,5,2
Group 3,RRG,-1.5,5,14,1699,9,2015,9,0
Group 3,RRG,-1.5,5,14,1700,9,2015,7,2
Group 3,RRG,-1.5,5,14,1701,4,2015,4,0
Group 3,RRG,-1.5,5,14,1702,8,2015,8,0
Group 3,RRG,-1.5,5,14,1703,6,2015,8,-2
Group 3,RRG,-1.5,5,14,1704,10,2015,5,5
Group 3,RRG,-1.5,5,14,1705,8,2015,5,3
Group 3,RRG,-1.5,5,14,1706,7,2015,8,-1
Group 3,RRG,-1.5,5,14,1707,6,2015,5,1
Group 3,RRG,-1.5,5,14,1708,6,2015,8,-2
Group 3,RRG,-1.5,5,14,1709,5,2015,3,2
Group 3,RRG,-1.5,5,14,1710,4,2015,0,4
Group 3,RRG,-1.5,5,14,1711,7,2015,3,4
Group 3,RRG,-1.5,5,14,1712,11,2015,12,-1
Group 3,RRG,-1.5,5,14,1713,6,2015,10,-4
Group 3,RRG,-1.5,5,14,1714,7,2015,4,3
Group 3,RRG,-1.5,5,14,1715,7,2015,4,3
Group 3,RRG,-1.5,5,14,1716,5,2015,9,-4
Group 3,RRG,-1.5,5,14,1717,7,2015,7,0
Group 3,RRG,-1.5,5,14,1718,12,2015,9,3
Group 3,RRG,-1.5,5,14,1719,10,2015,11,-1
Group 3,RRG,-1.5,5,14,1720,6,2015,5,1
Group 3,RRG,-1.5,5,14,1721,11,2015,11,0
Group 3,RRG,-1.5,5,14,1722,8,2015,8,0
Group 3,RRG,-1.5,5,14,1723,9,2015,10,-1
Group 3,RRG,-1.5,5,14,1724,9,2015,3,6
Group 3,RRG,-1.5,5,14,1725,12,2015,12,0
Group 3,RRG,-1.5,5,14,1726,8,2015,5,3
Group 3,RRG,-1.5,5,14,1727,7,2015,4,3
Group 3,RRG,-1.5,5,14,1728,7,2015,5,2
Group 3,RRG,-1.5,5,14,1729,4,2015,5,-1
Group 3,RRG,-1.5,5,14,1730,14,2015,12,2
Group 3,RRG,-1.5,5,14,1731,7,2015,6,1
Group 3,RRG,-1.5,5,14,1732,4,2015,9,-5
Group 3,RRG,-1.5,5,14,1733,8,2015,9,-1
Group 3,RRG,-1.5,5,14,1734,12,2015,11,1
Group 3,RRG,-1.5,5,14,1735,6,2015,4,2
Group 3,RRG,-1.5,5,14,1736,6,2015,7,-1
Group 3,RRG,-1.5,5,14,1737,12,2015,7,5
Group 3,RRG,-1.5,5,14,1738,10,2015,11,-1
Group 3,RRG,-1.5,5,14,1739,7,2015,10,-3
Group 3,RRG,-1.5,5,14,1740,9,2015,11,-2
Group 3,RRG,-1.5,5,14,1741,8,2015,10,-2
Group 3,RRG,-1.5,5,14,1742,9,2015,9,0
Group 3,RRG,-1.5,5,14,1743,5,2015,7,-2
Group 3,RRG,-1.5,5,14,1744,6,2015,7,-1
Group 3,RRG,-1.5,5,14,1745,6,2015,5,1
Group 3,RRG,-1.5,5,14,1746,7,2015,5,2
Group 3,RRG,-1.5,5,14,1747,6,2015,5,1
Group 3,RRG,-1.5,5,14,1748,6,2015,4,2
Group 3,RRG,-1.5,5,14,1749,10,2015,6,4
Group 3,RRG,-1.5,5,14,1750,6,2015,7,-1
Group 3,RRG,-1.5,5,14,1751,5,2015,6,-1
Group 3,RRG,-1.5,5,14,1752,1,2015,5,-4
Group 3,RRG,-1.5,5,14,1753,2,2015,10,-8
Group 3,RRG,-1.5,5,14,1754,8,2015,5,3
Group 3,RRG,-1.5,5,14,1755,6,2015,6,0
Group 3,RRG,-1.5,5,14,1756,6,2015,6,0
Group 3,RRG,-1.5,5,14,1757,5,2015,6,-1
Group 3,RRG,-1.5,5,14,1758,5,2015,4,1
Group 3,RRG,-1.5,5,14,1759,6,2015,4,2
Group 3,RRG,-1.5,5,14,1760,7,2015,7,0
Group 3,RRG,-1.5,5,14,1761,9,2015,4,5
Group 3,RRG,-1.5,5,14,1762,7,2015,13,-6
Group 3,RRG,-1.5,5,14,1763,7,2015,8,-1
Group 3,RRG,-1.5,5,14,1764,10,2015,8,2
Group 3,RRG,-1.5,5,14,1765,4,2015,4,0
Group 3,RRG,-1.5,5,14,1766,5,2015,6,-1
Group 3,RRG,-1.5,5,14,1767,11,2015,9,2
Group 3,RRG,-1.5,5,14,1768,3,2015,3,0
Group 3,RRG,-1.5,5,14,1769,6,2015,11,-5
Group 3,RRG,-1.5,5,14,1770,6,2015,8,-2
Group 3,RRG,-1.5,5,14,1771,6,2015,7,-1
Group 3,RRG,-1.5,5,14,1772,7,2015,4,3
Group 3,RRG,-1.5,5,14,1773,0,2015,5,-5
Group 3,RRG,-1.5,5,14,1774,9,2015,9,0
Group 3,RRG,-1.5,5,14,1775,11,2015,9,2
Group 3,RRG,-1.5,5,14,1776,5,2015,6,-1
Group 3,RRG,-1.5,5,14,1777,7,2015,4,3
Group 3,RRG,-1.5,5,14,1778,6,2015,9,-3
Group 3,RRG,-1.5,5,14,1779,4,2015,9,-5
Group 3,RRG,-1.5,5,14,1780,8,2015,8,0
Group 3,RRG,-1.5,5,14,1781,6,2015,7,-1
Group 3,RRG,-1.5,5,14,1782,6,2015,8,-2
Group 3,RRG,-1.5,5,14,1783,8,2015,6,2
Group 3,RRG,-1.5,5,14,1784,8,2015,5,3
Group 3,RRG,-1.5,5,14,1785,6,2015,4,2
Group 3,RRG,-1.5,5,14,1786,7,2015,7,0
Group 3,RRG,-1.5,5,14,1787,8,2015,6,2
Group 3,RRG,-1.5,5,14,1788,2,2015,8,-6
Group 3,RRG,-1.5,5,14,1789,3,2015,10,-7
Group 3,RRG,-1.5,5,14,1790,4,2015,7,-3
Group 3,RRG,-1.5,5,14,1791,7,2015,4,3
Group 3,RRG,-1.5,5,14,1792,6,2015,5,1
Group 3,RRG,-1.5,5,14,1793,6,2015,4,2
Group 3,RRG,-1.5,5,14,1794,7,2015,2,5
Group 3,RRG,-1.5,5,14,1795,8,2015,9,-1
Group 3,RRG,-1.5,5,14,1796,10,2015,11,-1
Group 3,RRG,-1.5,5,14,1797,11,2015,9,2
Group 3,RRG,-1.5,5,14,1798,12,2015,12,0
Group 3,RRG,-1.5,5,14,1799,10,2015,14,-4
Group 3,RRG,-1.5,5,14,1800,6,2015,4,2
Group 3,RRG,-1.5,5,14,1801,8,2015,12,-4
Group 3,RRG,-1.5,5,14,1802,5,2015,5,0
Group 3,RRG,-1.5,5,14,1803,4,2015,8,-4
Group 3,RRG,-1.5,5,14,1804,4,2015,4,0
Group 3,RRG,-1.5,5,14,1805,5,2015,8,-3
Group 3,RRG,-1.5,5,14,1806,9,2015,11,-2
Group 3,RRG,-1.5,5,14,1807,5,2015,4,1
Group 3,RRG,-1.5,5,14,1808,8,2015,7,1
Group 3,RRG,-1.5,5,14,1809,8,2015,4,4
Group 3,RRG,-1.5,5,14,1810,10,2015,6,4
Group 3,RRG,-1.5,5,14,1811,7,2015,2,5
Group 3,RRG,-1.5,5,14,1812,4,2015,11,-7
Group 3,RRG,-1.5,5,14,1813,4,2015,9,-5
Group 3,RRG,-1.5,5,14,1814,8,2015,11,-3
Group 3,RRG,-1.5,5,14,1815,11,2015,7,4
Group 3,RRG,-1.5,5,14,1816,12,2015,5,7
Group 3,RRG,-1.5,5,14,1817,9,2015,8,1
Group 3,RRG,-1.5,5,14,1818,5,2015,11,-6
Group 3,RRG,-1.5,5,14,1819,7,2015,6,1
Group 3,RRG,-1.5,5,14,1820,5,2015,7,-2
Group 3,RRG,-1.5,5,14,1821,10,2015,9,1
Group 3,RRG,-1.5,5,14,1822,9,2015,5,4
Group 3,RRG,-1.5,5,14,1823,10,2015,4,6
Group 3,RRG,-1.5,5,14,1824,10,2015,8,2
Group 3,RRG,-1.5,5,14,1825,4,2015,4,0
Group 3,RRG,-1.5,5,14,1826,3,2015,6,-3
Group 3,RRG,-1.5,5,14,1827,10,2015,5,5
Group 3,RRG,-1.5,5,14,1828,5,2015,4,1
Group 3,RRG,-1.5,5,14,1829,7,2015,6,1
Group 3,RRG,-1.5,5,14,1830,3,2015,4,-1
Group 3,RRG,-1.5,5,14,1831,4,2015,7,-3
Group 3,RRG,-1.5,5,14,1832,12,2015,5,7
Group 3,RRG,-1.5,5,14,1833,10,2015,9,1
Group 3,RRG,-1.5,5,14,1834,5,2015,9,-4
Group 3,RRG,-1.5,5,14,1835,11,2015,5,6
Group 3,RRG,-1.5,5,14,1836,4,2015,9,-5
Group 3,RRG,-1.5,5,14,1837,7,2015,7,0
Group 3,RRG,-1.5,5,14,1838,4,2015,7,-3
Group 3,RRG,-1.5,5,14,1839,9,2015,5,4
Group 3,RRG,-1.5,5,14,1840,5,2015,5,0
Group 3,RRG,-1.5,5,14,1841,4,2015,10,-6
Group 3,RRG,-1.5,5,14,1842,7,2015,9,-2
Group 3,RRG,-1.5,5,14,1843,5,2015,6,-1
Group 3,RRG,-1.5,5,14,1844,7,2015,6,1
Group 3,RRG,-1.5,5,14,1845,1,2015,4,-3
Group 3,RRG,-1.5,5,14,1846,3,2015,4,-1
Group 3,RRG,-1.5,5,14,1847,13,2015,7,6
Group 3,RRG,-1.5,5,14,1848,12,2015,9,3
Group 3,RRG,-1.5,5,14,1849,10,2015,6,4
Group 3,RRG,-1.5,5,14,1850,7,2015,4,3
Group 3,RRG,-1.5,5,14,1851,6,2015,9,-3
Group 3,RRG,-1.5,5,14,1852,5,2015,7,-2
Group 3,RRG,-1.5,5,14,1853,8,2015,8,0
Group 3,RRG,-1.5,5,14,1854,4,2015,8,-4
Group 3,RRG,-1.5,5,14,1855,2,2015,9,-7
Group 3,RRG,-1.5,5,14,1856,10,2015,9,1
Group 3,RRG,-1.5,5,14,1857,12,2015,12,0
Group 3,RRG,-1.5,5,14,1858,8,2015,7,1
Group 3,RRG,-1.5,5,14,1859,7,2015,10,-3
Group 3,RRG,-1.5,5,14,1860,4,2015,3,1
Group 3,RRG,-1.5,5,14,1861,7,2015,7,0
Group 3,RRG,-1.5,5,14,1862,10,2015,5,5
Group 3,RRG,-1.5,5,14,1863,8,2015,8,0
Group 3,RRG,-1.5,5,14,1864,7,2015,11,-4
Group 3,RRG,-1.5,5,14,1865,8,2015,7,1
Group 3,RRG,-1.5,5,14,1866,5,2015,6,-1
Group 3,RRG,-1.5,5,14,1867,4,2015,7,-3
Group 3,RRG,-1.5,5,14,1868,5,2015,7,-2
Group 3,RRG,-1.5,5,14,1869,5,2015,2,3
Group 3,RRG,-1.5,5,14,1870,3,2015,7,-4
Group 3,RRG,-1.5,5,14,1871,10,2015,7,3
Group 3,RRG,-1.5,5,14,1872,11,2015,4,7
Group 3,RRG,-1.5,5,14,1873,9,2015,5,4
Group 3,RRG,-1.5,5,14,1874,7,2015,7,0
Group 3,RRG,-1.5,5,14,1875,6,2015,11,-5
Group 3,RRG,-1.5,5,14,1876,5,2015,3,2
Group 3,RRG,-1.5,5,14,1877,8,2015,7,1
Group 3,RRG,-1.5,5,14,1878,7,2015,11,-4
Group 3,RRG,-1.5,5,14,1879,10,2015,8,2
Group 3,RRG,-1.5,5,14,1880,6,2015,12,-6
Group 3,RRG,-1.5,5,14,1881,5,2015,9,-4
Group 3,RRG,-1.5,5,14,1882,6,2015,6,0
Group 3,RRG,-1.5,5,14,1883,6,2015,4,2
Group 3,RRG,-1.5,5,14,1884,3,2015,4,-1
Group 3,RRG,-1.5,5,14,1885,10,2015,8,2
Group 3,RRG,-1.5,5,14,1886,3,2015,7,-4
Group 3,RRG,-1.5,5,14,1887,13,2015,8,5
Group 3,RRG,-1.5,5,14,1888,7,2015,4,3
Group 3,RRG,-1.5,5,14,1889,9,2015,6,3
Group 3,RRG,-1.5,5,14,1890,5,2015,5,0
Group 3,RRG,-1.5,5,14,1891,8,2015,7,1
Group 3,RRG,-1.5,5,14,1892,8,2015,7,1
Group 3,RRG,-1.5,5,14,1893,6,2015,7,-1
Group 3,RRG,-1.5,5,14,1894,6,2015,5,1
Group 3,RRG,-1.5,5,14,1895,9,2015,5,4
Group 3,RRG,-1.5,5,14,1896,5,2015,7,-2
Group 3,RRG,-1.5,5,14,1897,7,2015,6,1
Group 3,RRG,-1.5,5,14,1898,9,2015,9,0
Group 3,RRG,-1.5,5,14,1899,11,2015,6,5
Group 3,RRG,-1.5,5,14,1900,10,2015,6,4
Group 3,RRG,-1.5,5,14,1901,9,2015,6,3
Group 3,RRG,-1.5,5,14,1902,10,2015,3,7
Group 3,RRG,-1.5,5,14,1903,7,2015,3,4
Group 3,RRG,-1.5,5,14,1904,5,2015,8,-3
Group 3,RRG,-1.5,5,14,1905,7,2015,6,1
Group 3,RRG,-1.5,5,14,1906,1,2015,6,-5
Group 3,RRG,-1.5,5,14,1907,5,2015,6,-1
Group 3,RRG,-1.5,5,14,1908,2,2015,7,-5
Group 3,RRG,-1.5,5,14,1909,7,2015,3,4
Group 3,RRG,-1.5,5,14,1910,13,2015,10,3
Group 3,RRG,-1.5,5,14,1911,6,2015,8,-2
Group 3,RRG,-1.5,5,14,1912,8,2015,6,2
Group 3,RRG,-1.5,5,14,1913,8,2015,8,0
Group 3,RRG,-1.5,5,14,1914,7,2015,8,-1
Group 3,RRG,-1.5,5,14,1915,10,2015,10,0
Group 3,RRG,-1.5,5,14,1916,3,2015,2,1
Group 3,RRG,-1.5,5,14,1917,3,2015,4,-1
Group 3,RRG,-1.5,5,14,1918,3,2015,2,1
Group 3,RRG,-1.5,5,14,1919,3,2015,8,-5
Group 3,RRG,-1.5,5,14,1920,11,2015,8,3
Group 3,RRG,-1.5,5,14,1921,8,2015,10,-2
Group 3,RRG,-1.5,5,14,1922,10,2015,5,5
Group 3,RRG,-1.5,5,14,1923,5,2015,5,0
Group 3,RRG,-1.5,5,14,1924,7,2015,8,-1
Group 3,RRG,-1.5,5,14,1925,10,2015,8,2
Group 3,RRG,-1.5,5,14,1926,5,2015,9,-4
Group 3,RRG,-1.5,5,14,1927,6,2015,6,0
Group 3,RRG,-1.5,5,14,1928,4,2015,6,-2
Group 3,RRG,-1.5,5,14,1929,8,2015,5,3
Group 3,RRG,-1.5,5,14,1930,3,2015,7,-4
Group 3,RRG,-1.5,5,14,1931,7,2015,8,-1
Group 3,RRG,-1.5,5,14,1932,9,2015,7,2
Group 3,RRG,-1.5,5,14,1933,7,2015,8,-1
Group 3,RRG,-1.5,5,14,1934,8,2015,3,5
Group 3,RRG,-1.5,5,14,1935,5,2015,7,-2
Group 3,RRG,-1.5,5,14,1936,11,2015,8,3
Group 3,RRG,-1.5,5,14,1937,6,2015,8,-2
Group 3,RRG,-1.5,5,14,1938,5,2015,6,-1
Group 3,RRG,-1.5,5,14,1939,9,2015,9,0
Group 3,RRG,-1.5,5,14,1940,9,2015,11,-2
Group 3,RRG,-1.5,5,14,1941,6,2015,5,1
Group 3,RRG,-1.5,5,14,1942,8,2015,9,-1
Group 3,RRG,-1.5,5,14,1943,5,2015,7,-2
Group 3,RRG,-1.5,5,14,1944,4,2015,7,-3
Group 3,RRG,-1.5,5,14,1945,8,2015,5,3
Group 3,RRG,-1.5,5,14,1946,12,2015,7,5
Group 3,RRG,-1.5,5,14,1947,10,2015,5,5
Group 3,RRG,-1.5,5,14,1948,6,2015,7,-1
Group 3,RRG,-1.5,5,14,1949,10,2015,4,6
Group 3,RRG,-1.5,5,14,1950,2,2015,8,-6
Group 3,RRG,-1.5,5,14,1951,1,2015,5,-4
Group 3,RRG,-1.5,5,14,1952,9,2015,8,1
Group 3,RRG,-1.5,5,14,1953,4,2015,5,-1
Group 3,RRG,-1.5,5,14,1954,8,2015,4,4
Group 3,RRG,-1.5,5,14,1955,4,2015,8,-4
Group 3,RRG,-1.5,5,14,1956,4,2015,5,-1
Group 3,RRG,-1.5,5,14,1957,8,2015,4,4
Group 3,RRG,-1.5,5,14,1958,11,2015,8,3
Group 3,RRG,-1.5,5,14,1959,6,2015,10,-4
Group 3,RRG,-1.5,5,14,1960,9,2015,8,1
Group 3,RRG,-1.5,5,14,1961,9,2015,6,3
Group 3,RRG,-1.5,5,14,1962,8,2015,8,0
Group 3,RRG,-1.5,5,14,1963,9,2015,9,0
Group 3,RRG,-1.5,5,14,1964,8,2015,9,-1
Group 3,RRG,-1.5,5,14,1965,6,2015,6,0
Group 3,RRG,-1.5,5,14,1966,6,2015,7,-1
Group 3,RRG,-1.5,5,14,1967,11,2015,7,4
Group 3,RRG,-1.5,5,14,1968,7,2015,10,-3
Group 3,RRG,-1.5,5,14,1969,6,2015,10,-4
Group 3,RRG,-1.5,5,14,1970,2,2015,2,0
Group 3,RRG,-1.5,5,14,1971,0,2015,4,-4
Group 3,RRG,-1.5,5,14,1972,4,2015,5,-1
Group 3,RRG,-1.5,5,14,1973,13,2015,8,5
Group 3,RRG,-1.5,5,14,1974,12,2015,7,5
Group 3,RRG,-1.5,5,14,1975,12,2015,9,3
Group 3,RRG,-1.5,5,14,1976,12,2015,11,1
Group 3,RRG,-1.5,5,14,1977,13,2015,11,2
Group 3,RRG,-1.5,5,14,1978,5,2015,5,0
Group 3,RRG,-1.5,5,14,1979,3,2015,5,-2
Group 3,RRG,-1.5,5,14,1980,4,2015,2,2
Group 3,RRG,-1.5,5,14,1981,3,2015,6,-3
Group 3,RRG,-1.5,5,14,1982,2,2015,5,-3
Group 3,RRG,-1.5,5,14,1983,7,2015,5,2
Group 3,RRG,-1.5,5,14,1984,2,2015,9,-7
Group 3,RRG,-1.5,5,14,1985,0,2015,7,-7
Group 3,RRG,-1.5,5,14,1986,10,2015,6,4
Group 3,RRG,-1.5,5,14,1987,3,2015,5,-2
Group 3,RRG,-1.5,5,14,1988,2,2015,4,-2
Group 3,RRG,-1.5,5,14,1989,10,2015,7,3
Group 3,RRG,-1.5,5,14,1990,12,2015,4,8
Group 3,RRG,-1.5,5,14,1991,7,2015,11,-4
Group 3,RRG,-1.5,5,14,1992,7,2015,9,-2
Group 3,RRG,-1.5,5,14,1993,10,2015,10,0
Group 3,RRG,-1.5,5,14,1994,2,2015,5,-3
Group 3,RRG,-1.5,5,14,1995,7,2015,7,0
Group 3,RRG,-1.5,5,14,1996,4,2015,10,-6
Group 3,RRG,-1.5,5,14,1997,6,2015,9,-3
Group 3,RRG,-1.5,5,14,1998,3,2015,4,-1
Group 3,RRG,-1.5,5,14,1999,4,2015,6,-2
Group 3,RRG,-1.5,5,14,2000,7,2015,8,-1
Group 3,RRG,-1.5,5,14,2001,5,2015,4,1
Group 3,RRG,-1.5,5,14,2002,3,2015,5,-2
Group 3,RRG,-1.5,5,14,2003,11,2015,10,1
Group 3,RRG,-1.5,5,14,2004,5,2015,8,-3
Group 3,RRG,-1.5,5,14,2005,5,2015,3,2
Group 3,RRG,-1.5,5,14,2006,5,2015,2,3
Group 3,RRG,-1.5,5,14,2007,7,2015,7,0
Group 3,RRG,-1.5,5,14,2008,12,2015,9,3
Group 3,RRG,-1.5,5,14,2009,8,2015,10,-2
Group 3,RRG,-1.5,5,14,2010,7,2015,6,1
Group 3,RRG,-1.5,5,14,2011,12,2015,6,6
Group 3,RRG,-1.5,5,14,2012,6,2015,6,0
Group 3,RRG,-1.5,5,14,2013,5,2015,11,-6
Group 3,RRG,-1.5,5,14,2014,7,2015,8,-1
Group 3,RRG,-1.5,5,14,2015,5,2015,8,-3
Group 3,RRG,-1.5,5,14,2016,7,2015,7,0
Group 3,RRG,-1.5,5,14,2017,6,2015,10,-4
Group 3,RRG,-1.5,5,14,2018,8,2015,5,3
Group 3,RRG,-1.5,5,14,2019,9,2015,9,0
Group 3,RRG,-1.5,5,14,2020,5,2015,7,-2
Group 3,RRG,-1.5,5,14,2021,7,2015,8,-1
Group 3,RRG,-1.5,5,14,2022,5,2015,5,0
Group 3,RRG,-1.5,5,14,2023,10,2015,8,2
Group 3,RRG,-1.5,5,14,2024,4,2015,5,-1
Group 3,RRG,-1.5,5,14,2025,7,2015,8,-1
Group 3,RRG,-1.5,5,14,2026,7,2015,3,4
Group 3,RRG,-1.5,5,14,2027,9,2015,9,0
Group 3,RRG,-1.5,5,14,2028,2,2015,8,-6
Group 3,RRG,-1.5,5,14,2029,0,2015,2,-2
Group 3,RRG,-1.5,5,14,2030,1,2015,4,-3
Group 3,RRG,-1.5,5,14,2031,13,2015,10,3
Group 3,RRG,-1.5,5,14,2032,2,2015,4,-2
Group 3,RRG,-1.5,5,14,2033,5,2015,7,-2
Group 3,RRG,-1.5,5,14,2034,3,2015,8,-5
Group 3,RRG,-1.5,5,14,2035,11,2015,7,4
Group 3,RRG,-1.5,5,14,2036,6,2015,5,1
Group 3,RRG,-1.5,5,14,2037,6,2015,6,0
Group 3,RRG,-1.5,5,14,2038,6,2015,7,-1
Group 3,RRG,-1.5,5,14,2039,10,2015,8,2
Group 3,RRG,-1.5,5,14,2040,5,2015,5,0
Group 3,RRG,-1.5,5,14,2041,8,2015,7,1
Group 3,RRG,-1.5,5,14,2042,12,2015,9,3
Group 3,RRG,-1.5,5,14,2043,12,2015,7,5
Group 3,RRG,-1.5,5,14,2044,10,2015,6,4
Group 3,RRG,-1.5,5,14,2045,5,2015,7,-2
Group 3,RRG,-1.5,5,14,2046,9,2015,6,3
Group 3,RRG,-1.5,5,14,2047,5,2015,10,-5
Group 3,RRG,-1.5,5,14,2048,8,2015,9,-1
Group 3,RRG,-1.5,5,14,2049,10,2015,11,-1
Group 3,RRG,-1.5,5,14,2050,8,2015,8,0
Group 3,RRG,-1.5,5,14,2051,5,2015,7,-2
Group 3,RRG,-1.5,5,14,2052,7,2015,7,0
Group 3,RRG,-1.5,5,14,2053,7,2015,11,-4
Group 3,RRG,-1.5,5,14,2054,1,2015,5,-4
Group 3,RRG,-1.5,5,14,2055,4,2015,9,-5
Group 3,RRG,-1.5,5,14,2056,9,2015,6,3
Group 3,RRG,-1.5,5,14,2057,11,2015,7,4
Group 3,RRG,-1.5,5,14,2058,2,2015,2,0
Group 3,RRG,-1.5,5,14,2059,10,2015,6,4
Group 3,RRG,-1.5,5,14,2060,11,2015,6,5
Group 3,RRG,-1.5,5,14,2061,6,2015,8,-2
Group 3,RRG,-1.5,5,14,2062,11,2015,4,7
Group 3,RRG,-1.5,5,14,2063,4,2015,9,-5
Group 3,RRG,-1.5,5,14,2064,10,2015,6,4
Group 3,RRG,-1.5,5,14,2065,4,2015,3,1
Group 3,RRG,-1.5,5,14,2066,11,2015,7,4
Group 3,RRG,-1.5,5,14,2067,7,2015,3,4
Group 3,RRG,-1.5,5,14,2068,2,2015,4,-2
Group 3,RRG,-1.5,5,14,2069,3,2015,6,-3
Group 3,RRG,-1.5,5,14,2070,6,2015,6,0
Group 3,RRG,-1.5,5,14,2071,10,2015,7,3
Group 3,RRG,-1.5,5,14,2072,8,2015,10,-2
Group 3,RRG,-1.5,5,14,2073,2,2015,3,-1
Group 3,RRG,-1.5,5,14,2074,3,2015,7,-4
Group 3,RRG,-1.5,5,14,2075,5,2015,5,0
Group 3,RRG,-1.5,5,14,2076,3,2015,7,-4
Group 3,RRG,-1.5,5,14,2077,5,2015,5,0
Group 3,RRG,-1.5,5,14,2078,7,2015,8,-1
Group 3,RRG,-1.5,5,14,2079,3,2015,4,-1
Group 3,RRG,-1.5,5,14,2080,9,2015,6,3
Group 3,RRG,-1.5,5,14,2081,10,2015,10,0
Group 3,RRG,-1.5,5,14,2082,3,2015,6,-3
Group 3,RRG,-1.5,5,14,2083,8,2015,9,-1
Group 3,RRG,-1.5,5,14,2084,6,2015,3,3
Group 3,RRG,-1.5,5,14,2085,7,2015,11,-4
Group 3,RRG,-1.5,5,14,2086,6,2015,9,-3
Group 3,RRG,-1.5,5,14,2087,5,2015,9,-4
Group 3,RRG,-1.5,5,14,2088,4,2015,9,-5
Group 3,RRG,-1.5,5,14,2089,4,2015,6,-2
Group 3,RRG,-1.5,5,14,2090,6,2015,5,1
Group 3,RRG,-1.5,5,14,2091,10,2015,11,-1
Group 3,RRG,-1.5,5,14,2092,11,2015,8,3
Group 3,RRG,-1.5,5,14,2093,6,2015,11,-5
Group 3,RRG,-1.5,5,14,2094,8,2015,11,-3
Group 3,RRG,-1.5,5,14,2095,4,2015,7,-3
Group 3,RRG,-1.5,5,14,2096,9,2015,13,-4
Group 3,RRG,-1.5,5,14,2097,11,2015,11,0
Group 3,RRG,-1.5,5,14,2098,7,2015,10,-3
Group 3,RRG,-1.5,5,14,2099,8,2015,6,2
Group 3,RRG,-1.5,5,14,2100,5,2015,5,0
Group 3,RRG,-1.5,5,14,2101,3,2015,2,1
Group 3,RRG,-1.5,5,14,2102,4,2015,6,-2
Group 3,RRG,-1.5,5,14,2103,8,2015,6,2
Group 3,RRG,-1.5,5,14,2104,6,2015,6,0
Group 3,RRG,-1.5,5,14,2105,5,2015,8,-3
Group 3,RRG,-1.5,5,14,2106,5,2015,7,-2
Group 3,RRG,-1.5,5,14,2107,8,2015,8,0
Group 3,RRG,-1.5,5,14,2108,3,2015,4,-1
Group 3,RRG,-1.5,5,14,2109,8,2015,7,1
Group 3,RRG,-1.5,5,14,2110,8,2015,6,2
Group 3,RRG,-1.5,5,14,2111,7,2015,4,3
Group 3,RRG,-1.5,5,14,2112,5,2015,7,-2
Group 3,RRG,-1.5,5,14,2113,9,2015,8,1
Group 3,RRG,-1.5,5,14,2114,6,2015,4,2
Group 3,RRG,-1.5,5,14,2115,5,2015,7,-2
Group 3,RRG,-1.5,5,14,2116,8,2015,8,0
Group 3,RRG,-1.5,5,14,2117,8,2015,11,-3
Group 3,RRG,-1.5,5,14,2118,6,2015,6,0
Group 3,RRG,-1.5,5,14,2119,4,2015,3,1
Group 3,RRG,-1.5,5,14,2120,2,2015,7,-5
Group 3,RRG,-1.5,5,14,2121,4,2015,8,-4
Group 3,RRG,-1.5,5,14,2122,6,2015,4,2
Group 3,RRG,-1.5,5,14,2123,2,2015,4,-2
Group 3,RRG,-1.5,5,14,2124,6,2015,5,1
Group 3,RRG,-1.5,5,14,2125,9,2015,4,5
Group 3,RRG,-1.5,5,14,2126,6,2015,4,2
Group 3,RRG,-1.5,5,14,2127,8,2015,8,0
Group 3,RRG,-1.5,5,14,2128,7,2015,9,-2
Group 3,RRG,-1.5,5,14,2129,6,2015,6,0
Group 3,RRG,-1.5,5,14,2130,10,2015,8,2
Group 3,RRG,-1.5,5,14,2131,10,2015,6,4
Group 3,RRG,-1.5,5,14,2132,12,2015,5,7
Group 3,RRG,-1.5,5,14,2133,11,2015,8,3
Group 3,RRG,-1.5,5,14,2134,13,2015,7,6
Group 3,RRG,-1.5,5,14,2135,13,2015,6,7
Group 3,RRG,-1.5,5,14,2136,13,2015,5,8
Group 3,RRG,-1.5,5,14,2137,10,2015,5,5
Group 3,RRG,-1.5,5,14,2138,8,2015,5,3
Group 3,RRG,-1.5,5,14,2139,9,2015,8,1
Group 3,RRG,-1.5,5,14,2140,4,2015,9,-5
Group 3,RRG,-1.5,5,14,2141,1,2015,7,-6
Group 3,RRG,-1.5,5,14,2142,4,2015,6,-2
Group 3,RRG,-1.5,5,14,2143,3,2015,6,-3
Group 3,RRG,-1.5,5,14,2144,7,2015,7,0
Group 3,RRG,-1.5,5,14,2145,5,2015,5,0
Group 3,RRG,-1.5,5,14,2146,8,2015,9,-1
Group 3,RRG,-1.5,5,14,2147,2,2015,5,-3
Group 3,RRG,-1.5,5,14,2148,3,2015,5,-2
Group 3,RRG,-1.5,5,14,2149,5,2015,11,-6
Group 3,RRG,-1.5,5,14,2150,8,2015,5,3
Group 3,RRG,-1.5,5,14,2151,7,2015,3,4
Group 3,RRG,-1.5,5,14,2152,10,2015,9,1
Group 3,RRG,-1.5,5,14,2153,11,2015,11,0
Group 3,RRG,-1.5,5,14,2154,2,2015,0,2
Group 3,RRG,-1.5,5,14,2155,2,2015,4,-2
Group 3,RRG,-1.5,5,14,2156,3,2015,6,-3
Group 3,RRG,-1.5,5,14,2157,5,2015,3,2
Group 3,RRG,-1.5,5,14,2158,6,2015,4,2
Group 3,RRG,-1.5,5,14,2159,7,2015,8,-1
Group 3,RRG,-1.5,5,14,2160,9,2015,7,2
Group 3,RRG,-1.5,5,14,2161,5,2015,6,-1
Group 3,RRG,-1.5,5,14,2162,8,2015,8,0
Group 3,RRG,-1.5,5,14,2163,9,2015,5,4
Group 3,RRG,-1.5,5,14,2164,9,2015,5,4
Group 3,RRG,-1.5,5,14,2165,1,2015,4,-3
Group 3,RRG,-1.5,5,14,2166,9,2015,5,4
Group 3,RRG,-1.5,5,14,2167,9,2015,6,3
Group 3,RRG,-1.5,5,14,2168,5,2015,7,-2
Group 3,RRG,-1.5,5,14,2169,13,2015,10,3
Group 3,RRG,-1.5,5,14,2170,9,2015,8,1
Group 3,RRG,-1.5,5,14,2171,10,2015,6,4
Group 3,RRG,-1.5,5,14,2172,6,2015,5,1
Group 3,RRG,-1.5,5,14,2173,3,2015,10,-7
Group 3,RRG,-1.5,5,14,2174,5,2015,8,-3
Group 3,RRG,-1.5,5,14,2175,6,2015,10,-4
Group 3,RRG,-1.5,5,14,2176,4,2015,10,-6
Group 3,RRG,-1.5,5,14,2177,10,2015,5,5
Group 3,RRG,-1.5,5,14,2178,12,2015,8,4
Group 3,RRG,-1.5,5,14,2179,6,2015,7,-1
Group 3,RRG,-1.5,5,14,2180,8,2015,2,6
Group 3,RRG,-1.5,5,14,2181,7,2015,6,1
Group 3,RRG,-1.5,5,14,2182,6,2015,5,1
Group 3,RRG,-1.5,5,14,2183,8,2015,4,4
Group 3,RRG,-1.5,5,14,2184,9,2015,9,0
Group 3,RRG,-1.5,5,14,2185,6,2015,6,0
Group 3,RRG,-1.5,5,14,2186,8,2015,9,-1
Group 3,RRG,-1.5,5,14,2187,6,2015,3,3
Group 3,RRG,-1.5,5,14,2188,6,2015,5,1
Group 3,RRG,-1.5,5,14,2189,7,2015,7,0
Group 3,RRG,-1.5,5,14,2190,7,2015,7,0
Group 3,RRG,-1.5,5,14,2191,6,2015,9,-3
Group 3,RRG,-1.5,5,14,2192,11,2015,9,2
Group 3,RRG,-1.5,5,14,2193,10,2015,7,3
Group 3,RRG,-1.5,5,14,2194,6,2015,9,-3
Group 3,RRG,-1.5,5,14,2195,11,2015,9,2
Group 3,RRG,-1.5,5,14,2196,11,2015,7,4
Group 3,RRG,-1.5,5,14,2197,2,2015,4,-2
Group 3,RRG,-1.5,5,14,2198,5,2015,7,-2
Group 3,RRG,-1.5,5,14,2199,11,2015,10,1
Group 3,RRG,-1.5,5,14,2200,4,2015,4,0
Group 3,RRG,-1.5,5,14,2201,9,2015,10,-1
Group 3,RRG,-1.5,5,14,2202,5,2015,7,-2
Group 3,RRG,-1.5,5,14,2203,6,2015,6,0
Group 3,RRG,-1.5,5,14,2204,6,2015,5,1
Group 3,RRG,-1.5,5,14,2205,9,2015,2,7
Group 3,RRG,-1.5,5,14,2206,7,2015,5,2
Group 3,RRG,-1.5,5,14,2207,9,2015,6,3
Group 3,RRG,-1.5,5,14,2208,8,2015,8,0
Group 3,RRG,-1.5,5,14,2209,2,2015,7,-5
Group 3,RRG,-1.5,5,14,2210,11,2015,3,8
Group 3,RRG,-1.5,5,14,2211,10,2015,9,1
Group 3,RRG,-1.5,5,14,2212,7,2015,4,3
Group 3,RRG,-1.5,5,14,2213,6,2015,7,-1
Group 3,RRG,-1.5,5,14,2214,3,2015,7,-4
Group 3,RRG,-1.5,5,14,2215,2,2015,6,-4
Group 3,RRG,-1.5,5,14,2216,5,2015,6,-1
Group 3,RRG,-1.5,5,14,2217,3,2015,8,-5
Group 3,RRG,-1.5,5,14,2218,10,2015,8,2
Group 3,RRG,-1.5,5,14,2219,2,2015,4,-2
Group 3,RRG,-1.5,5,14,2220,4,2015,4,0
Group 3,RRG,-1.5,5,14,2221,5,2015,7,-2
Group 3,RRG,-1.5,5,14,2222,4,2015,4,0
Group 3,RRG,-1.5,5,14,2223,12,2015,8,4
Group 3,RRG,-1.5,5,14,2224,2,2015,5,-3
Group 3,RRG,-1.5,5,14,2225,5,2015,7,-2
Group 3,RRG,-1.5,5,14,2226,10,2015,6,4
Group 3,RRG,-1.5,5,14,2227,9,2015,9,0
Group 3,RRG,-1.5,5,14,2228,1,2015,5,-4
Group 3,RRG,-1.5,5,14,2229,7,2015,6,1
Group 3,RRG,-1.5,5,14,2230,9,2015,7,2
Group 3,RRG,-1.5,5,14,2231,7,2015,3,4
Group 3,RRG,-1.5,5,14,2232,4,2015,9,-5
Group 3,RRG,-1.5,5,14,2233,8,2015,6,2
Group 3,RRG,-1.5,5,14,2234,7,2015,5,2
Group 3,RRG,-1.5,5,14,2235,10,2015,13,-3
Group 3,RRG,-1.5,5,14,2236,7,2015,2,5
Group 3,RRG,-1.5,5,14,2237,6,2015,11,-5
Group 3,RRG,-1.5,5,14,2238,9,2015,8,1
Group 3,RRG,-1.5,5,14,2239,10,2015,7,3
Group 3,RRG,-1.5,5,14,2240,8,2015,7,1
Group 3,RRG,-1.5,5,14,2241,8,2015,9,-1
Group 3,RRG,-1.5,5,14,2242,6,2015,8,-2
Group 3,RRG,-1.5,5,14,2243,8,2015,9,-1
Group 3,RRG,-1.5,5,14,2244,5,2015,8,-3
Group 3,RRG,-1.5,5,14,2245,6,2015,5,1
Group 3,RRG,-1.5,5,14,2246,6,2015,6,0
Group 3,RRG,-1.5,5,14,2247,11,2015,10,1
Group 3,RRG,-1.5,5,14,2248,11,2015,8,3
Group 3,RRG,-1.5,5,14,2249,10,2015,9,1
Group 3,RRG,-1.5,5,14,2250,9,2015,6,3
Group 3,RRG,-1.5,5,14,2251,11,2015,9,2
Group 3,RRG,-1.5,5,14,2252,13,2015,10,3
Group 3,RRG,-1.5,5,14,2253,8,2015,6,2
Group 3,RRG,-1.5,5,14,2254,10,2015,6,4
Group 3,RRG,-1.5,5,14,2255,8,2015,7,1
Group 3,RRG,-1.5,5,14,2256,3,2015,10,-7
Group 3,RRG,-1.5,5,14,2257,3,2015,8,-5
Group 3,RRG,-1.5,5,14,2258,9,2015,7,2
Group 3,RRG,-1.5,5,14,2259,4,2015,3,1
Group 3,RRG,-1.5,5,14,2260,4,2015,8,-4
Group 3,RRG,-1.5,5,14,2261,9,2015,6,3
Group 3,RRG,-1.5,5,14,2262,9,2015,5,4
Group 3,RRG,-1.5,5,14,2263,5,2015,6,-1
Group 3,RRG,-1.5,5,14,2264,7,2015,3,4
Group 3,RRG,-1.5,5,14,2265,3,2015,7,-4
Group 3,RRG,-1.5,5,14,2266,8,2015,6,2
Group 3,RRG,-1.5,5,14,2267,6,2015,6,0
Group 3,RRG,-1.5,5,14,2268,11,2015,8,3
Group 3,RRG,-1.5,5,14,2269,6,2015,5,1
Group 3,RRG,-1.5,5,14,2270,8,2015,9,-1
Group 3,RRG,-1.5,5,14,2271,5,2015,6,-1
Group 3,RRG,-1.5,5,14,2272,5,2015,3,2
Group 3,RRG,-1.5,5,14,2273,6,2015,6,0
Group 3,RRG,-1.5,5,14,2274,10,2015,9,1
Group 3,RRG,-1.5,5,14,2275,3,2015,6,-3
Group 3,RRG,-1.5,5,14,2276,0,2015,7,-7
Group 3,RRG,-1.5,5,14,2277,5,2015,12,-7
Group 3,RRG,-1.5,5,14,2278,6,2015,6,0
Group 3,RRG,-1.5,5,14,2279,4,2015,8,-4
Group 3,RRG,-1.5,5,14,2280,5,2015,7,-2
Group 3,RRG,-1.5,5,14,2281,6,2015,9,-3
Group 3,RRG,-1.5,5,14,2282,7,2015,5,2
Group 3,RRG,-1.5,5,14,2283,6,2015,2,4
Group 3,RRG,-1.5,5,14,2284,6,2015,8,-2
Group 3,RRG,-1.5,5,14,2285,4,2015,7,-3
Group 3,RRG,-1.5,5,14,2286,5,2015,8,-3
Group 3,RRG,-1.5,5,14,2287,1,2015,9,-8
Group 3,RRG,-1.5,5,14,2288,4,2015,8,-4
Group 3,RRG,-1.5,5,14,2289,10,2015,9,1
Group 3,RRG,-1.5,5,14,2290,7,2015,8,-1
Group 3,RRG,-1.5,5,14,2291,8,2015,4,4
Group 3,RRG,-1.5,5,14,2292,3,2015,7,-4
Group 3,RRG,-1.5,5,14,2293,3,2015,7,-4
Group 3,RRG,-1.5,5,14,2294,8,2015,6,2
Group 3,RRG,-1.5,5,14,2295,7,2015,8,-1
Group 3,RRG,-1.5,5,14,2296,10,2015,7,3
Group 3,RRG,-1.5,5,14,2297,8,2015,5,3
Group 3,RRG,-1.5,5,14,2298,7,2015,6,1
Group 3,RRG,-1.5,5,14,2299,6,2015,5,1
Group 3,RRG,-1.5,5,14,2300,6,2015,4,2
Group 3,RRG,-1.5,5,14,2301,6,2015,9,-3
Group 3,RRG,-1.5,5,14,2302,5,2015,4,1
Group 3,RRG,-1.5,5,14,2303,7,2015,9,-2
Group 3,RRG,-1.5,5,14,2304,2,2015,4,-2
Group 3,RRG,-1.5,5,14,2305,6,2015,7,-1
Group 3,RRG,-1.5,5,14,2306,3,2015,5,-2
Group 3,RRG,-1.5,5,14,2307,2,2015,1,1
Group 3,RRG,-1.5,5,14,2308,5,2015,7,-2
Group 3,RRG,-1.5,5,14,2309,1,2015,3,-2
Group 3,RRG,-1.5,5,14,2310,8,2015,9,-1
Group 3,RRG,-1.5,5,14,2311,7,2015,9,-2
Group 3,RRG,-1.5,5,14,2312,4,2015,4,0
Group 3,RRG,-1.5,5,14,2313,4,2015,4,0
Group 3,RRG,-1.5,5,14,2314,5,2015,0,5
Group 3,RRG,-1.5,5,14,2315,5,2015,8,-3
Group 3,RRG,-1.5,5,14,2316,7,2015,3,4
Group 3,RRG,-1.5,5,14,2317,6,2015,9,-3
Group 3,RRG,-1.5,5,14,2318,4,2015,7,-3
Group 3,RRG,-1.5,5,14,2319,9,2015,6,3
Group 3,RRG,-1.5,5,14,2320,8,2015,13,-5
Group 3,RRG,-1.5,5,14,2321,7,2015,3,4
Group 3,RRG,-1.5,5,14,2322,8,2015,4,4
Group 3,RRG,-1.5,5,14,2323,4,2015,11,-7
Group 3,RRG,-1.5,5,14,2324,3,2015,10,-7
Group 3,RRG,-1.5,5,14,2325,4,2015,6,-2
Group 3,RRG,-1.5,5,14,2326,9,2015,9,0
Group 3,RRG,-1.5,5,14,2327,6,2015,5,1
Group 3,RRG,-1.5,5,14,2328,6,2015,5,1
Group 3,RRG,-1.5,5,14,2329,6,2015,5,1
Group 3,RRG,-1.5,5,14,2330,7,2015,4,3
Group 3,RRG,-1.5,5,14,2331,6,2015,4,2
Group 3,RRG,-1.5,5,14,2332,8,2015,7,1
Group 3,RRG,-1.5,5,14,2333,9,2015,7,2
Group 3,RRG,-1.5,5,14,2334,9,2015,6,3
Group 3,RRG,-1.5,5,14,2335,7,2015,3,4
Group 3,RRG,-1.5,5,14,2336,10,2015,10,0
Group 3,RRG,-1.5,5,14,2337,5,2015,6,-1
Group 3,RRG,-1.5,5,14,2338,8,2015,7,1
Group 3,RRG,-1.5,5,14,2339,7,2015,5,2
Group 3,RRG,-1.5,5,14,2340,7,2015,6,1
Group 3,RRG,-1.5,5,14,2341,5,2015,5,0
Group 3,RRG,-1.5,5,14,2342,7,2015,5,2
Group 3,RRG,-1.5,5,14,2343,9,2015,5,4
Group 3,RRG,-1.5,5,14,2344,12,2015,10,2
Group 3,RRG,-1.5,5,14,2345,4,2015,3,1
Group 3,RRG,-1.5,5,14,2346,9,2015,5,4
Group 3,RRG,-1.5,5,14,2347,1,2015,5,-4
Group 3,RRG,-1.5,5,14,2348,11,2015,8,3
Group 3,RRG,-1.5,5,14,2349,7,2015,1,6
Group 3,RRG,-1.5,5,14,2350,7,2015,8,-1
Group 3,RRG,-1.5,5,14,2351,7,2015,6,1
Group 3,RRG,-1.5,5,14,2352,7,2015,6,1
Group 3,RRG,-1.5,5,14,2353,10,2015,7,3
Group 3,RRG,-1.5,5,14,2354,6,2015,1,5
Group 3,RRG,-1.5,5,14,2355,11,2015,8,3
Group 3,RRG,-1.5,5,14,2356,8,2015,12,-4
Group 3,RRG,-1.5,5,14,2357,10,2015,9,1
Group 3,RRG,-1.5,5,14,2358,6,2015,8,-2
Group 3,RRG,-1.5,5,14,2359,5,2015,3,2
Group 3,RRG,-1.5,5,14,2360,8,2015,7,1
Group 3,RRG,-1.5,5,14,2361,10,2015,10,0
Group 3,RRG,-1.5,5,14,2362,10,2015,9,1
Group 3,RRG,-1.5,5,14,2363,5,2015,7,-2
Group 3,RRG,-1.5,5,14,2364,4,2015,7,-3
Group 3,RRG,-1.5,5,14,2365,8,2015,10,-2
Group 3,RRG,-1.5,5,14,2366,7,2015,6,1
Group 3,RRG,-1.5,5,14,2367,3,2015,6,-3
Group 3,RRG,-1.5,5,14,2368,3,2015,9,-6
Group 3,RRG,-1.5,5,14,2369,6,2015,4,2
Group 3,RRG,-1.5,5,14,2370,1,2015,2,-1
Group 3,RRG,-1.5,5,14,2371,2,2015,7,-5
Group 3,RRG,-1.5,5,14,2372,5,2015,6,-1
Group 3,RRG,-1.5,5,14,2373,4,2015,7,-3
Group 3,RRG,-1.5,5,14,2374,9,2015,11,-2
Group 3,RRG,-1.5,5,14,2375,3,2015,10,-7
Group 3,RRG,-1.5,5,14,2376,9,2015,7,2
Group 3,RRG,-1.5,5,14,2377,9,2015,5,4
Group 3,RRG,-1.5,5,14,2378,10,2015,8,2
Group 3,RRG,-1.5,5,14,2379,3,2015,2,1
Group 3,RRG,-1.5,5,14,2380,11,2015,5,6
Group 3,RRG,-1.5,5,14,2381,6,2015,3,3
Group 3,RRG,-1.5,5,14,2382,3,2015,5,-2
Group 3,RRG,-1.5,5,14,2383,7,2015,7,0
Group 3,RRG,-1.5,5,14,2384,13,2015,9,4
Group 3,RRG,-1.5,5,14,2385,6,2015,5,1
Group 3,RRG,-1.5,5,14,2386,6,2015,10,-4
Group 3,RRG,-1.5,5,14,2387,9,2015,5,4
Group 3,RRG,-1.5,5,14,2388,7,2015,5,2
Group 3,RRG,-1.5,5,14,2389,10,2015,10,0
Group 3,RRG,-1.5,5,14,2390,10,2015,13,-3
Group 3,RRG,-1.5,5,14,2391,10,2015,4,6
Group 3,RRG,-1.5,5,14,2392,11,2015,4,7
Group 3,RRG,-1.5,5,14,2393,4,2015,5,-1
Group 3,RRG,-1.5,5,14,2394,7,2015,7,0
Group 3,RRG,-1.5,5,14,2395,3,2015,8,-5
Group 3,RRG,-1.5,5,14,2396,9,2015,8,1
Group 3,RRG,-1.5,5,14,2397,11,2015,3,8
Group 3,RRG,-1.5,5,14,2398,0,2015,3,-3
Group 3,RRG,-1.5,5,14,2399,3,2015,11,-8
Group 3,RRG,-1.5,5,14,2400,9,2015,5,4
Group 3,RRG,-1.5,5,14,2401,8,2015,4,4
Group 3,RRG,-1.5,5,14,2402,9,2015,7,2
Group 3,RRG,-1.5,5,14,2403,5,2015,3,2
Group 3,RRG,-1.5,5,14,2404,10,2015,6,4
Group 3,RRG,-1.5,5,14,2405,11,2015,8,3
Group 3,RRG,-1.5,5,14,2406,3,2015,5,-2
Group 3,RRG,-1.5,5,14,2407,4,2015,5,-1
Group 3,RRG,-1.5,5,14,2408,7,2015,10,-3
Group 3,RRG,-1.5,5,14,2409,11,2015,6,5
Group 3,RRG,-1.5,5,14,2410,9,2015,11,-2
Group 3,RRG,-1.5,5,14,2411,7,2015,4,3
Group 3,RRG,-1.5,5,14,2412,6,2015,4,2
Group 3,RRG,-1.5,5,14,2413,5,2015,6,-1
Group 3,RRG,-1.5,5,14,2414,6,2015,10,-4
Group 3,RRG,-1.5,5,14,2415,7,2015,5,2
Group 3,RRG,-1.5,5,14,2416,9,2015,6,3
Group 3,RRG,-1.5,5,14,2417,9,2015,10,-1
Group 3,RRG,-1.5,5,14,2418,6,2015,11,-5
Group 3,RRG,-1.5,5,14,2419,4,2015,3,1
Group 3,RRG,-1.5,5,14,2420,9,2015,4,5
Group 3,RRG,-1.5,5,14,2421,5,2015,5,0
Group 3,RRG,-1.5,5,14,2422,7,2015,9,-2
Group 3,RRG,-1.5,5,14,2423,4,2015,4,0
Group 3,RRG,-1.5,5,14,2424,7,2015,10,-3
Group 3,RRG,-1.5,5,14,2425,2,2015,7,-5
Group 3,RRG,-1.5,5,14,2426,7,2015,2,5
Group 3,RRG,-1.5,5,14,2427,3,2015,6,-3
Group 3,RRG,-1.5,5,14,2428,4,2015,4,0
Group 3,RRG,-1.5,5,14,2429,9,2015,5,4
Group 3,RRG,-1.5,5,14,2430,11,2015,3,8
Group 3,RRG,-1.5,5,14,2431,8,2015,4,4
Group 3,RRG,-1.5,5,14,2432,2,2015,7,-5
Group 3,RRG,-1.5,5,14,2433,10,2015,9,1
Group 3,RRG,-1.5,5,14,2434,4,2015,6,-2
Group 3,RRG,-1.5,5,14,2435,0,2015,5,-5
Group 3,RRG,-1.5,5,14,2436,8,2015,11,-3
Group 3,RRG,-1.5,5,14,2437,7,2015,7,0
Group 3,RRG,-1.5,5,14,2438,3,2015,6,-3
Group 3,RRG,-1.5,5,14,2439,12,2015,7,5
Group 3,RRG,-1.5,5,14,2440,8,2015,5,3
Group 3,RRG,-1.5,5,14,2441,10,2015,8,2
Group 3,RRG,-1.5,5,14,2442,8,2015,8,0
Group 3,RRG,-1.5,5,14,2443,2,2015,6,-4
Group 3,RRG,-1.5,5,14,2444,6,2015,11,-5
Group 3,RRG,-1.5,5,14,2445,7,2015,7,0
Group 3,RRG,-1.5,5,14,2446,8,2015,3,5
Group 3,RRG,-1.5,5,14,2447,7,2015,6,1
Group 3,RRG,-1.5,5,14,2448,2,2015,3,-1
Group 3,RRG,-1.5,5,14,2449,5,2015,5,0
Group 3,RRG,-1.5,5,14,2450,6,2015,9,-3
Group 3,RRG,-1.5,5,14,2451,3,2015,3,0
Group 3,RRG,-1.5,5,14,2452,4,2015,5,-1
Group 3,RRG,-1.5,5,14,2453,5,2015,5,0
Group 3,RRG,-1.5,5,14,2454,3,2015,4,-1
Group 3,RRG,-1.5,5,14,2455,3,2015,7,-4
Group 3,RRG,-1.5,5,14,2456,9,2015,6,3
Group 3,RRG,-1.5,5,14,2457,8,2015,5,3
Group 3,RRG,-1.5,5,14,2458,7,2015,4,3
Group 3,RRG,-1.5,5,14,2459,7,2015,5,2
Group 3,RRG,-1.5,5,14,2460,12,2015,8,4
Group 3,RRG,-1.5,5,14,2461,10,2015,4,6
Group 3,RRG,-1.5,5,14,2462,4,2015,4,0
Group 3,RRG,-1.5,5,14,2463,2,2015,5,-3
Group 3,RRG,-1.5,5,14,2464,6,2015,5,1
Group 3,RRG,-1.5,5,14,2465,9,2015,7,2
Group 3,RRG,-1.5,5,14,2466,9,2015,10,-1
Group 3,RRG,-1.5,5,14,2467,8,2015,7,1
Group 3,RRG,-1.5,5,14,2468,8,2015,7,1
Group 3,RRG,-1.5,5,14,2469,14,2015,8,6
Group 3,RRG,-1.5,5,14,2470,10,2015,6,4
Group 3,RRG,-1.5,5,14,2471,9,2015,8,1
Group 3,RRG,-1.5,5,14,2472,10,2015,6,4
Group 3,RRG,-1.5,5,14,2473,9,2015,6,3
Group 3,RRG,-1.5,5,14,2474,10,2015,9,1
Group 3,RRG,-1.5,5,14,2475,9,2015,5,4
Group 3,RRG,-1.5,5,14,2476,12,2015,11,1
Group 3,RRG,-1.5,5,14,2477,4,2015,5,-1
Group 3,RRG,-1.5,5,14,2478,9,2015,6,3
Group 3,RRG,-1.5,5,14,2479,3,2015,8,-5
Group 3,RRG,-1.5,5,14,2480,0,2015,6,-6
Group 3,RRG,-1.5,5,14,2481,8,2015,8,0
Group 3,RRG,-1.5,5,14,2482,12,2015,11,1
Group 3,RRG,-1.5,5,14,2483,4,2015,7,-3
Group 3,RRG,-1.5,5,14,2484,5,2015,5,0
Group 3,RRG,-1.5,5,14,2485,7,2015,7,0
Group 3,RRG,-1.5,5,14,2486,7,2015,10,-3
Group 3,RRG,-1.5,5,14,2487,9,2015,8,1
Group 3,RRG,-1.5,5,14,2488,7,2015,8,-1
Group 3,RRG,-1.5,5,14,2489,7,2015,6,1
Group 3,RRG,-1.5,5,14,2490,3,2015,5,-2
Group 3,RRG,-1.5,5,14,2491,3,2015,10,-7
Group 3,RRG,-1.5,5,14,2492,8,2015,5,3
Group 3,RRG,-1.5,5,14,2493,8,2015,11,-3
Group 3,RRG,-1.5,5,14,2494,6,2015,8,-2
Group 3,RRG,-1.5,5,14,2495,6,2015,7,-1
Group 3,RRG,-1.5,5,14,2496,11,2015,8,3
Group 3,RRG,-1.5,5,14,2497,8,2015,10,-2
Group 3,RRG,-1.5,5,14,2498,4,2015,4,0
Group 3,RRG,-1.5,5,14,2499,6,2015,5,1
Group 3,RRG,-1.5,5,14,2500,9,2015,8,1
Group 3,RRG,-1.5,5,14,2501,7,2015,4,3
Group 3,RRG,-1.5,5,14,2502,1,2015,4,-3
Group 3,RRG,-1.5,5,14,2503,3,2015,7,-4
Group 3,RRG,-1.5,5,14,2504,6,2015,9,-3
Group 3,RRG,-1.5,5,14,2505,2,2015,4,-2
Group 3,RRG,-1.5,5,14,2506,4,2015,1,3
Group 3,RRG,-1.5,5,14,2507,0,2015,2,-2
Group 3,RRG,-1.5,5,14,2508,3,2015,6,-3
Group 3,RRG,-1.5,5,14,2509,2,2015,6,-4
Group 3,RRG,-1.5,5,14,2510,5,2015,9,-4
Group 3,RRG,-1.5,5,14,2511,3,2015,6,-3
Group 3,RRG,-1.5,5,14,2512,3,2015,8,-5
Group 3,RRG,-1.5,5,14,2513,4,2015,10,-6
Group 3,RRG,-1.5,5,14,2514,3,2015,5,-2
Group 3,RRG,-1.5,5,14,2515,5,2015,10,-5
Group 3,RRG,-1.5,5,14,2516,6,2015,8,-2
Group 3,RRG,-1.5,5,14,2517,8,2015,10,-2
Group 3,RRG,-1.5,5,14,2518,7,2015,8,-1
Group 3,RRG,-1.5,5,14,2519,6,2015,6,0
Group 3,RRG,-1.5,5,14,2520,4,2015,9,-5
Group 3,RRG,-1.5,5,14,2521,4,2015,4,0
Group 3,RRG,-1.5,5,14,2522,3,2015,6,-3
Group 3,RRG,-1.5,5,14,2523,4,2015,5,-1
Group 3,RRG,-1.5,5,14,2524,8,2015,5,3
Group 3,RRG,-1.5,5,14,2525,8,2015,10,-2
Group 3,RRG,-1.5,5,14,2526,6,2015,8,-2
Group 3,RRG,-1.5,5,14,2527,8,2015,8,0
Group 3,RRG,-1.5,5,14,2528,6,2015,8,-2
Group 3,RRG,-1.5,5,14,2529,9,2015,9,0
Group 3,RRG,-1.5,5,14,2530,8,2015,1,7
Group 3,RRG,-1.5,5,14,2531,9,2015,7,2
Group 3,RRG,-1.5,5,14,2532,9,2015,11,-2
Group 3,RRG,-1.5,5,14,2533,7,2015,7,0
Group 3,RRG,-1.5,5,14,2534,6,2015,9,-3
Group 3,RRG,-1.5,5,14,2535,8,2015,6,2
Group 3,RRG,-1.5,5,14,2536,9,2015,10,-1
Group 3,RRG,-1.5,5,14,2537,7,2015,8,-1
Group 3,RRG,-1.5,5,14,2538,5,2015,3,2
Group 3,RRG,-1.5,5,14,2539,2,2015,7,-5
Group 3,RRG,-1.5,5,14,2540,4,2015,6,-2
Group 3,RRG,-1.5,5,14,2541,4,2015,8,-4
Group 3,RRG,-1.5,5,14,2542,7,2015,8,-1
Group 3,RRG,-1.5,5,14,2543,9,2015,5,4
Group 3,RRG,-1.5,5,14,2544,4,2015,9,-5
Group 3,RRG,-1.5,5,14,2545,9,2015,12,-3
Group 3,RRG,-1.5,5,14,2546,9,2015,11,-2
Group 3,RRG,-1.5,5,14,2547,5,2015,8,-3
Group 3,RRG,-1.5,5,14,2548,4,2015,2,2
Group 3,RRG,-1.5,5,14,2549,7,2015,11,-4
Group 3,RRG,-1.5,5,14,2550,10,2015,9,1
Group 3,RRG,-1.5,5,14,2551,3,2015,2,1
Group 3,RRG,-1.5,5,14,2552,9,2015,8,1
Group 3,RRG,-1.5,5,14,2553,7,2015,6,1
Group 3,RRG,-1.5,5,14,2554,5,2015,4,1
Group 3,RRG,-1.5,5,14,2555,7,2015,9,-2
Group 3,RRG,-1.5,5,14,2556,12,2015,4,8
Group 3,RRG,-1.5,5,14,2557,5,2015,4,1
Group 3,RRG,-1.5,5,14,2558,8,2015,5,3
Group 3,RRG,-1.5,5,14,2559,2,2015,4,-2
Group 3,RRG,-1.5,5,14,2560,4,2015,5,-1
Group 3,RRG,-1.5,5,14,2561,6,2015,11,-5
Group 3,RRG,-1.5,5,14,2562,9,2015,6,3
Group 3,RRG,-1.5,5,14,2563,5,2015,6,-1
Group 3,RRG,-1.5,5,14,2564,3,2015,4,-1
Group 3,RRG,-1.5,5,14,2565,3,2015,6,-3
Group 3,RRG,-1.5,5,14,2566,9,2015,8,1
Group 3,RRG,-1.5,5,14,2567,10,2015,7,3
Group 3,RRG,-1.5,5,14,2568,10,2015,8,2
Group 3,RRG,-1.5,5,14,2569,7,2015,4,3
Group 3,RRG,-1.5,5,14,2570,6,2015,7,-1
Group 3,RRG,-1.5,5,14,2571,9,2015,8,1
Group 3,RRG,-1.5,5,14,2572,3,2015,4,-1
Group 3,RRG,-1.5,5,14,2573,3,2015,8,-5
Group 3,RRG,-1.5,5,14,2574,7,2015,8,-1
Group 3,RRG,-1.5,5,14,2575,8,2015,5,3
Group 3,RRG,-1.5,5,14,2576,4,2015,7,-3
Group 3,RRG,-1.5,5,14,2577,8,2015,5,3
Group 3,RRG,-1.5,5,14,2578,8,2015,9,-1
Group 3,RRG,-1.5,5,14,2579,6,2015,8,-2
Group 3,RRG,-1.5,5,14,2580,6,2015,8,-2
Group 3,RRG,-1.5,5,14,2581,6,2015,5,1
Group 3,RRG,-1.5,5,14,2582,6,2015,8,-2
Group 3,RRG,-1.5,5,14,2583,5,2015,4,1
Group 3,RRG,-1.5,5,14,2584,8,2015,4,4
Group 3,RRG,-1.5,5,14,2585,6,2015,5,1
Group 3,RRG,-1.5,5,14,2586,6,2015,4,2
Group 3,RRG,-1.5,5,14,2587,4,2015,8,-4
Group 3,RRG,-1.5,5,14,2588,3,2015,8,-5
Group 3,RRG,-1.5,5,14,2589,6,2015,5,1
Group 3,RRG,-1.5,5,14,2590,3,2015,8,-5
Group 3,RRG,-1.5,5,14,2591,7,2015,5,2
Group 3,RRG,-1.5,5,14,2592,2,2015,4,-2
Group 3,RRG,-1.5,5,14,2593,11,2015,11,0
Group 3,RRG,-1.5,5,14,2594,0,2015,5,-5
Group 3,RRG,-1.5,5,14,2595,8,2015,6,2
Group 3,RRG,-1.5,5,14,2596,7,2015,12,-5
Group 3,RRG,-1.5,5,14,2597,7,2015,7,0
Group 3,RRG,-1.5,5,14,2598,4,2015,5,-1
Group 3,RRG,-1.5,5,14,2599,7,2015,5,2
Group 3,RRG,-1.5,5,14,2600,5,2015,8,-3
Group 3,RRG,-1.5,5,14,2601,4,2015,5,-1
Group 3,RRG,-1.5,5,14,2602,5,2015,6,-1
Group 3,RRG,-1.5,5,14,2603,6,2015,5,1
Group 3,RRG,-1.5,5,14,2604,5,2015,10,-5
Group 3,RRG,-1.5,5,14,2605,3,2015,11,-8
Group 3,RRG,-1.5,5,14,2606,4,2015,8,-4
Group 3,RRG,-1.5,5,14,2607,9,2015,10,-1
Group 3,RRG,-1.5,5,14,2608,9,2015,10,-1
Group 3,RRG,-1.5,5,14,2609,4,2015,6,-2
Group 3,RRG,-1.5,5,14,2610,2,2015,2,0
Group 3,RRG,-1.5,5,14,2611,7,2015,7,0
Group 3,RRG,-1.5,5,14,2612,11,2015,4,7
Group 3,RRG,-1.5,5,14,2613,7,2015,7,0
Group 3,RRG,-1.5,5,14,2614,8,2015,9,-1
Group 3,RRG,-1.5,5,14,2615,4,2015,7,-3
Group 3,RRG,-1.5,5,14,2616,9,2015,10,-1
Group 3,RRG,-1.5,5,14,2617,9,2015,1,8
Group 3,RRG,-1.5,5,14,2618,8,2015,9,-1
Group 3,RRG,-1.5,5,14,2619,8,2015,5,3
Group 3,RRG,-1.5,5,14,2620,3,2015,9,-6
Group 3,RRG,-1.5,5,14,2621,6,2015,6,0
Group 3,RRG,-1.5,5,14,2622,10,2015,9,1
Group 3,RRG,-1.5,5,14,2623,11,2015,6,5
Group 3,RRG,-1.5,5,14,2624,6,2015,3,3
Group 3,RRG,-1.5,5,14,2625,4,2015,6,-2
Group 3,RRG,-1.5,5,14,2626,6,2015,5,1
Group 3,RRG,-1.5,5,14,2627,6,2015,9,-3
Group 3,RRG,-1.5,5,14,2628,3,2015,5,-2
Group 3,RRG,-1.5,5,14,2629,9,2015,8,1
Group 3,RRG,-1.5,5,14,2630,9,2015,8,1
Group 3,RRG,-1.5,5,14,2631,7,2015,4,3
Group 3,RRG,-1.5,5,14,2632,2,2015,7,-5
Group 3,RRG,-1.5,5,14,2633,11,2015,10,1
Group 3,RRG,-1.5,5,14,2634,4,2015,4,0
Group 3,RRG,-1.5,5,14,2635,6,2015,2,4
Group 3,RRG,-1.5,5,14,2636,7,2015,5,2
Group 3,RRG,-1.5,5,14,2637,1,2015,2,-1
Group 3,RRG,-1.5,5,14,2638,4,2015,6,-2
Group 3,RRG,-1.5,5,14,2639,8,2015,8,0
Group 3,RRG,-1.5,5,14,2640,8,2015,7,1
Group 3,RRG,-1.5,5,14,2641,7,2015,10,-3
Group 3,RRG,-1.5,5,14,2642,9,2015,10,-1
Group 3,RRG,-1.5,5,14,2643,9,2015,8,1
Group 3,RRG,-1.5,5,14,2644,9,2015,9,0
Group 3,RRG,-1.5,5,14,2645,2,2015,6,-4
Group 3,RRG,-1.5,5,14,2646,4,2015,4,0
Group 3,RRG,-1.5,5,14,2647,5,2015,7,-2
Group 3,RRG,-1.5,5,14,2648,7,2015,6,1
Group 3,RRG,-1.5,5,14,2649,6,2015,9,-3
Group 3,RRG,-1.5,5,14,2650,2,2015,6,-4
Group 3,RRG,-1.5,5,14,2651,3,2015,6,-3
Group 3,RRG,-1.5,5,14,2652,3,2015,4,-1
Group 3,RRG,-1.5,5,14,2653,4,2015,8,-4
Group 3,RRG,-1.5,5,14,2654,9,2015,7,2
Group 3,RRG,-1.5,5,14,2655,7,2015,9,-2
Group 3,RRG,-1.5,5,14,2656,7,2015,2,5
Group 3,RRG,-1.5,5,14,2657,10,2015,8,2
Group 3,RRG,-1.5,5,14,2658,7,2015,4,3
Group 3,RRG,-1.5,5,14,2659,9,2015,11,-2
Group 3,RRG,-1.5,5,14,2660,8,2015,4,4
Group 3,RRG,-1.5,5,14,2661,5,2015,7,-2
Group 3,RRG,-1.5,5,14,2662,2,2015,2,0
Group 3,RRG,-1.5,5,14,2663,11,2015,4,7
Group 3,RRG,-1.5,5,14,2664,10,2015,7,3
Group 3,RRG,-1.5,5,14,2665,4,2015,4,0
Group 3,RRG,-1.5,5,14,2666,8,2015,8,0
Group 3,RRG,-1.5,5,14,2667,9,2015,5,4
Group 3,RRG,-1.5,5,14,2668,9,2015,6,3
Group 3,RRG,-1.5,5,14,2669,6,2015,4,2
Group 3,RRG,-1.5,5,14,2670,7,2015,10,-3
Group 3,RRG,-1.5,5,14,2671,8,2015,5,3
Group 3,RRG,-1.5,5,14,2672,5,2015,9,-4
Group 3,RRG,-1.5,5,14,2673,11,2015,8,3
Group 3,RRG,-1.5,5,14,2674,7,2015,11,-4
Group 3,RRG,-1.5,5,14,2675,8,2015,8,0
Group 3,RRG,-1.5,5,14,2676,5,2015,4,1
Group 3,RRG,-1.5,5,14,2677,6,2015,8,-2
Group 3,RRG,-1.5,5,14,2678,7,2015,10,-3
Group 3,RRG,-1.5,5,14,2679,5,2015,7,-2
Group 3,RRG,-1.5,5,14,2680,6,2015,7,-1
Group 3,RRG,-1.5,5,14,2681,8,2015,11,-3
Group 3,RRG,-1.5,5,14,2682,4,2015,10,-6
Group 3,RRG,-1.5,5,14,2683,10,2015,11,-1
Group 3,RRG,-1.5,5,14,2684,11,2015,13,-2
Group 3,RRG,-1.5,5,14,2685,4,2015,5,-1
Group 3,RRG,-1.5,5,14,2686,11,2015,8,3
Group 3,RRG,-1.5,5,14,2687,6,2015,11,-5
Group 3,RRG,-1.5,5,14,2688,4,2015,4,0
Group 3,RRG,-1.5,5,14,2689,3,2015,10,-7
Group 3,RRG,-1.5,5,14,2690,10,2015,6,4
Group 3,RRG,-1.5,5,14,2691,9,2015,10,-1
Group 3,RRG,-1.5,5,14,2692,11,2015,11,0
Group 3,RRG,-1.5,5,14,2693,7,2015,10,-3
Group 3,RRG,-1.5,5,14,2694,5,2015,8,-3
Group 3,RRG,-1.5,5,14,2695,6,2015,7,-1
Group 3,RRG,-1.5,5,14,2696,6,2015,4,2
Group 3,RRG,-1.5,5,14,2697,6,2015,11,-5
Group 3,RRG,-1.5,5,14,2698,6,2015,5,1
Group 3,RRG,-1.5,5,14,2699,4,2015,7,-3
Group 3,RRG,-1.5,5,14,2700,1,2015,4,-3
Group 3,RRG,-1.5,5,14,2701,12,2015,11,1
Group 3,RRG,-1.5,5,14,2702,9,2015,4,5
Group 3,RRG,-1.5,5,14,2703,13,2015,8,5
Group 3,RRG,-1.5,5,14,2704,7,2015,8,-1
Group 3,RRG,-1.5,5,14,2705,8,2015,6,2
Group 3,RRG,-1.5,5,14,2706,7,2015,9,-2
Group 3,RRG,-1.5,5,14,2707,5,2015,8,-3
Group 3,RRG,-1.5,5,14,2708,4,2015,7,-3
Group 3,RRG,-1.5,5,14,2709,8,2015,8,0
Group 3,RRG,-1.5,5,14,2710,3,2015,6,-3
Group 3,RRG,-1.5,5,14,2711,14,2015,8,6
Group 3,RRG,-1.5,5,14,2712,5,2015,5,0
Group 3,RRG,-1.5,5,14,2713,1,2015,11,-10
Group 3,RRG,-1.5,5,14,2714,2,2015,4,-2
Group 3,RRG,-1.5,5,14,2715,11,2015,7,4
Group 3,RRG,-1.5,5,14,2716,3,2015,5,-2
Group 3,RRG,-1.5,5,14,2717,5,2015,4,1
Group 3,RRG,-1.5,5,14,2718,9,2015,8,1
Group 3,RRG,-1.5,5,14,2719,11,2015,4,7
Group 3,RRG,-1.5,5,14,2720,6,2015,6,0
Group 3,RRG,-1.5,5,14,2721,3,2015,5,-2
Group 3,RRG,-1.5,5,14,2722,6,2015,9,-3
Group 3,RRG,-1.5,5,14,2723,6,2015,10,-4
Group 3,RRG,-1.5,5,14,2724,6,2015,7,-1
Group 3,RRG,-1.5,5,14,2725,1,2015,2,-1
Group 3,RRG,-1.5,5,14,2726,1,2015,3,-2
Group 3,RRG,-1.5,5,14,2727,2,2015,0,2
Group 3,RRG,-1.5,5,14,2728,0,2015,3,-3
Group 3,RRG,-1.5,5,14,2729,3,2015,6,-3
Group 3,RRG,-1.5,5,14,2730,5,2015,6,-1
Group 3,RRG,-1.5,5,14,2731,8,2015,6,2
Group 3,RRG,-1.5,5,14,2732,5,2015,6,-1
Group 3,RRG,-1.5,5,14,2733,3,2015,6,-3
Group 3,RRG,-1.5,5,14,2734,3,2015,7,-4
Group 3,RRG,-1.5,5,14,2735,2,2015,6,-4
Group 3,RRG,-1.5,5,14,2736,8,2015,7,1
Group 3,RRG,-1.5,5,14,2737,7,2015,7,0
Group 3,RRG,-1.5,5,14,2738,8,2015,10,-2
Group 3,RRG,-1.5,5,14,2739,10,2015,10,0
Group 3,RRG,-1.5,5,14,2740,12,2015,10,2
Group 3,RRG,-1.5,5,14,2741,10,2015,11,-1
Group 3,RRG,-1.5,5,14,2742,6,2015,5,1
Group 3,RRG,-1.5,5,14,2743,4,2015,4,0
Group 3,RRG,-1.5,5,14,2744,5,2015,10,-5
Group 3,RRG,-1.5,5,14,2745,13,2015,5,8
Group 3,RRG,-1.5,5,14,2746,8,2015,5,3
Group 3,RRG,-1.5,5,14,2747,9,2015,8,1
Group 3,RRG,-1.5,5,14,2748,12,2015,8,4
Group 3,RRG,-1.5,5,14,2749,8,2015,7,1
Group 3,RRG,-1.5,5,14,2750,1,2015,5,-4
Group 3,RRG,-1.5,5,14,2751,5,2015,6,-1
Group 3,RRG,-1.5,5,14,2752,11,2015,6,5
Group 3,RRG,-1.5,5,14,2753,9,2015,6,3
Group 3,RRG,-1.5,5,14,2754,7,2015,5,2
Group 3,RRG,-1.5,5,14,2755,3,2015,8,-5
Group 3,RRG,-1.5,5,14,2756,10,2015,9,1
Group 3,RRG,-1.5,5,14,2757,1,2015,1,0
Group 3,RRG,-1.5,5,14,2758,4,2015,1,3
Group 3,RRG,-1.5,5,14,2759,6,2015,7,-1
Group 3,RRG,-1.5,5,14,2760,8,2015,6,2
Group 3,RRG,-1.5,5,14,2761,8,2015,2,6
Group 3,RRG,-1.5,5,14,2762,5,2015,9,-4
Group 3,RRG,-1.5,5,14,2763,7,2015,6,1
Group 3,RRG,-1.5,5,14,2764,7,2015,7,0
Group 3,RRG,-1.5,5,14,2765,7,2015,9,-2
Group 3,RRG,-1.5,5,14,2766,7,2015,6,1
Group 3,RRG,-1.5,5,14,2767,4,2015,6,-2
Group 3,RRG,-1.5,5,14,2768,4,2015,7,-3
Group 3,RRG,-1.5,5,14,2769,3,2015,4,-1
Group 3,RRG,-1.5,5,14,2770,5,2015,3,2
Group 3,RRG,-1.5,5,14,2771,8,2015,3,5
Group 3,RRG,-1.5,5,14,2772,9,2015,10,-1
Group 3,RRG,-1.5,5,14,2773,11,2015,10,1
Group 3,RRG,-1.5,5,14,2774,8,2015,10,-2
Group 3,RRG,-1.5,5,14,2775,11,2015,12,-1
Group 3,RRG,-1.5,5,14,2776,7,2015,13,-6
Group 3,RRG,-1.5,5,14,2777,12,2015,9,3
Group 3,RRG,-1.5,5,14,2778,9,2015,4,5
Group 3,RRG,-1.5,5,14,2779,6,2015,5,1
Group 3,RRG,-1.5,5,14,2780,9,2015,7,2
Group 3,RRG,-1.5,5,14,2781,11,2015,7,4
Group 3,RRG,-1.5,5,14,2782,8,2015,6,2
Group 3,RRG,-1.5,5,14,2783,11,2015,8,3
Group 3,RRG,-1.5,5,14,2784,1,2015,6,-5
Group 3,RRG,-1.5,5,14,2785,5,2015,5,0
Group 3,RRG,-1.5,5,14,2786,5,2015,6,-1
Group 3,RRG,-1.5,5,14,2787,5,2015,7,-2
Group 3,RRG,-1.5,5,14,2788,5,2015,12,-7
Group 3,RRG,-1.5,5,14,2789,4,2015,8,-4
Group 3,RRG,-1.5,5,14,2790,2,2015,10,-8
Group 3,RRG,-1.5,5,14,2791,1,2015,0,1
Group 3,RRG,-1.5,5,14,2792,5,2015,13,-8
Group 3,RRG,-1.5,5,14,2793,5,2015,10,-5
Group 3,RRG,-1.5,5,14,2794,1,2015,8,-7
Group 3,RRG,-1.5,5,14,2795,5,2015,7,-2
Group 3,RRG,-1.5,5,14,2796,5,2015,6,-1
Group 3,RRG,-1.5,5,14,2797,6,2015,8,-2
Group 3,RRG,-1.5,5,14,2798,4,2015,8,-4
Group 3,RRG,-1.5,5,14,2799,9,2015,6,3
Group 3,RRG,-1.5,5,14,2800,5,2015,3,2
Group 3,RRG,-1.5,5,14,2801,10,2015,7,3
Group 3,RRG,-1.5,5,14,2802,13,2015,5,8
Group 3,RRG,-1.5,5,14,2803,6,2015,6,0
Group 3,RRG,-1.5,5,14,2804,2,2015,7,-5
Group 3,RRG,-1.5,5,14,2805,5,2015,6,-1
Group 3,RRG,-1.5,5,14,2806,5,2015,7,-2
Group 3,RRG,-1.5,5,14,2807,6,2015,6,0
Group 3,RRG,-1.5,5,14,2808,4,2015,8,-4
Group 3,RRG,-1.5,5,14,2809,9,2015,3,6
Group 3,RRG,-1.5,5,14,2810,7,2015,7,0
Group 3,RRG,-1.5,5,14,2811,2,2015,5,-3
Group 3,RRG,-1.5,5,14,2812,3,2015,5,-2
Group 3,RRG,-1.5,5,14,2813,1,2015,5,-4
Group 3,RRG,-1.5,5,14,2814,4,2015,7,-3
Group 3,RRG,-1.5,5,14,2815,10,2015,8,2
Group 3,RRG,-1.5,5,14,2816,5,2015,4,1
Group 3,RRG,-1.5,5,14,2817,5,2015,5,0
Group 3,RRG,-1.5,5,14,2818,4,2015,3,1
Group 3,RRG,-1.5,5,14,2819,8,2015,7,1
Group 3,RRG,-1.5,5,14,2820,5,2015,3,2
Group 3,RRG,-1.5,5,14,2821,4,2015,3,1
Group 3,RRG,-1.5,5,14,2822,0,2015,6,-6
Group 3,RRG,-1.5,5,14,2823,10,2015,8,2
Group 3,RRG,-1.5,5,14,2824,9,2015,7,2
Group 3,RRG,-1.5,5,14,2825,8,2015,9,-1
Group 3,RRG,-1.5,5,14,2826,8,2015,8,0
Group 3,RRG,-1.5,5,14,2827,6,2015,8,-2
Group 3,RRG,-1.5,5,14,2828,9,2015,9,0
Group 3,RRG,-1.5,5,14,2829,8,2015,13,-5
Group 3,RRG,-1.5,5,14,2830,8,2015,10,-2
Group 3,RRG,-1.5,5,14,2831,7,2015,4,3
Group 3,RRG,-1.5,5,14,2832,6,2015,5,1
Group 3,RRG,-1.5,5,14,2833,6,2015,4,2
Group 3,RRG,-1.5,5,14,2834,7,2015,9,-2
Group 3,RRG,-1.5,5,14,2835,6,2015,5,1
Group 3,RRG,-1.5,5,14,2836,8,2015,4,4
Group 3,RRG,-1.5,5,14,2837,5,2015,10,-5
Group 3,RRG,-1.5,5,14,2838,3,2015,6,-3
Group 3,RRG,-1.5,5,14,2839,9,2015,10,-1
Group 3,RRG,-1.5,5,14,2840,2,2015,7,-5
Group 3,RRG,-1.5,5,14,2841,3,2015,8,-5
Group 3,RRG,-1.5,5,14,2842,5,2015,3,2
Group 3,RRG,-1.5,5,14,2843,11,2015,9,2
Group 3,RRG,-1.5,5,14,2844,12,2015,12,0
Group 3,RRG,-1.5,5,14,2845,10,2015,7,3
Group 3,RRG,-1.5,5,14,2846,10,2015,12,-2
Group 3,RRG,-1.5,5,14,2847,10,2015,10,0
Group 3,RRG,-1.5,5,14,2848,5,2015,10,-5
Group 3,RRG,-1.5,5,14,2849,4,2015,6,-2
Group 3,RRG,-1.5,5,14,2850,7,2015,7,0
Group 3,RRG,-1.5,5,14,2851,6,2015,6,0
Group 3,RRG,-1.5,5,14,2852,3,2015,10,-7
Group 3,RRG,-1.5,5,14,2853,7,2015,6,1
Group 3,RRG,-1.5,5,14,2854,7,2015,9,-2
Group 3,RRG,-1.5,5,14,2855,2,2015,6,-4
Group 3,RRG,-1.5,5,14,2856,1,2015,2,-1
Group 3,RRG,-1.5,5,14,2857,1,2015,4,-3
Group 3,RRG,-1.5,5,14,2858,7,2015,10,-3
Group 3,RRG,-1.5,5,14,2859,5,2015,3,2
Group 3,RRG,-1.5,5,14,2860,4,2015,2,2
Group 3,RRG,-1.5,5,14,2861,2,2015,5,-3
Group 3,RRG,-1.5,5,14,2862,1,2015,10,-9
Group 3,RRG,-1.5,5,14,2863,8,2015,5,3
Group 3,RRG,-1.5,5,14,2864,10,2015,6,4
Group 3,RRG,-1.5,5,14,2865,6,2015,6,0
Group 3,RRG,-1.5,5,14,2866,11,2015,4,7
Group 3,RRG,-1.5,5,14,2867,5,2015,8,-3
Group 3,RRG,-1.5,5,14,2868,9,2015,8,1
Group 3,RRG,-1.5,5,14,2869,4,2015,7,-3
Group 3,RRG,-1.5,5,14,2870,8,2015,7,1
Group 3,RRG,-1.5,5,14,2871,5,2015,9,-4
Group 3,RRG,-1.5,5,14,2872,3,2015,8,-5
Group 3,RRG,-1.5,5,14,2873,3,2015,3,0
Group 3,RRG,-1.5,5,14,2874,4,2015,4,0
Group 3,RRG,-1.5,5,14,2875,10,2015,5,5
Group 3,RRG,-1.5,5,14,2876,13,2015,9,4
Group 3,RRG,-1.5,5,14,2877,11,2015,10,1
Group 3,RRG,-1.5,5,14,2878,14,2015,6,8
Group 3,RRG,-1.5,5,14,2879,12,2015,7,5
Group 3,RRG,-1.5,5,14,2880,8,2015,8,0
Group 3,RRG,-1.5,5,14,2881,6,2015,4,2
Group 3,RRG,-1.5,5,14,2882,3,2015,6,-3
Group 3,RRG,-1.5,5,14,2883,3,2015,6,-3
Group 3,RRG,-1.5,5,14,2884,7,2015,6,1
Group 3,RRG,-1.5,5,14,2885,9,2015,5,4
Group 3,RRG,-1.5,5,14,2886,10,2015,5,5
Group 3,RRG,-1.5,5,14,2887,6,2015,6,0
Group 3,RRG,-1.5,5,14,2888,6,2015,9,-3
Group 3,RRG,-1.5,5,14,2889,4,2015,4,0
Group 3,RRG,-1.5,5,14,2890,8,2015,7,1
Group 3,RRG,-1.5,5,14,2891,6,2015,5,1
Group 3,RRG,-1.5,5,14,2892,11,2015,4,7
Group 3,RRG,-1.5,5,14,2893,10,2015,6,4
Group 3,RRG,-1.5,5,14,2894,10,2015,8,2
Group 3,RRG,-1.5,5,14,2895,11,2015,6,5
Group 3,RRG,-1.5,5,14,2896,9,2015,7,2
Group 3,RRG,-1.5,5,14,2897,9,2015,8,1
Group 3,RRG,-1.5,5,14,2898,3,2015,8,-5
Group 3,RRG,-1.5,5,14,2899,4,2015,5,-1
Group 3,RRG,-1.5,5,14,2900,5,2015,6,-1
Group 3,RRG,-1.5,5,14,2901,6,2015,4,2
Group 3,RRG,-1.5,5,14,2902,8,2015,6,2
Group 3,RRG,-1.5,5,14,2903,7,2015,5,2
Group 3,RRG,-1.5,5,14,2904,12,2015,6,6
Group 3,RRG,-1.5,5,14,2905,11,2015,9,2
Group 3,RRG,-1.5,5,14,2906,9,2015,12,-3
Group 3,RRG,-1.5,5,14,2907,8,2015,6,2
Group 3,RRG,-1.5,5,14,2908,8,2015,8,0
Group 3,RRG,-1.5,5,14,2909,9,2015,6,3
Group 3,RRG,-1.5,5,14,2910,8,2015,6,2
Group 3,RRG,-1.5,5,14,2911,4,2015,5,-1
Group 3,RRG,-1.5,5,14,2912,10,2015,7,3
Group 3,RRG,-1.5,5,14,2913,2,2015,7,-5
Group 3,RRG,-1.5,5,14,2914,8,2015,11,-3
Group 3,RRG,-1.5,5,14,2915,8,2015,7,1
Group 3,RRG,-1.5,5,14,2916,4,2015,6,-2
Group 3,RRG,-1.5,5,14,2917,7,2015,8,-1
Group 3,RRG,-1.5,5,14,2918,8,2015,11,-3
Group 3,RRG,-1.5,5,14,2919,3,2015,12,-9
Group 3,RRG,-1.5,5,14,2920,7,2015,3,4
Group 3,RRG,-1.5,5,14,2921,8,2015,5,3
Group 3,RRG,-1.5,5,14,2922,10,2015,8,2
Group 3,RRG,-1.5,5,14,2923,10,2015,6,4
Group 3,RRG,-1.5,5,14,2924,10,2015,6,4
Group 3,RRG,-1.5,5,14,2925,11,2015,8,3
Group 3,RRG,-1.5,5,14,2926,5,2015,11,-6
Group 3,RRG,-1.5,5,14,2927,3,2015,6,-3
Group 3,RRG,-1.5,5,14,2928,7,2015,7,0
Group 3,RRG,-1.5,5,14,2929,10,2015,4,6
Group 3,RRG,-1.5,5,14,2930,9,2015,2,7
Group 3,RRG,-1.5,5,14,2931,6,2015,9,-3
Group 3,RRG,-1.5,5,14,2932,8,2015,4,4
Group 3,RRG,-1.5,5,14,2933,11,2015,8,3
Group 3,RRG,-1.5,5,14,2934,6,2015,7,-1
Group 3,RRG,-1.5,5,14,2935,2,2015,5,-3
Group 3,RRG,-1.5,5,14,2936,10,2015,6,4
Group 3,RRG,-1.5,5,14,2937,10,2015,7,3
Group 3,RRG,-1.5,5,14,2938,10,2015,8,2
Group 3,RRG,-1.5,5,14,2939,7,2015,6,1
Group 3,RRG,-1.5,5,14,2940,7,2015,7,0
Group 3,RRG,-1.5,5,14,2941,3,2015,5,-2
Group 3,RRG,-1.5,5,14,2942,3,2015,4,-1
Group 3,RRG,-1.5,5,14,2943,4,2015,8,-4
Group 3,RRG,-1.5,5,14,2944,5,2015,6,-1
Group 3,RRG,-1.5,5,14,2945,7,2015,6,1
Group 3,RRG,-1.5,5,14,2946,6,2015,10,-4
Group 3,RRG,-1.5,5,14,2947,4,2015,4,0
Group 3,RRG,-1.5,5,14,2948,5,2015,6,-1
Group 3,RRG,-1.5,5,14,2949,7,2015,8,-1
Group 3,RRG,-1.5,5,14,2950,6,2015,9,-3
Group 3,RRG,-1.5,5,14,2951,6,2015,6,0
Group 3,RRG,-1.5,5,14,2952,5,2015,9,-4
Group 3,RRG,-1.5,5,14,2953,10,2015,9,1
Group 3,RRG,-1.5,5,14,2954,7,2015,3,4
Group 3,RRG,-1.5,5,14,2955,9,2015,6,3
Group 3,RRG,-1.5,5,14,2956,5,2015,5,0
Group 3,RRG,-1.5,5,14,2957,5,2015,10,-5
Group 3,RRG,-1.5,5,14,2958,1,2015,7,-6
Group 3,RRG,-1.5,5,14,2959,7,2015,6,1
Group 3,RRG,-1.5,5,14,2960,4,2015,5,-1
Group 3,RRG,-1.5,5,14,2961,2,2015,7,-5
Group 3,RRG,-1.5,5,14,2962,9,2015,7,2
Group 3,RRG,-1.5,5,14,2963,10,2015,9,1
Group 3,RRG,-1.5,5,14,2964,8,2015,8,0
Group 3,RRG,-1.5,5,14,2965,7,2015,7,0
Group 3,RRG,-1.5,5,14,2966,7,2015,7,0
Group 3,RRG,-1.5,5,14,2967,5,2015,6,-1
Group 3,RRG,-1.5,5,14,2968,8,2015,6,2
Group 3,RRG,-1.5,5,14,2969,11,2015,10,1
Group 3,RRG,-1.5,5,14,2970,5,2015,4,1
Group 3,RRG,-1.5,5,14,2971,3,2015,8,-5
Group 3,RRG,-1.5,5,14,2972,9,2015,13,-4
Group 3,RRG,-1.5,5,14,2973,8,2015,9,-1
Group 3,RRG,-1.5,5,14,2974,5,2015,7,-2
Group 3,RRG,-1.5,5,14,2975,4,2015,7,-3
Group 3,RRG,-1.5,5,14,2976,7,2015,5,2
Group 3,RRG,-1.5,5,14,2977,7,2015,9,-2
Group 3,RRG,-1.5,5,14,2978,6,2015,5,1
Group 3,RRG,-1.5,5,14,2979,8,2015,4,4
Group 3,RRG,-1.5,5,14,2980,6,2015,9,-3
Group 3,RRG,-1.5,5,14,2981,4,2015,0,4
Group 3,RRG,-1.5,5,14,2982,5,2015,1,4
Group 3,RRG,-1.5,5,14,2983,12,2015,8,4
Group 3,RRG,-1.5,5,14,2984,1,2015,3,-2
Group 3,RRG,-1.5,5,14,2985,4,2015,9,-5
Group 3,RRG,-1.5,5,14,2986,5,2015,9,-4
Group 3,RRG,-1.5,5,14,2987,5,2015,3,2
Group 3,RRG,-1.5,5,14,2988,2,2015,3,-1
Group 3,RRG,-1.5,5,14,2989,6,2015,5,1
Group 3,RRG,-1.5,5,14,2990,5,2015,6,-1
Group 3,RRG,-1.5,5,14,2991,5,2015,7,-2
Group 3,RRG,-1.5,5,14,2992,5,2015,8,-3
Group 3,RRG,-1.5,5,14,2993,9,2015,10,-1
Group 3,RRG,-1.5,5,14,2994,7,2015,2,5
Group 3,RRG,-1.5,5,14,2995,8,2015,4,4
Group 3,RRG,-1.5,5,14,2996,3,2015,2,1
Group 3,RRG,-1.5,5,14,2997,6,2015,5,1
Group 3,RRG,-1.5,5,14,2998,3,2015,6,-3
Group 3,RRG,-1.5,5,14,2999,3,2015,6,-3
Group 3,RRG,-1.5,5,14,3000,3,2015,3,0
Group 3,RRG,-1.5,5,14,3001,13,2015,7,6
Group 3,RRG,-1.5,5,14,3002,6,2015,8,-2
Group 3,RRG,-1.5,5,14,3003,5,2015,4,1
Group 3,RRG,-1.5,5,14,3004,11,2015,11,0
Group 3,RRG,-1.5,5,14,3005,5,2015,5,0
Group 3,RRG,-1.5,5,14,3006,9,2015,4,5
Group 3,RRG,-1.5,5,14,3007,9,2015,3,6
Group 3,RRG,-1.5,5,14,3008,0,2015,5,-5
Group 3,RRG,-1.5,5,14,3009,9,2015,8,1
Group 3,RRG,-1.5,5,14,3010,8,2015,9,-1
Group 3,RRG,-1.5,5,14,3011,3,2015,8,-5
Group 3,RRG,-1.5,5,14,3012,5,2015,13,-8
Group 3,RRG,-1.5,5,14,3013,7,2015,2,5
Group 3,RRG,-1.5,5,14,3014,6,2015,9,-3
Group 3,RRG,-1.5,5,14,3015,11,2015,10,1
Group 3,RRG,-1.5,5,14,3016,6,2015,5,1
Group 3,RRG,-1.5,5,14,3017,5,2015,8,-3
Group 3,RRG,-1.5,5,14,3018,13,2015,8,5
Group 3,RRG,-1.5,5,14,3019,6,2015,8,-2
Group 3,RRG,-1.5,5,14,3020,5,2015,8,-3
Group 3,RRG,-1.5,5,14,3021,6,2015,9,-3
Group 3,RRG,-1.5,5,14,3022,4,2015,4,0
Group 3,RRG,-1.5,5,14,3023,4,2015,4,0
Group 3,RRG,-1.5,5,14,3024,6,2015,9,-3
Group 3,RRG,-1.5,5,14,3025,6,2015,6,0
Group 3,RRG,-1.5,5,14,3026,5,2015,7,-2
Group 3,RRG,-1.5,5,14,3027,9,2015,5,4
Group 3,RRG,-1.5,5,14,3028,8,2015,11,-3
Group 3,RRG,-1.5,5,14,3029,6,2015,5,1
Group 3,RRG,-1.5,5,14,3030,6,2015,8,-2
Group 3,RRG,-1.5,5,14,3031,9,2015,7,2
Group 3,RRG,-1.5,5,14,3032,12,2015,4,8
Group 3,RRG,-1.5,5,14,3033,7,2015,10,-3
Group 3,RRG,-1.5,5,14,3034,7,2015,8,-1
Group 3,RRG,-1.5,5,14,3035,9,2015,7,2
Group 3,RRG,-1.5,5,14,3036,10,2015,6,4
Group 3,RRG,-1.5,5,14,3037,6,2015,6,0
Group 3,RRG,-1.5,5,14,3038,6,2015,9,-3
Group 3,RRG,-1.5,5,14,3039,4,2015,11,-7
Group 3,RRG,-1.5,5,14,3040,6,2015,6,0
Group 3,RRG,-1.5,5,14,3041,3,2015,6,-3
Group 3,RRG,-1.5,5,14,3042,3,2015,3,0
Group 3,RRG,-1.5,5,14,3043,13,2015,10,3
Group 3,RRG,-1.5,5,14,3044,11,2015,8,3
Group 3,RRG,-1.5,5,14,3045,3,2015,4,-1
Group 3,RRG,-1.5,5,14,3046,3,2015,5,-2
Group 3,RRG,-1.5,5,14,3047,8,2015,9,-1
Group 3,RRG,-1.5,5,14,3048,4,2015,6,-2
Group 3,RRG,-1.5,5,14,3049,4,2015,4,0
Group 3,RRG,-1.5,5,14,3050,3,2015,9,-6
Group 3,RRG,-1.5,5,14,3051,3,2015,4,-1
Group 3,RRG,-1.5,5,14,3052,5,2015,8,-3
Group 3,RRG,-1.5,5,14,3053,9,2015,8,1
Group 3,RRG,-1.5,5,14,3054,7,2015,7,0
Group 3,RRG,-1.5,5,14,3055,10,2015,9,1
Group 3,RRG,-1.5,5,14,3056,11,2015,6,5
Group 3,RRG,-1.5,5,14,3057,6,2015,6,0
Group 3,RRG,-1.5,5,14,3058,7,2015,8,-1
Group 3,RRG,-1.5,5,14,3059,10,2015,8,2
Group 3,RRG,-1.5,5,14,3060,10,2015,10,0
Group 3,RRG,-1.5,5,14,3061,9,2015,8,1
Group 3,RRG,-1.5,5,14,3062,2,2015,5,-3
Group 3,RRG,-1.5,5,14,3063,5,2015,7,-2
Group 3,RRG,-1.5,5,14,3064,3,2015,7,-4
Group 3,RRG,-1.5,5,14,3065,10,2015,9,1
Group 3,RRG,-1.5,5,14,3066,9,2015,7,2
Group 3,RRG,-1.5,5,14,3067,9,2015,8,1
Group 3,RRG,-1.5,5,14,3068,9,2015,4,5
Group 3,RRG,-1.5,5,14,3069,9,2015,8,1
Group 3,RRG,-1.5,5,14,3070,5,2015,5,0
Group 3,RRG,-1.5,5,14,3071,6,2015,7,-1
Group 3,RRG,-1.5,5,14,3072,4,2015,8,-4
Group 3,RRG,-1.5,5,14,3073,1,2015,8,-7
Group 3,RRG,-1.5,5,14,3074,5,2015,8,-3
Group 3,RRG,-1.5,5,14,3075,2,2015,6,-4
Group 3,RRG,-1.5,5,14,3076,6,2015,2,4
Group 3,RRG,-1.5,5,14,3077,5,2015,4,1
Group 3,RRG,-1.5,5,14,3078,7,2015,6,1
Group 3,RRG,-1.5,5,14,3079,8,2015,8,0
Group 3,RRG,-1.5,5,14,3080,7,2015,6,1
Group 3,RRG,-1.5,5,14,3081,6,2015,10,-4
Group 3,RRG,-1.5,5,14,3082,9,2015,8,1
Group 3,RRG,-1.5,5,14,3083,11,2015,5,6
Group 3,RRG,-1.5,5,14,3084,8,2015,7,1
Group 3,RRG,-1.5,5,14,3085,5,2015,8,-3
Group 3,RRG,-1.5,5,14,3086,7,2015,6,1
Group 3,RRG,-1.5,5,14,3087,7,2015,8,-1
Group 3,RRG,-1.5,5,14,3088,9,2015,8,1
Group 3,RRG,-1.5,5,14,3089,3,2015,6,-3
Group 3,RRG,-1.5,5,14,3090,9,2015,9,0
Group 3,RRG,-1.5,5,14,3091,3,2015,8,-5
Group 3,RRG,-1.5,5,14,3092,1,2015,7,-6
Group 3,RRG,-1.5,5,14,3093,10,2015,9,1
Group 3,RRG,-1.5,5,14,3094,6,2015,7,-1
Group 3,RRG,-1.5,5,14,3095,5,2015,12,-7
Group 3,RRG,-1.5,5,14,3096,6,2015,2,4
Group 3,RRG,-1.5,5,14,3097,3,2015,11,-8
Group 3,RRG,-1.5,5,14,3098,7,2015,5,2
Group 3,RRG,-1.5,5,14,3099,5,2015,8,-3
Group 3,RRG,-1.5,5,14,3100,4,2015,6,-2
Group 3,RRG,-1.5,5,14,3101,13,2015,8,5
Group 3,RRG,-1.5,5,14,3102,8,2015,8,0
Group 3,RRG,-1.5,5,14,3103,11,2015,3,8
Group 3,RRG,-1.5,5,14,3104,6,2015,9,-3
Group 3,RRG,-1.5,5,14,3105,10,2015,9,1
Group 3,RRG,-1.5,5,14,3106,5,2015,6,-1
Group 3,RRG,-1.5,5,14,3107,11,2015,8,3
Group 3,RRG,-1.5,5,14,3108,3,2015,9,-6
Group 3,RRG,-1.5,5,14,3109,10,2015,11,-1
Group 3,RRG,-1.5,5,14,3110,2,2015,3,-1
Group 3,RRG,-1.5,5,14,3111,10,2015,7,3
Group 3,RRG,-1.5,5,14,3112,5,2015,3,2
Group 3,RRG,-1.5,5,14,3113,10,2015,5,5
Group 3,RRG,-1.5,5,14,3114,6,2015,9,-3
Group 3,RRG,-1.5,5,14,3115,8,2015,4,4
Group 3,RRG,-1.5,5,14,3116,3,2015,4,-1
Group 3,RRG,-1.5,5,14,3117,8,2015,5,3
Group 3,RRG,-1.5,5,14,3118,6,2015,9,-3
Group 3,RRG,-1.5,5,14,3119,8,2015,7,1
Group 3,RRG,-1.5,5,14,3120,10,2015,7,3
Group 3,RRG,-1.5,5,14,3121,5,2015,6,-1
Group 3,RRG,-1.5,5,14,3122,9,2015,2,7
Group 3,RRG,-1.5,5,14,3123,5,2015,7,-2
Group 3,RRG,-1.5,5,14,3124,6,2015,10,-4
Group 3,RRG,-1.5,5,14,3125,11,2015,8,3
Group 3,RRG,-1.5,5,14,3126,3,2015,3,0
Group 3,RRG,-1.5,5,14,3127,6,2015,6,0
Group 3,RRG,-1.5,5,14,3128,7,2015,6,1
Group 3,RRG,-1.5,5,14,3129,5,2015,4,1
Group 3,RRG,-1.5,5,14,3130,4,2015,4,0
Group 3,RRG,-1.5,5,14,3131,7,2015,8,-1
Group 3,RRG,-1.5,5,14,3132,7,2015,8,-1
Group 3,RRG,-1.5,5,14,3133,5,2015,7,-2
Group 3,RRG,-1.5,5,14,3134,8,2015,8,0
Group 3,RRG,-1.5,5,14,3135,4,2015,6,-2
Group 3,RRG,-1.5,5,14,3136,3,2015,2,1
Group 3,RRG,-1.5,5,14,3137,9,2015,5,4
Group 3,RRG,-1.5,5,14,3138,5,2015,9,-4
Group 3,RRG,-1.5,5,14,3139,3,2015,3,0
Group 3,RRG,-1.5,5,14,3140,3,2015,7,-4
Group 3,RRG,-1.5,5,14,3141,3,2015,7,-4
Group 3,RRG,-1.5,5,14,3142,5,2015,5,0
Group 3,RRG,-1.5,5,14,3143,4,2015,5,-1
Group 3,RRG,-1.5,5,14,3144,10,2015,9,1
Group 3,RRG,-1.5,5,14,3145,9,2015,10,-1
Group 3,RRG,-1.5,5,14,3146,9,2015,9,0
Group 3,RRG,-1.5,5,14,3147,5,2015,6,-1
Group 3,RRG,-1.5,5,14,3148,5,2015,7,-2
Group 3,RRG,-1.5,5,14,3149,6,2015,7,-1
Group 3,RRG,-1.5,5,14,3150,6,2015,7,-1
Group 3,RRG,-1.5,5,14,3151,6,2015,7,-1
Group 3,RRG,-1.5,5,14,3152,9,2015,3,6
Group 3,RRG,-1.5,5,14,3153,7,2015,6,1
Group 3,RRG,-1.5,5,14,3154,4,2015,6,-2
Group 3,RRG,-1.5,5,14,3155,10,2015,10,0
Group 3,RRG,-1.5,5,14,3156,9,2015,10,-1
Group 3,RRG,-1.5,5,14,3157,5,2015,11,-6
Group 3,RRG,-1.5,5,14,3158,5,2015,4,1
Group 3,RRG,-1.5,5,14,3159,7,2015,5,2
Group 3,RRG,-1.5,5,14,3160,7,2015,7,0
Group 3,RRG,-1.5,5,14,3161,2,2015,8,-6
Group 3,RRG,-1.5,5,14,3162,9,2015,9,0
Group 3,RRG,-1.5,5,14,3163,11,2015,9,2
Group 3,RRG,-1.5,5,14,3164,5,2015,9,-4
Group 3,RRG,-1.5,5,14,3165,8,2015,9,-1
Group 3,RRG,-1.5,5,14,3166,6,2015,6,0
Group 3,RRG,-1.5,5,14,3167,6,2015,3,3
Group 3,RRG,-1.5,5,14,3168,4,2015,6,-2
Group 3,RRG,-1.5,5,14,3169,11,2015,11,0
Group 3,RRG,-1.5,5,14,3170,8,2015,12,-4
Group 3,RRG,-1.5,5,14,3171,7,2015,4,3
Group 3,RRG,-1.5,5,14,3172,6,2015,8,-2
Group 3,RRG,-1.5,5,14,3173,4,2015,8,-4
Group 3,RRG,-1.5,5,14,3174,1,2015,9,-8
Group 3,RRG,-1.5,5,14,3175,9,2015,11,-2
Group 3,RRG,-1.5,5,14,3176,12,2015,6,6
Group 3,RRG,-1.5,5,14,3177,11,2015,7,4
Group 3,RRG,-1.5,5,14,3178,12,2015,8,4
Group 3,RRG,-1.5,5,14,3179,5,2015,7,-2
Group 3,RRG,-1.5,5,14,3180,5,2015,8,-3
Group 3,RRG,-1.5,5,14,3181,6,2015,3,3
Group 3,RRG,-1.5,5,14,3182,5,2015,10,-5
Group 3,RRG,-1.5,5,14,3183,9,2015,6,3
Group 3,RRG,-1.5,5,14,3184,9,2015,10,-1
Group 3,RRG,-1.5,5,14,3185,5,2015,10,-5
Group 3,RRG,-1.5,5,14,3186,4,2015,7,-3
Group 3,RRG,-1.5,5,14,3187,8,2015,5,3
Group 3,RRG,-1.5,5,14,3188,7,2015,8,-1
Group 3,RRG,-1.5,5,14,3189,11,2015,5,6
Group 3,RRG,-1.5,5,14,3190,10,2015,5,5
Group 3,RRG,-1.5,5,14,3191,9,2015,8,1
Group 3,RRG,-1.5,5,14,3192,11,2015,7,4
Group 3,RRG,-1.5,5,14,3193,9,2015,4,5
Group 3,RRG,-1.5,5,14,3194,8,2015,9,-1
Group 3,RRG,-1.5,5,14,3195,4,2015,5,-1
Group 3,RRG,-1.5,5,14,3196,8,2015,7,1
Group 3,RRG,-1.5,5,14,3197,6,2015,6,0
Group 3,RRG,-1.5,5,14,3198,7,2015,3,4
Group 3,RRG,-1.5,5,14,3199,5,2015,10,-5
Group 3,RRG,-1.5,5,14,3200,7,2015,6,1
Group 3,RRG,-1.5,5,14,3201,5,2015,7,-2
Group 3,RRG,-1.5,5,14,3202,8,2015,5,3
Group 3,RRG,-1.5,5,14,3203,11,2015,11,0
Group 3,RRG,-1.5,5,14,3204,11,2015,8,3
Group 3,RRG,-1.5,5,14,3205,5,2015,4,1
Group 3,RRG,-1.5,5,14,3206,9,2015,6,3
Group 3,RRG,-1.5,5,14,3207,5,2015,7,-2
Group 3,RRG,-1.5,5,14,3208,4,2015,3,1
Group 3,RRG,-1.5,5,14,3209,10,2015,13,-3
Group 3,RRG,-1.5,5,14,3210,6,2015,5,1
Group 3,RRG,-1.5,5,14,3211,11,2015,10,1
Group 3,RRG,-1.5,5,14,3212,4,2015,6,-2
Group 3,RRG,-1.5,5,14,3213,10,2015,8,2
Group 3,RRG,-1.5,5,14,3214,5,2015,6,-1
Group 3,RRG,-1.5,5,14,3215,7,2015,9,-2
Group 3,RRG,-1.5,5,14,3216,7,2015,8,-1
Group 3,RRG,-1.5,5,14,3217,4,2015,9,-5
Group 3,RRG,-1.5,5,14,3218,6,2015,6,0
Group 3,RRG,-1.5,5,14,3219,7,2015,7,0
Group 3,RRG,-1.5,5,14,3220,5,2015,7,-2
Group 3,RRG,-1.5,5,14,3221,1,2015,6,-5
Group 3,RRG,-1.5,5,14,3222,8,2015,7,1
Group 3,RRG,-1.5,5,14,3223,5,2015,6,-1
Group 3,RRG,-1.5,5,14,3224,8,2015,6,2
Group 3,RRG,-1.5,5,14,3225,3,2015,1,2
Group 3,RRG,-1.5,5,14,3226,11,2015,8,3
Group 3,RRG,-1.5,5,14,3227,10,2015,13,-3
Group 3,RRG,-1.5,5,14,3228,2,2015,7,-5
Group 3,RRG,-1.5,5,14,3229,6,2015,5,1
Group 3,RRG,-1.5,5,14,3230,7,2015,7,0
Group 3,RRG,-1.5,5,14,3231,9,2015,8,1
Group 3,RRG,-1.5,5,14,3232,5,2015,5,0
Group 3,RRG,-1.5,5,14,3233,10,2015,12,-2
Group 3,RRG,-1.5,5,14,3234,3,2015,5,-2
Group 3,RRG,-1.5,5,14,3235,12,2015,9,3
Group 3,RRG,-1.5,5,14,3236,7,2015,8,-1
Group 3,RRG,-1.5,5,14,3237,10,2015,9,1
Group 3,RRG,-1.5,5,14,3238,6,2015,14,-8
Group 3,RRG,-1.5,5,14,3239,6,2015,8,-2
Group 3,RRG,-1.5,5,14,3240,7,2015,10,-3
Group 3,RRG,-1.5,5,14,3241,9,2015,6,3
Group 3,RRG,-1.5,5,14,3242,4,2015,8,-4
Group 3,RRG,-1.5,5,14,3243,9,2015,3,6
Group 3,RRG,-1.5,5,14,3244,8,2015,7,1
Group 3,RRG,-1.5,5,14,3245,7,2015,7,0
Group 3,RRG,-1.5,5,14,3246,12,2015,8,4
Group 3,RRG,-1.5,5,14,3247,13,2015,10,3
Group 3,RRG,-1.5,5,14,3248,7,2015,9,-2
Group 3,RRG,-1.5,5,14,3249,8,2015,7,1
Group 3,RRG,-1.5,5,14,3250,5,2015,7,-2
Group 3,RRG,-1.5,5,14,3251,8,2015,8,0
Group 3,RRG,-1.5,5,14,3252,6,2015,5,1
Group 3,RRG,-1.5,5,14,3253,9,2015,7,2
Group 3,RRG,-1.5,5,14,3254,8,2015,7,1
Group 3,RRG,-1.5,5,14,3255,6,2015,7,-1
Group 3,RRG,-1.5,5,14,3256,10,2015,5,5
Group 3,RRG,-1.5,5,14,3257,8,2015,6,2
Group 3,RRG,-1.5,5,14,3258,4,2015,6,-2
Group 3,RRG,-1.5,5,14,3259,7,2015,6,1
Group 3,RRG,-1.5,5,14,3260,1,2015,8,-7
Group 3,RRG,-1.5,5,14,3261,8,2015,4,4
Group 3,RRG,-1.5,5,14,3262,10,2015,8,2
Group 3,RRG,-1.5,5,14,3263,10,2015,8,2
Group 3,RRG,-1.5,5,14,3264,2,2015,9,-7
Group 3,RRG,-1.5,5,14,3265,4,2015,5,-1
Group 3,RRG,-1.5,5,14,3266,6,2015,6,0
Group 3,RRG,-1.5,5,14,3267,11,2015,6,5
Group 3,RRG,-1.5,5,14,3268,10,2015,7,3
Group 3,RRG,-1.5,5,14,3269,2,2015,9,-7
Group 3,RRG,-1.5,5,14,3270,6,2015,7,-1
Group 3,RRG,-1.5,5,14,3271,7,2015,6,1
Group 3,RRG,-1.5,5,14,3272,8,2015,9,-1
Group 3,RRG,-1.5,5,14,3273,11,2015,10,1
Group 3,RRG,-1.5,5,14,3274,8,2015,10,-2
Group 3,RRG,-1.5,5,14,3275,8,2015,10,-2
Group 3,RRG,-1.5,5,14,3276,3,2015,6,-3
Group 3,RRG,-1.5,5,14,3277,5,2015,5,0
Group 3,RRG,-1.5,5,14,3278,5,2015,6,-1
Group 3,RRG,-1.5,5,14,3279,11,2015,6,5
Group 3,RRG,-1.5,5,14,3280,8,2015,5,3
Group 3,RRG,-1.5,5,14,3281,5,2015,9,-4
Group 3,RRG,-1.5,5,14,3282,2,2015,5,-3
Group 3,RRG,-1.5,5,14,3283,8,2015,6,2
Group 3,RRG,-1.5,5,14,3284,11,2015,6,5
Group 3,RRG,-1.5,5,14,3285,12,2015,7,5
Group 3,RRG,-1.5,5,14,3286,7,2015,5,2
Group 3,RRG,-1.5,5,14,3287,7,2015,5,2
Group 3,RRG,-1.5,5,14,3288,11,2015,11,0
Group 3,RRG,-1.5,5,14,3289,11,2015,11,0
Group 3,RRG,-1.5,5,14,3290,4,2015,3,1
Group 3,RRG,-1.5,5,14,3291,3,2015,5,-2
Group 3,RRG,-1.5,5,14,3292,4,2015,0,4
Group 3,RRG,-1.5,5,14,3293,3,2015,6,-3
Group 3,RRG,-1.5,5,14,3294,6,2015,6,0
Group 3,RRG,-1.5,5,14,3295,3,2015,6,-3
Group 3,RRG,-1.5,5,14,3296,5,2015,6,-1
Group 3,RRG,-1.5,5,14,3297,3,2015,4,-1
Group 3,RRG,-1.5,5,14,3298,3,2015,8,-5
Group 3,RRG,-1.5,5,14,3299,9,2015,6,3
Group 3,RRG,-1.5,5,14,3300,6,2015,11,-5
Group 3,RRG,-1.5,5,14,3301,4,2015,4,0
Group 3,RRG,-1.5,5,14,3302,8,2015,10,-2
Group 3,RRG,-1.5,5,14,3303,4,2015,4,0
Group 3,RRG,-1.5,5,14,3304,4,2015,7,-3
Group 3,RRG,-1.5,5,14,3305,3,2015,6,-3
Group 3,RRG,-1.5,5,14,3306,0,2015,1,-1
Group 3,RRG,-1.5,5,14,3307,13,2015,11,2
Group 3,RRG,-1.5,5,14,3308,3,2015,4,-1
Group 3,RRG,-1.5,5,14,3309,13,2015,7,6
Group 3,RRG,-1.5,5,14,3310,7,2015,10,-3
Group 3,RRG,-1.5,5,14,3311,7,2015,5,2
Group 3,RRG,-1.5,5,14,3312,5,2015,2,3
Group 3,RRG,-1.5,5,14,3313,8,2015,4,4
Group 3,RRG,-1.5,5,14,3314,3,2015,5,-2
Group 3,RRG,-1.5,5,14,3315,5,2015,7,-2
Group 3,RRG,-1.5,5,14,3316,9,2015,8,1
Group 3,RRG,-1.5,5,14,3317,2,2015,6,-4
Group 3,RRG,-1.5,5,14,3318,3,2015,6,-3
Group 3,RRG,-1.5,5,14,3319,7,2015,5,2
Group 3,RRG,-1.5,5,14,3320,10,2015,5,5
Group 3,RRG,-1.5,5,14,3321,7,2015,9,-2
Group 3,RRG,-1.5,5,14,3322,7,2015,7,0
Group 3,RRG,-1.5,5,14,3323,6,2015,8,-2
Group 3,RRG,-1.5,5,14,3324,1,2015,6,-5
Group 3,RRG,-1.5,5,14,3325,10,2015,4,6
Group 3,RRG,-1.5,5,14,3326,11,2015,7,4
Group 3,RRG,-1.5,5,14,3327,1,2015,4,-3
Group 3,RRG,-1.5,5,14,3328,6,2015,7,-1
Group 3,RRG,-1.5,5,14,3329,8,2015,8,0
Group 3,RRG,-1.5,5,14,3330,9,2015,11,-2
Group 3,RRG,-1.5,5,14,3331,9,2015,9,0
Group 3,RRG,-1.5,5,14,3332,8,2015,6,2
Group 3,RRG,-1.5,5,14,3333,11,2015,7,4
Group 3,RRG,-1.5,5,14,3334,6,2015,3,3
Group 3,RRG,-1.5,5,14,3335,2,2015,3,-1
Group 3,RRG,-1.5,5,14,3336,10,2015,8,2
Group 3,RRG,-1.5,5,14,3337,7,2015,6,1
Group 3,RRG,-1.5,5,14,3338,11,2015,7,4
Group 3,RRG,-1.5,5,14,3339,10,2015,5,5
Group 3,RRG,-1.5,5,14,3340,8,2015,4,4
Group 3,RRG,-1.5,5,14,3341,9,2015,10,-1
Group 3,RRG,-1.5,5,14,3342,6,2015,4,2
Group 3,RRG,-1.5,5,14,3343,9,2015,5,4
Group 3,RRG,-1.5,5,14,3344,6,2015,7,-1
Group 3,RRG,-1.5,5,14,3345,5,2015,7,-2
Group 3,RRG,-1.5,5,14,3346,8,2015,7,1
Group 3,RRG,-1.5,5,14,3347,7,2015,11,-4
Group 3,RRG,-1.5,5,14,3348,8,2015,6,2
Group 3,RRG,-1.5,5,14,3349,8,2015,5,3
Group 3,RRG,-1.5,5,14,3350,9,2015,7,2
Group 3,RRG,-1.5,5,14,3351,12,2015,11,1
Group 3,RRG,-1.5,5,14,3352,3,2015,6,-3
Group 3,RRG,-1.5,5,14,3353,6,2015,5,1
Group 3,RRG,-1.5,5,14,3354,7,2015,5,2
Group 3,RRG,-1.5,5,14,3355,7,2015,8,-1
Group 3,RRG,-1.5,5,14,3356,6,2015,6,0
Group 3,RRG,-1.5,5,14,3357,4,2015,12,-8
Group 3,RRG,-1.5,5,14,3358,4,2015,5,-1
Group 3,RRG,-1.5,5,14,3359,6,2015,7,-1
Group 3,RRG,-1.5,5,14,3360,7,2015,6,1
Group 3,RRG,-1.5,5,14,3361,9,2015,9,0
Group 3,RRG,-1.5,5,14,3362,8,2015,10,-2
Group 3,RRG,-1.5,5,14,3363,9,2015,6,3
Group 3,RRG,-1.5,5,14,3364,7,2015,8,-1
Group 3,RRG,-1.5,5,14,3365,8,2015,6,2
Group 3,RRG,-1.5,5,14,3366,4,2015,8,-4
Group 3,RRG,-1.5,5,14,3367,5,2015,5,0
Group 3,RRG,-1.5,5,14,3368,8,2015,6,2
Group 3,RRG,-1.5,5,14,3369,3,2015,6,-3
Group 3,RRG,-1.5,5,14,3370,5,2015,7,-2
Group 3,RRG,-1.5,5,14,3371,5,2015,6,-1
Group 3,RRG,-1.5,5,14,3372,4,2015,6,-2
Group 3,RRG,-1.5,5,14,3373,6,2015,8,-2
Group 3,RRG,-1.5,5,14,3374,8,2015,9,-1
Group 3,RRG,-1.5,5,14,3375,9,2015,6,3
Group 3,RRG,-1.5,5,14,3376,11,2015,7,4
Group 3,RRG,-1.5,5,14,3377,8,2015,5,3
Group 3,RRG,-1.5,5,14,3378,9,2015,7,2
Group 3,RRG,-1.5,5,14,3379,3,2015,4,-1
Group 3,RRG,-1.5,5,14,3380,11,2015,12,-1
Group 3,RRG,-1.5,5,14,3381,12,2015,11,1
Group 3,RRG,-1.5,5,14,3382,8,2015,8,0
Group 3,RRG,-1.5,5,14,3383,6,2015,7,-1
Group 3,RRG,-1.5,5,14,3384,6,2015,8,-2
Group 3,RRG,-1.5,5,14,3385,11,2015,11,0
Group 3,RRG,-1.5,5,14,3386,6,2015,7,-1
Group 3,RRG,-1.5,5,14,3387,9,2015,6,3
Group 3,RRG,-1.5,5,14,3388,7,2015,7,0
Group 3,RRG,-1.5,5,14,3389,2,2015,5,-3
Group 3,RRG,-1.5,5,14,3390,11,2015,12,-1
Group 3,RRG,-1.5,5,14,3391,11,2015,10,1
Group 3,RRG,-1.5,5,14,3392,7,2015,10,-3
Group 3,RRG,-1.5,5,14,3393,6,2015,10,-4
Group 3,RRG,-1.5,5,14,3394,9,2015,8,1
Group 3,RRG,-1.5,5,14,3395,10,2015,8,2
Group 3,RRG,-1.5,5,14,3396,4,2015,8,-4
Group 3,RRG,-1.5,5,14,3397,4,2015,8,-4
Group 3,RRG,-1.5,5,14,3398,10,2015,5,5
Group 3,RRG,-1.5,5,14,3399,9,2015,4,5
Group 3,RRG,-1.5,5,14,3400,10,2015,9,1
Group 3,RRG,-1.5,5,14,3401,10,2015,6,4
Group 3,RRG,-1.5,5,14,3402,3,2015,7,-4
Group 3,RRG,-1.5,5,14,3403,6,2015,5,1
Group 3,RRG,-1.5,5,14,3404,6,2015,4,2
Group 3,RRG,-1.5,5,14,3405,8,2015,4,4
Group 3,RRG,-1.5,5,14,3406,6,2015,6,0
Group 3,RRG,-1.5,5,14,3407,7,2015,4,3
Group 3,RRG,-1.5,5,14,3408,7,2015,5,2
Group 3,RRG,-1.5,5,14,3409,8,2015,6,2
Group 3,RRG,-1.5,5,14,3410,11,2015,7,4
Group 3,RRG,-1.5,5,14,3411,2,2015,5,-3
Group 3,RRG,-1.5,5,14,3412,4,2015,6,-2
Group 3,RRG,-1.5,5,14,3413,6,2015,8,-2
Group 3,RRG,-1.5,5,14,3414,6,2015,7,-1
Group 3,RRG,-1.5,5,14,3415,10,2015,9,1
Group 3,RRG,-1.5,5,14,3416,4,2015,7,-3
Group 3,RRG,-1.5,5,14,3417,11,2015,7,4
Group 3,RRG,-1.5,5,14,3418,7,2015,3,4
Group 3,RRG,-1.5,5,14,3419,8,2015,5,3
Group 3,RRG,-1.5,5,14,3420,11,2015,9,2
Group 3,RRG,-1.5,5,14,3421,8,2015,6,2
Group 3,RRG,-1.5,5,14,3422,3,2015,6,-3
Group 3,RRG,-1.5,5,14,3423,10,2015,9,1
Group 3,RRG,-1.5,5,14,3424,12,2015,11,1
Group 3,RRG,-1.5,5,14,3425,12,2015,13,-1
Group 3,RRG,-1.5,5,14,3426,7,2015,5,2
Group 3,RRG,-1.5,5,14,3427,7,2015,7,0
Group 3,RRG,-1.5,5,14,3428,3,2015,1,2
Group 3,RRG,-1.5,5,14,3429,6,2015,6,0
Group 3,RRG,-1.5,5,14,3430,5,2015,7,-2
Group 3,RRG,-1.5,5,14,3431,9,2015,9,0
Group 3,RRG,-1.5,5,14,3432,5,2015,2,3
Group 3,RRG,-1.5,5,14,3433,7,2015,6,1
Group 3,RRG,-1.5,5,14,3434,8,2015,6,2
Group 3,RRG,-1.5,5,14,3435,6,2015,2,4
Group 3,RRG,-1.5,5,14,3436,4,2015,10,-6
Group 3,RRG,-1.5,5,14,3437,8,2015,9,-1
Group 3,RRG,-1.5,5,14,3438,8,2015,6,2
Group 3,RRG,-1.5,5,14,3439,7,2015,8,-1
Group 3,RRG,-1.5,5,14,3440,12,2015,6,6
Group 3,RRG,-1.5,5,14,3441,10,2015,7,3
Group 3,RRG,-1.5,5,14,3442,7,2015,6,1
Group 3,RRG,-1.5,5,14,3443,5,2015,6,-1
Group 3,RRG,-1.5,5,14,3444,4,2015,10,-6
Group 3,RRG,-1.5,5,14,3445,7,2015,7,0
Group 3,RRG,-1.5,5,14,3446,4,2015,5,-1
Group 3,RRG,-1.5,5,14,3447,6,2015,9,-3
Group 3,RRG,-1.5,5,14,3448,8,2015,7,1
Group 3,RRG,-1.5,5,14,3449,2,2015,6,-4
Group 3,RRG,-1.5,5,14,3450,8,2015,7,1
Group 3,RRG,-1.5,5,14,3451,6,2015,7,-1
Group 3,RRG,-1.5,5,14,3452,9,2015,3,6
Group 3,RRG,-1.5,5,14,3453,5,2015,7,-2
Group 3,RRG,-1.5,5,14,3454,7,2015,5,2
Group 3,RRG,-1.5,5,14,3455,7,2015,7,0
Group 3,RRG,-1.5,5,14,3456,8,2015,8,0
Group 3,RRG,-1.5,5,14,3457,2,2015,2,0
Group 3,RRG,-1.5,5,14,3458,8,2015,3,5
Group 3,RRG,-1.5,5,14,3459,5,2015,11,-6
Group 3,RRG,-1.5,5,14,3460,14,2015,9,5
Group 3,RRG,-1.5,5,14,3461,9,2015,7,2
Group 3,RRG,-1.5,5,14,3462,7,2015,5,2
Group 3,RRG,-1.5,5,14,3463,7,2015,4,3
Group 3,RRG,-1.5,5,14,3464,9,2015,5,4
Group 3,RRG,-1.5,5,14,3465,6,2015,7,-1
Group 3,RRG,-1.5,5,14,3466,6,2015,9,-3
Group 3,RRG,-1.5,5,14,3467,11,2015,9,2
Group 3,RRG,-1.5,5,14,3468,7,2015,6,1
Group 3,RRG,-1.5,5,14,3469,7,2015,8,-1
Group 3,RRG,-1.5,5,14,3470,9,2015,9,0
Group 3,RRG,-1.5,5,14,3471,8,2015,9,-1
Group 3,RRG,-1.5,5,14,3472,9,2015,8,1
Group 3,RRG,-1.5,5,14,3473,5,2015,9,-4
Group 3,RRG,-1.5,5,14,3474,5,2015,5,0
Group 3,RRG,-1.5,5,14,3475,8,2015,8,0
Group 3,RRG,-1.5,5,14,3476,4,2015,7,-3
Group 3,RRG,-1.5,5,14,3477,4,2015,3,1
Group 3,RRG,-1.5,5,14,3478,4,2015,4,0
Group 3,RRG,-1.5,5,14,3479,9,2015,7,2
Group 3,RRG,-1.5,5,14,3480,9,2015,9,0
Group 3,RRG,-1.5,5,14,3481,2,2015,7,-5
Group 3,RRG,-1.5,5,14,3482,13,2015,8,5
Group 3,RRG,-1.5,5,14,3483,9,2015,5,4
Group 3,RRG,-1.5,5,14,3484,8,2015,11,-3
Group 3,RRG,-1.5,5,14,3485,6,2015,9,-3
Group 3,RRG,-1.5,5,14,3486,4,2015,5,-1
Group 3,RRG,-1.5,5,14,3487,12,2015,5,7
Group 3,RRG,-1.5,5,14,3488,1,2015,3,-2
Group 3,RRG,-1.5,5,14,3489,1,2015,8,-7
Group 3,RRG,-1.5,5,14,3490,4,2015,3,1
Group 3,RRG,-1.5,5,14,3491,4,2015,7,-3
Group 3,RRG,-1.5,5,14,3492,8,2015,9,-1
Group 3,RRG,-1.5,5,14,3493,10,2015,10,0
Group 3,RRG,-1.5,5,14,3494,8,2015,6,2
Group 3,RRG,-1.5,5,14,3495,5,2015,8,-3
Group 3,RRG,-1.5,5,14,3496,5,2015,8,-3
Group 3,RRG,-1.5,5,14,3497,5,2015,6,-1
Group 3,RRG,-1.5,5,14,3498,11,2015,8,3
Group 3,RRG,-1.5,5,14,3499,4,2015,4,0
Group 3,RRG,-1.5,5,14,3500,10,2015,10,0
Group 3,RRG,-1.5,5,14,3501,4,2015,5,-1
Group 3,RRG,-1.5,5,14,3502,10,2015,11,-1
Group 3,RRG,-1.5,5,14,3503,11,2015,9,2
Group 3,RRG,-1.5,5,14,3504,7,2015,6,1
Group 3,RRG,-1.5,5,14,3505,2,2015,1,1
Group 3,RRG,-1.5,5,14,3506,5,2015,7,-2
Group 3,RRG,-1.5,5,14,3507,6,2015,4,2
Group 3,RRG,-1.5,5,14,3508,4,2015,5,-1
Group 3,RRG,-1.5,5,14,3509,7,2015,5,2
Group 3,RRG,-1.5,5,14,3510,10,2015,5,5
Group 3,RRG,-1.5,5,14,3511,9,2015,11,-2
Group 3,RRG,-1.5,5,14,3512,7,2015,5,2
Group 3,RRG,-1.5,5,14,3513,6,2015,9,-3
Group 3,RRG,-1.5,5,14,3514,7,2015,6,1
Group 3,RRG,-1.5,5,14,3515,6,2015,5,1
Group 3,RRG,-1.5,5,14,3516,6,2015,7,-1
Group 3,RRG,-1.5,5,14,3517,7,2015,5,2
Group 3,RRG,-1.5,5,14,3518,7,2015,6,1
Group 3,RRG,-1.5,5,14,3519,2,2015,5,-3
Group 3,RRG,-1.5,5,14,3520,6,2015,8,-2
Group 3,RRG,-1.5,5,14,3521,9,2015,3,6
Group 3,RRG,-1.5,5,14,3522,6,2015,5,1
Group 3,RRG,-1.5,5,14,3523,10,2015,3,7
Group 3,RRG,-1.5,5,14,3524,7,2015,3,4
Group 3,RRG,-1.5,5,14,3525,8,2015,10,-2
Group 3,RRG,-1.5,5,14,3526,8,2015,4,4
Group 3,RRG,-1.5,5,14,3527,10,2015,7,3
Group 3,RRG,-1.5,5,14,3528,11,2015,9,2
Group 3,RRG,-1.5,5,14,3529,10,2015,3,7
Group 3,RRG,-1.5,5,14,3530,10,2015,8,2
Group 3,RRG,-1.5,5,14,3531,13,2015,11,2
Group 3,RRG,-1.5,5,14,3532,13,2015,13,0
Group 3,RRG,-1.5,5,14,3533,2,2015,5,-3
Group 3,RRG,-1.5,5,14,3534,3,2015,3,0
Group 3,RRG,-1.5,5,14,3535,13,2015,10,3
Group 3,RRG,-1.5,5,14,3536,10,2015,13,-3
Group 3,RRG,-1.5,5,14,3537,8,2015,8,0
Group 3,RRG,-1.5,5,14,3538,8,2015,11,-3
Group 3,RRG,-1.5,5,14,3539,7,2015,3,4
Group 3,RRG,-1.5,5,14,3540,3,2015,4,-1
Group 3,RRG,-1.5,5,14,3541,3,2015,6,-3
Group 3,RRG,-1.5,5,14,3542,2,2015,8,-6
Group 3,RRG,-1.5,5,14,3543,4,2015,5,-1
Group 3,RRG,-1.5,5,14,3544,6,2015,5,1
Group 3,RRG,-1.5,5,14,3545,6,2015,8,-2
Group 3,RRG,-1.5,5,14,3546,5,2015,8,-3
Group 3,RRG,-1.5,5,14,3547,13,2015,5,8
Group 3,RRG,-1.5,5,14,3548,10,2015,5,5
Group 3,RRG,-1.5,5,14,3549,6,2015,6,0
Group 3,RRG,-1.5,5,14,3550,13,2015,10,3
Group 3,RRG,-1.5,5,14,3551,12,2015,3,9
Group 3,RRG,-1.5,5,14,3552,11,2015,3,8
Group 3,RRG,-1.5,5,14,3553,6,2015,1,5
Group 3,RRG,-1.5,5,14,3554,10,2015,6,4
Group 3,RRG,-1.5,5,14,3555,7,2015,6,1
Group 3,RRG,-1.5,5,14,3556,5,2015,5,0
Group 3,RRG,-1.5,5,14,3557,2,2015,7,-5
Group 3,RRG,-1.5,5,14,3558,8,2015,10,-2
Group 3,RRG,-1.5,5,14,3559,13,2015,6,7
Group 3,RRG,-1.5,5,14,3560,8,2015,8,0
Group 3,RRG,-1.5,5,14,3561,5,2015,6,-1
Group 3,RRG,-1.5,5,14,3562,7,2015,6,1
Group 3,RRG,-1.5,5,14,3563,2,2015,6,-4
Group 3,RRG,-1.5,5,14,3564,2,2015,3,-1
Group 3,RRG,-1.5,5,14,3565,12,2015,8,4
Group 3,RRG,-1.5,5,14,3566,4,2015,4,0
Group 3,RRG,-1.5,5,14,3567,6,2015,11,-5
Group 3,RRG,-1.5,5,14,3568,8,2015,10,-2
Group 3,RRG,-1.5,5,14,3569,9,2015,9,0
Group 3,RRG,-1.5,5,14,3570,3,2015,7,-4
Group 3,RRG,-1.5,5,14,3571,6,2015,12,-6
Group 3,RRG,-1.5,5,14,3572,8,2015,8,0
Group 3,RRG,-1.5,5,14,3573,7,2015,9,-2
Group 3,RRG,-1.5,5,14,3574,8,2015,9,-1
Group 3,RRG,-1.5,5,14,3575,7,2015,7,0
Group 3,RRG,-1.5,5,14,3576,6,2015,3,3
Group 3,RRG,-1.5,5,14,3577,7,2015,8,-1
Group 3,RRG,-1.5,5,14,3578,3,2015,7,-4
Group 3,RRG,-1.5,5,14,3579,5,2015,5,0
Group 3,RRG,-1.5,5,14,3580,8,2015,7,1
Group 3,RRG,-1.5,5,14,3581,6,2015,8,-2
Group 3,RRG,-1.5,5,14,3582,6,2015,2,4
Group 3,RRG,-1.5,5,14,3583,0,2015,3,-3
Group 3,RRG,-1.5,5,14,3584,6,2015,7,-1
Group 3,RRG,-1.5,5,14,3585,8,2015,8,0
Group 3,RRG,-1.5,5,14,3586,11,2015,10,1
Group 3,RRG,-1.5,5,14,3587,10,2015,6,4
Group 3,RRG,-1.5,5,14,3588,8,2015,9,-1
Group 3,RRG,-1.5,5,14,3589,9,2015,10,-1
Group 3,RRG,-1.5,5,14,3590,7,2015,12,-5
Group 3,RRG,-1.5,5,14,3591,6,2015,4,2
Group 3,RRG,-1.5,5,14,3592,6,2015,8,-2
Group 3,RRG,-1.5,5,14,3593,6,2015,8,-2
Group 3,RRG,-1.5,5,14,3594,10,2015,8,2
Group 3,RRG,-1.5,5,14,3595,10,2015,7,3
Group 3,RRG,-1.5,5,14,3596,0,2015,9,-9
Group 3,RRG,-1.5,5,14,3597,8,2015,4,4
Group 3,RRG,-1.5,5,14,3598,1,2015,1,0
Group 3,RRG,-1.5,5,14,3599,14,2015,9,5
Group 3,RRG,-1.5,5,14,3600,10,2015,9,1
Group 3,RRG,-1.5,5,14,3601,14,2015,9,5
Group 3,RRG,-1.5,5,14,3602,9,2015,5,4
Group 3,RRG,-1.5,5,14,3603,7,2015,5,2
Group 3,RRG,-1.5,5,14,3604,6,2015,6,0
Group 3,RRG,-1.5,5,14,3605,9,2015,7,2
Group 3,RRG,-1.5,5,14,3606,4,2015,4,0
Group 3,RRG,-1.5,5,14,3607,8,2015,9,-1
Group 3,RRG,-1.5,5,14,3608,4,2015,6,-2
Group 3,RRG,-1.5,5,14,3609,3,2015,8,-5
Group 3,RRG,-1.5,5,14,3610,7,2015,5,2
Group 3,RRG,-1.5,5,14,3611,4,2015,8,-4
Group 3,RRG,-1.5,5,14,3612,10,2015,8,2
Group 3,RRG,-1.5,5,14,3613,12,2015,7,5
Group 3,RRG,-1.5,5,14,3614,12,2015,12,0
Group 3,RRG,-1.5,5,14,3615,0,2015,4,-4
Group 3,RRG,-1.5,5,14,3616,5,2015,9,-4
Group 3,RRG,-1.5,5,14,3617,6,2015,6,0
Group 3,RRG,-1.5,5,14,3618,5,2015,13,-8
Group 3,RRG,-1.5,5,14,3619,8,2015,5,3
Group 3,RRG,-1.5,5,14,3620,8,2015,10,-2
Group 3,RRG,-1.5,5,14,3621,9,2015,3,6
Group 3,RRG,-1.5,5,14,3622,10,2015,8,2
Group 3,RRG,-1.5,5,14,3623,8,2015,4,4
Group 3,RRG,-1.5,5,14,3624,5,2015,7,-2
Group 3,RRG,-1.5,5,14,3625,9,2015,6,3
Group 3,RRG,-1.5,5,14,3626,8,2015,6,2
Group 3,RRG,-1.5,5,14,3627,6,2015,7,-1
Group 3,RRG,-1.5,5,14,3628,8,2015,11,-3
Group 3,RRG,-1.5,5,14,3629,3,2015,9,-6
Group 3,RRG,-1.5,5,14,3630,7,2015,10,-3
Group 3,RRG,-1.5,5,14,3631,7,2015,8,-1
Group 3,RRG,-1.5,5,14,3632,8,2015,4,4
Group 3,RRG,-1.5,5,14,3633,6,2015,8,-2
Group 3,RRG,-1.5,5,14,3634,3,2015,6,-3
Group 3,RRG,-1.5,5,14,3635,4,2015,7,-3
Group 3,RRG,-1.5,5,14,3636,7,2015,7,0
Group 3,RRG,-1.5,5,14,3637,1,2015,3,-2
Group 3,RRG,-1.5,5,14,3638,6,2015,7,-1
Group 3,RRG,-1.5,5,14,3639,6,2015,10,-4
Group 3,RRG,-1.5,5,14,3640,7,2015,7,0
Group 3,RRG,-1.5,5,14,3641,6,2015,6,0
Group 3,RRG,-1.5,5,14,3642,7,2015,10,-3
Group 3,RRG,-1.5,5,14,3643,13,2015,14,-1
Group 3,RRG,-1.5,5,14,3644,5,2015,8,-3
Group 3,RRG,-1.5,5,14,3645,7,2015,4,3
Group 3,RRG,-1.5,5,14,3646,5,2015,7,-2
Group 3,RRG,-1.5,5,14,3647,6,2015,7,-1
Group 3,RRG,-1.5,5,14,3648,3,2015,8,-5
Group 3,RRG,-1.5,5,14,3649,6,2015,11,-5
Group 3,RRG,-1.5,5,14,3650,4,2015,9,-5
Group 3,RRG,-1.5,5,14,3651,4,2015,4,0
Group 3,RRG,-1.5,5,14,3652,8,2015,6,2
Group 3,RRG,-1.5,5,14,3653,8,2015,9,-1
Group 3,RRG,-1.5,5,14,3654,4,2015,9,-5
Group 3,RRG,-1.5,5,14,3655,7,2015,6,1
Group 3,RRG,-1.5,5,14,3656,10,2015,6,4
Group 3,RRG,-1.5,5,14,3657,5,2015,8,-3
Group 3,RRG,-1.5,5,14,3658,7,2015,8,-1
Group 3,RRG,-1.5,5,14,3659,5,2015,3,2
Group 3,RRG,-1.5,5,14,3660,4,2015,9,-5
Group 3,RRG,-1.5,5,14,3661,6,2015,10,-4
Group 3,RRG,-1.5,5,14,3662,8,2015,9,-1
Group 3,RRG,-1.5,5,14,3663,6,2015,6,0
Group 3,RRG,-1.5,5,14,3664,4,2015,6,-2
Group 3,RRG,-1.5,5,14,3665,7,2015,7,0
Group 3,RRG,-1.5,5,14,3666,8,2015,5,3
Group 3,RRG,-1.5,5,14,3667,8,2015,9,-1
Group 3,RRG,-1.5,5,14,3668,7,2015,8,-1
Group 3,RRG,-1.5,5,14,3669,4,2015,3,1
Group 3,RRG,-1.5,5,14,3670,4,2015,5,-1
Group 3,RRG,-1.5,5,14,3671,9,2015,6,3
Group 3,RRG,-1.5,5,14,3672,4,2015,4,0
Group 3,RRG,-1.5,5,14,3673,2,2015,6,-4
Group 3,RRG,-1.5,5,14,3674,1,2015,6,-5
Group 3,RRG,-1.5,5,14,3675,3,2015,4,-1
Group 3,RRG,-1.5,5,14,3676,8,2015,10,-2
Group 3,RRG,-1.5,5,14,3677,7,2015,7,0
Group 3,RRG,-1.5,5,14,3678,7,2015,9,-2
Group 3,RRG,-1.5,5,14,3679,4,2015,5,-1
Group 3,RRG,-1.5,5,14,3680,10,2015,6,4
Group 3,RRG,-1.5,5,14,3681,12,2015,4,8
Group 3,RRG,-1.5,5,14,3682,7,2015,5,2
Group 3,RRG,-1.5,5,14,3683,5,2015,5,0
Group 3,RRG,-1.5,5,14,3684,8,2015,6,2
Group 3,RRG,-1.5,5,14,3685,5,2015,7,-2
Group 3,RRG,-1.5,5,14,3686,5,2015,6,-1
Group 3,RRG,-1.5,5,14,3687,9,2015,10,-1
Group 3,RRG,-1.5,5,14,3688,3,2015,7,-4
Group 3,RRG,-1.5,5,14,3689,12,2015,8,4
Group 3,RRG,-1.5,5,14,3690,5,2015,10,-5
Group 3,RRG,-1.5,5,14,3691,5,2015,3,2
Group 3,RRG,-1.5,5,14,3692,3,2015,10,-7
Group 3,RRG,-1.5,5,14,3693,8,2015,11,-3
Group 3,RRG,-1.5,5,14,3694,9,2015,3,6
Group 3,RRG,-1.5,5,14,3695,3,2015,7,-4
Group 3,RRG,-1.5,5,14,3696,3,2015,6,-3
Group 3,RRG,-1.5,5,14,3697,6,2015,6,0
Group 3,RRG,-1.5,5,14,3698,7,2015,9,-2
Group 3,RRG,-1.5,5,14,3699,5,2015,7,-2
Group 3,RRG,-1.5,5,14,3700,3,2015,4,-1
Group 3,RRG,-1.5,5,14,3701,3,2015,1,2
Group 3,RRG,-1.5,5,14,3702,10,2015,11,-1
Group 3,RRG,-1.5,5,14,3703,5,2015,6,-1
Group 3,RRG,-1.5,5,14,3704,1,2015,3,-2
Group 3,RRG,-1.5,5,14,3705,7,2015,9,-2
Group 3,RRG,-1.5,5,14,3706,10,2015,5,5
Group 3,RRG,-1.5,5,14,3707,4,2015,4,0
Group 3,RRG,-1.5,5,14,3708,7,2015,9,-2
Group 3,RRG,-1.5,5,14,3709,3,2015,8,-5
Group 3,RRG,-1.5,5,14,3710,6,2015,7,-1
Group 3,RRG,-1.5,5,14,3711,7,2015,6,1
Group 3,RRG,-1.5,5,14,3712,6,2015,9,-3
Group 3,RRG,-1.5,5,14,3713,10,2015,3,7
Group 3,RRG,-1.5,5,14,3714,11,2015,5,6
Group 3,RRG,-1.5,5,14,3715,7,2015,6,1
Group 3,RRG,-1.5,5,14,3716,11,2015,6,5
Group 3,RRG,-1.5,5,14,3717,8,2015,5,3
Group 3,RRG,-1.5,5,14,3718,6,2015,11,-5
Group 3,RRG,-1.5,5,14,3719,5,2015,4,1
Group 3,RRG,-1.5,5,14,3720,7,2015,2,5
Group 3,RRG,-1.5,5,14,3721,12,2015,5,7
Group 3,RRG,-1.5,5,14,3722,9,2015,9,0
Group 3,RRG,-1.5,5,14,3723,6,2015,9,-3
Group 3,RRG,-1.5,5,14,3724,6,2015,7,-1
Group 3,RRG,-1.5,5,14,3725,6,2015,8,-2
Group 3,RRG,-1.5,5,14,3726,11,2015,5,6
Group 3,RRG,-1.5,5,14,3727,9,2015,2,7
Group 3,RRG,-1.5,5,14,3728,9,2015,5,4
Group 3,RRG,-1.5,5,14,3729,7,2015,7,0
Group 3,RRG,-1.5,5,14,3730,10,2015,8,2
Group 3,RRG,-1.5,5,14,3731,5,2015,3,2
Group 3,RRG,-1.5,5,14,3732,5,2015,3,2
Group 3,RRG,-1.5,5,14,3733,8,2015,8,0
Group 3,RRG,-1.5,5,14,3734,3,2015,9,-6
Group 3,RRG,-1.5,5,14,3735,9,2015,8,1
Group 3,RRG,-1.5,5,14,3736,2,2015,4,-2
Group 3,RRG,-1.5,5,14,3737,4,2015,6,-2
Group 3,RRG,-1.5,5,14,3738,6,2015,9,-3
Group 3,RRG,-1.5,5,14,3739,6,2015,8,-2
Group 3,RRG,-1.5,5,14,3740,10,2015,9,1
Group 3,RRG,-1.5,5,14,3741,4,2015,5,-1
Group 3,RRG,-1.5,5,14,3742,4,2015,2,2
Group 3,RRG,-1.5,5,14,3743,3,2015,5,-2
Group 3,RRG,-1.5,5,14,3744,6,2015,7,-1
Group 3,RRG,-1.5,5,14,3745,8,2015,5,3
Group 3,RRG,-1.5,5,14,3746,12,2015,4,8
Group 3,RRG,-1.5,5,14,3747,11,2015,11,0
Group 3,RRG,-1.5,5,14,3748,8,2015,3,5
Group 3,RRG,-1.5,5,14,3749,8,2015,7,1
Group 3,RRG,-1.5,5,14,3750,10,2015,9,1
Group 3,RRG,-1.5,5,14,3751,6,2015,8,-2
Group 3,RRG,-1.5,5,14,3752,9,2015,4,5
Group 3,RRG,-1.5,5,14,3753,4,2015,3,1
Group 3,RRG,-1.5,5,14,3754,5,2015,11,-6
Group 3,RRG,-1.5,5,14,3755,6,2015,3,3
Group 3,RRG,-1.5,5,14,3756,7,2015,5,2
Group 3,RRG,-1.5,5,14,3757,5,2015,5,0
Group 3,RRG,-1.5,5,14,3758,2,2015,6,-4
Group 3,RRG,-1.5,5,14,3759,5,2015,8,-3
Group 3,RRG,-1.5,5,14,3760,3,2015,8,-5
Group 3,RRG,-1.5,5,14,3761,11,2015,8,3
Group 3,RRG,-1.5,5,14,3762,8,2015,9,-1
Group 3,RRG,-1.5,5,14,3763,2,2015,4,-2
Group 3,RRG,-1.5,5,14,3764,6,2015,9,-3
Group 3,RRG,-1.5,5,14,3765,3,2015,5,-2
Group 3,RRG,-1.5,5,14,3766,6,2015,6,0
Group 3,RRG,-1.5,5,14,3767,9,2015,9,0
Group 3,RRG,-1.5,5,14,3768,12,2015,8,4
Group 3,RRG,-1.5,5,14,3769,9,2015,8,1
Group 3,RRG,-1.5,5,14,3770,10,2015,10,0
Group 3,RRG,-1.5,5,14,3771,12,2015,12,0
Group 3,RRG,-1.5,5,14,3772,13,2015,5,8
Group 3,RRG,-1.5,5,14,3773,3,2015,6,-3
Group 3,RRG,-1.5,5,14,3774,5,2015,4,1
Group 3,RRG,-1.5,5,14,3775,4,2015,5,-1
Group 3,RRG,-1.5,5,14,3776,7,2015,8,-1
Group 3,RRG,-1.5,5,14,3777,7,2015,7,0
Group 3,RRG,-1.5,5,14,3778,6,2015,8,-2
Group 3,RRG,-1.5,5,14,3779,8,2015,4,4
Group 3,RRG,-1.5,5,14,3780,6,2015,9,-3
Group 3,RRG,-1.5,5,14,3781,4,2015,4,0
Group 3,RRG,-1.5,5,14,3782,6,2015,7,-1
Group 3,RRG,-1.5,5,14,3783,6,2015,10,-4
Group 3,RRG,-1.5,5,14,3784,9,2015,5,4
Group 3,RRG,-1.5,5,14,3785,9,2015,6,3
Group 3,RRG,-1.5,5,14,3786,9,2015,2,7
Group 3,RRG,-1.5,5,14,3787,6,2015,6,0
Group 3,RRG,-1.5,5,14,3788,4,2015,4,0
Group 3,RRG,-1.5,5,14,3789,4,2015,10,-6
Group 3,RRG,-1.5,5,14,3790,8,2015,3,5
Group 3,RRG,-1.5,5,14,3791,6,2015,5,1
Group 3,RRG,-1.5,5,14,3792,2,2015,6,-4
Group 3,RRG,-1.5,5,14,3793,5,2015,8,-3
Group 3,RRG,-1.5,5,14,3794,9,2015,12,-3
Group 3,RRG,-1.5,5,14,3795,10,2015,8,2
Group 3,RRG,-1.5,5,14,3796,9,2015,6,3
Group 3,RRG,-1.5,5,14,3797,2,2015,12,-10
Group 3,RRG,-1.5,5,14,3798,3,2015,4,-1
Group 3,RRG,-1.5,5,14,3799,7,2015,10,-3
Group 3,RRG,-1.5,5,14,3800,7,2015,7,0
Group 3,RRG,-1.5,5,14,3801,6,2015,5,1
Group 3,RRG,-1.5,5,14,3802,7,2015,6,1
Group 3,RRG,-1.5,5,14,3803,4,2015,8,-4
Group 3,RRG,-1.5,5,14,3804,1,2015,8,-7
Group 3,RRG,-1.5,5,14,3805,5,2015,6,-1
Group 3,RRG,-1.5,5,14,3806,10,2015,3,7
Group 3,RRG,-1.5,5,14,3807,12,2015,8,4
Group 3,RRG,-1.5,5,14,3808,3,2015,7,-4
Group 3,RRG,-1.5,5,14,3809,6,2015,7,-1
Group 3,RRG,-1.5,5,14,3810,6,2015,7,-1
Group 3,RRG,-1.5,5,14,3811,0,2015,8,-8
Group 3,RRG,-1.5,5,14,3812,14,2015,10,4
Group 3,RRG,-1.5,5,14,3813,9,2015,10,-1
Group 3,RRG,-1.5,5,14,3814,3,2015,5,-2
Group 3,RRG,-1.5,5,14,3815,2,2015,5,-3
Group 3,RRG,-1.5,5,14,3816,0,2015,5,-5
Group 3,RRG,-1.5,5,14,3817,4,2015,5,-1
Group 3,RRG,-1.5,5,14,3818,3,2015,5,-2
Group 3,RRG,-1.5,5,14,3819,1,2015,9,-8
Group 3,RRG,-1.5,5,14,3820,5,2015,5,0
Group 3,RRG,-1.5,5,14,3821,5,2015,6,-1
Group 3,RRG,-1.5,5,14,3822,3,2015,5,-2
Group 3,RRG,-1.5,5,14,3823,3,2015,6,-3
Group 3,RRG,-1.5,5,14,3824,4,2015,4,0
Group 3,RRG,-1.5,5,14,3825,4,2015,6,-2
Group 3,RRG,-1.5,5,14,3826,6,2015,5,1
Group 3,RRG,-1.5,5,14,3827,9,2015,6,3
Group 3,RRG,-1.5,5,14,3828,9,2015,3,6
Group 3,RRG,-1.5,5,14,3829,6,2015,5,1
Group 3,RRG,-1.5,5,14,3830,9,2015,7,2
Group 3,RRG,-1.5,5,14,3831,2,2015,4,-2
Group 3,RRG,-1.5,5,14,3832,9,2015,8,1
Group 3,RRG,-1.5,5,14,3833,8,2015,7,1
Group 3,RRG,-1.5,5,14,3834,8,2015,6,2
Group 3,RRG,-1.5,5,14,3835,7,2015,8,-1
Group 3,RRG,-1.5,5,14,3836,12,2015,8,4
Group 3,RRG,-1.5,5,14,3837,4,2015,8,-4
Group 3,RRG,-1.5,5,14,3838,4,2015,8,-4
Group 3,RRG,-1.5,5,14,3839,5,2015,7,-2
Group 3,RRG,-1.5,5,14,3840,3,2015,4,-1
Group 3,RRG,-1.5,5,14,3841,6,2015,7,-1
Group 3,RRG,-1.5,5,14,3842,2,2015,10,-8
Group 3,RRG,-1.5,5,14,3843,6,2015,9,-3
Group 3,RRG,-1.5,5,14,3844,12,2015,11,1
Group 3,RRG,-1.5,5,14,3845,4,2015,8,-4
Group 3,RRG,-1.5,5,14,3846,7,2015,6,1
Group 3,RRG,-1.5,5,14,3847,5,2015,6,-1
Group 3,RRG,-1.5,5,14,3848,5,2015,6,-1
Group 3,RRG,-1.5,5,14,3849,5,2015,10,-5
Group 3,RRG,-1.5,5,14,3850,3,2015,7,-4
Group 3,RRG,-1.5,5,14,3851,4,2015,7,-3
Group 3,RRG,-1.5,5,14,3852,7,2015,8,-1
Group 3,RRG,-1.5,5,14,3853,6,2015,5,1
Group 3,RRG,-1.5,5,14,3854,8,2015,8,0
Group 3,RRG,-1.5,5,14,3855,8,2015,11,-3
Group 3,RRG,-1.5,5,14,3856,9,2015,9,0
Group 3,RRG,-1.5,5,14,3857,9,2015,7,2
Group 3,RRG,-1.5,5,14,3858,7,2015,8,-1
Group 3,RRG,-1.5,5,14,3859,2,2015,4,-2
Group 3,RRG,-1.5,5,14,3860,5,2015,6,-1
Group 3,RRG,-1.5,5,14,3861,4,2015,10,-6
Group 3,RRG,-1.5,5,14,3862,6,2015,8,-2
Group 3,RRG,-1.5,5,14,3863,8,2015,6,2
Group 3,RRG,-1.5,5,14,3864,7,2015,12,-5
Group 3,RRG,-1.5,5,14,3865,7,2015,14,-7
Group 3,RRG,-1.5,5,14,3866,8,2015,8,0
Group 3,RRG,-1.5,5,14,3867,5,2015,4,1
Group 3,RRG,-1.5,5,14,3868,5,2015,5,0
Group 3,RRG,-1.5,5,14,3869,2,2015,2,0
Group 3,RRG,-1.5,5,14,3870,5,2015,6,-1
Group 3,RRG,-1.5,5,14,3871,10,2015,4,6
Group 3,RRG,-1.5,5,14,3872,5,2015,10,-5
Group 3,RRG,-1.5,5,14,3873,6,2015,2,4
Group 3,RRG,-1.5,5,14,3874,7,2015,9,-2
Group 3,RRG,-1.5,5,14,3875,1,2015,5,-4
Group 3,RRG,-1.5,5,14,3876,1,2015,5,-4
Group 3,RRG,-1.5,5,14,3877,1,2015,7,-6
Group 3,RRG,-1.5,5,14,3878,4,2015,4,0
Group 3,RRG,-1.5,5,14,3879,3,2015,4,-1
Group 3,RRG,-1.5,5,14,3880,4,2015,7,-3
Group 3,RRG,-1.5,5,14,3881,8,2015,5,3
Group 3,RRG,-1.5,5,14,3882,12,2015,9,3
Group 3,RRG,-1.5,5,14,3883,1,2015,8,-7
Group 3,RRG,-1.5,5,14,3884,5,2015,9,-4
Group 3,RRG,-1.5,5,14,3885,8,2015,7,1
Group 3,RRG,-1.5,5,14,3886,3,2015,5,-2
Group 3,RRG,-1.5,5,14,3887,7,2015,5,2
Group 3,RRG,-1.5,5,14,3888,6,2015,3,3
Group 3,RRG,-1.5,5,14,3889,5,2015,4,1
Group 3,RRG,-1.5,5,14,3890,7,2015,7,0
Group 3,RRG,-1.5,5,14,3891,2,2015,6,-4
Group 3,RRG,-1.5,5,14,3892,8,2015,10,-2
Group 3,RRG,-1.5,5,14,3893,2,2015,6,-4
Group 3,RRG,-1.5,5,14,3894,8,2015,7,1
Group 3,RRG,-1.5,5,14,3895,8,2015,9,-1
Group 3,RRG,-1.5,5,14,3896,5,2015,5,0
Group 3,RRG,-1.5,5,14,3897,7,2015,5,2
Group 3,RRG,-1.5,5,14,3898,10,2015,7,3
Group 3,RRG,-1.5,5,14,3899,9,2015,3,6
Group 3,RRG,-1.5,5,14,3900,6,2015,7,-1
Group 3,RRG,-1.5,5,14,3901,5,2015,9,-4
Group 3,RRG,-1.5,5,14,3902,14,2015,11,3
Group 3,RRG,-1.5,5,14,3903,9,2015,7,2
Group 3,RRG,-1.5,5,14,3904,10,2015,10,0
Group 3,RRG,-1.5,5,14,3905,3,2015,8,-5
Group 3,RRG,-1.5,5,14,3906,5,2015,5,0
Group 3,RRG,-1.5,5,14,3907,8,2015,6,2
Group 3,RRG,-1.5,5,14,3908,6,2015,9,-3
Group 3,RRG,-1.5,5,14,3909,5,2015,5,0
Group 3,RRG,-1.5,5,14,3910,4,2015,9,-5
Group 3,RRG,-1.5,5,14,3911,9,2015,5,4
Group 3,RRG,-1.5,5,14,3912,5,2015,6,-1
Group 3,RRG,-1.5,5,14,3913,6,2015,7,-1
Group 3,RRG,-1.5,5,14,3914,4,2015,4,0
Group 3,RRG,-1.5,5,14,3915,6,2015,5,1
Group 3,RRG,-1.5,5,14,3916,8,2015,8,0
Group 3,RRG,-1.5,5,14,3917,6,2015,6,0
Group 3,RRG,-1.5,5,14,3918,10,2015,4,6
Group 3,RRG,-1.5,5,14,3919,12,2015,7,5
Group 3,RRG,-1.5,5,14,3920,10,2015,3,7
Group 3,RRG,-1.5,5,14,3921,7,2015,8,-1
Group 3,RRG,-1.5,5,14,3922,3,2015,11,-8
Group 3,RRG,-1.5,5,14,3923,6,2015,6,0
Group 3,RRG,-1.5,5,14,3924,10,2015,5,5
Group 3,RRG,-1.5,5,14,3925,6,2015,8,-2
Group 3,RRG,-1.5,5,14,3926,5,2015,8,-3
Group 3,RRG,-1.5,5,14,3927,8,2015,6,2
Group 3,RRG,-1.5,5,14,3928,3,2015,1,2
Group 3,RRG,-1.5,5,14,3929,6,2015,7,-1
Group 3,RRG,-1.5,5,14,3930,10,2015,8,2
Group 3,RRG,-1.5,5,14,3931,8,2015,8,0
Group 3,RRG,-1.5,5,14,3932,10,2015,7,3
Group 3,RRG,-1.5,5,14,3933,10,2015,13,-3
Group 3,RRG,-1.5,5,14,3934,10,2015,8,2
Group 3,RRG,-1.5,5,14,3935,8,2015,3,5
Group 3,RRG,-1.5,5,14,3936,5,2015,6,-1
Group 3,RRG,-1.5,5,14,3937,3,2015,5,-2
Group 3,RRG,-1.5,5,14,3938,5,2015,7,-2
Group 3,RRG,-1.5,5,14,3939,9,2015,6,3
Group 3,RRG,-1.5,5,14,3940,9,2015,5,4
Group 3,RRG,-1.5,5,14,3941,11,2015,11,0
Group 3,RRG,-1.5,5,14,3942,4,2015,4,0
Group 3,RRG,-1.5,5,14,3943,4,2015,7,-3
Group 3,RRG,-1.5,5,14,3944,10,2015,8,2
Group 3,RRG,-1.5,5,14,3945,10,2015,9,1
Group 3,RRG,-1.5,5,14,3946,10,2015,7,3
Group 3,RRG,-1.5,5,14,3947,9,2015,9,0
Group 3,RRG,-1.5,5,14,3948,9,2015,6,3
Group 3,RRG,-1.5,5,14,3949,6,2015,10,-4
Group 3,RRG,-1.5,5,14,3950,1,2015,4,-3
Group 3,RRG,-1.5,5,14,3951,6,2015,8,-2
Group 3,RRG,-1.5,5,14,3952,3,2015,7,-4
Group 3,RRG,-1.5,5,14,3953,6,2015,6,0
Group 3,RRG,-1.5,5,14,3954,12,2015,8,4
Group 3,RRG,-1.5,5,14,3955,12,2015,7,5
Group 3,RRG,-1.5,5,14,3956,8,2015,7,1
Group 3,RRG,-1.5,5,14,3957,5,2015,11,-6
Group 3,RRG,-1.5,5,14,3958,10,2015,5,5
Group 3,RRG,-1.5,5,14,3959,12,2015,6,6
Group 3,RRG,-1.5,5,14,3960,4,2015,7,-3
Group 3,RRG,-1.5,5,14,3961,9,2015,5,4
Group 3,RRG,-1.5,5,14,3962,2,2015,11,-9
Group 3,RRG,-1.5,5,14,3963,1,2015,4,-3
Group 3,RRG,-1.5,5,14,3964,6,2015,3,3
Group 3,RRG,-1.5,5,14,3965,3,2015,5,-2
Group 3,RRG,-1.5,5,14,3966,4,2015,3,1
Group 3,RRG,-1.5,5,14,3967,10,2015,9,1
Group 3,RRG,-1.5,5,14,3968,10,2015,8,2
Group 3,RRG,-1.5,5,14,3969,6,2015,8,-2
Group 3,RRG,-1.5,5,14,3970,4,2015,6,-2
Group 3,RRG,-1.5,5,14,3971,2,2015,6,-4
Group 3,RRG,-1.5,5,14,3972,3,2015,10,-7
Group 3,RRG,-1.5,5,14,3973,6,2015,8,-2
Group 3,RRG,-1.5,5,14,3974,11,2015,7,4
Group 3,RRG,-1.5,5,14,3975,12,2015,5,7
Group 3,RRG,-1.5,5,14,3976,9,2015,8,1
Group 3,RRG,-1.5,5,14,3977,5,2015,5,0
Group 3,RRG,-1.5,5,14,3978,8,2015,10,-2
Group 3,RRG,-1.5,5,14,3979,9,2015,6,3
Group 3,RRG,-1.5,5,14,3980,2,2015,7,-5
Group 3,RRG,-1.5,5,14,3981,9,2015,12,-3
Group 3,RRG,-1.5,5,14,3982,7,2015,8,-1
Group 3,RRG,-1.5,5,14,3983,8,2015,10,-2
Group 3,RRG,-1.5,5,14,3984,5,2015,4,1
Group 3,RRG,-1.5,5,14,3985,2,2015,4,-2
Group 3,RRG,-1.5,5,14,3986,4,2015,9,-5
Group 3,RRG,-1.5,5,14,3987,7,2015,2,5
Group 3,RRG,-1.5,5,14,3988,3,2015,6,-3
Group 3,RRG,-1.5,5,14,3989,8,2015,6,2
Group 3,RRG,-1.5,5,14,3990,6,2015,7,-1
Group 3,RRG,-1.5,5,14,3991,6,2015,9,-3
Group 3,RRG,-1.5,5,14,3992,11,2015,9,2
Group 3,RRG,-1.5,5,14,3993,5,2015,9,-4
Group 3,RRG,-1.5,5,14,3994,7,2015,4,3
Group 3,RRG,-1.5,5,14,3995,3,2015,9,-6
Group 3,RRG,-1.5,5,14,3996,7,2015,6,1
Group 3,RRG,-1.5,5,14,3997,5,2015,4,1
Group 3,RRG,-1.5,5,14,3998,6,2015,6,0
Group 3,RRG,-1.5,5,14,3999,4,2015,5,-1
Group 3,RRG,-1.5,5,14,4000,6,2015,7,-1
Group 5,RRG,-1.5,6,14,1,7,2015,5,2
Group 5,RRG,-1.5,6,14,2,11,2015,5,6
Group 5,RRG,-1.5,6,14,3,8,2015,4,4
Group 5,RRG,-1.5,6,14,4,9,2015,10,-1
Group 5,RRG,-1.5,6,14,5,10,2015,8,2
Group 5,RRG,-1.5,6,14,6,12,2015,12,0
Group 5,RRG,-1.5,6,14,7,9,2015,5,4
Group 5,RRG,-1.5,6,14,8,11,2015,9,2
Group 5,RRG,-1.5,6,14,9,9,2015,6,3
Group 5,RRG,-1.5,6,14,10,8,2015,8,0
Group 5,RRG,-1.5,6,14,11,6,2015,8,-2
Group 5,RRG,-1.5,6,14,12,9,2015,7,2
Group 5,RRG,-1.5,6,14,13,9,2015,9,0
Group 5,RRG,-1.5,6,14,14,11,2015,8,3
Group 5,RRG,-1.5,6,14,15,11,2015,6,5
Group 5,RRG,-1.5,6,14,16,7,2015,6,1
Group 5,RRG,-1.5,6,14,17,8,2015,5,3
Group 5,RRG,-1.5,6,14,18,11,2015,7,4
Group 5,RRG,-1.5,6,14,19,10,2015,6,4
Group 5,RRG,-1.5,6,14,20,8,2015,4,4
Group 5,RRG,-1.5,6,14,21,11,2015,7,4
Group 5,RRG,-1.5,6,14,22,8,2015,8,0
Group 5,RRG,-1.5,6,14,23,13,2015,10,3
Group 5,RRG,-1.5,6,14,24,7,2015,9,-2
Group 5,RRG,-1.5,6,14,25,7,2015,8,-1
Group 5,RRG,-1.5,6,14,26,5,2015,7,-2
Group 5,RRG,-1.5,6,14,27,12,2015,6,6
Group 5,RRG,-1.5,6,14,28,8,2015,10,-2
Group 5,RRG,-1.5,6,14,29,9,2015,4,5
Group 5,RRG,-1.5,6,14,30,10,2015,7,3
Group 5,RRG,-1.5,6,14,31,7,2015,4,3
Group 5,RRG,-1.5,6,14,32,10,2015,5,5
Group 5,RRG,-1.5,6,14,33,9,2015,10,-1
Group 5,RRG,-1.5,6,14,34,9,2015,6,3
Group 5,RRG,-1.5,6,14,35,8,2015,5,3
Group 5,RRG,-1.5,6,14,36,12,2015,10,2
Group 5,RRG,-1.5,6,14,37,13,2015,8,5
Group 5,RRG,-1.5,6,14,38,7,2015,7,0
Group 5,RRG,-1.5,6,14,39,12,2015,6,6
Group 5,RRG,-1.5,6,14,40,8,2015,7,1
Group 5,RRG,-1.5,6,14,41,6,2015,4,2
Group 5,RRG,-1.5,6,14,42,6,2015,5,1
Group 5,RRG,-1.5,6,14,43,5,2015,6,-1
Group 5,RRG,-1.5,6,14,44,13,2015,8,5
Group 5,RRG,-1.5,6,14,45,13,2015,10,3
Group 5,RRG,-1.5,6,14,46,12,2015,9,3
Group 5,RRG,-1.5,6,14,47,11,2015,4,7
Group 5,RRG,-1.5,6,14,48,9,2015,7,2
Group 5,RRG,-1.5,6,14,49,11,2015,6,5
Group 5,RRG,-1.5,6,14,50,7,2015,8,-1
Group 5,RRG,-1.5,6,14,51,10,2015,11,-1
Group 5,RRG,-1.5,6,14,52,7,2015,4,3
Group 5,RRG,-1.5,6,14,53,10,2015,5,5
Group 5,RRG,-1.5,6,14,54,8,2015,8,0
Group 5,RRG,-1.5,6,14,55,6,2015,6,0
Group 5,RRG,-1.5,6,14,56,7,2015,11,-4
Group 5,RRG,-1.5,6,14,57,10,2015,7,3
Group 5,RRG,-1.5,6,14,58,10,2015,7,3
Group 5,RRG,-1.5,6,14,59,13,2015,8,5
Group 5,RRG,-1.5,6,14,60,10,2015,3,7
Group 5,RRG,-1.5,6,14,61,10,2015,13,-3
Group 5,RRG,-1.5,6,14,62,6,2015,12,-6
Group 5,RRG,-1.5,6,14,63,11,2015,8,3
Group 5,RRG,-1.5,6,14,64,7,2015,9,-2
Group 5,RRG,-1.5,6,14,65,9,2015,7,2
Group 5,RRG,-1.5,6,14,66,9,2015,12,-3
Group 5,RRG,-1.5,6,14,67,8,2015,4,4
Group 5,RRG,-1.5,6,14,68,10,2015,2,8
Group 5,RRG,-1.5,6,14,69,8,2015,0,8
Group 5,RRG,-1.5,6,14,70,10,2015,5,5
Group 5,RRG,-1.5,6,14,71,12,2015,4,8
Group 5,RRG,-1.5,6,14,72,11,2015,9,2
Group 5,RRG,-1.5,6,14,73,12,2015,9,3
Group 5,RRG,-1.5,6,14,74,5,2015,4,1
Group 5,RRG,-1.5,6,14,75,10,2015,7,3
Group 5,RRG,-1.5,6,14,76,8,2015,0,8
Group 5,RRG,-1.5,6,14,77,8,2015,12,-4
Group 5,RRG,-1.5,6,14,78,7,2015,6,1
Group 5,RRG,-1.5,6,14,79,6,2015,7,-1
Group 5,RRG,-1.5,6,14,80,7,2015,9,-2
Group 5,RRG,-1.5,6,14,81,5,2015,6,-1
Group 5,RRG,-1.5,6,14,82,8,2015,8,0
Group 5,RRG,-1.5,6,14,83,10,2015,5,5
Group 5,RRG,-1.5,6,14,84,13,2015,7,6
Group 5,RRG,-1.5,6,14,85,10,2015,9,1
Group 5,RRG,-1.5,6,14,86,5,2015,2,3
Group 5,RRG,-1.5,6,14,87,11,2015,5,6
Group 5,RRG,-1.5,6,14,88,9,2015,8,1
Group 5,RRG,-1.5,6,14,89,14,2015,7,7
Group 5,RRG,-1.5,6,14,90,12,2015,5,7
Group 5,RRG,-1.5,6,14,91,11,2015,7,4
Group 5,RRG,-1.5,6,14,92,10,2015,8,2
Group 5,RRG,-1.5,6,14,93,10,2015,2,8
Group 5,RRG,-1.5,6,14,94,11,2015,6,5
Group 5,RRG,-1.5,6,14,95,10,2015,7,3
Group 5,RRG,-1.5,6,14,96,10,2015,6,4
Group 5,RRG,-1.5,6,14,97,10,2015,4,6
Group 5,RRG,-1.5,6,14,98,10,2015,5,5
Group 5,RRG,-1.5,6,14,99,12,2015,8,4
Group 5,RRG,-1.5,6,14,100,10,2015,5,5
Group 5,RRG,-1.5,6,14,101,12,2015,7,5
Group 5,RRG,-1.5,6,14,102,13,2015,5,8
Group 5,RRG,-1.5,6,14,103,8,2015,10,-2
Group 5,RRG,-1.5,6,14,104,10,2015,2,8
Group 5,RRG,-1.5,6,14,105,9,2015,6,3
Group 5,RRG,-1.5,6,14,106,9,2015,9,0
Group 5,RRG,-1.5,6,14,107,10,2015,10,0
Group 5,RRG,-1.5,6,14,108,14,2015,5,9
Group 5,RRG,-1.5,6,14,109,7,2015,5,2
Group 5,RRG,-1.5,6,14,110,8,2015,7,1
Group 5,RRG,-1.5,6,14,111,9,2015,5,4
Group 5,RRG,-1.5,6,14,112,10,2015,5,5
Group 5,RRG,-1.5,6,14,113,11,2015,7,4
Group 5,RRG,-1.5,6,14,114,11,2015,10,1
Group 5,RRG,-1.5,6,14,115,8,2015,0,8
Group 5,RRG,-1.5,6,14,116,9,2015,3,6
Group 5,RRG,-1.5,6,14,117,7,2015,6,1
Group 5,RRG,-1.5,6,14,118,6,2015,7,-1
Group 5,RRG,-1.5,6,14,119,12,2015,10,2
Group 5,RRG,-1.5,6,14,120,6,2015,9,-3
Group 5,RRG,-1.5,6,14,121,10,2015,10,0
Group 5,RRG,-1.5,6,14,122,10,2015,5,5
Group 5,RRG,-1.5,6,14,123,10,2015,9,1
Group 5,RRG,-1.5,6,14,124,13,2015,11,2
Group 5,RRG,-1.5,6,14,125,13,2015,9,4
Group 5,RRG,-1.5,6,14,126,8,2015,9,-1
Group 5,RRG,-1.5,6,14,127,10,2015,8,2
Group 5,RRG,-1.5,6,14,128,12,2015,6,6
Group 5,RRG,-1.5,6,14,129,9,2015,4,5
Group 5,RRG,-1.5,6,14,130,8,2015,8,0
Group 5,RRG,-1.5,6,14,131,8,2015,7,1
Group 5,RRG,-1.5,6,14,132,10,2015,5,5
Group 5,RRG,-1.5,6,14,133,7,2015,10,-3
Group 5,RRG,-1.5,6,14,134,12,2015,3,9
Group 5,RRG,-1.5,6,14,135,6,2015,9,-3
Group 5,RRG,-1.5,6,14,136,9,2015,8,1
Group 5,RRG,-1.5,6,14,137,9,2015,7,2
Group 5,RRG,-1.5,6,14,138,11,2015,7,4
Group 5,RRG,-1.5,6,14,139,9,2015,5,4
Group 5,RRG,-1.5,6,14,140,11,2015,8,3
Group 5,RRG,-1.5,6,14,141,6,2015,5,1
Group 5,RRG,-1.5,6,14,142,10,2015,8,2
Group 5,RRG,-1.5,6,14,143,12,2015,12,0
Group 5,RRG,-1.5,6,14,144,11,2015,10,1
Group 5,RRG,-1.5,6,14,145,9,2015,3,6
Group 5,RRG,-1.5,6,14,146,10,2015,6,4
Group 5,RRG,-1.5,6,14,147,12,2015,5,7
Group 5,RRG,-1.5,6,14,148,9,2015,10,-1
Group 5,RRG,-1.5,6,14,149,9,2015,8,1
Group 5,RRG,-1.5,6,14,150,13,2015,6,7
Group 5,RRG,-1.5,6,14,151,11,2015,4,7
Group 5,RRG,-1.5,6,14,152,8,2015,11,-3
Group 5,RRG,-1.5,6,14,153,9,2015,3,6
Group 5,RRG,-1.5,6,14,154,10,2015,5,5
Group 5,RRG,-1.5,6,14,155,11,2015,8,3
Group 5,RRG,-1.5,6,14,156,12,2015,10,2
Group 5,RRG,-1.5,6,14,157,10,2015,8,2
Group 5,RRG,-1.5,6,14,158,11,2015,4,7
Group 5,RRG,-1.5,6,14,159,13,2015,7,6
Group 5,RRG,-1.5,6,14,160,12,2015,4,8
Group 5,RRG,-1.5,6,14,161,10,2015,6,4
Group 5,RRG,-1.5,6,14,162,8,2015,9,-1
Group 5,RRG,-1.5,6,14,163,9,2015,6,3
Group 5,RRG,-1.5,6,14,164,7,2015,9,-2
Group 5,RRG,-1.5,6,14,165,6,2015,7,-1
Group 5,RRG,-1.5,6,14,166,7,2015,6,1
Group 5,RRG,-1.5,6,14,167,9,2015,7,2
Group 5,RRG,-1.5,6,14,168,10,2015,2,8
Group 5,RRG,-1.5,6,14,169,8,2015,8,0
Group 5,RRG,-1.5,6,14,170,12,2015,9,3
Group 5,RRG,-1.5,6,14,171,12,2015,10,2
Group 5,RRG,-1.5,6,14,172,11,2015,3,8
Group 5,RRG,-1.5,6,14,173,4,2015,3,1
Group 5,RRG,-1.5,6,14,174,10,2015,6,4
Group 5,RRG,-1.5,6,14,175,9,2015,8,1
Group 5,RRG,-1.5,6,14,176,13,2015,7,6
Group 5,RRG,-1.5,6,14,177,11,2015,9,2
Group 5,RRG,-1.5,6,14,178,13,2015,5,8
Group 5,RRG,-1.5,6,14,179,11,2015,7,4
Group 5,RRG,-1.5,6,14,180,10,2015,7,3
Group 5,RRG,-1.5,6,14,181,10,2015,8,2
Group 5,RRG,-1.5,6,14,182,8,2015,6,2
Group 5,RRG,-1.5,6,14,183,8,2015,7,1
Group 5,RRG,-1.5,6,14,184,11,2015,10,1
Group 5,RRG,-1.5,6,14,185,11,2015,7,4
Group 5,RRG,-1.5,6,14,186,7,2015,7,0
Group 5,RRG,-1.5,6,14,187,6,2015,8,-2
Group 5,RRG,-1.5,6,14,188,6,2015,6,0
Group 5,RRG,-1.5,6,14,189,12,2015,4,8
Group 5,RRG,-1.5,6,14,190,11,2015,7,4
Group 5,RRG,-1.5,6,14,191,5,2015,6,-1
Group 5,RRG,-1.5,6,14,192,11,2015,2,9
Group 5,RRG,-1.5,6,14,193,6,2015,7,-1
Group 5,RRG,-1.5,6,14,194,10,2015,9,1
Group 5,RRG,-1.5,6,14,195,5,2015,5,0
Group 5,RRG,-1.5,6,14,196,4,2015,5,-1
Group 5,RRG,-1.5,6,14,197,12,2015,12,0
Group 5,RRG,-1.5,6,14,198,6,2015,4,2
Group 5,RRG,-1.5,6,14,199,8,2015,6,2
Group 5,RRG,-1.5,6,14,200,4,2015,7,-3
Group 5,RRG,-1.5,6,14,201,9,2015,4,5
Group 5,RRG,-1.5,6,14,202,12,2015,6,6
Group 5,RRG,-1.5,6,14,203,9,2015,8,1
Group 5,RRG,-1.5,6,14,204,10,2015,8,2
Group 5,RRG,-1.5,6,14,205,11,2015,6,5
Group 5,RRG,-1.5,6,14,206,5,2015,10,-5
Group 5,RRG,-1.5,6,14,207,10,2015,4,6
Group 5,RRG,-1.5,6,14,208,8,2015,4,4
Group 5,RRG,-1.5,6,14,209,10,2015,5,5
Group 5,RRG,-1.5,6,14,210,11,2015,12,-1
Group 5,RRG,-1.5,6,14,211,11,2015,9,2
Group 5,RRG,-1.5,6,14,212,13,2015,5,8
Group 5,RRG,-1.5,6,14,213,10,2015,4,6
Group 5,RRG,-1.5,6,14,214,5,2015,3,2
Group 5,RRG,-1.5,6,14,215,6,2015,8,-2
Group 5,RRG,-1.5,6,14,216,6,2015,8,-2
Group 5,RRG,-1.5,6,14,217,13,2015,7,6
Group 5,RRG,-1.5,6,14,218,7,2015,7,0
Group 5,RRG,-1.5,6,14,219,10,2015,7,3
Group 5,RRG,-1.5,6,14,220,7,2015,10,-3
Group 5,RRG,-1.5,6,14,221,10,2015,9,1
Group 5,RRG,-1.5,6,14,222,13,2015,10,3
Group 5,RRG,-1.5,6,14,223,10,2015,2,8
Group 5,RRG,-1.5,6,14,224,13,2015,10,3
Group 5,RRG,-1.5,6,14,225,9,2015,5,4
Group 5,RRG,-1.5,6,14,226,8,2015,6,2
Group 5,RRG,-1.5,6,14,227,7,2015,6,1
Group 5,RRG,-1.5,6,14,228,9,2015,9,0
Group 5,RRG,-1.5,6,14,229,13,2015,7,6
Group 5,RRG,-1.5,6,14,230,5,2015,10,-5
Group 5,RRG,-1.5,6,14,231,7,2015,7,0
Group 5,RRG,-1.5,6,14,232,12,2015,7,5
Group 5,RRG,-1.5,6,14,233,10,2015,6,4
Group 5,RRG,-1.5,6,14,234,8,2015,8,0
Group 5,RRG,-1.5,6,14,235,10,2015,9,1
Group 5,RRG,-1.5,6,14,236,9,2015,10,-1
Group 5,RRG,-1.5,6,14,237,9,2015,9,0
Group 5,RRG,-1.5,6,14,238,9,2015,6,3
Group 5,RRG,-1.5,6,14,239,12,2015,6,6
Group 5,RRG,-1.5,6,14,240,8,2015,8,0
Group 5,RRG,-1.5,6,14,241,13,2015,8,5
Group 5,RRG,-1.5,6,14,242,10,2015,9,1
Group 5,RRG,-1.5,6,14,243,10,2015,7,3
Group 5,RRG,-1.5,6,14,244,13,2015,7,6
Group 5,RRG,-1.5,6,14,245,8,2015,8,0
Group 5,RRG,-1.5,6,14,246,9,2015,6,3
Group 5,RRG,-1.5,6,14,247,10,2015,9,1
Group 5,RRG,-1.5,6,14,248,10,2015,3,7
Group 5,RRG,-1.5,6,14,249,8,2015,5,3
Group 5,RRG,-1.5,6,14,250,12,2015,9,3
Group 5,RRG,-1.5,6,14,251,11,2015,2,9
Group 5,RRG,-1.5,6,14,252,9,2015,8,1
Group 5,RRG,-1.5,6,14,253,13,2015,6,7
Group 5,RRG,-1.5,6,14,254,5,2015,6,-1
Group 5,RRG,-1.5,6,14,255,5,2015,7,-2
Group 5,RRG,-1.5,6,14,256,5,2015,7,-2
Group 5,RRG,-1.5,6,14,257,13,2015,3,10
Group 5,RRG,-1.5,6,14,258,9,2015,9,0
Group 5,RRG,-1.5,6,14,259,10,2015,6,4
Group 5,RRG,-1.5,6,14,260,11,2015,6,5
Group 5,RRG,-1.5,6,14,261,12,2015,7,5
Group 5,RRG,-1.5,6,14,262,11,2015,8,3
Group 5,RRG,-1.5,6,14,263,4,2015,3,1
Group 5,RRG,-1.5,6,14,264,13,2015,8,5
Group 5,RRG,-1.5,6,14,265,0,2015,4,-4
Group 5,RRG,-1.5,6,14,266,14,2015,7,7
Group 5,RRG,-1.5,6,14,267,3,2015,7,-4
Group 5,RRG,-1.5,6,14,268,10,2015,3,7
Group 5,RRG,-1.5,6,14,269,9,2015,6,3
Group 5,RRG,-1.5,6,14,270,9,2015,8,1
Group 5,RRG,-1.5,6,14,271,9,2015,8,1
Group 5,RRG,-1.5,6,14,272,12,2015,11,1
Group 5,RRG,-1.5,6,14,273,11,2015,8,3
Group 5,RRG,-1.5,6,14,274,12,2015,6,6
Group 5,RRG,-1.5,6,14,275,10,2015,10,0
Group 5,RRG,-1.5,6,14,276,10,2015,3,7
Group 5,RRG,-1.5,6,14,277,8,2015,6,2
Group 5,RRG,-1.5,6,14,278,9,2015,3,6
Group 5,RRG,-1.5,6,14,279,11,2015,11,0
Group 5,RRG,-1.5,6,14,280,10,2015,10,0
Group 5,RRG,-1.5,6,14,281,6,2015,10,-4
Group 5,RRG,-1.5,6,14,282,11,2015,9,2
Group 5,RRG,-1.5,6,14,283,11,2015,5,6
Group 5,RRG,-1.5,6,14,284,10,2015,7,3
Group 5,RRG,-1.5,6,14,285,4,2015,4,0
Group 5,RRG,-1.5,6,14,286,12,2015,7,5
Group 5,RRG,-1.5,6,14,287,6,2015,6,0
Group 5,RRG,-1.5,6,14,288,13,2015,8,5
Group 5,RRG,-1.5,6,14,289,10,2015,5,5
Group 5,RRG,-1.5,6,14,290,7,2015,9,-2
Group 5,RRG,-1.5,6,14,291,8,2015,5,3
Group 5,RRG,-1.5,6,14,292,9,2015,7,2
Group 5,RRG,-1.5,6,14,293,11,2015,9,2
Group 5,RRG,-1.5,6,14,294,12,2015,8,4
Group 5,RRG,-1.5,6,14,295,12,2015,4,8
Group 5,RRG,-1.5,6,14,296,11,2015,12,-1
Group 5,RRG,-1.5,6,14,297,11,2015,7,4
Group 5,RRG,-1.5,6,14,298,9,2015,6,3
Group 5,RRG,-1.5,6,14,299,9,2015,8,1
Group 5,RRG,-1.5,6,14,300,11,2015,6,5
Group 5,RRG,-1.5,6,14,301,13,2015,11,2
Group 5,RRG,-1.5,6,14,302,11,2015,10,1
Group 5,RRG,-1.5,6,14,303,13,2015,7,6
Group 5,RRG,-1.5,6,14,304,7,2015,5,2
Group 5,RRG,-1.5,6,14,305,7,2015,4,3
Group 5,RRG,-1.5,6,14,306,6,2015,7,-1
Group 5,RRG,-1.5,6,14,307,10,2015,8,2
Group 5,RRG,-1.5,6,14,308,10,2015,5,5
Group 5,RRG,-1.5,6,14,309,2,2015,9,-7
Group 5,RRG,-1.5,6,14,310,12,2015,9,3
Group 5,RRG,-1.5,6,14,311,14,2015,9,5
Group 5,RRG,-1.5,6,14,312,7,2015,8,-1
Group 5,RRG,-1.5,6,14,313,8,2015,6,2
Group 5,RRG,-1.5,6,14,314,13,2015,11,2
Group 5,RRG,-1.5,6,14,315,8,2015,8,0
Group 5,RRG,-1.5,6,14,316,11,2015,4,7
Group 5,RRG,-1.5,6,14,317,9,2015,7,2
Group 5,RRG,-1.5,6,14,318,10,2015,3,7
Group 5,RRG,-1.5,6,14,319,9,2015,7,2
Group 5,RRG,-1.5,6,14,320,10,2015,8,2
Group 5,RRG,-1.5,6,14,321,11,2015,7,4
Group 5,RRG,-1.5,6,14,322,12,2015,9,3
Group 5,RRG,-1.5,6,14,323,12,2015,9,3
Group 5,RRG,-1.5,6,14,324,13,2015,5,8
Group 5,RRG,-1.5,6,14,325,2,2015,8,-6
Group 5,RRG,-1.5,6,14,326,12,2015,6,6
Group 5,RRG,-1.5,6,14,327,11,2015,6,5
Group 5,RRG,-1.5,6,14,328,12,2015,8,4
Group 5,RRG,-1.5,6,14,329,10,2015,5,5
Group 5,RRG,-1.5,6,14,330,6,2015,7,-1
Group 5,RRG,-1.5,6,14,331,9,2015,8,1
Group 5,RRG,-1.5,6,14,332,11,2015,1,10
Group 5,RRG,-1.5,6,14,333,14,2015,5,9
Group 5,RRG,-1.5,6,14,334,11,2015,6,5
Group 5,RRG,-1.5,6,14,335,6,2015,11,-5
Group 5,RRG,-1.5,6,14,336,11,2015,7,4
Group 5,RRG,-1.5,6,14,337,11,2015,5,6
Group 5,RRG,-1.5,6,14,338,8,2015,7,1
Group 5,RRG,-1.5,6,14,339,7,2015,8,-1
Group 5,RRG,-1.5,6,14,340,9,2015,9,0
Group 5,RRG,-1.5,6,14,341,5,2015,4,1
Group 5,RRG,-1.5,6,14,342,12,2015,9,3
Group 5,RRG,-1.5,6,14,343,5,2015,7,-2
Group 5,RRG,-1.5,6,14,344,13,2015,7,6
Group 5,RRG,-1.5,6,14,345,3,2015,4,-1
Group 5,RRG,-1.5,6,14,346,7,2015,7,0
Group 5,RRG,-1.5,6,14,347,11,2015,9,2
Group 5,RRG,-1.5,6,14,348,8,2015,4,4
Group 5,RRG,-1.5,6,14,349,10,2015,6,4
Group 5,RRG,-1.5,6,14,350,4,2015,8,-4
Group 5,RRG,-1.5,6,14,351,8,2015,6,2
Group 5,RRG,-1.5,6,14,352,12,2015,8,4
Group 5,RRG,-1.5,6,14,353,7,2015,2,5
Group 5,RRG,-1.5,6,14,354,12,2015,6,6
Group 5,RRG,-1.5,6,14,355,13,2015,8,5
Group 5,RRG,-1.5,6,14,356,10,2015,12,-2
Group 5,RRG,-1.5,6,14,357,8,2015,10,-2
Group 5,RRG,-1.5,6,14,358,7,2015,7,0
Group 5,RRG,-1.5,6,14,359,11,2015,7,4
Group 5,RRG,-1.5,6,14,360,13,2015,4,9
Group 5,RRG,-1.5,6,14,361,11,2015,6,5
Group 5,RRG,-1.5,6,14,362,11,2015,5,6
Group 5,RRG,-1.5,6,14,363,10,2015,9,1
Group 5,RRG,-1.5,6,14,364,9,2015,8,1
Group 5,RRG,-1.5,6,14,365,12,2015,8,4
Group 5,RRG,-1.5,6,14,366,5,2015,9,-4
Group 5,RRG,-1.5,6,14,367,8,2015,10,-2
Group 5,RRG,-1.5,6,14,368,4,2015,6,-2
Group 5,RRG,-1.5,6,14,369,7,2015,10,-3
Group 5,RRG,-1.5,6,14,370,9,2015,5,4
Group 5,RRG,-1.5,6,14,371,10,2015,9,1
Group 5,RRG,-1.5,6,14,372,10,2015,7,3
Group 5,RRG,-1.5,6,14,373,13,2015,10,3
Group 5,RRG,-1.5,6,14,374,7,2015,12,-5
Group 5,RRG,-1.5,6,14,375,9,2015,6,3
Group 5,RRG,-1.5,6,14,376,7,2015,11,-4
Group 5,RRG,-1.5,6,14,377,7,2015,3,4
Group 5,RRG,-1.5,6,14,378,8,2015,8,0
Group 5,RRG,-1.5,6,14,379,13,2015,4,9
Group 5,RRG,-1.5,6,14,380,7,2015,4,3
Group 5,RRG,-1.5,6,14,381,10,2015,9,1
Group 5,RRG,-1.5,6,14,382,11,2015,7,4
Group 5,RRG,-1.5,6,14,383,8,2015,7,1
Group 5,RRG,-1.5,6,14,384,13,2015,9,4
Group 5,RRG,-1.5,6,14,385,12,2015,8,4
Group 5,RRG,-1.5,6,14,386,9,2015,5,4
Group 5,RRG,-1.5,6,14,387,7,2015,6,1
Group 5,RRG,-1.5,6,14,388,6,2015,7,-1
Group 5,RRG,-1.5,6,14,389,10,2015,11,-1
Group 5,RRG,-1.5,6,14,390,4,2015,2,2
Group 5,RRG,-1.5,6,14,391,11,2015,5,6
Group 5,RRG,-1.5,6,14,392,13,2015,5,8
Group 5,RRG,-1.5,6,14,393,10,2015,10,0
Group 5,RRG,-1.5,6,14,394,12,2015,2,10
Group 5,RRG,-1.5,6,14,395,11,2015,4,7
Group 5,RRG,-1.5,6,14,396,11,2015,9,2
Group 5,RRG,-1.5,6,14,397,11,2015,7,4
Group 5,RRG,-1.5,6,14,398,10,2015,5,5
Group 5,RRG,-1.5,6,14,399,10,2015,8,2
Group 5,RRG,-1.5,6,14,400,11,2015,6,5
Group 5,RRG,-1.5,6,14,401,7,2015,7,0
Group 5,RRG,-1.5,6,14,402,14,2015,5,9
Group 5,RRG,-1.5,6,14,403,5,2015,6,-1
Group 5,RRG,-1.5,6,14,404,4,2015,9,-5
Group 5,RRG,-1.5,6,14,405,9,2015,9,0
Group 5,RRG,-1.5,6,14,406,12,2015,4,8
Group 5,RRG,-1.5,6,14,407,12,2015,5,7
Group 5,RRG,-1.5,6,14,408,9,2015,7,2
Group 5,RRG,-1.5,6,14,409,10,2015,10,0
Group 5,RRG,-1.5,6,14,410,12,2015,11,1
Group 5,RRG,-1.5,6,14,411,7,2015,3,4
Group 5,RRG,-1.5,6,14,412,3,2015,5,-2
Group 5,RRG,-1.5,6,14,413,5,2015,9,-4
Group 5,RRG,-1.5,6,14,414,14,2015,5,9
Group 5,RRG,-1.5,6,14,415,7,2015,10,-3
Group 5,RRG,-1.5,6,14,416,7,2015,6,1
Group 5,RRG,-1.5,6,14,417,11,2015,5,6
Group 5,RRG,-1.5,6,14,418,7,2015,9,-2
Group 5,RRG,-1.5,6,14,419,7,2015,5,2
Group 5,RRG,-1.5,6,14,420,11,2015,3,8
Group 5,RRG,-1.5,6,14,421,7,2015,8,-1
Group 5,RRG,-1.5,6,14,422,10,2015,5,5
Group 5,RRG,-1.5,6,14,423,6,2015,13,-7
Group 5,RRG,-1.5,6,14,424,9,2015,9,0
Group 5,RRG,-1.5,6,14,425,7,2015,9,-2
Group 5,RRG,-1.5,6,14,426,12,2015,3,9
Group 5,RRG,-1.5,6,14,427,10,2015,6,4
Group 5,RRG,-1.5,6,14,428,12,2015,5,7
Group 5,RRG,-1.5,6,14,429,10,2015,5,5
Group 5,RRG,-1.5,6,14,430,7,2015,11,-4
Group 5,RRG,-1.5,6,14,431,9,2015,9,0
Group 5,RRG,-1.5,6,14,432,11,2015,4,7
Group 5,RRG,-1.5,6,14,433,6,2015,5,1
Group 5,RRG,-1.5,6,14,434,11,2015,5,6
Group 5,RRG,-1.5,6,14,435,11,2015,8,3
Group 5,RRG,-1.5,6,14,436,13,2015,8,5
Group 5,RRG,-1.5,6,14,437,12,2015,10,2
Group 5,RRG,-1.5,6,14,438,14,2015,3,11
Group 5,RRG,-1.5,6,14,439,7,2015,9,-2
Group 5,RRG,-1.5,6,14,440,10,2015,7,3
Group 5,RRG,-1.5,6,14,441,11,2015,7,4
Group 5,RRG,-1.5,6,14,442,9,2015,4,5
Group 5,RRG,-1.5,6,14,443,6,2015,11,-5
Group 5,RRG,-1.5,6,14,444,11,2015,5,6
Group 5,RRG,-1.5,6,14,445,7,2015,6,1
Group 5,RRG,-1.5,6,14,446,8,2015,5,3
Group 5,RRG,-1.5,6,14,447,9,2015,12,-3
Group 5,RRG,-1.5,6,14,448,10,2015,10,0
Group 5,RRG,-1.5,6,14,449,11,2015,8,3
Group 5,RRG,-1.5,6,14,450,9,2015,8,1
Group 5,RRG,-1.5,6,14,451,9,2015,9,0
Group 5,RRG,-1.5,6,14,452,6,2015,7,-1
Group 5,RRG,-1.5,6,14,453,13,2015,4,9
Group 5,RRG,-1.5,6,14,454,11,2015,12,-1
Group 5,RRG,-1.5,6,14,455,11,2015,5,6
Group 5,RRG,-1.5,6,14,456,10,2015,6,4
Group 5,RRG,-1.5,6,14,457,7,2015,7,0
Group 5,RRG,-1.5,6,14,458,10,2015,8,2
Group 5,RRG,-1.5,6,14,459,14,2015,7,7
Group 5,RRG,-1.5,6,14,460,5,2015,9,-4
Group 5,RRG,-1.5,6,14,461,5,2015,2,3
Group 5,RRG,-1.5,6,14,462,8,2015,7,1
Group 5,RRG,-1.5,6,14,463,12,2015,9,3
Group 5,RRG,-1.5,6,14,464,6,2015,8,-2
Group 5,RRG,-1.5,6,14,465,8,2015,10,-2
Group 5,RRG,-1.5,6,14,466,13,2015,3,10
Group 5,RRG,-1.5,6,14,467,14,2015,9,5
Group 5,RRG,-1.5,6,14,468,4,2015,3,1
Group 5,RRG,-1.5,6,14,469,11,2015,9,2
Group 5,RRG,-1.5,6,14,470,8,2015,3,5
Group 5,RRG,-1.5,6,14,471,12,2015,6,6
Group 5,RRG,-1.5,6,14,472,11,2015,4,7
Group 5,RRG,-1.5,6,14,473,10,2015,13,-3
Group 5,RRG,-1.5,6,14,474,13,2015,5,8
Group 5,RRG,-1.5,6,14,475,11,2015,6,5
Group 5,RRG,-1.5,6,14,476,12,2015,8,4
Group 5,RRG,-1.5,6,14,477,10,2015,7,3
Group 5,RRG,-1.5,6,14,478,7,2015,4,3
Group 5,RRG,-1.5,6,14,479,10,2015,8,2
Group 5,RRG,-1.5,6,14,480,8,2015,7,1
Group 5,RRG,-1.5,6,14,481,10,2015,8,2
Group 5,RRG,-1.5,6,14,482,8,2015,7,1
Group 5,RRG,-1.5,6,14,483,13,2015,11,2
Group 5,RRG,-1.5,6,14,484,11,2015,8,3
Group 5,RRG,-1.5,6,14,485,7,2015,7,0
Group 5,RRG,-1.5,6,14,486,8,2015,10,-2
Group 5,RRG,-1.5,6,14,487,10,2015,11,-1
Group 5,RRG,-1.5,6,14,488,14,2015,7,7
Group 5,RRG,-1.5,6,14,489,9,2015,9,0
Group 5,RRG,-1.5,6,14,490,12,2015,9,3
Group 5,RRG,-1.5,6,14,491,10,2015,6,4
Group 5,RRG,-1.5,6,14,492,9,2015,5,4
Group 5,RRG,-1.5,6,14,493,8,2015,8,0
Group 5,RRG,-1.5,6,14,494,8,2015,9,-1
Group 5,RRG,-1.5,6,14,495,8,2015,6,2
Group 5,RRG,-1.5,6,14,496,12,2015,3,9
Group 5,RRG,-1.5,6,14,497,11,2015,3,8
Group 5,RRG,-1.5,6,14,498,9,2015,9,0
Group 5,RRG,-1.5,6,14,499,12,2015,9,3
Group 5,RRG,-1.5,6,14,500,11,2015,4,7
Group 5,RRG,-1.5,6,14,501,14,2015,7,7
Group 5,RRG,-1.5,6,14,502,10,2015,12,-2
Group 5,RRG,-1.5,6,14,503,10,2015,8,2
Group 5,RRG,-1.5,6,14,504,11,2015,10,1
Group 5,RRG,-1.5,6,14,505,9,2015,6,3
Group 5,RRG,-1.5,6,14,506,10,2015,10,0
Group 5,RRG,-1.5,6,14,507,14,2015,8,6
Group 5,RRG,-1.5,6,14,508,11,2015,9,2
Group 5,RRG,-1.5,6,14,509,8,2015,7,1
Group 5,RRG,-1.5,6,14,510,8,2015,9,-1
Group 5,RRG,-1.5,6,14,511,12,2015,5,7
Group 5,RRG,-1.5,6,14,512,6,2015,5,1
Group 5,RRG,-1.5,6,14,513,8,2015,5,3
Group 5,RRG,-1.5,6,14,514,11,2015,9,2
Group 5,RRG,-1.5,6,14,515,11,2015,10,1
Group 5,RRG,-1.5,6,14,516,9,2015,4,5
Group 5,RRG,-1.5,6,14,517,10,2015,7,3
Group 5,RRG,-1.5,6,14,518,14,2015,6,8
Group 5,RRG,-1.5,6,14,519,13,2015,6,7
Group 5,RRG,-1.5,6,14,520,12,2015,6,6
Group 5,RRG,-1.5,6,14,521,7,2015,5,2
Group 5,RRG,-1.5,6,14,522,12,2015,4,8
Group 5,RRG,-1.5,6,14,523,10,2015,6,4
Group 5,RRG,-1.5,6,14,524,10,2015,5,5
Group 5,RRG,-1.5,6,14,525,10,2015,5,5
Group 5,RRG,-1.5,6,14,526,13,2015,8,5
Group 5,RRG,-1.5,6,14,527,8,2015,4,4
Group 5,RRG,-1.5,6,14,528,9,2015,5,4
Group 5,RRG,-1.5,6,14,529,11,2015,7,4
Group 5,RRG,-1.5,6,14,530,11,2015,6,5
Group 5,RRG,-1.5,6,14,531,11,2015,7,4
Group 5,RRG,-1.5,6,14,532,7,2015,10,-3
Group 5,RRG,-1.5,6,14,533,9,2015,7,2
Group 5,RRG,-1.5,6,14,534,7,2015,6,1
Group 5,RRG,-1.5,6,14,535,9,2015,5,4
Group 5,RRG,-1.5,6,14,536,8,2015,6,2
Group 5,RRG,-1.5,6,14,537,13,2015,9,4
Group 5,RRG,-1.5,6,14,538,13,2015,6,7
Group 5,RRG,-1.5,6,14,539,7,2015,11,-4
Group 5,RRG,-1.5,6,14,540,11,2015,4,7
Group 5,RRG,-1.5,6,14,541,1,2015,7,-6
Group 5,RRG,-1.5,6,14,542,7,2015,8,-1
Group 5,RRG,-1.5,6,14,543,9,2015,5,4
Group 5,RRG,-1.5,6,14,544,9,2015,6,3
Group 5,RRG,-1.5,6,14,545,8,2015,8,0
Group 5,RRG,-1.5,6,14,546,11,2015,10,1
Group 5,RRG,-1.5,6,14,547,12,2015,2,10
Group 5,RRG,-1.5,6,14,548,11,2015,3,8
Group 5,RRG,-1.5,6,14,549,13,2015,8,5
Group 5,RRG,-1.5,6,14,550,6,2015,4,2
Group 5,RRG,-1.5,6,14,551,11,2015,4,7
Group 5,RRG,-1.5,6,14,552,13,2015,5,8
Group 5,RRG,-1.5,6,14,553,4,2015,7,-3
Group 5,RRG,-1.5,6,14,554,4,2015,4,0
Group 5,RRG,-1.5,6,14,555,6,2015,5,1
Group 5,RRG,-1.5,6,14,556,12,2015,5,7
Group 5,RRG,-1.5,6,14,557,12,2015,12,0
Group 5,RRG,-1.5,6,14,558,4,2015,4,0
Group 5,RRG,-1.5,6,14,559,11,2015,13,-2
Group 5,RRG,-1.5,6,14,560,9,2015,3,6
Group 5,RRG,-1.5,6,14,561,9,2015,10,-1
Group 5,RRG,-1.5,6,14,562,10,2015,5,5
Group 5,RRG,-1.5,6,14,563,11,2015,8,3
Group 5,RRG,-1.5,6,14,564,8,2015,9,-1
Group 5,RRG,-1.5,6,14,565,7,2015,3,4
Group 5,RRG,-1.5,6,14,566,7,2015,4,3
Group 5,RRG,-1.5,6,14,567,6,2015,7,-1
Group 5,RRG,-1.5,6,14,568,12,2015,9,3
Group 5,RRG,-1.5,6,14,569,10,2015,12,-2
Group 5,RRG,-1.5,6,14,570,7,2015,6,1
Group 5,RRG,-1.5,6,14,571,9,2015,6,3
Group 5,RRG,-1.5,6,14,572,9,2015,2,7
Group 5,RRG,-1.5,6,14,573,10,2015,6,4
Group 5,RRG,-1.5,6,14,574,11,2015,4,7
Group 5,RRG,-1.5,6,14,575,5,2015,2,3
Group 5,RRG,-1.5,6,14,576,5,2015,7,-2
Group 5,RRG,-1.5,6,14,577,6,2015,8,-2
Group 5,RRG,-1.5,6,14,578,13,2015,3,10
Group 5,RRG,-1.5,6,14,579,7,2015,11,-4
Group 5,RRG,-1.5,6,14,580,11,2015,7,4
Group 5,RRG,-1.5,6,14,581,8,2015,8,0
Group 5,RRG,-1.5,6,14,582,9,2015,9,0
Group 5,RRG,-1.5,6,14,583,12,2015,9,3
Group 5,RRG,-1.5,6,14,584,12,2015,5,7
Group 5,RRG,-1.5,6,14,585,4,2015,5,-1
Group 5,RRG,-1.5,6,14,586,9,2015,5,4
Group 5,RRG,-1.5,6,14,587,8,2015,8,0
Group 5,RRG,-1.5,6,14,588,10,2015,3,7
Group 5,RRG,-1.5,6,14,589,12,2015,6,6
Group 5,RRG,-1.5,6,14,590,12,2015,9,3
Group 5,RRG,-1.5,6,14,591,8,2015,7,1
Group 5,RRG,-1.5,6,14,592,9,2015,5,4
Group 5,RRG,-1.5,6,14,593,12,2015,10,2
Group 5,RRG,-1.5,6,14,594,12,2015,6,6
Group 5,RRG,-1.5,6,14,595,12,2015,5,7
Group 5,RRG,-1.5,6,14,596,11,2015,6,5
Group 5,RRG,-1.5,6,14,597,8,2015,7,1
Group 5,RRG,-1.5,6,14,598,10,2015,8,2
Group 5,RRG,-1.5,6,14,599,7,2015,6,1
Group 5,RRG,-1.5,6,14,600,13,2015,7,6
Group 5,RRG,-1.5,6,14,601,10,2015,5,5
Group 5,RRG,-1.5,6,14,602,10,2015,6,4
Group 5,RRG,-1.5,6,14,603,7,2015,5,2
Group 5,RRG,-1.5,6,14,604,1,2015,11,-10
Group 5,RRG,-1.5,6,14,605,8,2015,4,4
Group 5,RRG,-1.5,6,14,606,11,2015,8,3
Group 5,RRG,-1.5,6,14,607,10,2015,7,3
Group 5,RRG,-1.5,6,14,608,9,2015,9,0
Group 5,RRG,-1.5,6,14,609,9,2015,7,2
Group 5,RRG,-1.5,6,14,610,12,2015,7,5
Group 5,RRG,-1.5,6,14,611,8,2015,10,-2
Group 5,RRG,-1.5,6,14,612,12,2015,7,5
Group 5,RRG,-1.5,6,14,613,10,2015,3,7
Group 5,RRG,-1.5,6,14,614,6,2015,7,-1
Group 5,RRG,-1.5,6,14,615,9,2015,8,1
Group 5,RRG,-1.5,6,14,616,9,2015,9,0
Group 5,RRG,-1.5,6,14,617,10,2015,9,1
Group 5,RRG,-1.5,6,14,618,9,2015,7,2
Group 5,RRG,-1.5,6,14,619,10,2015,6,4
Group 5,RRG,-1.5,6,14,620,6,2015,5,1
Group 5,RRG,-1.5,6,14,621,5,2015,8,-3
Group 5,RRG,-1.5,6,14,622,4,2015,6,-2
Group 5,RRG,-1.5,6,14,623,8,2015,6,2
Group 5,RRG,-1.5,6,14,624,11,2015,2,9
Group 5,RRG,-1.5,6,14,625,10,2015,11,-1
Group 5,RRG,-1.5,6,14,626,13,2015,9,4
Group 5,RRG,-1.5,6,14,627,8,2015,5,3
Group 5,RRG,-1.5,6,14,628,12,2015,10,2
Group 5,RRG,-1.5,6,14,629,8,2015,7,1
Group 5,RRG,-1.5,6,14,630,10,2015,8,2
Group 5,RRG,-1.5,6,14,631,11,2015,10,1
Group 5,RRG,-1.5,6,14,632,10,2015,6,4
Group 5,RRG,-1.5,6,14,633,13,2015,5,8
Group 5,RRG,-1.5,6,14,634,10,2015,3,7
Group 5,RRG,-1.5,6,14,635,9,2015,6,3
Group 5,RRG,-1.5,6,14,636,7,2015,5,2
Group 5,RRG,-1.5,6,14,637,4,2015,10,-6
Group 5,RRG,-1.5,6,14,638,13,2015,7,6
Group 5,RRG,-1.5,6,14,639,10,2015,5,5
Group 5,RRG,-1.5,6,14,640,13,2015,8,5
Group 5,RRG,-1.5,6,14,641,8,2015,5,3
Group 5,RRG,-1.5,6,14,642,10,2015,6,4
Group 5,RRG,-1.5,6,14,643,10,2015,11,-1
Group 5,RRG,-1.5,6,14,644,10,2015,6,4
Group 5,RRG,-1.5,6,14,645,8,2015,7,1
Group 5,RRG,-1.5,6,14,646,11,2015,3,8
Group 5,RRG,-1.5,6,14,647,9,2015,6,3
Group 5,RRG,-1.5,6,14,648,8,2015,3,5
Group 5,RRG,-1.5,6,14,649,9,2015,2,7
Group 5,RRG,-1.5,6,14,650,7,2015,6,1
Group 5,RRG,-1.5,6,14,651,10,2015,8,2
Group 5,RRG,-1.5,6,14,652,10,2015,5,5
Group 5,RRG,-1.5,6,14,653,7,2015,7,0
Group 5,RRG,-1.5,6,14,654,11,2015,6,5
Group 5,RRG,-1.5,6,14,655,8,2015,6,2
Group 5,RRG,-1.5,6,14,656,10,2015,8,2
Group 5,RRG,-1.5,6,14,657,11,2015,8,3
Group 5,RRG,-1.5,6,14,658,9,2015,5,4
Group 5,RRG,-1.5,6,14,659,11,2015,7,4
Group 5,RRG,-1.5,6,14,660,7,2015,7,0
Group 5,RRG,-1.5,6,14,661,7,2015,6,1
Group 5,RRG,-1.5,6,14,662,12,2015,6,6
Group 5,RRG,-1.5,6,14,663,13,2015,6,7
Group 5,RRG,-1.5,6,14,664,12,2015,8,4
Group 5,RRG,-1.5,6,14,665,10,2015,7,3
Group 5,RRG,-1.5,6,14,666,9,2015,8,1
Group 5,RRG,-1.5,6,14,667,7,2015,9,-2
Group 5,RRG,-1.5,6,14,668,7,2015,13,-6
Group 5,RRG,-1.5,6,14,669,6,2015,11,-5
Group 5,RRG,-1.5,6,14,670,10,2015,7,3
Group 5,RRG,-1.5,6,14,671,12,2015,10,2
Group 5,RRG,-1.5,6,14,672,10,2015,4,6
Group 5,RRG,-1.5,6,14,673,13,2015,7,6
Group 5,RRG,-1.5,6,14,674,8,2015,3,5
Group 5,RRG,-1.5,6,14,675,13,2015,9,4
Group 5,RRG,-1.5,6,14,676,13,2015,9,4
Group 5,RRG,-1.5,6,14,677,10,2015,7,3
Group 5,RRG,-1.5,6,14,678,10,2015,11,-1
Group 5,RRG,-1.5,6,14,679,11,2015,4,7
Group 5,RRG,-1.5,6,14,680,13,2015,4,9
Group 5,RRG,-1.5,6,14,681,11,2015,8,3
Group 5,RRG,-1.5,6,14,682,7,2015,8,-1
Group 5,RRG,-1.5,6,14,683,10,2015,3,7
Group 5,RRG,-1.5,6,14,684,10,2015,9,1
Group 5,RRG,-1.5,6,14,685,12,2015,7,5
Group 5,RRG,-1.5,6,14,686,10,2015,3,7
Group 5,RRG,-1.5,6,14,687,8,2015,8,0
Group 5,RRG,-1.5,6,14,688,9,2015,9,0
Group 5,RRG,-1.5,6,14,689,11,2015,10,1
Group 5,RRG,-1.5,6,14,690,12,2015,10,2
Group 5,RRG,-1.5,6,14,691,8,2015,8,0
Group 5,RRG,-1.5,6,14,692,13,2015,5,8
Group 5,RRG,-1.5,6,14,693,3,2015,4,-1
Group 5,RRG,-1.5,6,14,694,6,2015,7,-1
Group 5,RRG,-1.5,6,14,695,10,2015,10,0
Group 5,RRG,-1.5,6,14,696,13,2015,5,8
Group 5,RRG,-1.5,6,14,697,10,2015,8,2
Group 5,RRG,-1.5,6,14,698,13,2015,4,9
Group 5,RRG,-1.5,6,14,699,8,2015,6,2
Group 5,RRG,-1.5,6,14,700,10,2015,7,3
Group 5,RRG,-1.5,6,14,701,8,2015,4,4
Group 5,RRG,-1.5,6,14,702,6,2015,5,1
Group 5,RRG,-1.5,6,14,703,8,2015,12,-4
Group 5,RRG,-1.5,6,14,704,8,2015,5,3
Group 5,RRG,-1.5,6,14,705,13,2015,7,6
Group 5,RRG,-1.5,6,14,706,3,2015,5,-2
Group 5,RRG,-1.5,6,14,707,7,2015,4,3
Group 5,RRG,-1.5,6,14,708,11,2015,10,1
Group 5,RRG,-1.5,6,14,709,12,2015,7,5
Group 5,RRG,-1.5,6,14,710,8,2015,8,0
Group 5,RRG,-1.5,6,14,711,13,2015,6,7
Group 5,RRG,-1.5,6,14,712,3,2015,5,-2
Group 5,RRG,-1.5,6,14,713,12,2015,4,8
Group 5,RRG,-1.5,6,14,714,13,2015,4,9
Group 5,RRG,-1.5,6,14,715,3,2015,5,-2
Group 5,RRG,-1.5,6,14,716,8,2015,2,6
Group 5,RRG,-1.5,6,14,717,9,2015,10,-1
Group 5,RRG,-1.5,6,14,718,12,2015,0,12
Group 5,RRG,-1.5,6,14,719,12,2015,12,0
Group 5,RRG,-1.5,6,14,720,13,2015,9,4
Group 5,RRG,-1.5,6,14,721,14,2015,9,5
Group 5,RRG,-1.5,6,14,722,11,2015,7,4
Group 5,RRG,-1.5,6,14,723,11,2015,7,4
Group 5,RRG,-1.5,6,14,724,9,2015,6,3
Group 5,RRG,-1.5,6,14,725,12,2015,9,3
Group 5,RRG,-1.5,6,14,726,9,2015,6,3
Group 5,RRG,-1.5,6,14,727,9,2015,12,-3
Group 5,RRG,-1.5,6,14,728,8,2015,10,-2
Group 5,RRG,-1.5,6,14,729,14,2015,7,7
Group 5,RRG,-1.5,6,14,730,0,2015,11,-11
Group 5,RRG,-1.5,6,14,731,11,2015,8,3
Group 5,RRG,-1.5,6,14,732,10,2015,8,2
Group 5,RRG,-1.5,6,14,733,10,2015,4,6
Group 5,RRG,-1.5,6,14,734,10,2015,7,3
Group 5,RRG,-1.5,6,14,735,10,2015,5,5
Group 5,RRG,-1.5,6,14,736,10,2015,7,3
Group 5,RRG,-1.5,6,14,737,9,2015,6,3
Group 5,RRG,-1.5,6,14,738,9,2015,8,1
Group 5,RRG,-1.5,6,14,739,11,2015,9,2
Group 5,RRG,-1.5,6,14,740,8,2015,4,4
Group 5,RRG,-1.5,6,14,741,9,2015,11,-2
Group 5,RRG,-1.5,6,14,742,12,2015,7,5
Group 5,RRG,-1.5,6,14,743,7,2015,10,-3
Group 5,RRG,-1.5,6,14,744,12,2015,11,1
Group 5,RRG,-1.5,6,14,745,12,2015,8,4
Group 5,RRG,-1.5,6,14,746,8,2015,9,-1
Group 5,RRG,-1.5,6,14,747,9,2015,6,3
Group 5,RRG,-1.5,6,14,748,11,2015,7,4
Group 5,RRG,-1.5,6,14,749,7,2015,4,3
Group 5,RRG,-1.5,6,14,750,6,2015,5,1
Group 5,RRG,-1.5,6,14,751,12,2015,7,5
Group 5,RRG,-1.5,6,14,752,10,2015,6,4
Group 5,RRG,-1.5,6,14,753,12,2015,8,4
Group 5,RRG,-1.5,6,14,754,12,2015,6,6
Group 5,RRG,-1.5,6,14,755,6,2015,6,0
Group 5,RRG,-1.5,6,14,756,9,2015,9,0
Group 5,RRG,-1.5,6,14,757,8,2015,6,2
Group 5,RRG,-1.5,6,14,758,7,2015,3,4
Group 5,RRG,-1.5,6,14,759,10,2015,11,-1
Group 5,RRG,-1.5,6,14,760,12,2015,3,9
Group 5,RRG,-1.5,6,14,761,13,2015,7,6
Group 5,RRG,-1.5,6,14,762,11,2015,7,4
Group 5,RRG,-1.5,6,14,763,3,2015,4,-1
Group 5,RRG,-1.5,6,14,764,4,2015,6,-2
Group 5,RRG,-1.5,6,14,765,10,2015,8,2
Group 5,RRG,-1.5,6,14,766,12,2015,5,7
Group 5,RRG,-1.5,6,14,767,12,2015,6,6
Group 5,RRG,-1.5,6,14,768,5,2015,6,-1
Group 5,RRG,-1.5,6,14,769,14,2015,8,6
Group 5,RRG,-1.5,6,14,770,10,2015,4,6
Group 5,RRG,-1.5,6,14,771,10,2015,3,7
Group 5,RRG,-1.5,6,14,772,7,2015,8,-1
Group 5,RRG,-1.5,6,14,773,3,2015,11,-8
Group 5,RRG,-1.5,6,14,774,10,2015,9,1
Group 5,RRG,-1.5,6,14,775,9,2015,2,7
Group 5,RRG,-1.5,6,14,776,12,2015,8,4
Group 5,RRG,-1.5,6,14,777,11,2015,10,1
Group 5,RRG,-1.5,6,14,778,11,2015,8,3
Group 5,RRG,-1.5,6,14,779,9,2015,8,1
Group 5,RRG,-1.5,6,14,780,11,2015,10,1
Group 5,RRG,-1.5,6,14,781,11,2015,1,10
Group 5,RRG,-1.5,6,14,782,8,2015,3,5
Group 5,RRG,-1.5,6,14,783,7,2015,7,0
Group 5,RRG,-1.5,6,14,784,9,2015,5,4
Group 5,RRG,-1.5,6,14,785,12,2015,6,6
Group 5,RRG,-1.5,6,14,786,9,2015,4,5
Group 5,RRG,-1.5,6,14,787,11,2015,5,6
Group 5,RRG,-1.5,6,14,788,12,2015,4,8
Group 5,RRG,-1.5,6,14,789,10,2015,7,3
Group 5,RRG,-1.5,6,14,790,13,2015,9,4
Group 5,RRG,-1.5,6,14,791,3,2015,5,-2
Group 5,RRG,-1.5,6,14,792,7,2015,2,5
Group 5,RRG,-1.5,6,14,793,12,2015,6,6
Group 5,RRG,-1.5,6,14,794,8,2015,7,1
Group 5,RRG,-1.5,6,14,795,10,2015,9,1
Group 5,RRG,-1.5,6,14,796,11,2015,5,6
Group 5,RRG,-1.5,6,14,797,11,2015,2,9
Group 5,RRG,-1.5,6,14,798,10,2015,3,7
Group 5,RRG,-1.5,6,14,799,7,2015,8,-1
Group 5,RRG,-1.5,6,14,800,10,2015,2,8
Group 5,RRG,-1.5,6,14,801,11,2015,4,7
Group 5,RRG,-1.5,6,14,802,7,2015,3,4
Group 5,RRG,-1.5,6,14,803,11,2015,7,4
Group 5,RRG,-1.5,6,14,804,12,2015,4,8
Group 5,RRG,-1.5,6,14,805,12,2015,1,11
Group 5,RRG,-1.5,6,14,806,9,2015,8,1
Group 5,RRG,-1.5,6,14,807,12,2015,7,5
Group 5,RRG,-1.5,6,14,808,9,2015,6,3
Group 5,RRG,-1.5,6,14,809,7,2015,7,0
Group 5,RRG,-1.5,6,14,810,12,2015,8,4
Group 5,RRG,-1.5,6,14,811,5,2015,8,-3
Group 5,RRG,-1.5,6,14,812,12,2015,10,2
Group 5,RRG,-1.5,6,14,813,4,2015,6,-2
Group 5,RRG,-1.5,6,14,814,7,2015,8,-1
Group 5,RRG,-1.5,6,14,815,12,2015,8,4
Group 5,RRG,-1.5,6,14,816,11,2015,8,3
Group 5,RRG,-1.5,6,14,817,8,2015,4,4
Group 5,RRG,-1.5,6,14,818,10,2015,10,0
Group 5,RRG,-1.5,6,14,819,7,2015,7,0
Group 5,RRG,-1.5,6,14,820,11,2015,7,4
Group 5,RRG,-1.5,6,14,821,8,2015,6,2
Group 5,RRG,-1.5,6,14,822,12,2015,8,4
Group 5,RRG,-1.5,6,14,823,11,2015,4,7
Group 5,RRG,-1.5,6,14,824,10,2015,5,5
Group 5,RRG,-1.5,6,14,825,8,2015,6,2
Group 5,RRG,-1.5,6,14,826,12,2015,7,5
Group 5,RRG,-1.5,6,14,827,9,2015,4,5
Group 5,RRG,-1.5,6,14,828,11,2015,8,3
Group 5,RRG,-1.5,6,14,829,12,2015,4,8
Group 5,RRG,-1.5,6,14,830,12,2015,9,3
Group 5,RRG,-1.5,6,14,831,7,2015,10,-3
Group 5,RRG,-1.5,6,14,832,8,2015,4,4
Group 5,RRG,-1.5,6,14,833,8,2015,9,-1
Group 5,RRG,-1.5,6,14,834,13,2015,9,4
Group 5,RRG,-1.5,6,14,835,7,2015,8,-1
Group 5,RRG,-1.5,6,14,836,12,2015,9,3
Group 5,RRG,-1.5,6,14,837,12,2015,7,5
Group 5,RRG,-1.5,6,14,838,6,2015,7,-1
Group 5,RRG,-1.5,6,14,839,14,2015,7,7
Group 5,RRG,-1.5,6,14,840,10,2015,5,5
Group 5,RRG,-1.5,6,14,841,12,2015,5,7
Group 5,RRG,-1.5,6,14,842,6,2015,9,-3
Group 5,RRG,-1.5,6,14,843,13,2015,6,7
Group 5,RRG,-1.5,6,14,844,11,2015,6,5
Group 5,RRG,-1.5,6,14,845,11,2015,9,2
Group 5,RRG,-1.5,6,14,846,10,2015,7,3
Group 5,RRG,-1.5,6,14,847,12,2015,7,5
Group 5,RRG,-1.5,6,14,848,9,2015,9,0
Group 5,RRG,-1.5,6,14,849,10,2015,7,3
Group 5,RRG,-1.5,6,14,850,6,2015,9,-3
Group 5,RRG,-1.5,6,14,851,11,2015,8,3
Group 5,RRG,-1.5,6,14,852,8,2015,6,2
Group 5,RRG,-1.5,6,14,853,7,2015,7,0
Group 5,RRG,-1.5,6,14,854,3,2015,8,-5
Group 5,RRG,-1.5,6,14,855,5,2015,13,-8
Group 5,RRG,-1.5,6,14,856,12,2015,7,5
Group 5,RRG,-1.5,6,14,857,10,2015,9,1
Group 5,RRG,-1.5,6,14,858,14,2015,7,7
Group 5,RRG,-1.5,6,14,859,13,2015,5,8
Group 5,RRG,-1.5,6,14,860,11,2015,12,-1
Group 5,RRG,-1.5,6,14,861,11,2015,7,4
Group 5,RRG,-1.5,6,14,862,8,2015,6,2
Group 5,RRG,-1.5,6,14,863,11,2015,8,3
Group 5,RRG,-1.5,6,14,864,8,2015,7,1
Group 5,RRG,-1.5,6,14,865,12,2015,7,5
Group 5,RRG,-1.5,6,14,866,12,2015,10,2
Group 5,RRG,-1.5,6,14,867,11,2015,6,5
Group 5,RRG,-1.5,6,14,868,9,2015,7,2
Group 5,RRG,-1.5,6,14,869,7,2015,5,2
Group 5,RRG,-1.5,6,14,870,12,2015,7,5
Group 5,RRG,-1.5,6,14,871,6,2015,7,-1
Group 5,RRG,-1.5,6,14,872,10,2015,9,1
Group 5,RRG,-1.5,6,14,873,8,2015,7,1
Group 5,RRG,-1.5,6,14,874,8,2015,7,1
Group 5,RRG,-1.5,6,14,875,10,2015,9,1
Group 5,RRG,-1.5,6,14,876,13,2015,6,7
Group 5,RRG,-1.5,6,14,877,13,2015,7,6
Group 5,RRG,-1.5,6,14,878,7,2015,5,2
Group 5,RRG,-1.5,6,14,879,11,2015,12,-1
Group 5,RRG,-1.5,6,14,880,11,2015,6,5
Group 5,RRG,-1.5,6,14,881,11,2015,6,5
Group 5,RRG,-1.5,6,14,882,11,2015,9,2
Group 5,RRG,-1.5,6,14,883,9,2015,5,4
Group 5,RRG,-1.5,6,14,884,7,2015,7,0
Group 5,RRG,-1.5,6,14,885,12,2015,8,4
Group 5,RRG,-1.5,6,14,886,11,2015,10,1
Group 5,RRG,-1.5,6,14,887,14,2015,6,8
Group 5,RRG,-1.5,6,14,888,12,2015,5,7
Group 5,RRG,-1.5,6,14,889,8,2015,7,1
Group 5,RRG,-1.5,6,14,890,8,2015,5,3
Group 5,RRG,-1.5,6,14,891,9,2015,7,2
Group 5,RRG,-1.5,6,14,892,8,2015,7,1
Group 5,RRG,-1.5,6,14,893,7,2015,8,-1
Group 5,RRG,-1.5,6,14,894,11,2015,11,0
Group 5,RRG,-1.5,6,14,895,10,2015,7,3
Group 5,RRG,-1.5,6,14,896,11,2015,4,7
Group 5,RRG,-1.5,6,14,897,6,2015,3,3
Group 5,RRG,-1.5,6,14,898,5,2015,11,-6
Group 5,RRG,-1.5,6,14,899,12,2015,2,10
Group 5,RRG,-1.5,6,14,900,13,2015,4,9
Group 5,RRG,-1.5,6,14,901,6,2015,7,-1
Group 5,RRG,-1.5,6,14,902,13,2015,6,7
Group 5,RRG,-1.5,6,14,903,7,2015,7,0
Group 5,RRG,-1.5,6,14,904,10,2015,6,4
Group 5,RRG,-1.5,6,14,905,11,2015,7,4
Group 5,RRG,-1.5,6,14,906,10,2015,2,8
Group 5,RRG,-1.5,6,14,907,10,2015,5,5
Group 5,RRG,-1.5,6,14,908,10,2015,2,8
Group 5,RRG,-1.5,6,14,909,9,2015,8,1
Group 5,RRG,-1.5,6,14,910,12,2015,2,10
Group 5,RRG,-1.5,6,14,911,11,2015,9,2
Group 5,RRG,-1.5,6,14,912,8,2015,2,6
Group 5,RRG,-1.5,6,14,913,6,2015,3,3
Group 5,RRG,-1.5,6,14,914,8,2015,5,3
Group 5,RRG,-1.5,6,14,915,7,2015,1,6
Group 5,RRG,-1.5,6,14,916,8,2015,3,5
Group 5,RRG,-1.5,6,14,917,11,2015,5,6
Group 5,RRG,-1.5,6,14,918,13,2015,8,5
Group 5,RRG,-1.5,6,14,919,10,2015,8,2
Group 5,RRG,-1.5,6,14,920,11,2015,9,2
Group 5,RRG,-1.5,6,14,921,8,2015,6,2
Group 5,RRG,-1.5,6,14,922,7,2015,7,0
Group 5,RRG,-1.5,6,14,923,12,2015,6,6
Group 5,RRG,-1.5,6,14,924,7,2015,6,1
Group 5,RRG,-1.5,6,14,925,12,2015,4,8
Group 5,RRG,-1.5,6,14,926,13,2015,10,3
Group 5,RRG,-1.5,6,14,927,7,2015,10,-3
Group 5,RRG,-1.5,6,14,928,9,2015,10,-1
Group 5,RRG,-1.5,6,14,929,8,2015,9,-1
Group 5,RRG,-1.5,6,14,930,8,2015,9,-1
Group 5,RRG,-1.5,6,14,931,10,2015,6,4
Group 5,RRG,-1.5,6,14,932,10,2015,10,0
Group 5,RRG,-1.5,6,14,933,8,2015,5,3
Group 5,RRG,-1.5,6,14,934,9,2015,7,2
Group 5,RRG,-1.5,6,14,935,14,2015,2,12
Group 5,RRG,-1.5,6,14,936,10,2015,8,2
Group 5,RRG,-1.5,6,14,937,9,2015,5,4
Group 5,RRG,-1.5,6,14,938,11,2015,10,1
Group 5,RRG,-1.5,6,14,939,11,2015,3,8
Group 5,RRG,-1.5,6,14,940,10,2015,6,4
Group 5,RRG,-1.5,6,14,941,9,2015,10,-1
Group 5,RRG,-1.5,6,14,942,10,2015,8,2
Group 5,RRG,-1.5,6,14,943,11,2015,5,6
Group 5,RRG,-1.5,6,14,944,7,2015,5,2
Group 5,RRG,-1.5,6,14,945,13,2015,1,12
Group 5,RRG,-1.5,6,14,946,11,2015,12,-1
Group 5,RRG,-1.5,6,14,947,12,2015,11,1
Group 5,RRG,-1.5,6,14,948,10,2015,7,3
Group 5,RRG,-1.5,6,14,949,14,2015,6,8
Group 5,RRG,-1.5,6,14,950,13,2015,7,6
Group 5,RRG,-1.5,6,14,951,12,2015,4,8
Group 5,RRG,-1.5,6,14,952,9,2015,8,1
Group 5,RRG,-1.5,6,14,953,6,2015,6,0
Group 5,RRG,-1.5,6,14,954,12,2015,6,6
Group 5,RRG,-1.5,6,14,955,9,2015,10,-1
Group 5,RRG,-1.5,6,14,956,8,2015,6,2
Group 5,RRG,-1.5,6,14,957,7,2015,8,-1
Group 5,RRG,-1.5,6,14,958,8,2015,5,3
Group 5,RRG,-1.5,6,14,959,7,2015,4,3
Group 5,RRG,-1.5,6,14,960,6,2015,8,-2
Group 5,RRG,-1.5,6,14,961,12,2015,2,10
Group 5,RRG,-1.5,6,14,962,11,2015,7,4
Group 5,RRG,-1.5,6,14,963,10,2015,5,5
Group 5,RRG,-1.5,6,14,964,10,2015,7,3
Group 5,RRG,-1.5,6,14,965,9,2015,2,7
Group 5,RRG,-1.5,6,14,966,12,2015,5,7
Group 5,RRG,-1.5,6,14,967,11,2015,8,3
Group 5,RRG,-1.5,6,14,968,8,2015,8,0
Group 5,RRG,-1.5,6,14,969,6,2015,5,1
Group 5,RRG,-1.5,6,14,970,11,2015,7,4
Group 5,RRG,-1.5,6,14,971,12,2015,5,7
Group 5,RRG,-1.5,6,14,972,12,2015,6,6
Group 5,RRG,-1.5,6,14,973,12,2015,7,5
Group 5,RRG,-1.5,6,14,974,9,2015,5,4
Group 5,RRG,-1.5,6,14,975,7,2015,9,-2
Group 5,RRG,-1.5,6,14,976,9,2015,10,-1
Group 5,RRG,-1.5,6,14,977,11,2015,9,2
Group 5,RRG,-1.5,6,14,978,6,2015,3,3
Group 5,RRG,-1.5,6,14,979,10,2015,9,1
Group 5,RRG,-1.5,6,14,980,6,2015,1,5
Group 5,RRG,-1.5,6,14,981,11,2015,11,0
Group 5,RRG,-1.5,6,14,982,12,2015,10,2
Group 5,RRG,-1.5,6,14,983,12,2015,10,2
Group 5,RRG,-1.5,6,14,984,10,2015,4,6
Group 5,RRG,-1.5,6,14,985,10,2015,8,2
Group 5,RRG,-1.5,6,14,986,8,2015,6,2
Group 5,RRG,-1.5,6,14,987,8,2015,10,-2
Group 5,RRG,-1.5,6,14,988,8,2015,7,1
Group 5,RRG,-1.5,6,14,989,8,2015,7,1
Group 5,RRG,-1.5,6,14,990,12,2015,7,5
Group 5,RRG,-1.5,6,14,991,8,2015,8,0
Group 5,RRG,-1.5,6,14,992,11,2015,8,3
Group 5,RRG,-1.5,6,14,993,7,2015,10,-3
Group 5,RRG,-1.5,6,14,994,12,2015,2,10
Group 5,RRG,-1.5,6,14,995,3,2015,4,-1
Group 5,RRG,-1.5,6,14,996,11,2015,10,1
Group 5,RRG,-1.5,6,14,997,12,2015,13,-1
Group 5,RRG,-1.5,6,14,998,5,2015,6,-1
Group 5,RRG,-1.5,6,14,999,11,2015,5,6
Group 5,RRG,-1.5,6,14,1000,7,2015,11,-4
Group 5,RRG,-1.5,6,14,1001,13,2015,8,5
Group 5,RRG,-1.5,6,14,1002,10,2015,11,-1
Group 5,RRG,-1.5,6,14,1003,7,2015,10,-3
Group 5,RRG,-1.5,6,14,1004,13,2015,10,3
Group 5,RRG,-1.5,6,14,1005,5,2015,3,2
Group 5,RRG,-1.5,6,14,1006,12,2015,8,4
Group 5,RRG,-1.5,6,14,1007,13,2015,10,3
Group 5,RRG,-1.5,6,14,1008,10,2015,7,3
Group 5,RRG,-1.5,6,14,1009,11,2015,9,2
Group 5,RRG,-1.5,6,14,1010,11,2015,9,2
Group 5,RRG,-1.5,6,14,1011,13,2015,8,5
Group 5,RRG,-1.5,6,14,1012,8,2015,8,0
Group 5,RRG,-1.5,6,14,1013,12,2015,7,5
Group 5,RRG,-1.5,6,14,1014,12,2015,10,2
Group 5,RRG,-1.5,6,14,1015,12,2015,4,8
Group 5,RRG,-1.5,6,14,1016,12,2015,5,7
Group 5,RRG,-1.5,6,14,1017,12,2015,9,3
Group 5,RRG,-1.5,6,14,1018,9,2015,5,4
Group 5,RRG,-1.5,6,14,1019,13,2015,2,11
Group 5,RRG,-1.5,6,14,1020,9,2015,6,3
Group 5,RRG,-1.5,6,14,1021,7,2015,7,0
Group 5,RRG,-1.5,6,14,1022,0,2015,7,-7
Group 5,RRG,-1.5,6,14,1023,8,2015,7,1
Group 5,RRG,-1.5,6,14,1024,14,2015,8,6
Group 5,RRG,-1.5,6,14,1025,11,2015,5,6
Group 5,RRG,-1.5,6,14,1026,11,2015,9,2
Group 5,RRG,-1.5,6,14,1027,10,2015,11,-1
Group 5,RRG,-1.5,6,14,1028,9,2015,5,4
Group 5,RRG,-1.5,6,14,1029,5,2015,5,0
Group 5,RRG,-1.5,6,14,1030,10,2015,4,6
Group 5,RRG,-1.5,6,14,1031,9,2015,6,3
Group 5,RRG,-1.5,6,14,1032,12,2015,4,8
Group 5,RRG,-1.5,6,14,1033,8,2015,4,4
Group 5,RRG,-1.5,6,14,1034,11,2015,2,9
Group 5,RRG,-1.5,6,14,1035,7,2015,5,2
Group 5,RRG,-1.5,6,14,1036,11,2015,10,1
Group 5,RRG,-1.5,6,14,1037,9,2015,10,-1
Group 5,RRG,-1.5,6,14,1038,11,2015,3,8
Group 5,RRG,-1.5,6,14,1039,10,2015,9,1
Group 5,RRG,-1.5,6,14,1040,12,2015,5,7
Group 5,RRG,-1.5,6,14,1041,11,2015,6,5
Group 5,RRG,-1.5,6,14,1042,12,2015,6,6
Group 5,RRG,-1.5,6,14,1043,9,2015,5,4
Group 5,RRG,-1.5,6,14,1044,12,2015,10,2
Group 5,RRG,-1.5,6,14,1045,12,2015,7,5
Group 5,RRG,-1.5,6,14,1046,9,2015,5,4
Group 5,RRG,-1.5,6,14,1047,11,2015,9,2
Group 5,RRG,-1.5,6,14,1048,10,2015,5,5
Group 5,RRG,-1.5,6,14,1049,8,2015,9,-1
Group 5,RRG,-1.5,6,14,1050,7,2015,5,2
Group 5,RRG,-1.5,6,14,1051,9,2015,4,5
Group 5,RRG,-1.5,6,14,1052,14,2015,5,9
Group 5,RRG,-1.5,6,14,1053,12,2015,5,7
Group 5,RRG,-1.5,6,14,1054,11,2015,3,8
Group 5,RRG,-1.5,6,14,1055,8,2015,6,2
Group 5,RRG,-1.5,6,14,1056,12,2015,10,2
Group 5,RRG,-1.5,6,14,1057,12,2015,3,9
Group 5,RRG,-1.5,6,14,1058,11,2015,2,9
Group 5,RRG,-1.5,6,14,1059,11,2015,6,5
Group 5,RRG,-1.5,6,14,1060,6,2015,7,-1
Group 5,RRG,-1.5,6,14,1061,7,2015,7,0
Group 5,RRG,-1.5,6,14,1062,10,2015,8,2
Group 5,RRG,-1.5,6,14,1063,12,2015,5,7
Group 5,RRG,-1.5,6,14,1064,13,2015,7,6
Group 5,RRG,-1.5,6,14,1065,10,2015,6,4
Group 5,RRG,-1.5,6,14,1066,12,2015,1,11
Group 5,RRG,-1.5,6,14,1067,10,2015,7,3
Group 5,RRG,-1.5,6,14,1068,8,2015,10,-2
Group 5,RRG,-1.5,6,14,1069,12,2015,5,7
Group 5,RRG,-1.5,6,14,1070,9,2015,8,1
Group 5,RRG,-1.5,6,14,1071,8,2015,6,2
Group 5,RRG,-1.5,6,14,1072,8,2015,8,0
Group 5,RRG,-1.5,6,14,1073,7,2015,8,-1
Group 5,RRG,-1.5,6,14,1074,8,2015,6,2
Group 5,RRG,-1.5,6,14,1075,6,2015,9,-3
Group 5,RRG,-1.5,6,14,1076,9,2015,12,-3
Group 5,RRG,-1.5,6,14,1077,9,2015,9,0
Group 5,RRG,-1.5,6,14,1078,4,2015,13,-9
Group 5,RRG,-1.5,6,14,1079,12,2015,10,2
Group 5,RRG,-1.5,6,14,1080,14,2015,7,7
Group 5,RRG,-1.5,6,14,1081,8,2015,6,2
Group 5,RRG,-1.5,6,14,1082,9,2015,4,5
Group 5,RRG,-1.5,6,14,1083,11,2015,8,3
Group 5,RRG,-1.5,6,14,1084,12,2015,8,4
Group 5,RRG,-1.5,6,14,1085,9,2015,8,1
Group 5,RRG,-1.5,6,14,1086,11,2015,7,4
Group 5,RRG,-1.5,6,14,1087,6,2015,7,-1
Group 5,RRG,-1.5,6,14,1088,9,2015,1,8
Group 5,RRG,-1.5,6,14,1089,10,2015,10,0
Group 5,RRG,-1.5,6,14,1090,7,2015,5,2
Group 5,RRG,-1.5,6,14,1091,8,2015,8,0
Group 5,RRG,-1.5,6,14,1092,11,2015,9,2
Group 5,RRG,-1.5,6,14,1093,10,2015,5,5
Group 5,RRG,-1.5,6,14,1094,10,2015,5,5
Group 5,RRG,-1.5,6,14,1095,7,2015,7,0
Group 5,RRG,-1.5,6,14,1096,5,2015,6,-1
Group 5,RRG,-1.5,6,14,1097,3,2015,4,-1
Group 5,RRG,-1.5,6,14,1098,11,2015,10,1
Group 5,RRG,-1.5,6,14,1099,4,2015,1,3
Group 5,RRG,-1.5,6,14,1100,6,2015,3,3
Group 5,RRG,-1.5,6,14,1101,7,2015,5,2
Group 5,RRG,-1.5,6,14,1102,13,2015,6,7
Group 5,RRG,-1.5,6,14,1103,13,2015,7,6
Group 5,RRG,-1.5,6,14,1104,13,2015,5,8
Group 5,RRG,-1.5,6,14,1105,12,2015,7,5
Group 5,RRG,-1.5,6,14,1106,11,2015,6,5
Group 5,RRG,-1.5,6,14,1107,11,2015,6,5
Group 5,RRG,-1.5,6,14,1108,6,2015,6,0
Group 5,RRG,-1.5,6,14,1109,9,2015,11,-2
Group 5,RRG,-1.5,6,14,1110,12,2015,4,8
Group 5,RRG,-1.5,6,14,1111,12,2015,3,9
Group 5,RRG,-1.5,6,14,1112,10,2015,6,4
Group 5,RRG,-1.5,6,14,1113,12,2015,5,7
Group 5,RRG,-1.5,6,14,1114,13,2015,9,4
Group 5,RRG,-1.5,6,14,1115,7,2015,9,-2
Group 5,RRG,-1.5,6,14,1116,11,2015,6,5
Group 5,RRG,-1.5,6,14,1117,11,2015,7,4
Group 5,RRG,-1.5,6,14,1118,11,2015,10,1
Group 5,RRG,-1.5,6,14,1119,10,2015,12,-2
Group 5,RRG,-1.5,6,14,1120,13,2015,7,6
Group 5,RRG,-1.5,6,14,1121,7,2015,3,4
Group 5,RRG,-1.5,6,14,1122,11,2015,2,9
Group 5,RRG,-1.5,6,14,1123,8,2015,11,-3
Group 5,RRG,-1.5,6,14,1124,11,2015,8,3
Group 5,RRG,-1.5,6,14,1125,11,2015,3,8
Group 5,RRG,-1.5,6,14,1126,8,2015,9,-1
Group 5,RRG,-1.5,6,14,1127,11,2015,5,6
Group 5,RRG,-1.5,6,14,1128,8,2015,10,-2
Group 5,RRG,-1.5,6,14,1129,8,2015,4,4
Group 5,RRG,-1.5,6,14,1130,11,2015,6,5
Group 5,RRG,-1.5,6,14,1131,10,2015,11,-1
Group 5,RRG,-1.5,6,14,1132,6,2015,9,-3
Group 5,RRG,-1.5,6,14,1133,6,2015,12,-6
Group 5,RRG,-1.5,6,14,1134,10,2015,7,3
Group 5,RRG,-1.5,6,14,1135,11,2015,11,0
Group 5,RRG,-1.5,6,14,1136,12,2015,5,7
Group 5,RRG,-1.5,6,14,1137,10,2015,3,7
Group 5,RRG,-1.5,6,14,1138,9,2015,5,4
Group 5,RRG,-1.5,6,14,1139,11,2015,3,8
Group 5,RRG,-1.5,6,14,1140,11,2015,8,3
Group 5,RRG,-1.5,6,14,1141,9,2015,6,3
Group 5,RRG,-1.5,6,14,1142,13,2015,9,4
Group 5,RRG,-1.5,6,14,1143,12,2015,3,9
Group 5,RRG,-1.5,6,14,1144,12,2015,7,5
Group 5,RRG,-1.5,6,14,1145,9,2015,9,0
Group 5,RRG,-1.5,6,14,1146,5,2015,5,0
Group 5,RRG,-1.5,6,14,1147,9,2015,5,4
Group 5,RRG,-1.5,6,14,1148,11,2015,5,6
Group 5,RRG,-1.5,6,14,1149,9,2015,6,3
Group 5,RRG,-1.5,6,14,1150,9,2015,6,3
Group 5,RRG,-1.5,6,14,1151,6,2015,8,-2
Group 5,RRG,-1.5,6,14,1152,8,2015,8,0
Group 5,RRG,-1.5,6,14,1153,13,2015,12,1
Group 5,RRG,-1.5,6,14,1154,11,2015,3,8
Group 5,RRG,-1.5,6,14,1155,9,2015,6,3
Group 5,RRG,-1.5,6,14,1156,6,2015,11,-5
Group 5,RRG,-1.5,6,14,1157,12,2015,5,7
Group 5,RRG,-1.5,6,14,1158,10,2015,7,3
Group 5,RRG,-1.5,6,14,1159,12,2015,10,2
Group 5,RRG,-1.5,6,14,1160,12,2015,5,7
Group 5,RRG,-1.5,6,14,1161,9,2015,11,-2
Group 5,RRG,-1.5,6,14,1162,7,2015,8,-1
Group 5,RRG,-1.5,6,14,1163,13,2015,8,5
Group 5,RRG,-1.5,6,14,1164,6,2015,6,0
Group 5,RRG,-1.5,6,14,1165,9,2015,8,1
Group 5,RRG,-1.5,6,14,1166,9,2015,10,-1
Group 5,RRG,-1.5,6,14,1167,9,2015,5,4
Group 5,RRG,-1.5,6,14,1168,8,2015,6,2
Group 5,RRG,-1.5,6,14,1169,12,2015,5,7
Group 5,RRG,-1.5,6,14,1170,8,2015,8,0
Group 5,RRG,-1.5,6,14,1171,9,2015,9,0
Group 5,RRG,-1.5,6,14,1172,6,2015,9,-3
Group 5,RRG,-1.5,6,14,1173,11,2015,3,8
Group 5,RRG,-1.5,6,14,1174,6,2015,6,0
Group 5,RRG,-1.5,6,14,1175,11,2015,8,3
Group 5,RRG,-1.5,6,14,1176,10,2015,8,2
Group 5,RRG,-1.5,6,14,1177,9,2015,8,1
Group 5,RRG,-1.5,6,14,1178,12,2015,9,3
Group 5,RRG,-1.5,6,14,1179,9,2015,7,2
Group 5,RRG,-1.5,6,14,1180,8,2015,8,0
Group 5,RRG,-1.5,6,14,1181,12,2015,8,4
Group 5,RRG,-1.5,6,14,1182,13,2015,7,6
Group 5,RRG,-1.5,6,14,1183,11,2015,3,8
Group 5,RRG,-1.5,6,14,1184,11,2015,7,4
Group 5,RRG,-1.5,6,14,1185,12,2015,7,5
Group 5,RRG,-1.5,6,14,1186,8,2015,7,1
Group 5,RRG,-1.5,6,14,1187,8,2015,6,2
Group 5,RRG,-1.5,6,14,1188,13,2015,9,4
Group 5,RRG,-1.5,6,14,1189,9,2015,7,2
Group 5,RRG,-1.5,6,14,1190,7,2015,9,-2
Group 5,RRG,-1.5,6,14,1191,11,2015,9,2
Group 5,RRG,-1.5,6,14,1192,10,2015,4,6
Group 5,RRG,-1.5,6,14,1193,10,2015,6,4
Group 5,RRG,-1.5,6,14,1194,5,2015,6,-1
Group 5,RRG,-1.5,6,14,1195,8,2015,4,4
Group 5,RRG,-1.5,6,14,1196,4,2015,6,-2
Group 5,RRG,-1.5,6,14,1197,9,2015,9,0
Group 5,RRG,-1.5,6,14,1198,11,2015,6,5
Group 5,RRG,-1.5,6,14,1199,6,2015,3,3
Group 5,RRG,-1.5,6,14,1200,8,2015,4,4
Group 5,RRG,-1.5,6,14,1201,14,2015,9,5
Group 5,RRG,-1.5,6,14,1202,8,2015,4,4
Group 5,RRG,-1.5,6,14,1203,7,2015,4,3
Group 5,RRG,-1.5,6,14,1204,8,2015,8,0
Group 5,RRG,-1.5,6,14,1205,8,2015,4,4
Group 5,RRG,-1.5,6,14,1206,10,2015,6,4
Group 5,RRG,-1.5,6,14,1207,14,2015,7,7
Group 5,RRG,-1.5,6,14,1208,7,2015,5,2
Group 5,RRG,-1.5,6,14,1209,12,2015,6,6
Group 5,RRG,-1.5,6,14,1210,13,2015,3,10
Group 5,RRG,-1.5,6,14,1211,12,2015,9,3
Group 5,RRG,-1.5,6,14,1212,11,2015,6,5
Group 5,RRG,-1.5,6,14,1213,13,2015,2,11
Group 5,RRG,-1.5,6,14,1214,14,2015,8,6
Group 5,RRG,-1.5,6,14,1215,9,2015,2,7
Group 5,RRG,-1.5,6,14,1216,12,2015,7,5
Group 5,RRG,-1.5,6,14,1217,13,2015,10,3
Group 5,RRG,-1.5,6,14,1218,10,2015,3,7
Group 5,RRG,-1.5,6,14,1219,7,2015,11,-4
Group 5,RRG,-1.5,6,14,1220,10,2015,5,5
Group 5,RRG,-1.5,6,14,1221,7,2015,8,-1
Group 5,RRG,-1.5,6,14,1222,11,2015,8,3
Group 5,RRG,-1.5,6,14,1223,4,2015,11,-7
Group 5,RRG,-1.5,6,14,1224,9,2015,9,0
Group 5,RRG,-1.5,6,14,1225,1,2015,7,-6
Group 5,RRG,-1.5,6,14,1226,6,2015,7,-1
Group 5,RRG,-1.5,6,14,1227,11,2015,8,3
Group 5,RRG,-1.5,6,14,1228,11,2015,10,1
Group 5,RRG,-1.5,6,14,1229,9,2015,5,4
Group 5,RRG,-1.5,6,14,1230,10,2015,7,3
Group 5,RRG,-1.5,6,14,1231,11,2015,7,4
Group 5,RRG,-1.5,6,14,1232,11,2015,6,5
Group 5,RRG,-1.5,6,14,1233,7,2015,8,-1
Group 5,RRG,-1.5,6,14,1234,13,2015,6,7
Group 5,RRG,-1.5,6,14,1235,10,2015,4,6
Group 5,RRG,-1.5,6,14,1236,12,2015,4,8
Group 5,RRG,-1.5,6,14,1237,8,2015,5,3
Group 5,RRG,-1.5,6,14,1238,12,2015,4,8
Group 5,RRG,-1.5,6,14,1239,8,2015,2,6
Group 5,RRG,-1.5,6,14,1240,5,2015,5,0
Group 5,RRG,-1.5,6,14,1241,7,2015,4,3
Group 5,RRG,-1.5,6,14,1242,8,2015,7,1
Group 5,RRG,-1.5,6,14,1243,5,2015,6,-1
Group 5,RRG,-1.5,6,14,1244,13,2015,8,5
Group 5,RRG,-1.5,6,14,1245,12,2015,9,3
Group 5,RRG,-1.5,6,14,1246,11,2015,9,2
Group 5,RRG,-1.5,6,14,1247,11,2015,9,2
Group 5,RRG,-1.5,6,14,1248,12,2015,7,5
Group 5,RRG,-1.5,6,14,1249,8,2015,9,-1
Group 5,RRG,-1.5,6,14,1250,10,2015,11,-1
Group 5,RRG,-1.5,6,14,1251,8,2015,10,-2
Group 5,RRG,-1.5,6,14,1252,6,2015,7,-1
Group 5,RRG,-1.5,6,14,1253,12,2015,6,6
Group 5,RRG,-1.5,6,14,1254,12,2015,6,6
Group 5,RRG,-1.5,6,14,1255,9,2015,7,2
Group 5,RRG,-1.5,6,14,1256,9,2015,4,5
Group 5,RRG,-1.5,6,14,1257,7,2015,5,2
Group 5,RRG,-1.5,6,14,1258,11,2015,6,5
Group 5,RRG,-1.5,6,14,1259,11,2015,7,4
Group 5,RRG,-1.5,6,14,1260,13,2015,6,7
Group 5,RRG,-1.5,6,14,1261,8,2015,7,1
Group 5,RRG,-1.5,6,14,1262,11,2015,7,4
Group 5,RRG,-1.5,6,14,1263,6,2015,9,-3
Group 5,RRG,-1.5,6,14,1264,7,2015,10,-3
Group 5,RRG,-1.5,6,14,1265,6,2015,7,-1
Group 5,RRG,-1.5,6,14,1266,12,2015,9,3
Group 5,RRG,-1.5,6,14,1267,13,2015,4,9
Group 5,RRG,-1.5,6,14,1268,7,2015,9,-2
Group 5,RRG,-1.5,6,14,1269,7,2015,7,0
Group 5,RRG,-1.5,6,14,1270,8,2015,6,2
Group 5,RRG,-1.5,6,14,1271,8,2015,5,3
Group 5,RRG,-1.5,6,14,1272,11,2015,4,7
Group 5,RRG,-1.5,6,14,1273,7,2015,4,3
Group 5,RRG,-1.5,6,14,1274,9,2015,6,3
Group 5,RRG,-1.5,6,14,1275,10,2015,6,4
Group 5,RRG,-1.5,6,14,1276,11,2015,3,8
Group 5,RRG,-1.5,6,14,1277,6,2015,7,-1
Group 5,RRG,-1.5,6,14,1278,9,2015,9,0
Group 5,RRG,-1.5,6,14,1279,13,2015,6,7
Group 5,RRG,-1.5,6,14,1280,9,2015,9,0
Group 5,RRG,-1.5,6,14,1281,12,2015,7,5
Group 5,RRG,-1.5,6,14,1282,12,2015,2,10
Group 5,RRG,-1.5,6,14,1283,12,2015,7,5
Group 5,RRG,-1.5,6,14,1284,8,2015,7,1
Group 5,RRG,-1.5,6,14,1285,9,2015,8,1
Group 5,RRG,-1.5,6,14,1286,6,2015,10,-4
Group 5,RRG,-1.5,6,14,1287,8,2015,5,3
Group 5,RRG,-1.5,6,14,1288,9,2015,3,6
Group 5,RRG,-1.5,6,14,1289,10,2015,7,3
Group 5,RRG,-1.5,6,14,1290,7,2015,10,-3
Group 5,RRG,-1.5,6,14,1291,11,2015,8,3
Group 5,RRG,-1.5,6,14,1292,13,2015,9,4
Group 5,RRG,-1.5,6,14,1293,9,2015,10,-1
Group 5,RRG,-1.5,6,14,1294,11,2015,11,0
Group 5,RRG,-1.5,6,14,1295,12,2015,10,2
Group 5,RRG,-1.5,6,14,1296,6,2015,4,2
Group 5,RRG,-1.5,6,14,1297,13,2015,6,7
Group 5,RRG,-1.5,6,14,1298,7,2015,5,2
Group 5,RRG,-1.5,6,14,1299,10,2015,7,3
Group 5,RRG,-1.5,6,14,1300,6,2015,7,-1
Group 5,RRG,-1.5,6,14,1301,10,2015,5,5
Group 5,RRG,-1.5,6,14,1302,9,2015,0,9
Group 5,RRG,-1.5,6,14,1303,8,2015,2,6
Group 5,RRG,-1.5,6,14,1304,11,2015,5,6
Group 5,RRG,-1.5,6,14,1305,10,2015,5,5
Group 5,RRG,-1.5,6,14,1306,10,2015,7,3
Group 5,RRG,-1.5,6,14,1307,8,2015,9,-1
Group 5,RRG,-1.5,6,14,1308,7,2015,6,1
Group 5,RRG,-1.5,6,14,1309,13,2015,9,4
Group 5,RRG,-1.5,6,14,1310,8,2015,9,-1
Group 5,RRG,-1.5,6,14,1311,11,2015,6,5
Group 5,RRG,-1.5,6,14,1312,11,2015,4,7
Group 5,RRG,-1.5,6,14,1313,8,2015,8,0
Group 5,RRG,-1.5,6,14,1314,9,2015,4,5
Group 5,RRG,-1.5,6,14,1315,10,2015,10,0
Group 5,RRG,-1.5,6,14,1316,9,2015,5,4
Group 5,RRG,-1.5,6,14,1317,5,2015,8,-3
Group 5,RRG,-1.5,6,14,1318,7,2015,8,-1
Group 5,RRG,-1.5,6,14,1319,9,2015,4,5
Group 5,RRG,-1.5,6,14,1320,5,2015,5,0
Group 5,RRG,-1.5,6,14,1321,14,2015,10,4
Group 5,RRG,-1.5,6,14,1322,4,2015,4,0
Group 5,RRG,-1.5,6,14,1323,11,2015,9,2
Group 5,RRG,-1.5,6,14,1324,12,2015,9,3
Group 5,RRG,-1.5,6,14,1325,13,2015,5,8
Group 5,RRG,-1.5,6,14,1326,14,2015,7,7
Group 5,RRG,-1.5,6,14,1327,11,2015,10,1
Group 5,RRG,-1.5,6,14,1328,13,2015,5,8
Group 5,RRG,-1.5,6,14,1329,12,2015,6,6
Group 5,RRG,-1.5,6,14,1330,6,2015,6,0
Group 5,RRG,-1.5,6,14,1331,10,2015,6,4
Group 5,RRG,-1.5,6,14,1332,10,2015,8,2
Group 5,RRG,-1.5,6,14,1333,13,2015,7,6
Group 5,RRG,-1.5,6,14,1334,10,2015,5,5
Group 5,RRG,-1.5,6,14,1335,8,2015,9,-1
Group 5,RRG,-1.5,6,14,1336,10,2015,6,4
Group 5,RRG,-1.5,6,14,1337,10,2015,5,5
Group 5,RRG,-1.5,6,14,1338,5,2015,4,1
Group 5,RRG,-1.5,6,14,1339,9,2015,10,-1
Group 5,RRG,-1.5,6,14,1340,12,2015,10,2
Group 5,RRG,-1.5,6,14,1341,12,2015,4,8
Group 5,RRG,-1.5,6,14,1342,9,2015,6,3
Group 5,RRG,-1.5,6,14,1343,8,2015,4,4
Group 5,RRG,-1.5,6,14,1344,9,2015,8,1
Group 5,RRG,-1.5,6,14,1345,7,2015,9,-2
Group 5,RRG,-1.5,6,14,1346,14,2015,8,6
Group 5,RRG,-1.5,6,14,1347,4,2015,8,-4
Group 5,RRG,-1.5,6,14,1348,11,2015,3,8
Group 5,RRG,-1.5,6,14,1349,11,2015,3,8
Group 5,RRG,-1.5,6,14,1350,12,2015,6,6
Group 5,RRG,-1.5,6,14,1351,7,2015,6,1
Group 5,RRG,-1.5,6,14,1352,10,2015,5,5
Group 5,RRG,-1.5,6,14,1353,8,2015,4,4
Group 5,RRG,-1.5,6,14,1354,8,2015,6,2
Group 5,RRG,-1.5,6,14,1355,13,2015,4,9
Group 5,RRG,-1.5,6,14,1356,11,2015,7,4
Group 5,RRG,-1.5,6,14,1357,7,2015,10,-3
Group 5,RRG,-1.5,6,14,1358,7,2015,10,-3
Group 5,RRG,-1.5,6,14,1359,10,2015,5,5
Group 5,RRG,-1.5,6,14,1360,13,2015,6,7
Group 5,RRG,-1.5,6,14,1361,3,2015,9,-6
Group 5,RRG,-1.5,6,14,1362,8,2015,7,1
Group 5,RRG,-1.5,6,14,1363,2,2015,8,-6
Group 5,RRG,-1.5,6,14,1364,9,2015,12,-3
Group 5,RRG,-1.5,6,14,1365,8,2015,11,-3
Group 5,RRG,-1.5,6,14,1366,11,2015,11,0
Group 5,RRG,-1.5,6,14,1367,7,2015,8,-1
Group 5,RRG,-1.5,6,14,1368,3,2015,6,-3
Group 5,RRG,-1.5,6,14,1369,9,2015,7,2
Group 5,RRG,-1.5,6,14,1370,5,2015,6,-1
Group 5,RRG,-1.5,6,14,1371,12,2015,7,5
Group 5,RRG,-1.5,6,14,1372,13,2015,8,5
Group 5,RRG,-1.5,6,14,1373,8,2015,5,3
Group 5,RRG,-1.5,6,14,1374,10,2015,4,6
Group 5,RRG,-1.5,6,14,1375,11,2015,8,3
Group 5,RRG,-1.5,6,14,1376,12,2015,6,6
Group 5,RRG,-1.5,6,14,1377,12,2015,6,6
Group 5,RRG,-1.5,6,14,1378,9,2015,6,3
Group 5,RRG,-1.5,6,14,1379,9,2015,9,0
Group 5,RRG,-1.5,6,14,1380,10,2015,8,2
Group 5,RRG,-1.5,6,14,1381,9,2015,5,4
Group 5,RRG,-1.5,6,14,1382,11,2015,9,2
Group 5,RRG,-1.5,6,14,1383,10,2015,5,5
Group 5,RRG,-1.5,6,14,1384,8,2015,6,2
Group 5,RRG,-1.5,6,14,1385,8,2015,4,4
Group 5,RRG,-1.5,6,14,1386,7,2015,6,1
Group 5,RRG,-1.5,6,14,1387,11,2015,7,4
Group 5,RRG,-1.5,6,14,1388,10,2015,8,2
Group 5,RRG,-1.5,6,14,1389,11,2015,10,1
Group 5,RRG,-1.5,6,14,1390,10,2015,6,4
Group 5,RRG,-1.5,6,14,1391,10,2015,6,4
Group 5,RRG,-1.5,6,14,1392,11,2015,7,4
Group 5,RRG,-1.5,6,14,1393,13,2015,7,6
Group 5,RRG,-1.5,6,14,1394,7,2015,10,-3
Group 5,RRG,-1.5,6,14,1395,12,2015,5,7
Group 5,RRG,-1.5,6,14,1396,11,2015,4,7
Group 5,RRG,-1.5,6,14,1397,7,2015,10,-3
Group 5,RRG,-1.5,6,14,1398,10,2015,7,3
Group 5,RRG,-1.5,6,14,1399,10,2015,6,4
Group 5,RRG,-1.5,6,14,1400,8,2015,7,1
Group 5,RRG,-1.5,6,14,1401,9,2015,5,4
Group 5,RRG,-1.5,6,14,1402,13,2015,6,7
Group 5,RRG,-1.5,6,14,1403,5,2015,9,-4
Group 5,RRG,-1.5,6,14,1404,12,2015,8,4
Group 5,RRG,-1.5,6,14,1405,9,2015,8,1
Group 5,RRG,-1.5,6,14,1406,6,2015,6,0
Group 5,RRG,-1.5,6,14,1407,10,2015,8,2
Group 5,RRG,-1.5,6,14,1408,12,2015,8,4
Group 5,RRG,-1.5,6,14,1409,13,2015,3,10
Group 5,RRG,-1.5,6,14,1410,5,2015,8,-3
Group 5,RRG,-1.5,6,14,1411,12,2015,6,6
Group 5,RRG,-1.5,6,14,1412,13,2015,8,5
Group 5,RRG,-1.5,6,14,1413,12,2015,9,3
Group 5,RRG,-1.5,6,14,1414,13,2015,6,7
Group 5,RRG,-1.5,6,14,1415,13,2015,5,8
Group 5,RRG,-1.5,6,14,1416,9,2015,13,-4
Group 5,RRG,-1.5,6,14,1417,13,2015,2,11
Group 5,RRG,-1.5,6,14,1418,10,2015,6,4
Group 5,RRG,-1.5,6,14,1419,13,2015,1,12
Group 5,RRG,-1.5,6,14,1420,12,2015,9,3
Group 5,RRG,-1.5,6,14,1421,8,2015,5,3
Group 5,RRG,-1.5,6,14,1422,10,2015,9,1
Group 5,RRG,-1.5,6,14,1423,7,2015,5,2
Group 5,RRG,-1.5,6,14,1424,8,2015,9,-1
Group 5,RRG,-1.5,6,14,1425,8,2015,6,2
Group 5,RRG,-1.5,6,14,1426,11,2015,7,4
Group 5,RRG,-1.5,6,14,1427,11,2015,5,6
Group 5,RRG,-1.5,6,14,1428,10,2015,8,2
Group 5,RRG,-1.5,6,14,1429,9,2015,9,0
Group 5,RRG,-1.5,6,14,1430,9,2015,10,-1
Group 5,RRG,-1.5,6,14,1431,9,2015,9,0
Group 5,RRG,-1.5,6,14,1432,11,2015,7,4
Group 5,RRG,-1.5,6,14,1433,9,2015,7,2
Group 5,RRG,-1.5,6,14,1434,8,2015,4,4
Group 5,RRG,-1.5,6,14,1435,8,2015,6,2
Group 5,RRG,-1.5,6,14,1436,10,2015,5,5
Group 5,RRG,-1.5,6,14,1437,9,2015,6,3
Group 5,RRG,-1.5,6,14,1438,8,2015,6,2
Group 5,RRG,-1.5,6,14,1439,9,2015,3,6
Group 5,RRG,-1.5,6,14,1440,14,2015,10,4
Group 5,RRG,-1.5,6,14,1441,14,2015,9,5
Group 5,RRG,-1.5,6,14,1442,12,2015,8,4
Group 5,RRG,-1.5,6,14,1443,10,2015,9,1
Group 5,RRG,-1.5,6,14,1444,9,2015,5,4
Group 5,RRG,-1.5,6,14,1445,8,2015,7,1
Group 5,RRG,-1.5,6,14,1446,7,2015,9,-2
Group 5,RRG,-1.5,6,14,1447,10,2015,7,3
Group 5,RRG,-1.5,6,14,1448,12,2015,8,4
Group 5,RRG,-1.5,6,14,1449,9,2015,9,0
Group 5,RRG,-1.5,6,14,1450,8,2015,4,4
Group 5,RRG,-1.5,6,14,1451,10,2015,8,2
Group 5,RRG,-1.5,6,14,1452,5,2015,9,-4
Group 5,RRG,-1.5,6,14,1453,10,2015,6,4
Group 5,RRG,-1.5,6,14,1454,6,2015,6,0
Group 5,RRG,-1.5,6,14,1455,7,2015,5,2
Group 5,RRG,-1.5,6,14,1456,14,2015,4,10
Group 5,RRG,-1.5,6,14,1457,5,2015,9,-4
Group 5,RRG,-1.5,6,14,1458,9,2015,12,-3
Group 5,RRG,-1.5,6,14,1459,10,2015,5,5
Group 5,RRG,-1.5,6,14,1460,7,2015,5,2
Group 5,RRG,-1.5,6,14,1461,13,2015,10,3
Group 5,RRG,-1.5,6,14,1462,12,2015,6,6
Group 5,RRG,-1.5,6,14,1463,6,2015,5,1
Group 5,RRG,-1.5,6,14,1464,9,2015,10,-1
Group 5,RRG,-1.5,6,14,1465,5,2015,5,0
Group 5,RRG,-1.5,6,14,1466,7,2015,7,0
Group 5,RRG,-1.5,6,14,1467,12,2015,5,7
Group 5,RRG,-1.5,6,14,1468,8,2015,6,2
Group 5,RRG,-1.5,6,14,1469,10,2015,5,5
Group 5,RRG,-1.5,6,14,1470,10,2015,9,1
Group 5,RRG,-1.5,6,14,1471,12,2015,5,7
Group 5,RRG,-1.5,6,14,1472,10,2015,10,0
Group 5,RRG,-1.5,6,14,1473,11,2015,5,6
Group 5,RRG,-1.5,6,14,1474,10,2015,6,4
Group 5,RRG,-1.5,6,14,1475,13,2015,9,4
Group 5,RRG,-1.5,6,14,1476,12,2015,5,7
Group 5,RRG,-1.5,6,14,1477,11,2015,7,4
Group 5,RRG,-1.5,6,14,1478,11,2015,5,6
Group 5,RRG,-1.5,6,14,1479,9,2015,6,3
Group 5,RRG,-1.5,6,14,1480,12,2015,2,10
Group 5,RRG,-1.5,6,14,1481,12,2015,7,5
Group 5,RRG,-1.5,6,14,1482,13,2015,5,8
Group 5,RRG,-1.5,6,14,1483,12,2015,9,3
Group 5,RRG,-1.5,6,14,1484,10,2015,11,-1
Group 5,RRG,-1.5,6,14,1485,11,2015,7,4
Group 5,RRG,-1.5,6,14,1486,8,2015,9,-1
Group 5,RRG,-1.5,6,14,1487,11,2015,8,3
Group 5,RRG,-1.5,6,14,1488,4,2015,2,2
Group 5,RRG,-1.5,6,14,1489,13,2015,10,3
Group 5,RRG,-1.5,6,14,1490,13,2015,12,1
Group 5,RRG,-1.5,6,14,1491,13,2015,2,11
Group 5,RRG,-1.5,6,14,1492,5,2015,6,-1
Group 5,RRG,-1.5,6,14,1493,11,2015,6,5
Group 5,RRG,-1.5,6,14,1494,13,2015,5,8
Group 5,RRG,-1.5,6,14,1495,9,2015,2,7
Group 5,RRG,-1.5,6,14,1496,9,2015,10,-1
Group 5,RRG,-1.5,6,14,1497,8,2015,8,0
Group 5,RRG,-1.5,6,14,1498,10,2015,8,2
Group 5,RRG,-1.5,6,14,1499,8,2015,5,3
Group 5,RRG,-1.5,6,14,1500,9,2015,5,4
Group 5,RRG,-1.5,6,14,1501,11,2015,8,3
Group 5,RRG,-1.5,6,14,1502,9,2015,9,0
Group 5,RRG,-1.5,6,14,1503,6,2015,7,-1
Group 5,RRG,-1.5,6,14,1504,4,2015,8,-4
Group 5,RRG,-1.5,6,14,1505,10,2015,5,5
Group 5,RRG,-1.5,6,14,1506,13,2015,9,4
Group 5,RRG,-1.5,6,14,1507,11,2015,3,8
Group 5,RRG,-1.5,6,14,1508,13,2015,5,8
Group 5,RRG,-1.5,6,14,1509,10,2015,6,4
Group 5,RRG,-1.5,6,14,1510,8,2015,6,2
Group 5,RRG,-1.5,6,14,1511,6,2015,13,-7
Group 5,RRG,-1.5,6,14,1512,12,2015,12,0
Group 5,RRG,-1.5,6,14,1513,10,2015,4,6
Group 5,RRG,-1.5,6,14,1514,11,2015,8,3
Group 5,RRG,-1.5,6,14,1515,11,2015,6,5
Group 5,RRG,-1.5,6,14,1516,5,2015,5,0
Group 5,RRG,-1.5,6,14,1517,10,2015,6,4
Group 5,RRG,-1.5,6,14,1518,13,2015,4,9
Group 5,RRG,-1.5,6,14,1519,10,2015,6,4
Group 5,RRG,-1.5,6,14,1520,11,2015,5,6
Group 5,RRG,-1.5,6,14,1521,9,2015,7,2
Group 5,RRG,-1.5,6,14,1522,9,2015,8,1
Group 5,RRG,-1.5,6,14,1523,12,2015,6,6
Group 5,RRG,-1.5,6,14,1524,10,2015,8,2
Group 5,RRG,-1.5,6,14,1525,12,2015,12,0
Group 5,RRG,-1.5,6,14,1526,8,2015,4,4
Group 5,RRG,-1.5,6,14,1527,7,2015,5,2
Group 5,RRG,-1.5,6,14,1528,10,2015,8,2
Group 5,RRG,-1.5,6,14,1529,10,2015,7,3
Group 5,RRG,-1.5,6,14,1530,8,2015,8,0
Group 5,RRG,-1.5,6,14,1531,7,2015,7,0
Group 5,RRG,-1.5,6,14,1532,11,2015,8,3
Group 5,RRG,-1.5,6,14,1533,9,2015,5,4
Group 5,RRG,-1.5,6,14,1534,13,2015,4,9
Group 5,RRG,-1.5,6,14,1535,7,2015,5,2
Group 5,RRG,-1.5,6,14,1536,12,2015,11,1
Group 5,RRG,-1.5,6,14,1537,7,2015,6,1
Group 5,RRG,-1.5,6,14,1538,11,2015,10,1
Group 5,RRG,-1.5,6,14,1539,14,2015,8,6
Group 5,RRG,-1.5,6,14,1540,12,2015,8,4
Group 5,RRG,-1.5,6,14,1541,14,2015,9,5
Group 5,RRG,-1.5,6,14,1542,7,2015,7,0
Group 5,RRG,-1.5,6,14,1543,12,2015,3,9
Group 5,RRG,-1.5,6,14,1544,8,2015,4,4
Group 5,RRG,-1.5,6,14,1545,11,2015,5,6
Group 5,RRG,-1.5,6,14,1546,6,2015,5,1
Group 5,RRG,-1.5,6,14,1547,4,2015,11,-7
Group 5,RRG,-1.5,6,14,1548,6,2015,7,-1
Group 5,RRG,-1.5,6,14,1549,11,2015,5,6
Group 5,RRG,-1.5,6,14,1550,10,2015,7,3
Group 5,RRG,-1.5,6,14,1551,9,2015,9,0
Group 5,RRG,-1.5,6,14,1552,13,2015,7,6
Group 5,RRG,-1.5,6,14,1553,7,2015,9,-2
Group 5,RRG,-1.5,6,14,1554,9,2015,2,7
Group 5,RRG,-1.5,6,14,1555,9,2015,3,6
Group 5,RRG,-1.5,6,14,1556,13,2015,4,9
Group 5,RRG,-1.5,6,14,1557,10,2015,5,5
Group 5,RRG,-1.5,6,14,1558,8,2015,11,-3
Group 5,RRG,-1.5,6,14,1559,9,2015,4,5
Group 5,RRG,-1.5,6,14,1560,10,2015,10,0
Group 5,RRG,-1.5,6,14,1561,9,2015,6,3
Group 5,RRG,-1.5,6,14,1562,10,2015,6,4
Group 5,RRG,-1.5,6,14,1563,10,2015,9,1
Group 5,RRG,-1.5,6,14,1564,6,2015,7,-1
Group 5,RRG,-1.5,6,14,1565,8,2015,5,3
Group 5,RRG,-1.5,6,14,1566,10,2015,3,7
Group 5,RRG,-1.5,6,14,1567,8,2015,6,2
Group 5,RRG,-1.5,6,14,1568,5,2015,6,-1
Group 5,RRG,-1.5,6,14,1569,14,2015,10,4
Group 5,RRG,-1.5,6,14,1570,12,2015,6,6
Group 5,RRG,-1.5,6,14,1571,9,2015,6,3
Group 5,RRG,-1.5,6,14,1572,8,2015,6,2
Group 5,RRG,-1.5,6,14,1573,11,2015,10,1
Group 5,RRG,-1.5,6,14,1574,13,2015,7,6
Group 5,RRG,-1.5,6,14,1575,13,2015,8,5
Group 5,RRG,-1.5,6,14,1576,10,2015,9,1
Group 5,RRG,-1.5,6,14,1577,8,2015,2,6
Group 5,RRG,-1.5,6,14,1578,3,2015,6,-3
Group 5,RRG,-1.5,6,14,1579,5,2015,2,3
Group 5,RRG,-1.5,6,14,1580,12,2015,11,1
Group 5,RRG,-1.5,6,14,1581,13,2015,7,6
Group 5,RRG,-1.5,6,14,1582,12,2015,6,6
Group 5,RRG,-1.5,6,14,1583,8,2015,7,1
Group 5,RRG,-1.5,6,14,1584,10,2015,8,2
Group 5,RRG,-1.5,6,14,1585,5,2015,8,-3
Group 5,RRG,-1.5,6,14,1586,7,2015,8,-1
Group 5,RRG,-1.5,6,14,1587,11,2015,10,1
Group 5,RRG,-1.5,6,14,1588,12,2015,12,0
Group 5,RRG,-1.5,6,14,1589,12,2015,6,6
Group 5,RRG,-1.5,6,14,1590,13,2015,9,4
Group 5,RRG,-1.5,6,14,1591,13,2015,6,7
Group 5,RRG,-1.5,6,14,1592,8,2015,8,0
Group 5,RRG,-1.5,6,14,1593,11,2015,2,9
Group 5,RRG,-1.5,6,14,1594,9,2015,3,6
Group 5,RRG,-1.5,6,14,1595,12,2015,5,7
Group 5,RRG,-1.5,6,14,1596,9,2015,8,1
Group 5,RRG,-1.5,6,14,1597,9,2015,8,1
Group 5,RRG,-1.5,6,14,1598,8,2015,9,-1
Group 5,RRG,-1.5,6,14,1599,12,2015,6,6
Group 5,RRG,-1.5,6,14,1600,11,2015,7,4
Group 5,RRG,-1.5,6,14,1601,9,2015,7,2
Group 5,RRG,-1.5,6,14,1602,12,2015,11,1
Group 5,RRG,-1.5,6,14,1603,12,2015,5,7
Group 5,RRG,-1.5,6,14,1604,11,2015,4,7
Group 5,RRG,-1.5,6,14,1605,12,2015,5,7
Group 5,RRG,-1.5,6,14,1606,12,2015,1,11
Group 5,RRG,-1.5,6,14,1607,13,2015,9,4
Group 5,RRG,-1.5,6,14,1608,9,2015,8,1
Group 5,RRG,-1.5,6,14,1609,7,2015,8,-1
Group 5,RRG,-1.5,6,14,1610,11,2015,3,8
Group 5,RRG,-1.5,6,14,1611,9,2015,8,1
Group 5,RRG,-1.5,6,14,1612,10,2015,2,8
Group 5,RRG,-1.5,6,14,1613,9,2015,6,3
Group 5,RRG,-1.5,6,14,1614,7,2015,8,-1
Group 5,RRG,-1.5,6,14,1615,6,2015,7,-1
Group 5,RRG,-1.5,6,14,1616,10,2015,2,8
Group 5,RRG,-1.5,6,14,1617,8,2015,7,1
Group 5,RRG,-1.5,6,14,1618,5,2015,4,1
Group 5,RRG,-1.5,6,14,1619,12,2015,5,7
Group 5,RRG,-1.5,6,14,1620,13,2015,11,2
Group 5,RRG,-1.5,6,14,1621,12,2015,10,2
Group 5,RRG,-1.5,6,14,1622,11,2015,6,5
Group 5,RRG,-1.5,6,14,1623,12,2015,7,5
Group 5,RRG,-1.5,6,14,1624,3,2015,6,-3
Group 5,RRG,-1.5,6,14,1625,8,2015,11,-3
Group 5,RRG,-1.5,6,14,1626,9,2015,10,-1
Group 5,RRG,-1.5,6,14,1627,11,2015,10,1
Group 5,RRG,-1.5,6,14,1628,5,2015,5,0
Group 5,RRG,-1.5,6,14,1629,9,2015,5,4
Group 5,RRG,-1.5,6,14,1630,12,2015,2,10
Group 5,RRG,-1.5,6,14,1631,8,2015,4,4
Group 5,RRG,-1.5,6,14,1632,6,2015,11,-5
Group 5,RRG,-1.5,6,14,1633,3,2015,8,-5
Group 5,RRG,-1.5,6,14,1634,13,2015,5,8
Group 5,RRG,-1.5,6,14,1635,8,2015,7,1
Group 5,RRG,-1.5,6,14,1636,9,2015,9,0
Group 5,RRG,-1.5,6,14,1637,7,2015,7,0
Group 5,RRG,-1.5,6,14,1638,10,2015,8,2
Group 5,RRG,-1.5,6,14,1639,11,2015,2,9
Group 5,RRG,-1.5,6,14,1640,14,2015,3,11
Group 5,RRG,-1.5,6,14,1641,11,2015,4,7
Group 5,RRG,-1.5,6,14,1642,11,2015,6,5
Group 5,RRG,-1.5,6,14,1643,12,2015,4,8
Group 5,RRG,-1.5,6,14,1644,10,2015,4,6
Group 5,RRG,-1.5,6,14,1645,10,2015,8,2
Group 5,RRG,-1.5,6,14,1646,12,2015,6,6
Group 5,RRG,-1.5,6,14,1647,8,2015,6,2
Group 5,RRG,-1.5,6,14,1648,9,2015,4,5
Group 5,RRG,-1.5,6,14,1649,13,2015,9,4
Group 5,RRG,-1.5,6,14,1650,9,2015,6,3
Group 5,RRG,-1.5,6,14,1651,5,2015,7,-2
Group 5,RRG,-1.5,6,14,1652,12,2015,7,5
Group 5,RRG,-1.5,6,14,1653,14,2015,7,7
Group 5,RRG,-1.5,6,14,1654,14,2015,8,6
Group 5,RRG,-1.5,6,14,1655,9,2015,4,5
Group 5,RRG,-1.5,6,14,1656,7,2015,9,-2
Group 5,RRG,-1.5,6,14,1657,13,2015,2,11
Group 5,RRG,-1.5,6,14,1658,9,2015,7,2
Group 5,RRG,-1.5,6,14,1659,12,2015,5,7
Group 5,RRG,-1.5,6,14,1660,13,2015,6,7
Group 5,RRG,-1.5,6,14,1661,7,2015,4,3
Group 5,RRG,-1.5,6,14,1662,11,2015,9,2
Group 5,RRG,-1.5,6,14,1663,12,2015,7,5
Group 5,RRG,-1.5,6,14,1664,12,2015,8,4
Group 5,RRG,-1.5,6,14,1665,4,2015,6,-2
Group 5,RRG,-1.5,6,14,1666,7,2015,5,2
Group 5,RRG,-1.5,6,14,1667,13,2015,8,5
Group 5,RRG,-1.5,6,14,1668,7,2015,10,-3
Group 5,RRG,-1.5,6,14,1669,9,2015,5,4
Group 5,RRG,-1.5,6,14,1670,10,2015,6,4
Group 5,RRG,-1.5,6,14,1671,11,2015,6,5
Group 5,RRG,-1.5,6,14,1672,12,2015,9,3
Group 5,RRG,-1.5,6,14,1673,9,2015,7,2
Group 5,RRG,-1.5,6,14,1674,11,2015,7,4
Group 5,RRG,-1.5,6,14,1675,12,2015,9,3
Group 5,RRG,-1.5,6,14,1676,11,2015,9,2
Group 5,RRG,-1.5,6,14,1677,10,2015,7,3
Group 5,RRG,-1.5,6,14,1678,11,2015,4,7
Group 5,RRG,-1.5,6,14,1679,12,2015,8,4
Group 5,RRG,-1.5,6,14,1680,8,2015,6,2
Group 5,RRG,-1.5,6,14,1681,11,2015,6,5
Group 5,RRG,-1.5,6,14,1682,6,2015,7,-1
Group 5,RRG,-1.5,6,14,1683,11,2015,7,4
Group 5,RRG,-1.5,6,14,1684,14,2015,7,7
Group 5,RRG,-1.5,6,14,1685,11,2015,8,3
Group 5,RRG,-1.5,6,14,1686,8,2015,7,1
Group 5,RRG,-1.5,6,14,1687,9,2015,6,3
Group 5,RRG,-1.5,6,14,1688,9,2015,8,1
Group 5,RRG,-1.5,6,14,1689,9,2015,3,6
Group 5,RRG,-1.5,6,14,1690,6,2015,11,-5
Group 5,RRG,-1.5,6,14,1691,5,2015,10,-5
Group 5,RRG,-1.5,6,14,1692,13,2015,6,7
Group 5,RRG,-1.5,6,14,1693,11,2015,6,5
Group 5,RRG,-1.5,6,14,1694,12,2015,6,6
Group 5,RRG,-1.5,6,14,1695,9,2015,3,6
Group 5,RRG,-1.5,6,14,1696,9,2015,5,4
Group 5,RRG,-1.5,6,14,1697,12,2015,7,5
Group 5,RRG,-1.5,6,14,1698,13,2015,5,8
Group 5,RRG,-1.5,6,14,1699,10,2015,9,1
Group 5,RRG,-1.5,6,14,1700,10,2015,7,3
Group 5,RRG,-1.5,6,14,1701,13,2015,4,9
Group 5,RRG,-1.5,6,14,1702,9,2015,8,1
Group 5,RRG,-1.5,6,14,1703,12,2015,8,4
Group 5,RRG,-1.5,6,14,1704,8,2015,5,3
Group 5,RRG,-1.5,6,14,1705,8,2015,5,3
Group 5,RRG,-1.5,6,14,1706,11,2015,8,3
Group 5,RRG,-1.5,6,14,1707,9,2015,5,4
Group 5,RRG,-1.5,6,14,1708,12,2015,8,4
Group 5,RRG,-1.5,6,14,1709,10,2015,3,7
Group 5,RRG,-1.5,6,14,1710,11,2015,0,11
Group 5,RRG,-1.5,6,14,1711,12,2015,3,9
Group 5,RRG,-1.5,6,14,1712,6,2015,12,-6
Group 5,RRG,-1.5,6,14,1713,9,2015,10,-1
Group 5,RRG,-1.5,6,14,1714,8,2015,4,4
Group 5,RRG,-1.5,6,14,1715,9,2015,4,5
Group 5,RRG,-1.5,6,14,1716,8,2015,9,-1
Group 5,RRG,-1.5,6,14,1717,7,2015,7,0
Group 5,RRG,-1.5,6,14,1718,10,2015,9,1
Group 5,RRG,-1.5,6,14,1719,11,2015,11,0
Group 5,RRG,-1.5,6,14,1720,8,2015,5,3
Group 5,RRG,-1.5,6,14,1721,8,2015,11,-3
Group 5,RRG,-1.5,6,14,1722,9,2015,8,1
Group 5,RRG,-1.5,6,14,1723,7,2015,10,-3
Group 5,RRG,-1.5,6,14,1724,7,2015,3,4
Group 5,RRG,-1.5,6,14,1725,10,2015,12,-2
Group 5,RRG,-1.5,6,14,1726,8,2015,5,3
Group 5,RRG,-1.5,6,14,1727,8,2015,4,4
Group 5,RRG,-1.5,6,14,1728,8,2015,5,3
Group 5,RRG,-1.5,6,14,1729,12,2015,5,7
Group 5,RRG,-1.5,6,14,1730,11,2015,12,-1
Group 5,RRG,-1.5,6,14,1731,12,2015,6,6
Group 5,RRG,-1.5,6,14,1732,7,2015,9,-2
Group 5,RRG,-1.5,6,14,1733,12,2015,9,3
Group 5,RRG,-1.5,6,14,1734,11,2015,11,0
Group 5,RRG,-1.5,6,14,1735,8,2015,4,4
Group 5,RRG,-1.5,6,14,1736,12,2015,7,5
Group 5,RRG,-1.5,6,14,1737,14,2015,7,7
Group 5,RRG,-1.5,6,14,1738,13,2015,11,2
Group 5,RRG,-1.5,6,14,1739,14,2015,10,4
Group 5,RRG,-1.5,6,14,1740,12,2015,11,1
Group 5,RRG,-1.5,6,14,1741,11,2015,10,1
Group 5,RRG,-1.5,6,14,1742,13,2015,9,4
Group 5,RRG,-1.5,6,14,1743,11,2015,7,4
Group 5,RRG,-1.5,6,14,1744,12,2015,7,5
Group 5,RRG,-1.5,6,14,1745,9,2015,5,4
Group 5,RRG,-1.5,6,14,1746,13,2015,5,8
Group 5,RRG,-1.5,6,14,1747,6,2015,5,1
Group 5,RRG,-1.5,6,14,1748,11,2015,4,7
Group 5,RRG,-1.5,6,14,1749,10,2015,6,4
Group 5,RRG,-1.5,6,14,1750,12,2015,7,5
Group 5,RRG,-1.5,6,14,1751,10,2015,6,4
Group 5,RRG,-1.5,6,14,1752,8,2015,5,3
Group 5,RRG,-1.5,6,14,1753,5,2015,10,-5
Group 5,RRG,-1.5,6,14,1754,9,2015,5,4
Group 5,RRG,-1.5,6,14,1755,9,2015,6,3
Group 5,RRG,-1.5,6,14,1756,12,2015,6,6
Group 5,RRG,-1.5,6,14,1757,10,2015,6,4
Group 5,RRG,-1.5,6,14,1758,11,2015,4,7
Group 5,RRG,-1.5,6,14,1759,12,2015,4,8
Group 5,RRG,-1.5,6,14,1760,12,2015,7,5
Group 5,RRG,-1.5,6,14,1761,8,2015,4,4
Group 5,RRG,-1.5,6,14,1762,13,2015,13,0
Group 5,RRG,-1.5,6,14,1763,10,2015,8,2
Group 5,RRG,-1.5,6,14,1764,9,2015,8,1
Group 5,RRG,-1.5,6,14,1765,8,2015,4,4
Group 5,RRG,-1.5,6,14,1766,7,2015,6,1
Group 5,RRG,-1.5,6,14,1767,10,2015,9,1
Group 5,RRG,-1.5,6,14,1768,7,2015,3,4
Group 5,RRG,-1.5,6,14,1769,10,2015,11,-1
Group 5,RRG,-1.5,6,14,1770,9,2015,8,1
Group 5,RRG,-1.5,6,14,1771,11,2015,7,4
Group 5,RRG,-1.5,6,14,1772,11,2015,4,7
Group 5,RRG,-1.5,6,14,1773,10,2015,5,5
Group 5,RRG,-1.5,6,14,1774,10,2015,9,1
Group 5,RRG,-1.5,6,14,1775,10,2015,9,1
Group 5,RRG,-1.5,6,14,1776,5,2015,6,-1
Group 5,RRG,-1.5,6,14,1777,9,2015,4,5
Group 5,RRG,-1.5,6,14,1778,9,2015,9,0
Group 5,RRG,-1.5,6,14,1779,5,2015,9,-4
Group 5,RRG,-1.5,6,14,1780,7,2015,8,-1
Group 5,RRG,-1.5,6,14,1781,9,2015,7,2
Group 5,RRG,-1.5,6,14,1782,13,2015,8,5
Group 5,RRG,-1.5,6,14,1783,2,2015,6,-4
Group 5,RRG,-1.5,6,14,1784,11,2015,5,6
Group 5,RRG,-1.5,6,14,1785,10,2015,4,6
Group 5,RRG,-1.5,6,14,1786,13,2015,7,6
Group 5,RRG,-1.5,6,14,1787,9,2015,6,3
Group 5,RRG,-1.5,6,14,1788,11,2015,8,3
Group 5,RRG,-1.5,6,14,1789,13,2015,10,3
Group 5,RRG,-1.5,6,14,1790,11,2015,7,4
Group 5,RRG,-1.5,6,14,1791,13,2015,4,9
Group 5,RRG,-1.5,6,14,1792,9,2015,5,4
Group 5,RRG,-1.5,6,14,1793,11,2015,4,7
Group 5,RRG,-1.5,6,14,1794,12,2015,2,10
Group 5,RRG,-1.5,6,14,1795,6,2015,9,-3
Group 5,RRG,-1.5,6,14,1796,8,2015,11,-3
Group 5,RRG,-1.5,6,14,1797,10,2015,9,1
Group 5,RRG,-1.5,6,14,1798,10,2015,12,-2
Group 5,RRG,-1.5,6,14,1799,8,2015,14,-6
Group 5,RRG,-1.5,6,14,1800,12,2015,4,8
Group 5,RRG,-1.5,6,14,1801,7,2015,12,-5
Group 5,RRG,-1.5,6,14,1802,13,2015,5,8
Group 5,RRG,-1.5,6,14,1803,9,2015,8,1
Group 5,RRG,-1.5,6,14,1804,10,2015,4,6
Group 5,RRG,-1.5,6,14,1805,8,2015,8,0
Group 5,RRG,-1.5,6,14,1806,8,2015,11,-3
Group 5,RRG,-1.5,6,14,1807,9,2015,4,5
Group 5,RRG,-1.5,6,14,1808,13,2015,7,6
Group 5,RRG,-1.5,6,14,1809,11,2015,4,7
Group 5,RRG,-1.5,6,14,1810,7,2015,6,1
Group 5,RRG,-1.5,6,14,1811,11,2015,2,9
Group 5,RRG,-1.5,6,14,1812,10,2015,11,-1
Group 5,RRG,-1.5,6,14,1813,10,2015,9,1
Group 5,RRG,-1.5,6,14,1814,6,2015,11,-5
Group 5,RRG,-1.5,6,14,1815,10,2015,7,3
Group 5,RRG,-1.5,6,14,1816,4,2015,5,-1
Group 5,RRG,-1.5,6,14,1817,9,2015,8,1
Group 5,RRG,-1.5,6,14,1818,14,2015,11,3
Group 5,RRG,-1.5,6,14,1819,9,2015,6,3
Group 5,RRG,-1.5,6,14,1820,13,2015,7,6
Group 5,RRG,-1.5,6,14,1821,11,2015,9,2
Group 5,RRG,-1.5,6,14,1822,8,2015,5,3
Group 5,RRG,-1.5,6,14,1823,6,2015,4,2
Group 5,RRG,-1.5,6,14,1824,12,2015,8,4
Group 5,RRG,-1.5,6,14,1825,9,2015,4,5
Group 5,RRG,-1.5,6,14,1826,9,2015,6,3
Group 5,RRG,-1.5,6,14,1827,10,2015,5,5
Group 5,RRG,-1.5,6,14,1828,5,2015,4,1
Group 5,RRG,-1.5,6,14,1829,7,2015,6,1
Group 5,RRG,-1.5,6,14,1830,6,2015,4,2
Group 5,RRG,-1.5,6,14,1831,7,2015,7,0
Group 5,RRG,-1.5,6,14,1832,5,2015,5,0
Group 5,RRG,-1.5,6,14,1833,3,2015,9,-6
Group 5,RRG,-1.5,6,14,1834,6,2015,9,-3
Group 5,RRG,-1.5,6,14,1835,11,2015,5,6
Group 5,RRG,-1.5,6,14,1836,9,2015,9,0
Group 5,RRG,-1.5,6,14,1837,13,2015,7,6
Group 5,RRG,-1.5,6,14,1838,9,2015,7,2
Group 5,RRG,-1.5,6,14,1839,12,2015,5,7
Group 5,RRG,-1.5,6,14,1840,10,2015,5,5
Group 5,RRG,-1.5,6,14,1841,7,2015,10,-3
Group 5,RRG,-1.5,6,14,1842,12,2015,9,3
Group 5,RRG,-1.5,6,14,1843,10,2015,6,4
Group 5,RRG,-1.5,6,14,1844,11,2015,6,5
Group 5,RRG,-1.5,6,14,1845,8,2015,4,4
Group 5,RRG,-1.5,6,14,1846,8,2015,4,4
Group 5,RRG,-1.5,6,14,1847,8,2015,7,1
Group 5,RRG,-1.5,6,14,1848,13,2015,9,4
Group 5,RRG,-1.5,6,14,1849,10,2015,6,4
Group 5,RRG,-1.5,6,14,1850,10,2015,4,6
Group 5,RRG,-1.5,6,14,1851,12,2015,9,3
Group 5,RRG,-1.5,6,14,1852,10,2015,7,3
Group 5,RRG,-1.5,6,14,1853,13,2015,8,5
Group 5,RRG,-1.5,6,14,1854,7,2015,8,-1
Group 5,RRG,-1.5,6,14,1855,7,2015,9,-2
Group 5,RRG,-1.5,6,14,1856,6,2015,9,-3
Group 5,RRG,-1.5,6,14,1857,4,2015,12,-8
Group 5,RRG,-1.5,6,14,1858,11,2015,7,4
Group 5,RRG,-1.5,6,14,1859,9,2015,10,-1
Group 5,RRG,-1.5,6,14,1860,11,2015,3,8
Group 5,RRG,-1.5,6,14,1861,5,2015,7,-2
Group 5,RRG,-1.5,6,14,1862,10,2015,5,5
Group 5,RRG,-1.5,6,14,1863,10,2015,8,2
Group 5,RRG,-1.5,6,14,1864,10,2015,11,-1
Group 5,RRG,-1.5,6,14,1865,13,2015,7,6
Group 5,RRG,-1.5,6,14,1866,11,2015,6,5
Group 5,RRG,-1.5,6,14,1867,11,2015,7,4
Group 5,RRG,-1.5,6,14,1868,7,2015,7,0
Group 5,RRG,-1.5,6,14,1869,7,2015,2,5
Group 5,RRG,-1.5,6,14,1870,12,2015,7,5
Group 5,RRG,-1.5,6,14,1871,8,2015,7,1
Group 5,RRG,-1.5,6,14,1872,11,2015,4,7
Group 5,RRG,-1.5,6,14,1873,11,2015,5,6
Group 5,RRG,-1.5,6,14,1874,11,2015,7,4
Group 5,RRG,-1.5,6,14,1875,7,2015,11,-4
Group 5,RRG,-1.5,6,14,1876,6,2015,3,3
Group 5,RRG,-1.5,6,14,1877,9,2015,7,2
Group 5,RRG,-1.5,6,14,1878,10,2015,11,-1
Group 5,RRG,-1.5,6,14,1879,8,2015,8,0
Group 5,RRG,-1.5,6,14,1880,9,2015,12,-3
Group 5,RRG,-1.5,6,14,1881,9,2015,9,0
Group 5,RRG,-1.5,6,14,1882,9,2015,6,3
Group 5,RRG,-1.5,6,14,1883,8,2015,4,4
Group 5,RRG,-1.5,6,14,1884,12,2015,4,8
Group 5,RRG,-1.5,6,14,1885,11,2015,8,3
Group 5,RRG,-1.5,6,14,1886,11,2015,7,4
Group 5,RRG,-1.5,6,14,1887,12,2015,8,4
Group 5,RRG,-1.5,6,14,1888,8,2015,4,4
Group 5,RRG,-1.5,6,14,1889,10,2015,6,4
Group 5,RRG,-1.5,6,14,1890,7,2015,5,2
Group 5,RRG,-1.5,6,14,1891,12,2015,7,5
Group 5,RRG,-1.5,6,14,1892,8,2015,7,1
Group 5,RRG,-1.5,6,14,1893,12,2015,7,5
Group 5,RRG,-1.5,6,14,1894,13,2015,5,8
Group 5,RRG,-1.5,6,14,1895,11,2015,5,6
Group 5,RRG,-1.5,6,14,1896,7,2015,7,0
Group 5,RRG,-1.5,6,14,1897,6,2015,6,0
Group 5,RRG,-1.5,6,14,1898,8,2015,9,-1
Group 5,RRG,-1.5,6,14,1899,13,2015,6,7
Group 5,RRG,-1.5,6,14,1900,10,2015,6,4
Group 5,RRG,-1.5,6,14,1901,10,2015,6,4
Group 5,RRG,-1.5,6,14,1902,10,2015,3,7
Group 5,RRG,-1.5,6,14,1903,7,2015,3,4
Group 5,RRG,-1.5,6,14,1904,7,2015,8,-1
Group 5,RRG,-1.5,6,14,1905,7,2015,6,1
Group 5,RRG,-1.5,6,14,1906,11,2015,6,5
Group 5,RRG,-1.5,6,14,1907,5,2015,6,-1
Group 5,RRG,-1.5,6,14,1908,7,2015,7,0
Group 5,RRG,-1.5,6,14,1909,9,2015,3,6
Group 5,RRG,-1.5,6,14,1910,10,2015,10,0
Group 5,RRG,-1.5,6,14,1911,10,2015,8,2
Group 5,RRG,-1.5,6,14,1912,12,2015,6,6
Group 5,RRG,-1.5,6,14,1913,10,2015,8,2
Group 5,RRG,-1.5,6,14,1914,10,2015,8,2
Group 5,RRG,-1.5,6,14,1915,8,2015,10,-2
Group 5,RRG,-1.5,6,14,1916,12,2015,2,10
Group 5,RRG,-1.5,6,14,1917,12,2015,4,8
Group 5,RRG,-1.5,6,14,1918,10,2015,2,8
Group 5,RRG,-1.5,6,14,1919,10,2015,8,2
Group 5,RRG,-1.5,6,14,1920,12,2015,8,4
Group 5,RRG,-1.5,6,14,1921,8,2015,10,-2
Group 5,RRG,-1.5,6,14,1922,9,2015,5,4
Group 5,RRG,-1.5,6,14,1923,9,2015,5,4
Group 5,RRG,-1.5,6,14,1924,10,2015,8,2
Group 5,RRG,-1.5,6,14,1925,8,2015,8,0
Group 5,RRG,-1.5,6,14,1926,10,2015,9,1
Group 5,RRG,-1.5,6,14,1927,12,2015,6,6
Group 5,RRG,-1.5,6,14,1928,5,2015,6,-1
Group 5,RRG,-1.5,6,14,1929,11,2015,5,6
Group 5,RRG,-1.5,6,14,1930,4,2015,7,-3
Group 5,RRG,-1.5,6,14,1931,11,2015,8,3
Group 5,RRG,-1.5,6,14,1932,10,2015,7,3
Group 5,RRG,-1.5,6,14,1933,7,2015,8,-1
Group 5,RRG,-1.5,6,14,1934,7,2015,3,4
Group 5,RRG,-1.5,6,14,1935,11,2015,7,4
Group 5,RRG,-1.5,6,14,1936,12,2015,8,4
Group 5,RRG,-1.5,6,14,1937,6,2015,8,-2
Group 5,RRG,-1.5,6,14,1938,9,2015,6,3
Group 5,RRG,-1.5,6,14,1939,5,2015,9,-4
Group 5,RRG,-1.5,6,14,1940,10,2015,11,-1
Group 5,RRG,-1.5,6,14,1941,7,2015,5,2
Group 5,RRG,-1.5,6,14,1942,14,2015,9,5
Group 5,RRG,-1.5,6,14,1943,14,2015,7,7
Group 5,RRG,-1.5,6,14,1944,13,2015,7,6
Group 5,RRG,-1.5,6,14,1945,14,2015,5,9
Group 5,RRG,-1.5,6,14,1946,8,2015,7,1
Group 5,RRG,-1.5,6,14,1947,8,2015,5,3
Group 5,RRG,-1.5,6,14,1948,10,2015,7,3
Group 5,RRG,-1.5,6,14,1949,12,2015,4,8
Group 5,RRG,-1.5,6,14,1950,11,2015,8,3
Group 5,RRG,-1.5,6,14,1951,9,2015,5,4
Group 5,RRG,-1.5,6,14,1952,8,2015,8,0
Group 5,RRG,-1.5,6,14,1953,4,2015,5,-1
Group 5,RRG,-1.5,6,14,1954,14,2015,4,10
Group 5,RRG,-1.5,6,14,1955,6,2015,8,-2
Group 5,RRG,-1.5,6,14,1956,10,2015,5,5
Group 5,RRG,-1.5,6,14,1957,10,2015,4,6
Group 5,RRG,-1.5,6,14,1958,11,2015,8,3
Group 5,RRG,-1.5,6,14,1959,11,2015,10,1
Group 5,RRG,-1.5,6,14,1960,9,2015,8,1
Group 5,RRG,-1.5,6,14,1961,10,2015,6,4
Group 5,RRG,-1.5,6,14,1962,11,2015,8,3
Group 5,RRG,-1.5,6,14,1963,10,2015,9,1
Group 5,RRG,-1.5,6,14,1964,12,2015,9,3
Group 5,RRG,-1.5,6,14,1965,7,2015,6,1
Group 5,RRG,-1.5,6,14,1966,6,2015,7,-1
Group 5,RRG,-1.5,6,14,1967,6,2015,7,-1
Group 5,RRG,-1.5,6,14,1968,5,2015,10,-5
Group 5,RRG,-1.5,6,14,1969,7,2015,10,-3
Group 5,RRG,-1.5,6,14,1970,12,2015,2,10
Group 5,RRG,-1.5,6,14,1971,6,2015,4,2
Group 5,RRG,-1.5,6,14,1972,6,2015,5,1
Group 5,RRG,-1.5,6,14,1973,10,2015,8,2
Group 5,RRG,-1.5,6,14,1974,9,2015,7,2
Group 5,RRG,-1.5,6,14,1975,11,2015,9,2
Group 5,RRG,-1.5,6,14,1976,9,2015,11,-2
Group 5,RRG,-1.5,6,14,1977,11,2015,11,0
Group 5,RRG,-1.5,6,14,1978,10,2015,5,5
Group 5,RRG,-1.5,6,14,1979,8,2015,5,3
Group 5,RRG,-1.5,6,14,1980,13,2015,2,11
Group 5,RRG,-1.5,6,14,1981,11,2015,6,5
Group 5,RRG,-1.5,6,14,1982,9,2015,5,4
Group 5,RRG,-1.5,6,14,1983,8,2015,5,3
Group 5,RRG,-1.5,6,14,1984,9,2015,9,0
Group 5,RRG,-1.5,6,14,1985,10,2015,7,3
Group 5,RRG,-1.5,6,14,1986,7,2015,6,1
Group 5,RRG,-1.5,6,14,1987,10,2015,5,5
Group 5,RRG,-1.5,6,14,1988,10,2015,4,6
Group 5,RRG,-1.5,6,14,1989,11,2015,7,4
Group 5,RRG,-1.5,6,14,1990,11,2015,4,7
Group 5,RRG,-1.5,6,14,1991,11,2015,11,0
Group 5,RRG,-1.5,6,14,1992,7,2015,9,-2
Group 5,RRG,-1.5,6,14,1993,11,2015,10,1
Group 5,RRG,-1.5,6,14,1994,11,2015,5,6
Group 5,RRG,-1.5,6,14,1995,13,2015,7,6
Group 5,RRG,-1.5,6,14,1996,14,2015,10,4
Group 5,RRG,-1.5,6,14,1997,14,2015,9,5
Group 5,RRG,-1.5,6,14,1998,4,2015,4,0
Group 5,RRG,-1.5,6,14,1999,7,2015,6,1
Group 5,RRG,-1.5,6,14,2000,11,2015,8,3
Group 5,RRG,-1.5,6,14,2001,10,2015,4,6
Group 5,RRG,-1.5,6,14,2002,12,2015,5,7
Group 5,RRG,-1.5,6,14,2003,9,2015,10,-1
Group 5,RRG,-1.5,6,14,2004,10,2015,8,2
Group 5,RRG,-1.5,6,14,2005,11,2015,3,8
Group 5,RRG,-1.5,6,14,2006,7,2015,2,5
Group 5,RRG,-1.5,6,14,2007,8,2015,7,1
Group 5,RRG,-1.5,6,14,2008,8,2015,9,-1
Group 5,RRG,-1.5,6,14,2009,6,2015,10,-4
Group 5,RRG,-1.5,6,14,2010,11,2015,6,5
Group 5,RRG,-1.5,6,14,2011,12,2015,6,6
Group 5,RRG,-1.5,6,14,2012,8,2015,6,2
Group 5,RRG,-1.5,6,14,2013,10,2015,11,-1
Group 5,RRG,-1.5,6,14,2014,13,2015,8,5
Group 5,RRG,-1.5,6,14,2015,12,2015,8,4
Group 5,RRG,-1.5,6,14,2016,10,2015,7,3
Group 5,RRG,-1.5,6,14,2017,14,2015,10,4
Group 5,RRG,-1.5,6,14,2018,8,2015,5,3
Group 5,RRG,-1.5,6,14,2019,12,2015,9,3
Group 5,RRG,-1.5,6,14,2020,10,2015,7,3
Group 5,RRG,-1.5,6,14,2021,8,2015,8,0
Group 5,RRG,-1.5,6,14,2022,7,2015,5,2
Group 5,RRG,-1.5,6,14,2023,10,2015,8,2
Group 5,RRG,-1.5,6,14,2024,9,2015,5,4
Group 5,RRG,-1.5,6,14,2025,8,2015,8,0
Group 5,RRG,-1.5,6,14,2026,9,2015,3,6
Group 5,RRG,-1.5,6,14,2027,12,2015,9,3
Group 5,RRG,-1.5,6,14,2028,8,2015,8,0
Group 5,RRG,-1.5,6,14,2029,8,2015,2,6
Group 5,RRG,-1.5,6,14,2030,13,2015,4,9
Group 5,RRG,-1.5,6,14,2031,12,2015,10,2
Group 5,RRG,-1.5,6,14,2032,9,2015,4,5
Group 5,RRG,-1.5,6,14,2033,11,2015,7,4
Group 5,RRG,-1.5,6,14,2034,8,2015,8,0
Group 5,RRG,-1.5,6,14,2035,8,2015,7,1
Group 5,RRG,-1.5,6,14,2036,13,2015,5,8
Group 5,RRG,-1.5,6,14,2037,13,2015,6,7
Group 5,RRG,-1.5,6,14,2038,10,2015,7,3
Group 5,RRG,-1.5,6,14,2039,11,2015,8,3
Group 5,RRG,-1.5,6,14,2040,10,2015,5,5
Group 5,RRG,-1.5,6,14,2041,9,2015,7,2
Group 5,RRG,-1.5,6,14,2042,11,2015,9,2
Group 5,RRG,-1.5,6,14,2043,7,2015,7,0
Group 5,RRG,-1.5,6,14,2044,9,2015,6,3
Group 5,RRG,-1.5,6,14,2045,10,2015,7,3
Group 5,RRG,-1.5,6,14,2046,10,2015,6,4
Group 5,RRG,-1.5,6,14,2047,8,2015,10,-2
Group 5,RRG,-1.5,6,14,2048,10,2015,9,1
Group 5,RRG,-1.5,6,14,2049,10,2015,11,-1
Group 5,RRG,-1.5,6,14,2050,9,2015,8,1
Group 5,RRG,-1.5,6,14,2051,12,2015,7,5
Group 5,RRG,-1.5,6,14,2052,11,2015,7,4
Group 5,RRG,-1.5,6,14,2053,11,2015,11,0
Group 5,RRG,-1.5,6,14,2054,8,2015,5,3
Group 5,RRG,-1.5,6,14,2055,8,2015,9,-1
Group 5,RRG,-1.5,6,14,2056,10,2015,6,4
Group 5,RRG,-1.5,6,14,2057,11,2015,7,4
Group 5,RRG,-1.5,6,14,2058,7,2015,2,5
Group 5,RRG,-1.5,6,14,2059,13,2015,6,7
Group 5,RRG,-1.5,6,14,2060,11,2015,6,5
Group 5,RRG,-1.5,6,14,2061,10,2015,8,2
Group 5,RRG,-1.5,6,14,2062,10,2015,4,6
Group 5,RRG,-1.5,6,14,2063,12,2015,9,3
Group 5,RRG,-1.5,6,14,2064,12,2015,6,6
Group 5,RRG,-1.5,6,14,2065,9,2015,3,6
Group 5,RRG,-1.5,6,14,2066,10,2015,7,3
Group 5,RRG,-1.5,6,14,2067,9,2015,3,6
Group 5,RRG,-1.5,6,14,2068,13,2015,4,9
Group 5,RRG,-1.5,6,14,2069,9,2015,6,3
Group 5,RRG,-1.5,6,14,2070,9,2015,6,3
Group 5,RRG,-1.5,6,14,2071,13,2015,7,6
Group 5,RRG,-1.5,6,14,2072,7,2015,10,-3
Group 5,RRG,-1.5,6,14,2073,8,2015,3,5
Group 5,RRG,-1.5,6,14,2074,11,2015,7,4
Group 5,RRG,-1.5,6,14,2075,9,2015,5,4
Group 5,RRG,-1.5,6,14,2076,11,2015,7,4
Group 5,RRG,-1.5,6,14,2077,9,2015,5,4
Group 5,RRG,-1.5,6,14,2078,9,2015,8,1
Group 5,RRG,-1.5,6,14,2079,6,2015,4,2
Group 5,RRG,-1.5,6,14,2080,9,2015,6,3
Group 5,RRG,-1.5,6,14,2081,11,2015,10,1
Group 5,RRG,-1.5,6,14,2082,5,2015,6,-1
Group 5,RRG,-1.5,6,14,2083,6,2015,9,-3
Group 5,RRG,-1.5,6,14,2084,13,2015,3,10
Group 5,RRG,-1.5,6,14,2085,11,2015,11,0
Group 5,RRG,-1.5,6,14,2086,5,2015,9,-4
Group 5,RRG,-1.5,6,14,2087,5,2015,9,-4
Group 5,RRG,-1.5,6,14,2088,13,2015,9,4
Group 5,RRG,-1.5,6,14,2089,9,2015,6,3
Group 5,RRG,-1.5,6,14,2090,9,2015,5,4
Group 5,RRG,-1.5,6,14,2091,6,2015,11,-5
Group 5,RRG,-1.5,6,14,2092,10,2015,8,2
Group 5,RRG,-1.5,6,14,2093,10,2015,11,-1
Group 5,RRG,-1.5,6,14,2094,11,2015,11,0
Group 5,RRG,-1.5,6,14,2095,5,2015,7,-2
Group 5,RRG,-1.5,6,14,2096,6,2015,13,-7
Group 5,RRG,-1.5,6,14,2097,6,2015,11,-5
Group 5,RRG,-1.5,6,14,2098,10,2015,10,0
Group 5,RRG,-1.5,6,14,2099,11,2015,6,5
Group 5,RRG,-1.5,6,14,2100,10,2015,5,5
Group 5,RRG,-1.5,6,14,2101,14,2015,2,12
Group 5,RRG,-1.5,6,14,2102,9,2015,6,3
Group 5,RRG,-1.5,6,14,2103,9,2015,6,3
Group 5,RRG,-1.5,6,14,2104,9,2015,6,3
Group 5,RRG,-1.5,6,14,2105,10,2015,8,2
Group 5,RRG,-1.5,6,14,2106,8,2015,7,1
Group 5,RRG,-1.5,6,14,2107,5,2015,8,-3
Group 5,RRG,-1.5,6,14,2108,10,2015,4,6
Group 5,RRG,-1.5,6,14,2109,8,2015,7,1
Group 5,RRG,-1.5,6,14,2110,7,2015,6,1
Group 5,RRG,-1.5,6,14,2111,9,2015,4,5
Group 5,RRG,-1.5,6,14,2112,10,2015,7,3
Group 5,RRG,-1.5,6,14,2113,10,2015,8,2
Group 5,RRG,-1.5,6,14,2114,10,2015,4,6
Group 5,RRG,-1.5,6,14,2115,9,2015,7,2
Group 5,RRG,-1.5,6,14,2116,7,2015,8,-1
Group 5,RRG,-1.5,6,14,2117,7,2015,11,-4
Group 5,RRG,-1.5,6,14,2118,12,2015,6,6
Group 5,RRG,-1.5,6,14,2119,7,2015,3,4
Group 5,RRG,-1.5,6,14,2120,11,2015,7,4
Group 5,RRG,-1.5,6,14,2121,11,2015,8,3
Group 5,RRG,-1.5,6,14,2122,8,2015,4,4
Group 5,RRG,-1.5,6,14,2123,8,2015,4,4
Group 5,RRG,-1.5,6,14,2124,14,2015,5,9
Group 5,RRG,-1.5,6,14,2125,11,2015,4,7
Group 5,RRG,-1.5,6,14,2126,12,2015,4,8
Group 5,RRG,-1.5,6,14,2127,11,2015,8,3
Group 5,RRG,-1.5,6,14,2128,7,2015,9,-2
Group 5,RRG,-1.5,6,14,2129,12,2015,6,6
Group 5,RRG,-1.5,6,14,2130,10,2015,8,2
Group 5,RRG,-1.5,6,14,2131,12,2015,6,6
Group 5,RRG,-1.5,6,14,2132,13,2015,5,8
Group 5,RRG,-1.5,6,14,2133,8,2015,8,0
Group 5,RRG,-1.5,6,14,2134,4,2015,7,-3
Group 5,RRG,-1.5,6,14,2135,7,2015,6,1
Group 5,RRG,-1.5,6,14,2136,10,2015,5,5
Group 5,RRG,-1.5,6,14,2137,12,2015,5,7
Group 5,RRG,-1.5,6,14,2138,10,2015,5,5
Group 5,RRG,-1.5,6,14,2139,9,2015,8,1
Group 5,RRG,-1.5,6,14,2140,11,2015,9,2
Group 5,RRG,-1.5,6,14,2141,7,2015,7,0
Group 5,RRG,-1.5,6,14,2142,5,2015,6,-1
Group 5,RRG,-1.5,6,14,2143,9,2015,6,3
Group 5,RRG,-1.5,6,14,2144,9,2015,7,2
Group 5,RRG,-1.5,6,14,2145,11,2015,5,6
Group 5,RRG,-1.5,6,14,2146,9,2015,9,0
Group 5,RRG,-1.5,6,14,2147,12,2015,5,7
Group 5,RRG,-1.5,6,14,2148,5,2015,5,0
Group 5,RRG,-1.5,6,14,2149,7,2015,11,-4
Group 5,RRG,-1.5,6,14,2150,14,2015,5,9
Group 5,RRG,-1.5,6,14,2151,13,2015,3,10
Group 5,RRG,-1.5,6,14,2152,11,2015,9,2
Group 5,RRG,-1.5,6,14,2153,13,2015,11,2
Group 5,RRG,-1.5,6,14,2154,9,2015,0,9
Group 5,RRG,-1.5,6,14,2155,8,2015,4,4
Group 5,RRG,-1.5,6,14,2156,7,2015,6,1
Group 5,RRG,-1.5,6,14,2157,9,2015,3,6
Group 5,RRG,-1.5,6,14,2158,11,2015,4,7
Group 5,RRG,-1.5,6,14,2159,8,2015,8,0
Group 5,RRG,-1.5,6,14,2160,8,2015,7,1
Group 5,RRG,-1.5,6,14,2161,6,2015,6,0
Group 5,RRG,-1.5,6,14,2162,7,2015,8,-1
Group 5,RRG,-1.5,6,14,2163,9,2015,5,4
Group 5,RRG,-1.5,6,14,2164,11,2015,5,6
Group 5,RRG,-1.5,6,14,2165,9,2015,4,5
Group 5,RRG,-1.5,6,14,2166,9,2015,5,4
Group 5,RRG,-1.5,6,14,2167,3,2015,6,-3
Group 5,RRG,-1.5,6,14,2168,4,2015,7,-3
Group 5,RRG,-1.5,6,14,2169,14,2015,10,4
Group 5,RRG,-1.5,6,14,2170,13,2015,8,5
Group 5,RRG,-1.5,6,14,2171,14,2015,6,8
Group 5,RRG,-1.5,6,14,2172,9,2015,5,4
Group 5,RRG,-1.5,6,14,2173,8,2015,10,-2
Group 5,RRG,-1.5,6,14,2174,2,2015,8,-6
Group 5,RRG,-1.5,6,14,2175,9,2015,10,-1
Group 5,RRG,-1.5,6,14,2176,12,2015,10,2
Group 5,RRG,-1.5,6,14,2177,12,2015,5,7
Group 5,RRG,-1.5,6,14,2178,12,2015,8,4
Group 5,RRG,-1.5,6,14,2179,10,2015,7,3
Group 5,RRG,-1.5,6,14,2180,13,2015,2,11
Group 5,RRG,-1.5,6,14,2181,9,2015,6,3
Group 5,RRG,-1.5,6,14,2182,8,2015,5,3
Group 5,RRG,-1.5,6,14,2183,8,2015,4,4
Group 5,RRG,-1.5,6,14,2184,10,2015,9,1
Group 5,RRG,-1.5,6,14,2185,9,2015,6,3
Group 5,RRG,-1.5,6,14,2186,9,2015,9,0
Group 5,RRG,-1.5,6,14,2187,6,2015,3,3
Group 5,RRG,-1.5,6,14,2188,10,2015,5,5
Group 5,RRG,-1.5,6,14,2189,11,2015,7,4
Group 5,RRG,-1.5,6,14,2190,13,2015,7,6
Group 5,RRG,-1.5,6,14,2191,13,2015,9,4
Group 5,RRG,-1.5,6,14,2192,7,2015,9,-2
Group 5,RRG,-1.5,6,14,2193,11,2015,7,4
Group 5,RRG,-1.5,6,14,2194,9,2015,9,0
Group 5,RRG,-1.5,6,14,2195,9,2015,9,0
Group 5,RRG,-1.5,6,14,2196,10,2015,7,3
Group 5,RRG,-1.5,6,14,2197,4,2015,4,0
Group 5,RRG,-1.5,6,14,2198,11,2015,7,4
Group 5,RRG,-1.5,6,14,2199,12,2015,10,2
Group 5,RRG,-1.5,6,14,2200,9,2015,4,5
Group 5,RRG,-1.5,6,14,2201,11,2015,10,1
Group 5,RRG,-1.5,6,14,2202,8,2015,7,1
Group 5,RRG,-1.5,6,14,2203,10,2015,6,4
Group 5,RRG,-1.5,6,14,2204,11,2015,5,6
Group 5,RRG,-1.5,6,14,2205,13,2015,2,11
Group 5,RRG,-1.5,6,14,2206,11,2015,5,6
Group 5,RRG,-1.5,6,14,2207,9,2015,6,3
Group 5,RRG,-1.5,6,14,2208,7,2015,8,-1
Group 5,RRG,-1.5,6,14,2209,8,2015,7,1
Group 5,RRG,-1.5,6,14,2210,10,2015,3,7
Group 5,RRG,-1.5,6,14,2211,10,2015,9,1
Group 5,RRG,-1.5,6,14,2212,10,2015,4,6
Group 5,RRG,-1.5,6,14,2213,9,2015,7,2
Group 5,RRG,-1.5,6,14,2214,10,2015,7,3
Group 5,RRG,-1.5,6,14,2215,8,2015,6,2
Group 5,RRG,-1.5,6,14,2216,5,2015,6,-1
Group 5,RRG,-1.5,6,14,2217,9,2015,8,1
Group 5,RRG,-1.5,6,14,2218,9,2015,8,1
Group 5,RRG,-1.5,6,14,2219,13,2015,4,9
Group 5,RRG,-1.5,6,14,2220,14,2015,4,10
Group 5,RRG,-1.5,6,14,2221,7,2015,7,0
Group 5,RRG,-1.5,6,14,2222,8,2015,4,4
Group 5,RRG,-1.5,6,14,2223,14,2015,8,6
Group 5,RRG,-1.5,6,14,2224,4,2015,5,-1
Group 5,RRG,-1.5,6,14,2225,3,2015,7,-4
Group 5,RRG,-1.5,6,14,2226,8,2015,6,2
Group 5,RRG,-1.5,6,14,2227,7,2015,9,-2
Group 5,RRG,-1.5,6,14,2228,11,2015,5,6
Group 5,RRG,-1.5,6,14,2229,12,2015,6,6
Group 5,RRG,-1.5,6,14,2230,12,2015,7,5
Group 5,RRG,-1.5,6,14,2231,11,2015,3,8
Group 5,RRG,-1.5,6,14,2232,12,2015,9,3
Group 5,RRG,-1.5,6,14,2233,10,2015,6,4
Group 5,RRG,-1.5,6,14,2234,10,2015,5,5
Group 5,RRG,-1.5,6,14,2235,10,2015,13,-3
Group 5,RRG,-1.5,6,14,2236,9,2015,2,7
Group 5,RRG,-1.5,6,14,2237,6,2015,11,-5
Group 5,RRG,-1.5,6,14,2238,8,2015,8,0
Group 5,RRG,-1.5,6,14,2239,11,2015,7,4
Group 5,RRG,-1.5,6,14,2240,8,2015,7,1
Group 5,RRG,-1.5,6,14,2241,10,2015,9,1
Group 5,RRG,-1.5,6,14,2242,6,2015,8,-2
Group 5,RRG,-1.5,6,14,2243,10,2015,9,1
Group 5,RRG,-1.5,6,14,2244,10,2015,8,2
Group 5,RRG,-1.5,6,14,2245,13,2015,5,8
Group 5,RRG,-1.5,6,14,2246,10,2015,6,4
Group 5,RRG,-1.5,6,14,2247,13,2015,10,3
Group 5,RRG,-1.5,6,14,2248,9,2015,8,1
Group 5,RRG,-1.5,6,14,2249,9,2015,9,0
Group 5,RRG,-1.5,6,14,2250,11,2015,6,5
Group 5,RRG,-1.5,6,14,2251,9,2015,9,0
Group 5,RRG,-1.5,6,14,2252,14,2015,10,4
Group 5,RRG,-1.5,6,14,2253,10,2015,6,4
Group 5,RRG,-1.5,6,14,2254,9,2015,6,3
Group 5,RRG,-1.5,6,14,2255,10,2015,7,3
Group 5,RRG,-1.5,6,14,2256,7,2015,10,-3
Group 5,RRG,-1.5,6,14,2257,8,2015,8,0
Group 5,RRG,-1.5,6,14,2258,9,2015,7,2
Group 5,RRG,-1.5,6,14,2259,12,2015,3,9
Group 5,RRG,-1.5,6,14,2260,7,2015,8,-1
Group 5,RRG,-1.5,6,14,2261,9,2015,6,3
Group 5,RRG,-1.5,6,14,2262,7,2015,5,2
Group 5,RRG,-1.5,6,14,2263,9,2015,6,3
Group 5,RRG,-1.5,6,14,2264,7,2015,3,4
Group 5,RRG,-1.5,6,14,2265,6,2015,7,-1
Group 5,RRG,-1.5,6,14,2266,10,2015,6,4
Group 5,RRG,-1.5,6,14,2267,13,2015,6,7
Group 5,RRG,-1.5,6,14,2268,9,2015,8,1
Group 5,RRG,-1.5,6,14,2269,10,2015,5,5
Group 5,RRG,-1.5,6,14,2270,9,2015,9,0
Group 5,RRG,-1.5,6,14,2271,11,2015,6,5
Group 5,RRG,-1.5,6,14,2272,14,2015,3,11
Group 5,RRG,-1.5,6,14,2273,10,2015,6,4
Group 5,RRG,-1.5,6,14,2274,6,2015,9,-3
Group 5,RRG,-1.5,6,14,2275,7,2015,6,1
Group 5,RRG,-1.5,6,14,2276,8,2015,7,1
Group 5,RRG,-1.5,6,14,2277,6,2015,12,-6
Group 5,RRG,-1.5,6,14,2278,8,2015,6,2
Group 5,RRG,-1.5,6,14,2279,8,2015,8,0
Group 5,RRG,-1.5,6,14,2280,8,2015,7,1
Group 5,RRG,-1.5,6,14,2281,5,2015,9,-4
Group 5,RRG,-1.5,6,14,2282,11,2015,5,6
Group 5,RRG,-1.5,6,14,2283,9,2015,2,7
Group 5,RRG,-1.5,6,14,2284,10,2015,8,2
Group 5,RRG,-1.5,6,14,2285,10,2015,7,3
Group 5,RRG,-1.5,6,14,2286,7,2015,8,-1
Group 5,RRG,-1.5,6,14,2287,5,2015,9,-4
Group 5,RRG,-1.5,6,14,2288,2,2015,8,-6
Group 5,RRG,-1.5,6,14,2289,11,2015,9,2
Group 5,RRG,-1.5,6,14,2290,1,2015,8,-7
Group 5,RRG,-1.5,6,14,2291,14,2015,4,10
Group 5,RRG,-1.5,6,14,2292,9,2015,7,2
Group 5,RRG,-1.5,6,14,2293,7,2015,7,0
Group 5,RRG,-1.5,6,14,2294,14,2015,6,8
Group 5,RRG,-1.5,6,14,2295,6,2015,8,-2
Group 5,RRG,-1.5,6,14,2296,11,2015,7,4
Group 5,RRG,-1.5,6,14,2297,8,2015,5,3
Group 5,RRG,-1.5,6,14,2298,13,2015,6,7
Group 5,RRG,-1.5,6,14,2299,9,2015,5,4
Group 5,RRG,-1.5,6,14,2300,11,2015,4,7
Group 5,RRG,-1.5,6,14,2301,6,2015,9,-3
Group 5,RRG,-1.5,6,14,2302,13,2015,4,9
Group 5,RRG,-1.5,6,14,2303,8,2015,9,-1
Group 5,RRG,-1.5,6,14,2304,10,2015,4,6
Group 5,RRG,-1.5,6,14,2305,12,2015,7,5
Group 5,RRG,-1.5,6,14,2306,10,2015,5,5
Group 5,RRG,-1.5,6,14,2307,12,2015,1,11
Group 5,RRG,-1.5,6,14,2308,11,2015,7,4
Group 5,RRG,-1.5,6,14,2309,8,2015,3,5
Group 5,RRG,-1.5,6,14,2310,11,2015,9,2
Group 5,RRG,-1.5,6,14,2311,11,2015,9,2
Group 5,RRG,-1.5,6,14,2312,9,2015,4,5
Group 5,RRG,-1.5,6,14,2313,11,2015,4,7
Group 5,RRG,-1.5,6,14,2314,8,2015,0,8
Group 5,RRG,-1.5,6,14,2315,13,2015,8,5
Group 5,RRG,-1.5,6,14,2316,11,2015,3,8
Group 5,RRG,-1.5,6,14,2317,13,2015,9,4
Group 5,RRG,-1.5,6,14,2318,9,2015,7,2
Group 5,RRG,-1.5,6,14,2319,13,2015,6,7
Group 5,RRG,-1.5,6,14,2320,13,2015,13,0
Group 5,RRG,-1.5,6,14,2321,12,2015,3,9
Group 5,RRG,-1.5,6,14,2322,13,2015,4,9
Group 5,RRG,-1.5,6,14,2323,12,2015,11,1
Group 5,RRG,-1.5,6,14,2324,9,2015,10,-1
Group 5,RRG,-1.5,6,14,2325,12,2015,6,6
Group 5,RRG,-1.5,6,14,2326,8,2015,9,-1
Group 5,RRG,-1.5,6,14,2327,3,2015,5,-2
Group 5,RRG,-1.5,6,14,2328,10,2015,5,5
Group 5,RRG,-1.5,6,14,2329,12,2015,5,7
Group 5,RRG,-1.5,6,14,2330,10,2015,4,6
Group 5,RRG,-1.5,6,14,2331,8,2015,4,4
Group 5,RRG,-1.5,6,14,2332,6,2015,7,-1
Group 5,RRG,-1.5,6,14,2333,9,2015,7,2
Group 5,RRG,-1.5,6,14,2334,10,2015,6,4
Group 5,RRG,-1.5,6,14,2335,10,2015,3,7
Group 5,RRG,-1.5,6,14,2336,10,2015,10,0
Group 5,RRG,-1.5,6,14,2337,8,2015,6,2
Group 5,RRG,-1.5,6,14,2338,13,2015,7,6
Group 5,RRG,-1.5,6,14,2339,11,2015,5,6
Group 5,RRG,-1.5,6,14,2340,11,2015,6,5
Group 5,RRG,-1.5,6,14,2341,7,2015,5,2
Group 5,RRG,-1.5,6,14,2342,9,2015,5,4
Group 5,RRG,-1.5,6,14,2343,11,2015,5,6
Group 5,RRG,-1.5,6,14,2344,9,2015,10,-1
Group 5,RRG,-1.5,6,14,2345,8,2015,3,5
Group 5,RRG,-1.5,6,14,2346,8,2015,5,3
Group 5,RRG,-1.5,6,14,2347,9,2015,5,4
Group 5,RRG,-1.5,6,14,2348,10,2015,8,2
Group 5,RRG,-1.5,6,14,2349,11,2015,1,10
Group 5,RRG,-1.5,6,14,2350,13,2015,8,5
Group 5,RRG,-1.5,6,14,2351,9,2015,6,3
Group 5,RRG,-1.5,6,14,2352,10,2015,6,4
Group 5,RRG,-1.5,6,14,2353,12,2015,7,5
Group 5,RRG,-1.5,6,14,2354,13,2015,1,12
Group 5,RRG,-1.5,6,14,2355,12,2015,8,4
Group 5,RRG,-1.5,6,14,2356,13,2015,12,1
Group 5,RRG,-1.5,6,14,2357,8,2015,9,-1
Group 5,RRG,-1.5,6,14,2358,11,2015,8,3
Group 5,RRG,-1.5,6,14,2359,10,2015,3,7
Group 5,RRG,-1.5,6,14,2360,8,2015,7,1
Group 5,RRG,-1.5,6,14,2361,11,2015,10,1
Group 5,RRG,-1.5,6,14,2362,10,2015,9,1
Group 5,RRG,-1.5,6,14,2363,6,2015,7,-1
Group 5,RRG,-1.5,6,14,2364,8,2015,7,1
Group 5,RRG,-1.5,6,14,2365,11,2015,10,1
Group 5,RRG,-1.5,6,14,2366,11,2015,6,5
Group 5,RRG,-1.5,6,14,2367,9,2015,6,3
Group 5,RRG,-1.5,6,14,2368,12,2015,9,3
Group 5,RRG,-1.5,6,14,2369,7,2015,4,3
Group 5,RRG,-1.5,6,14,2370,10,2015,2,8
Group 5,RRG,-1.5,6,14,2371,13,2015,7,6
Group 5,RRG,-1.5,6,14,2372,14,2015,6,8
Group 5,RRG,-1.5,6,14,2373,10,2015,7,3
Group 5,RRG,-1.5,6,14,2374,10,2015,11,-1
Group 5,RRG,-1.5,6,14,2375,9,2015,10,-1
Group 5,RRG,-1.5,6,14,2376,9,2015,7,2
Group 5,RRG,-1.5,6,14,2377,12,2015,5,7
Group 5,RRG,-1.5,6,14,2378,12,2015,8,4
Group 5,RRG,-1.5,6,14,2379,4,2015,2,2
Group 5,RRG,-1.5,6,14,2380,12,2015,5,7
Group 5,RRG,-1.5,6,14,2381,10,2015,3,7
Group 5,RRG,-1.5,6,14,2382,12,2015,5,7
Group 5,RRG,-1.5,6,14,2383,9,2015,7,2
Group 5,RRG,-1.5,6,14,2384,8,2015,9,-1
Group 5,RRG,-1.5,6,14,2385,9,2015,5,4
Group 5,RRG,-1.5,6,14,2386,12,2015,10,2
Group 5,RRG,-1.5,6,14,2387,11,2015,5,6
Group 5,RRG,-1.5,6,14,2388,10,2015,5,5
Group 5,RRG,-1.5,6,14,2389,10,2015,10,0
Group 5,RRG,-1.5,6,14,2390,12,2015,13,-1
Group 5,RRG,-1.5,6,14,2391,11,2015,4,7
Group 5,RRG,-1.5,6,14,2392,13,2015,4,9
Group 5,RRG,-1.5,6,14,2393,11,2015,5,6
Group 5,RRG,-1.5,6,14,2394,13,2015,7,6
Group 5,RRG,-1.5,6,14,2395,11,2015,8,3
Group 5,RRG,-1.5,6,14,2396,8,2015,8,0
Group 5,RRG,-1.5,6,14,2397,11,2015,3,8
Group 5,RRG,-1.5,6,14,2398,14,2015,3,11
Group 5,RRG,-1.5,6,14,2399,14,2015,11,3
Group 5,RRG,-1.5,6,14,2400,14,2015,5,9
Group 5,RRG,-1.5,6,14,2401,14,2015,4,10
Group 5,RRG,-1.5,6,14,2402,9,2015,7,2
Group 5,RRG,-1.5,6,14,2403,9,2015,3,6
Group 5,RRG,-1.5,6,14,2404,14,2015,6,8
Group 5,RRG,-1.5,6,14,2405,10,2015,8,2
Group 5,RRG,-1.5,6,14,2406,10,2015,5,5
Group 5,RRG,-1.5,6,14,2407,12,2015,5,7
Group 5,RRG,-1.5,6,14,2408,9,2015,10,-1
Group 5,RRG,-1.5,6,14,2409,13,2015,6,7
Group 5,RRG,-1.5,6,14,2410,12,2015,11,1
Group 5,RRG,-1.5,6,14,2411,8,2015,4,4
Group 5,RRG,-1.5,6,14,2412,11,2015,4,7
Group 5,RRG,-1.5,6,14,2413,9,2015,6,3
Group 5,RRG,-1.5,6,14,2414,9,2015,10,-1
Group 5,RRG,-1.5,6,14,2415,12,2015,5,7
Group 5,RRG,-1.5,6,14,2416,9,2015,6,3
Group 5,RRG,-1.5,6,14,2417,14,2015,10,4
Group 5,RRG,-1.5,6,14,2418,7,2015,11,-4
Group 5,RRG,-1.5,6,14,2419,8,2015,3,5
Group 5,RRG,-1.5,6,14,2420,13,2015,4,9
Group 5,RRG,-1.5,6,14,2421,12,2015,5,7
Group 5,RRG,-1.5,6,14,2422,9,2015,9,0
Group 5,RRG,-1.5,6,14,2423,12,2015,4,8
Group 5,RRG,-1.5,6,14,2424,11,2015,10,1
Group 5,RRG,-1.5,6,14,2425,10,2015,7,3
Group 5,RRG,-1.5,6,14,2426,10,2015,2,8
Group 5,RRG,-1.5,6,14,2427,7,2015,6,1
Group 5,RRG,-1.5,6,14,2428,11,2015,4,7
Group 5,RRG,-1.5,6,14,2429,13,2015,5,8
Group 5,RRG,-1.5,6,14,2430,10,2015,3,7
Group 5,RRG,-1.5,6,14,2431,10,2015,4,6
Group 5,RRG,-1.5,6,14,2432,8,2015,7,1
Group 5,RRG,-1.5,6,14,2433,10,2015,9,1
Group 5,RRG,-1.5,6,14,2434,13,2015,6,7
Group 5,RRG,-1.5,6,14,2435,13,2015,5,8
Group 5,RRG,-1.5,6,14,2436,8,2015,11,-3
Group 5,RRG,-1.5,6,14,2437,10,2015,7,3
Group 5,RRG,-1.5,6,14,2438,7,2015,6,1
Group 5,RRG,-1.5,6,14,2439,13,2015,7,6
Group 5,RRG,-1.5,6,14,2440,9,2015,5,4
Group 5,RRG,-1.5,6,14,2441,11,2015,8,3
Group 5,RRG,-1.5,6,14,2442,10,2015,8,2
Group 5,RRG,-1.5,6,14,2443,2,2015,6,-4
Group 5,RRG,-1.5,6,14,2444,9,2015,11,-2
Group 5,RRG,-1.5,6,14,2445,11,2015,7,4
Group 5,RRG,-1.5,6,14,2446,5,2015,3,2
Group 5,RRG,-1.5,6,14,2447,9,2015,6,3
Group 5,RRG,-1.5,6,14,2448,8,2015,3,5
Group 5,RRG,-1.5,6,14,2449,9,2015,5,4
Group 5,RRG,-1.5,6,14,2450,6,2015,9,-3
Group 5,RRG,-1.5,6,14,2451,9,2015,3,6
Group 5,RRG,-1.5,6,14,2452,3,2015,5,-2
Group 5,RRG,-1.5,6,14,2453,9,2015,5,4
Group 5,RRG,-1.5,6,14,2454,9,2015,4,5
Group 5,RRG,-1.5,6,14,2455,11,2015,7,4
Group 5,RRG,-1.5,6,14,2456,10,2015,6,4
Group 5,RRG,-1.5,6,14,2457,13,2015,5,8
Group 5,RRG,-1.5,6,14,2458,14,2015,4,10
Group 5,RRG,-1.5,6,14,2459,8,2015,5,3
Group 5,RRG,-1.5,6,14,2460,6,2015,8,-2
Group 5,RRG,-1.5,6,14,2461,9,2015,4,5
Group 5,RRG,-1.5,6,14,2462,10,2015,4,6
Group 5,RRG,-1.5,6,14,2463,14,2015,5,9
Group 5,RRG,-1.5,6,14,2464,13,2015,5,8
Group 5,RRG,-1.5,6,14,2465,9,2015,7,2
Group 5,RRG,-1.5,6,14,2466,9,2015,10,-1
Group 5,RRG,-1.5,6,14,2467,8,2015,7,1
Group 5,RRG,-1.5,6,14,2468,11,2015,7,4
Group 5,RRG,-1.5,6,14,2469,10,2015,8,2
Group 5,RRG,-1.5,6,14,2470,10,2015,6,4
Group 5,RRG,-1.5,6,14,2471,9,2015,8,1
Group 5,RRG,-1.5,6,14,2472,5,2015,6,-1
Group 5,RRG,-1.5,6,14,2473,5,2015,6,-1
Group 5,RRG,-1.5,6,14,2474,11,2015,9,2
Group 5,RRG,-1.5,6,14,2475,6,2015,5,1
Group 5,RRG,-1.5,6,14,2476,7,2015,11,-4
Group 5,RRG,-1.5,6,14,2477,9,2015,5,4
Group 5,RRG,-1.5,6,14,2478,12,2015,6,6
Group 5,RRG,-1.5,6,14,2479,11,2015,8,3
Group 5,RRG,-1.5,6,14,2480,11,2015,6,5
Group 5,RRG,-1.5,6,14,2481,10,2015,8,2
Group 5,RRG,-1.5,6,14,2482,9,2015,11,-2
Group 5,RRG,-1.5,6,14,2483,10,2015,7,3
Group 5,RRG,-1.5,6,14,2484,10,2015,5,5
Group 5,RRG,-1.5,6,14,2485,8,2015,7,1
Group 5,RRG,-1.5,6,14,2486,9,2015,10,-1
Group 5,RRG,-1.5,6,14,2487,11,2015,8,3
Group 5,RRG,-1.5,6,14,2488,11,2015,8,3
Group 5,RRG,-1.5,6,14,2489,9,2015,6,3
Group 5,RRG,-1.5,6,14,2490,10,2015,5,5
Group 5,RRG,-1.5,6,14,2491,10,2015,10,0
Group 5,RRG,-1.5,6,14,2492,10,2015,5,5
Group 5,RRG,-1.5,6,14,2493,7,2015,11,-4
Group 5,RRG,-1.5,6,14,2494,11,2015,8,3
Group 5,RRG,-1.5,6,14,2495,9,2015,7,2
Group 5,RRG,-1.5,6,14,2496,9,2015,8,1
Group 5,RRG,-1.5,6,14,2497,6,2015,10,-4
Group 5,RRG,-1.5,6,14,2498,10,2015,4,6
Group 5,RRG,-1.5,6,14,2499,7,2015,5,2
Group 5,RRG,-1.5,6,14,2500,5,2015,8,-3
Group 5,RRG,-1.5,6,14,2501,6,2015,4,2
Group 5,RRG,-1.5,6,14,2502,12,2015,4,8
Group 5,RRG,-1.5,6,14,2503,6,2015,7,-1
Group 5,RRG,-1.5,6,14,2504,12,2015,9,3
Group 5,RRG,-1.5,6,14,2505,14,2015,4,10
Group 5,RRG,-1.5,6,14,2506,11,2015,1,10
Group 5,RRG,-1.5,6,14,2507,9,2015,2,7
Group 5,RRG,-1.5,6,14,2508,10,2015,6,4
Group 5,RRG,-1.5,6,14,2509,11,2015,6,5
Group 5,RRG,-1.5,6,14,2510,10,2015,9,1
Group 5,RRG,-1.5,6,14,2511,3,2015,6,-3
Group 5,RRG,-1.5,6,14,2512,2,2015,8,-6
Group 5,RRG,-1.5,6,14,2513,8,2015,10,-2
Group 5,RRG,-1.5,6,14,2514,8,2015,5,3
Group 5,RRG,-1.5,6,14,2515,12,2015,10,2
Group 5,RRG,-1.5,6,14,2516,6,2015,8,-2
Group 5,RRG,-1.5,6,14,2517,9,2015,10,-1
Group 5,RRG,-1.5,6,14,2518,9,2015,8,1
Group 5,RRG,-1.5,6,14,2519,10,2015,6,4
Group 5,RRG,-1.5,6,14,2520,13,2015,9,4
Group 5,RRG,-1.5,6,14,2521,11,2015,4,7
Group 5,RRG,-1.5,6,14,2522,10,2015,6,4
Group 5,RRG,-1.5,6,14,2523,13,2015,5,8
Group 5,RRG,-1.5,6,14,2524,13,2015,5,8
Group 5,RRG,-1.5,6,14,2525,9,2015,10,-1
Group 5,RRG,-1.5,6,14,2526,12,2015,8,4
Group 5,RRG,-1.5,6,14,2527,8,2015,8,0
Group 5,RRG,-1.5,6,14,2528,9,2015,8,1
Group 5,RRG,-1.5,6,14,2529,7,2015,9,-2
Group 5,RRG,-1.5,6,14,2530,8,2015,1,7
Group 5,RRG,-1.5,6,14,2531,8,2015,7,1
Group 5,RRG,-1.5,6,14,2532,13,2015,11,2
Group 5,RRG,-1.5,6,14,2533,9,2015,7,2
Group 5,RRG,-1.5,6,14,2534,12,2015,9,3
Group 5,RRG,-1.5,6,14,2535,12,2015,6,6
Group 5,RRG,-1.5,6,14,2536,13,2015,10,3
Group 5,RRG,-1.5,6,14,2537,9,2015,8,1
Group 5,RRG,-1.5,6,14,2538,9,2015,3,6
Group 5,RRG,-1.5,6,14,2539,7,2015,7,0
Group 5,RRG,-1.5,6,14,2540,11,2015,6,5
Group 5,RRG,-1.5,6,14,2541,13,2015,8,5
Group 5,RRG,-1.5,6,14,2542,11,2015,8,3
Group 5,RRG,-1.5,6,14,2543,10,2015,5,5
Group 5,RRG,-1.5,6,14,2544,2,2015,9,-7
Group 5,RRG,-1.5,6,14,2545,5,2015,12,-7
Group 5,RRG,-1.5,6,14,2546,5,2015,11,-6
Group 5,RRG,-1.5,6,14,2547,13,2015,8,5
Group 5,RRG,-1.5,6,14,2548,3,2015,2,1
Group 5,RRG,-1.5,6,14,2549,8,2015,11,-3
Group 5,RRG,-1.5,6,14,2550,7,2015,9,-2
Group 5,RRG,-1.5,6,14,2551,11,2015,2,9
Group 5,RRG,-1.5,6,14,2552,7,2015,8,-1
Group 5,RRG,-1.5,6,14,2553,6,2015,6,0
Group 5,RRG,-1.5,6,14,2554,8,2015,4,4
Group 5,RRG,-1.5,6,14,2555,11,2015,9,2
Group 5,RRG,-1.5,6,14,2556,11,2015,4,7
Group 5,RRG,-1.5,6,14,2557,9,2015,4,5
Group 5,RRG,-1.5,6,14,2558,12,2015,5,7
Group 5,RRG,-1.5,6,14,2559,6,2015,4,2
Group 5,RRG,-1.5,6,14,2560,10,2015,5,5
Group 5,RRG,-1.5,6,14,2561,9,2015,11,-2
Group 5,RRG,-1.5,6,14,2562,12,2015,6,6
Group 5,RRG,-1.5,6,14,2563,10,2015,6,4
Group 5,RRG,-1.5,6,14,2564,13,2015,4,9
Group 5,RRG,-1.5,6,14,2565,6,2015,6,0
Group 5,RRG,-1.5,6,14,2566,12,2015,8,4
Group 5,RRG,-1.5,6,14,2567,11,2015,7,4
Group 5,RRG,-1.5,6,14,2568,10,2015,8,2
Group 5,RRG,-1.5,6,14,2569,7,2015,4,3
Group 5,RRG,-1.5,6,14,2570,10,2015,7,3
Group 5,RRG,-1.5,6,14,2571,11,2015,8,3
Group 5,RRG,-1.5,6,14,2572,6,2015,4,2
Group 5,RRG,-1.5,6,14,2573,11,2015,8,3
Group 5,RRG,-1.5,6,14,2574,9,2015,8,1
Group 5,RRG,-1.5,6,14,2575,10,2015,5,5
Group 5,RRG,-1.5,6,14,2576,10,2015,7,3
Group 5,RRG,-1.5,6,14,2577,5,2015,5,0
Group 5,RRG,-1.5,6,14,2578,7,2015,9,-2
Group 5,RRG,-1.5,6,14,2579,7,2015,8,-1
Group 5,RRG,-1.5,6,14,2580,8,2015,8,0
Group 5,RRG,-1.5,6,14,2581,11,2015,5,6
Group 5,RRG,-1.5,6,14,2582,8,2015,8,0
Group 5,RRG,-1.5,6,14,2583,9,2015,4,5
Group 5,RRG,-1.5,6,14,2584,9,2015,4,5
Group 5,RRG,-1.5,6,14,2585,7,2015,5,2
Group 5,RRG,-1.5,6,14,2586,9,2015,4,5
Group 5,RRG,-1.5,6,14,2587,9,2015,8,1
Group 5,RRG,-1.5,6,14,2588,7,2015,8,-1
Group 5,RRG,-1.5,6,14,2589,7,2015,5,2
Group 5,RRG,-1.5,6,14,2590,10,2015,8,2
Group 5,RRG,-1.5,6,14,2591,12,2015,5,7
Group 5,RRG,-1.5,6,14,2592,7,2015,4,3
Group 5,RRG,-1.5,6,14,2593,11,2015,11,0
Group 5,RRG,-1.5,6,14,2594,6,2015,5,1
Group 5,RRG,-1.5,6,14,2595,12,2015,6,6
Group 5,RRG,-1.5,6,14,2596,11,2015,12,-1
Group 5,RRG,-1.5,6,14,2597,10,2015,7,3
Group 5,RRG,-1.5,6,14,2598,9,2015,5,4
Group 5,RRG,-1.5,6,14,2599,10,2015,5,5
Group 5,RRG,-1.5,6,14,2600,8,2015,8,0
Group 5,RRG,-1.5,6,14,2601,10,2015,5,5
Group 5,RRG,-1.5,6,14,2602,13,2015,6,7
Group 5,RRG,-1.5,6,14,2603,6,2015,5,1
Group 5,RRG,-1.5,6,14,2604,10,2015,10,0
Group 5,RRG,-1.5,6,14,2605,9,2015,11,-2
Group 5,RRG,-1.5,6,14,2606,7,2015,8,-1
Group 5,RRG,-1.5,6,14,2607,11,2015,10,1
Group 5,RRG,-1.5,6,14,2608,8,2015,10,-2
Group 5,RRG,-1.5,6,14,2609,8,2015,6,2
Group 5,RRG,-1.5,6,14,2610,9,2015,2,7
Group 5,RRG,-1.5,6,14,2611,9,2015,7,2
Group 5,RRG,-1.5,6,14,2612,7,2015,4,3
Group 5,RRG,-1.5,6,14,2613,7,2015,7,0
Group 5,RRG,-1.5,6,14,2614,12,2015,9,3
Group 5,RRG,-1.5,6,14,2615,11,2015,7,4
Group 5,RRG,-1.5,6,14,2616,11,2015,10,1
Group 5,RRG,-1.5,6,14,2617,11,2015,1,10
Group 5,RRG,-1.5,6,14,2618,7,2015,9,-2
Group 5,RRG,-1.5,6,14,2619,9,2015,5,4
Group 5,RRG,-1.5,6,14,2620,8,2015,9,-1
Group 5,RRG,-1.5,6,14,2621,7,2015,6,1
Group 5,RRG,-1.5,6,14,2622,7,2015,9,-2
Group 5,RRG,-1.5,6,14,2623,12,2015,6,6
Group 5,RRG,-1.5,6,14,2624,11,2015,3,8
Group 5,RRG,-1.5,6,14,2625,11,2015,6,5
Group 5,RRG,-1.5,6,14,2626,10,2015,5,5
Group 5,RRG,-1.5,6,14,2627,8,2015,9,-1
Group 5,RRG,-1.5,6,14,2628,6,2015,5,1
Group 5,RRG,-1.5,6,14,2629,12,2015,8,4
Group 5,RRG,-1.5,6,14,2630,10,2015,8,2
Group 5,RRG,-1.5,6,14,2631,12,2015,4,8
Group 5,RRG,-1.5,6,14,2632,8,2015,7,1
Group 5,RRG,-1.5,6,14,2633,13,2015,10,3
Group 5,RRG,-1.5,6,14,2634,11,2015,4,7
Group 5,RRG,-1.5,6,14,2635,9,2015,2,7
Group 5,RRG,-1.5,6,14,2636,11,2015,5,6
Group 5,RRG,-1.5,6,14,2637,10,2015,2,8
Group 5,RRG,-1.5,6,14,2638,10,2015,6,4
Group 5,RRG,-1.5,6,14,2639,9,2015,8,1
Group 5,RRG,-1.5,6,14,2640,12,2015,7,5
Group 5,RRG,-1.5,6,14,2641,14,2015,10,4
Group 5,RRG,-1.5,6,14,2642,10,2015,10,0
Group 5,RRG,-1.5,6,14,2643,12,2015,8,4
Group 5,RRG,-1.5,6,14,2644,10,2015,9,1
Group 5,RRG,-1.5,6,14,2645,8,2015,6,2
Group 5,RRG,-1.5,6,14,2646,11,2015,4,7
Group 5,RRG,-1.5,6,14,2647,11,2015,7,4
Group 5,RRG,-1.5,6,14,2648,10,2015,6,4
Group 5,RRG,-1.5,6,14,2649,6,2015,9,-3
Group 5,RRG,-1.5,6,14,2650,4,2015,6,-2
Group 5,RRG,-1.5,6,14,2651,11,2015,6,5
Group 5,RRG,-1.5,6,14,2652,14,2015,4,10
Group 5,RRG,-1.5,6,14,2653,8,2015,8,0
Group 5,RRG,-1.5,6,14,2654,11,2015,7,4
Group 5,RRG,-1.5,6,14,2655,7,2015,9,-2
Group 5,RRG,-1.5,6,14,2656,14,2015,2,12
Group 5,RRG,-1.5,6,14,2657,13,2015,8,5
Group 5,RRG,-1.5,6,14,2658,7,2015,4,3
Group 5,RRG,-1.5,6,14,2659,9,2015,11,-2
Group 5,RRG,-1.5,6,14,2660,9,2015,4,5
Group 5,RRG,-1.5,6,14,2661,9,2015,7,2
Group 5,RRG,-1.5,6,14,2662,9,2015,2,7
Group 5,RRG,-1.5,6,14,2663,12,2015,4,8
Group 5,RRG,-1.5,6,14,2664,8,2015,7,1
Group 5,RRG,-1.5,6,14,2665,7,2015,4,3
Group 5,RRG,-1.5,6,14,2666,11,2015,8,3
Group 5,RRG,-1.5,6,14,2667,9,2015,5,4
Group 5,RRG,-1.5,6,14,2668,10,2015,6,4
Group 5,RRG,-1.5,6,14,2669,9,2015,4,5
Group 5,RRG,-1.5,6,14,2670,13,2015,10,3
Group 5,RRG,-1.5,6,14,2671,12,2015,5,7
Group 5,RRG,-1.5,6,14,2672,12,2015,9,3
Group 5,RRG,-1.5,6,14,2673,12,2015,8,4
Group 5,RRG,-1.5,6,14,2674,8,2015,11,-3
Group 5,RRG,-1.5,6,14,2675,11,2015,8,3
Group 5,RRG,-1.5,6,14,2676,9,2015,4,5
Group 5,RRG,-1.5,6,14,2677,10,2015,8,2
Group 5,RRG,-1.5,6,14,2678,8,2015,10,-2
Group 5,RRG,-1.5,6,14,2679,12,2015,7,5
Group 5,RRG,-1.5,6,14,2680,8,2015,7,1
Group 5,RRG,-1.5,6,14,2681,11,2015,11,0
Group 5,RRG,-1.5,6,14,2682,7,2015,10,-3
Group 5,RRG,-1.5,6,14,2683,8,2015,11,-3
Group 5,RRG,-1.5,6,14,2684,11,2015,13,-2
Group 5,RRG,-1.5,6,14,2685,12,2015,5,7
Group 5,RRG,-1.5,6,14,2686,6,2015,8,-2
Group 5,RRG,-1.5,6,14,2687,10,2015,11,-1
Group 5,RRG,-1.5,6,14,2688,11,2015,4,7
Group 5,RRG,-1.5,6,14,2689,11,2015,10,1
Group 5,RRG,-1.5,6,14,2690,9,2015,6,3
Group 5,RRG,-1.5,6,14,2691,12,2015,10,2
Group 5,RRG,-1.5,6,14,2692,12,2015,11,1
Group 5,RRG,-1.5,6,14,2693,9,2015,10,-1
Group 5,RRG,-1.5,6,14,2694,9,2015,8,1
Group 5,RRG,-1.5,6,14,2695,12,2015,7,5
Group 5,RRG,-1.5,6,14,2696,11,2015,4,7
Group 5,RRG,-1.5,6,14,2697,11,2015,11,0
Group 5,RRG,-1.5,6,14,2698,9,2015,5,4
Group 5,RRG,-1.5,6,14,2699,10,2015,7,3
Group 5,RRG,-1.5,6,14,2700,11,2015,4,7
Group 5,RRG,-1.5,6,14,2701,8,2015,11,-3
Group 5,RRG,-1.5,6,14,2702,10,2015,4,6
Group 5,RRG,-1.5,6,14,2703,8,2015,8,0
Group 5,RRG,-1.5,6,14,2704,11,2015,8,3
Group 5,RRG,-1.5,6,14,2705,8,2015,6,2
Group 5,RRG,-1.5,6,14,2706,7,2015,9,-2
Group 5,RRG,-1.5,6,14,2707,10,2015,8,2
Group 5,RRG,-1.5,6,14,2708,9,2015,7,2
Group 5,RRG,-1.5,6,14,2709,9,2015,8,1
Group 5,RRG,-1.5,6,14,2710,5,2015,6,-1
Group 5,RRG,-1.5,6,14,2711,10,2015,8,2
Group 5,RRG,-1.5,6,14,2712,8,2015,5,3
Group 5,RRG,-1.5,6,14,2713,7,2015,11,-4
Group 5,RRG,-1.5,6,14,2714,10,2015,4,6
Group 5,RRG,-1.5,6,14,2715,13,2015,7,6
Group 5,RRG,-1.5,6,14,2716,12,2015,5,7
Group 5,RRG,-1.5,6,14,2717,11,2015,4,7
Group 5,RRG,-1.5,6,14,2718,13,2015,8,5
Group 5,RRG,-1.5,6,14,2719,12,2015,4,8
Group 5,RRG,-1.5,6,14,2720,12,2015,6,6
Group 5,RRG,-1.5,6,14,2721,14,2015,5,9
Group 5,RRG,-1.5,6,14,2722,13,2015,9,4
Group 5,RRG,-1.5,6,14,2723,11,2015,10,1
Group 5,RRG,-1.5,6,14,2724,10,2015,7,3
Group 5,RRG,-1.5,6,14,2725,12,2015,2,10
Group 5,RRG,-1.5,6,14,2726,12,2015,3,9
Group 5,RRG,-1.5,6,14,2727,14,2015,0,14
Group 5,RRG,-1.5,6,14,2728,12,2015,3,9
Group 5,RRG,-1.5,6,14,2729,10,2015,6,4
Group 5,RRG,-1.5,6,14,2730,9,2015,6,3
Group 5,RRG,-1.5,6,14,2731,12,2015,6,6
Group 5,RRG,-1.5,6,14,2732,10,2015,6,4
Group 5,RRG,-1.5,6,14,2733,9,2015,6,3
Group 5,RRG,-1.5,6,14,2734,5,2015,7,-2
Group 5,RRG,-1.5,6,14,2735,4,2015,6,-2
Group 5,RRG,-1.5,6,14,2736,13,2015,7,6
Group 5,RRG,-1.5,6,14,2737,12,2015,7,5
Group 5,RRG,-1.5,6,14,2738,13,2015,10,3
Group 5,RRG,-1.5,6,14,2739,11,2015,10,1
Group 5,RRG,-1.5,6,14,2740,12,2015,10,2
Group 5,RRG,-1.5,6,14,2741,5,2015,11,-6
Group 5,RRG,-1.5,6,14,2742,8,2015,5,3
Group 5,RRG,-1.5,6,14,2743,9,2015,4,5
Group 5,RRG,-1.5,6,14,2744,9,2015,10,-1
Group 5,RRG,-1.5,6,14,2745,10,2015,5,5
Group 5,RRG,-1.5,6,14,2746,14,2015,5,9
Group 5,RRG,-1.5,6,14,2747,13,2015,8,5
Group 5,RRG,-1.5,6,14,2748,11,2015,8,3
Group 5,RRG,-1.5,6,14,2749,10,2015,7,3
Group 5,RRG,-1.5,6,14,2750,9,2015,5,4
Group 5,RRG,-1.5,6,14,2751,9,2015,6,3
Group 5,RRG,-1.5,6,14,2752,13,2015,6,7
Group 5,RRG,-1.5,6,14,2753,11,2015,6,5
Group 5,RRG,-1.5,6,14,2754,9,2015,5,4
Group 5,RRG,-1.5,6,14,2755,6,2015,8,-2
Group 5,RRG,-1.5,6,14,2756,10,2015,9,1
Group 5,RRG,-1.5,6,14,2757,10,2015,1,9
Group 5,RRG,-1.5,6,14,2758,4,2015,1,3
Group 5,RRG,-1.5,6,14,2759,10,2015,7,3
Group 5,RRG,-1.5,6,14,2760,11,2015,6,5
Group 5,RRG,-1.5,6,14,2761,10,2015,2,8
Group 5,RRG,-1.5,6,14,2762,8,2015,9,-1
Group 5,RRG,-1.5,6,14,2763,10,2015,6,4
Group 5,RRG,-1.5,6,14,2764,6,2015,7,-1
Group 5,RRG,-1.5,6,14,2765,8,2015,9,-1
Group 5,RRG,-1.5,6,14,2766,9,2015,6,3
Group 5,RRG,-1.5,6,14,2767,10,2015,6,4
Group 5,RRG,-1.5,6,14,2768,11,2015,7,4
Group 5,RRG,-1.5,6,14,2769,9,2015,4,5
Group 5,RRG,-1.5,6,14,2770,14,2015,3,11
Group 5,RRG,-1.5,6,14,2771,11,2015,3,8
Group 5,RRG,-1.5,6,14,2772,14,2015,10,4
Group 5,RRG,-1.5,6,14,2773,11,2015,10,1
Group 5,RRG,-1.5,6,14,2774,9,2015,10,-1
Group 5,RRG,-1.5,6,14,2775,13,2015,12,1
Group 5,RRG,-1.5,6,14,2776,12,2015,13,-1
Group 5,RRG,-1.5,6,14,2777,11,2015,9,2
Group 5,RRG,-1.5,6,14,2778,12,2015,4,8
Group 5,RRG,-1.5,6,14,2779,8,2015,5,3
Group 5,RRG,-1.5,6,14,2780,11,2015,7,4
Group 5,RRG,-1.5,6,14,2781,11,2015,7,4
Group 5,RRG,-1.5,6,14,2782,8,2015,6,2
Group 5,RRG,-1.5,6,14,2783,13,2015,8,5
Group 5,RRG,-1.5,6,14,2784,12,2015,6,6
Group 5,RRG,-1.5,6,14,2785,14,2015,5,9
Group 5,RRG,-1.5,6,14,2786,11,2015,6,5
Group 5,RRG,-1.5,6,14,2787,10,2015,7,3
Group 5,RRG,-1.5,6,14,2788,12,2015,12,0
Group 5,RRG,-1.5,6,14,2789,10,2015,8,2
Group 5,RRG,-1.5,6,14,2790,6,2015,10,-4
Group 5,RRG,-1.5,6,14,2791,7,2015,0,7
Group 5,RRG,-1.5,6,14,2792,9,2015,13,-4
Group 5,RRG,-1.5,6,14,2793,8,2015,10,-2
Group 5,RRG,-1.5,6,14,2794,9,2015,8,1
Group 5,RRG,-1.5,6,14,2795,8,2015,7,1
Group 5,RRG,-1.5,6,14,2796,5,2015,6,-1
Group 5,RRG,-1.5,6,14,2797,9,2015,8,1
Group 5,RRG,-1.5,6,14,2798,13,2015,8,5
Group 5,RRG,-1.5,6,14,2799,7,2015,6,1
Group 5,RRG,-1.5,6,14,2800,11,2015,3,8
Group 5,RRG,-1.5,6,14,2801,11,2015,7,4
Group 5,RRG,-1.5,6,14,2802,14,2015,5,9
Group 5,RRG,-1.5,6,14,2803,9,2015,6,3
Group 5,RRG,-1.5,6,14,2804,12,2015,7,5
Group 5,RRG,-1.5,6,14,2805,7,2015,6,1
Group 5,RRG,-1.5,6,14,2806,11,2015,7,4
Group 5,RRG,-1.5,6,14,2807,11,2015,6,5
Group 5,RRG,-1.5,6,14,2808,9,2015,8,1
Group 5,RRG,-1.5,6,14,2809,11,2015,3,8
Group 5,RRG,-1.5,6,14,2810,11,2015,7,4
Group 5,RRG,-1.5,6,14,2811,7,2015,5,2
Group 5,RRG,-1.5,6,14,2812,9,2015,5,4
Group 5,RRG,-1.5,6,14,2813,8,2015,5,3
Group 5,RRG,-1.5,6,14,2814,11,2015,7,4
Group 5,RRG,-1.5,6,14,2815,8,2015,8,0
Group 5,RRG,-1.5,6,14,2816,11,2015,4,7
Group 5,RRG,-1.5,6,14,2817,9,2015,5,4
Group 5,RRG,-1.5,6,14,2818,9,2015,3,6
Group 5,RRG,-1.5,6,14,2819,8,2015,7,1
Group 5,RRG,-1.5,6,14,2820,14,2015,3,11
Group 5,RRG,-1.5,6,14,2821,11,2015,3,8
Group 5,RRG,-1.5,6,14,2822,12,2015,6,6
Group 5,RRG,-1.5,6,14,2823,10,2015,8,2
Group 5,RRG,-1.5,6,14,2824,12,2015,7,5
Group 5,RRG,-1.5,6,14,2825,8,2015,9,-1
Group 5,RRG,-1.5,6,14,2826,10,2015,8,2
Group 5,RRG,-1.5,6,14,2827,9,2015,8,1
Group 5,RRG,-1.5,6,14,2828,11,2015,9,2
Group 5,RRG,-1.5,6,14,2829,10,2015,13,-3
Group 5,RRG,-1.5,6,14,2830,12,2015,10,2
Group 5,RRG,-1.5,6,14,2831,9,2015,4,5
Group 5,RRG,-1.5,6,14,2832,11,2015,5,6
Group 5,RRG,-1.5,6,14,2833,10,2015,4,6
Group 5,RRG,-1.5,6,14,2834,8,2015,9,-1
Group 5,RRG,-1.5,6,14,2835,11,2015,5,6
Group 5,RRG,-1.5,6,14,2836,13,2015,4,9
Group 5,RRG,-1.5,6,14,2837,8,2015,10,-2
Group 5,RRG,-1.5,6,14,2838,12,2015,6,6
Group 5,RRG,-1.5,6,14,2839,10,2015,10,0
Group 5,RRG,-1.5,6,14,2840,8,2015,7,1
Group 5,RRG,-1.5,6,14,2841,14,2015,8,6
Group 5,RRG,-1.5,6,14,2842,9,2015,3,6
Group 5,RRG,-1.5,6,14,2843,11,2015,9,2
Group 5,RRG,-1.5,6,14,2844,5,2015,12,-7
Group 5,RRG,-1.5,6,14,2845,10,2015,7,3
Group 5,RRG,-1.5,6,14,2846,4,2015,12,-8
Group 5,RRG,-1.5,6,14,2847,11,2015,10,1
Group 5,RRG,-1.5,6,14,2848,9,2015,10,-1
Group 5,RRG,-1.5,6,14,2849,9,2015,6,3
Group 5,RRG,-1.5,6,14,2850,8,2015,7,1
Group 5,RRG,-1.5,6,14,2851,10,2015,6,4
Group 5,RRG,-1.5,6,14,2852,10,2015,10,0
Group 5,RRG,-1.5,6,14,2853,10,2015,6,4
Group 5,RRG,-1.5,6,14,2854,11,2015,9,2
Group 5,RRG,-1.5,6,14,2855,13,2015,6,7
Group 5,RRG,-1.5,6,14,2856,12,2015,2,10
Group 5,RRG,-1.5,6,14,2857,7,2015,4,3
Group 5,RRG,-1.5,6,14,2858,10,2015,10,0
Group 5,RRG,-1.5,6,14,2859,7,2015,3,4
Group 5,RRG,-1.5,6,14,2860,8,2015,2,6
Group 5,RRG,-1.5,6,14,2861,10,2015,5,5
Group 5,RRG,-1.5,6,14,2862,10,2015,10,0
Group 5,RRG,-1.5,6,14,2863,9,2015,5,4
Group 5,RRG,-1.5,6,14,2864,9,2015,6,3
Group 5,RRG,-1.5,6,14,2865,9,2015,6,3
Group 5,RRG,-1.5,6,14,2866,8,2015,4,4
Group 5,RRG,-1.5,6,14,2867,10,2015,8,2
Group 5,RRG,-1.5,6,14,2868,11,2015,8,3
Group 5,RRG,-1.5,6,14,2869,10,2015,7,3
Group 5,RRG,-1.5,6,14,2870,9,2015,7,2
Group 5,RRG,-1.5,6,14,2871,10,2015,9,1
Group 5,RRG,-1.5,6,14,2872,7,2015,8,-1
Group 5,RRG,-1.5,6,14,2873,7,2015,3,4
Group 5,RRG,-1.5,6,14,2874,5,2015,4,1
Group 5,RRG,-1.5,6,14,2875,11,2015,5,6
Group 5,RRG,-1.5,6,14,2876,10,2015,9,1
Group 5,RRG,-1.5,6,14,2877,12,2015,10,2
Group 5,RRG,-1.5,6,14,2878,3,2015,6,-3
Group 5,RRG,-1.5,6,14,2879,11,2015,7,4
Group 5,RRG,-1.5,6,14,2880,8,2015,8,0
Group 5,RRG,-1.5,6,14,2881,6,2015,4,2
Group 5,RRG,-1.5,6,14,2882,10,2015,6,4
Group 5,RRG,-1.5,6,14,2883,9,2015,6,3
Group 5,RRG,-1.5,6,14,2884,9,2015,6,3
Group 5,RRG,-1.5,6,14,2885,9,2015,5,4
Group 5,RRG,-1.5,6,14,2886,11,2015,5,6
Group 5,RRG,-1.5,6,14,2887,9,2015,6,3
Group 5,RRG,-1.5,6,14,2888,11,2015,9,2
Group 5,RRG,-1.5,6,14,2889,11,2015,4,7
Group 5,RRG,-1.5,6,14,2890,7,2015,7,0
Group 5,RRG,-1.5,6,14,2891,8,2015,5,3
Group 5,RRG,-1.5,6,14,2892,12,2015,4,8
Group 5,RRG,-1.5,6,14,2893,12,2015,6,6
Group 5,RRG,-1.5,6,14,2894,11,2015,8,3
Group 5,RRG,-1.5,6,14,2895,11,2015,6,5
Group 5,RRG,-1.5,6,14,2896,7,2015,7,0
Group 5,RRG,-1.5,6,14,2897,12,2015,8,4
Group 5,RRG,-1.5,6,14,2898,7,2015,8,-1
Group 5,RRG,-1.5,6,14,2899,12,2015,5,7
Group 5,RRG,-1.5,6,14,2900,4,2015,6,-2
Group 5,RRG,-1.5,6,14,2901,10,2015,4,6
Group 5,RRG,-1.5,6,14,2902,11,2015,6,5
Group 5,RRG,-1.5,6,14,2903,13,2015,5,8
Group 5,RRG,-1.5,6,14,2904,11,2015,6,5
Group 5,RRG,-1.5,6,14,2905,8,2015,9,-1
Group 5,RRG,-1.5,6,14,2906,7,2015,12,-5
Group 5,RRG,-1.5,6,14,2907,7,2015,6,1
Group 5,RRG,-1.5,6,14,2908,5,2015,8,-3
Group 5,RRG,-1.5,6,14,2909,9,2015,6,3
Group 5,RRG,-1.5,6,14,2910,12,2015,6,6
Group 5,RRG,-1.5,6,14,2911,10,2015,5,5
Group 5,RRG,-1.5,6,14,2912,8,2015,7,1
Group 5,RRG,-1.5,6,14,2913,12,2015,7,5
Group 5,RRG,-1.5,6,14,2914,12,2015,11,1
Group 5,RRG,-1.5,6,14,2915,12,2015,7,5
Group 5,RRG,-1.5,6,14,2916,8,2015,6,2
Group 5,RRG,-1.5,6,14,2917,13,2015,8,5
Group 5,RRG,-1.5,6,14,2918,11,2015,11,0
Group 5,RRG,-1.5,6,14,2919,7,2015,12,-5
Group 5,RRG,-1.5,6,14,2920,9,2015,3,6
Group 5,RRG,-1.5,6,14,2921,8,2015,5,3
Group 5,RRG,-1.5,6,14,2922,8,2015,8,0
Group 5,RRG,-1.5,6,14,2923,9,2015,6,3
Group 5,RRG,-1.5,6,14,2924,10,2015,6,4
Group 5,RRG,-1.5,6,14,2925,8,2015,8,0
Group 5,RRG,-1.5,6,14,2926,8,2015,11,-3
Group 5,RRG,-1.5,6,14,2927,11,2015,6,5
Group 5,RRG,-1.5,6,14,2928,12,2015,7,5
Group 5,RRG,-1.5,6,14,2929,9,2015,4,5
Group 5,RRG,-1.5,6,14,2930,9,2015,2,7
Group 5,RRG,-1.5,6,14,2931,8,2015,9,-1
Group 5,RRG,-1.5,6,14,2932,9,2015,4,5
Group 5,RRG,-1.5,6,14,2933,13,2015,8,5
Group 5,RRG,-1.5,6,14,2934,9,2015,7,2
Group 5,RRG,-1.5,6,14,2935,12,2015,5,7
Group 5,RRG,-1.5,6,14,2936,6,2015,6,0
Group 5,RRG,-1.5,6,14,2937,9,2015,7,2
Group 5,RRG,-1.5,6,14,2938,12,2015,8,4
Group 5,RRG,-1.5,6,14,2939,11,2015,6,5
Group 5,RRG,-1.5,6,14,2940,6,2015,7,-1
Group 5,RRG,-1.5,6,14,2941,9,2015,5,4
Group 5,RRG,-1.5,6,14,2942,8,2015,4,4
Group 5,RRG,-1.5,6,14,2943,7,2015,8,-1
Group 5,RRG,-1.5,6,14,2944,11,2015,6,5
Group 5,RRG,-1.5,6,14,2945,8,2015,6,2
Group 5,RRG,-1.5,6,14,2946,9,2015,10,-1
Group 5,RRG,-1.5,6,14,2947,11,2015,4,7
Group 5,RRG,-1.5,6,14,2948,7,2015,6,1
Group 5,RRG,-1.5,6,14,2949,8,2015,8,0
Group 5,RRG,-1.5,6,14,2950,8,2015,9,-1
Group 5,RRG,-1.5,6,14,2951,12,2015,6,6
Group 5,RRG,-1.5,6,14,2952,9,2015,9,0
Group 5,RRG,-1.5,6,14,2953,11,2015,9,2
Group 5,RRG,-1.5,6,14,2954,8,2015,3,5
Group 5,RRG,-1.5,6,14,2955,13,2015,6,7
Group 5,RRG,-1.5,6,14,2956,12,2015,5,7
Group 5,RRG,-1.5,6,14,2957,10,2015,10,0
Group 5,RRG,-1.5,6,14,2958,11,2015,7,4
Group 5,RRG,-1.5,6,14,2959,11,2015,6,5
Group 5,RRG,-1.5,6,14,2960,6,2015,5,1
Group 5,RRG,-1.5,6,14,2961,11,2015,7,4
Group 5,RRG,-1.5,6,14,2962,11,2015,7,4
Group 5,RRG,-1.5,6,14,2963,11,2015,9,2
Group 5,RRG,-1.5,6,14,2964,13,2015,8,5
Group 5,RRG,-1.5,6,14,2965,10,2015,7,3
Group 5,RRG,-1.5,6,14,2966,12,2015,7,5
Group 5,RRG,-1.5,6,14,2967,11,2015,6,5
Group 5,RRG,-1.5,6,14,2968,9,2015,6,3
Group 5,RRG,-1.5,6,14,2969,10,2015,10,0
Group 5,RRG,-1.5,6,14,2970,11,2015,4,7
Group 5,RRG,-1.5,6,14,2971,6,2015,8,-2
Group 5,RRG,-1.5,6,14,2972,13,2015,13,0
Group 5,RRG,-1.5,6,14,2973,8,2015,9,-1
Group 5,RRG,-1.5,6,14,2974,7,2015,7,0
Group 5,RRG,-1.5,6,14,2975,9,2015,7,2
Group 5,RRG,-1.5,6,14,2976,4,2015,5,-1
Group 5,RRG,-1.5,6,14,2977,10,2015,9,1
Group 5,RRG,-1.5,6,14,2978,13,2015,5,8
Group 5,RRG,-1.5,6,14,2979,12,2015,4,8
Group 5,RRG,-1.5,6,14,2980,12,2015,9,3
Group 5,RRG,-1.5,6,14,2981,10,2015,0,10
Group 5,RRG,-1.5,6,14,2982,9,2015,1,8
Group 5,RRG,-1.5,6,14,2983,5,2015,8,-3
Group 5,RRG,-1.5,6,14,2984,13,2015,3,10
Group 5,RRG,-1.5,6,14,2985,11,2015,9,2
Group 5,RRG,-1.5,6,14,2986,8,2015,9,-1
Group 5,RRG,-1.5,6,14,2987,10,2015,3,7
Group 5,RRG,-1.5,6,14,2988,7,2015,3,4
Group 5,RRG,-1.5,6,14,2989,8,2015,5,3
Group 5,RRG,-1.5,6,14,2990,8,2015,6,2
Group 5,RRG,-1.5,6,14,2991,7,2015,7,0
Group 5,RRG,-1.5,6,14,2992,12,2015,8,4
Group 5,RRG,-1.5,6,14,2993,12,2015,10,2
Group 5,RRG,-1.5,6,14,2994,3,2015,2,1
Group 5,RRG,-1.5,6,14,2995,7,2015,4,3
Group 5,RRG,-1.5,6,14,2996,8,2015,2,6
Group 5,RRG,-1.5,6,14,2997,11,2015,5,6
Group 5,RRG,-1.5,6,14,2998,10,2015,6,4
Group 5,RRG,-1.5,6,14,2999,8,2015,6,2
Group 5,RRG,-1.5,6,14,3000,6,2015,3,3
Group 5,RRG,-1.5,6,14,3001,8,2015,7,1
Group 5,RRG,-1.5,6,14,3002,5,2015,8,-3
Group 5,RRG,-1.5,6,14,3003,8,2015,4,4
Group 5,RRG,-1.5,6,14,3004,10,2015,11,-1
Group 5,RRG,-1.5,6,14,3005,12,2015,5,7
Group 5,RRG,-1.5,6,14,3006,10,2015,4,6
Group 5,RRG,-1.5,6,14,3007,14,2015,3,11
Group 5,RRG,-1.5,6,14,3008,7,2015,5,2
Group 5,RRG,-1.5,6,14,3009,12,2015,8,4
Group 5,RRG,-1.5,6,14,3010,13,2015,9,4
Group 5,RRG,-1.5,6,14,3011,9,2015,8,1
Group 5,RRG,-1.5,6,14,3012,5,2015,13,-8
Group 5,RRG,-1.5,6,14,3013,9,2015,2,7
Group 5,RRG,-1.5,6,14,3014,10,2015,9,1
Group 5,RRG,-1.5,6,14,3015,13,2015,10,3
Group 5,RRG,-1.5,6,14,3016,11,2015,5,6
Group 5,RRG,-1.5,6,14,3017,11,2015,8,3
Group 5,RRG,-1.5,6,14,3018,4,2015,8,-4
Group 5,RRG,-1.5,6,14,3019,12,2015,8,4
Group 5,RRG,-1.5,6,14,3020,6,2015,8,-2
Group 5,RRG,-1.5,6,14,3021,8,2015,9,-1
Group 5,RRG,-1.5,6,14,3022,13,2015,4,9
Group 5,RRG,-1.5,6,14,3023,12,2015,4,8
Group 5,RRG,-1.5,6,14,3024,10,2015,9,1
Group 5,RRG,-1.5,6,14,3025,9,2015,6,3
Group 5,RRG,-1.5,6,14,3026,9,2015,7,2
Group 5,RRG,-1.5,6,14,3027,10,2015,5,5
Group 5,RRG,-1.5,6,14,3028,10,2015,11,-1
Group 5,RRG,-1.5,6,14,3029,8,2015,5,3
Group 5,RRG,-1.5,6,14,3030,11,2015,8,3
Group 5,RRG,-1.5,6,14,3031,6,2015,7,-1
Group 5,RRG,-1.5,6,14,3032,10,2015,4,6
Group 5,RRG,-1.5,6,14,3033,11,2015,10,1
Group 5,RRG,-1.5,6,14,3034,9,2015,8,1
Group 5,RRG,-1.5,6,14,3035,11,2015,7,4
Group 5,RRG,-1.5,6,14,3036,7,2015,6,1
Group 5,RRG,-1.5,6,14,3037,10,2015,6,4
Group 5,RRG,-1.5,6,14,3038,11,2015,9,2
Group 5,RRG,-1.5,6,14,3039,10,2015,11,-1
Group 5,RRG,-1.5,6,14,3040,9,2015,6,3
Group 5,RRG,-1.5,6,14,3041,6,2015,6,0
Group 5,RRG,-1.5,6,14,3042,11,2015,3,8
Group 5,RRG,-1.5,6,14,3043,11,2015,10,1
Group 5,RRG,-1.5,6,14,3044,12,2015,8,4
Group 5,RRG,-1.5,6,14,3045,6,2015,4,2
Group 5,RRG,-1.5,6,14,3046,8,2015,5,3
Group 5,RRG,-1.5,6,14,3047,11,2015,9,2
Group 5,RRG,-1.5,6,14,3048,7,2015,6,1
Group 5,RRG,-1.5,6,14,3049,7,2015,4,3
Group 5,RRG,-1.5,6,14,3050,9,2015,9,0
Group 5,RRG,-1.5,6,14,3051,11,2015,4,7
Group 5,RRG,-1.5,6,14,3052,11,2015,8,3
Group 5,RRG,-1.5,6,14,3053,13,2015,8,5
Group 5,RRG,-1.5,6,14,3054,9,2015,7,2
Group 5,RRG,-1.5,6,14,3055,9,2015,9,0
Group 5,RRG,-1.5,6,14,3056,13,2015,6,7
Group 5,RRG,-1.5,6,14,3057,11,2015,6,5
Group 5,RRG,-1.5,6,14,3058,11,2015,8,3
Group 5,RRG,-1.5,6,14,3059,13,2015,8,5
Group 5,RRG,-1.5,6,14,3060,7,2015,10,-3
Group 5,RRG,-1.5,6,14,3061,10,2015,8,2
Group 5,RRG,-1.5,6,14,3062,6,2015,5,1
Group 5,RRG,-1.5,6,14,3063,9,2015,7,2
Group 5,RRG,-1.5,6,14,3064,11,2015,7,4
Group 5,RRG,-1.5,6,14,3065,5,2015,9,-4
Group 5,RRG,-1.5,6,14,3066,10,2015,7,3
Group 5,RRG,-1.5,6,14,3067,4,2015,8,-4
Group 5,RRG,-1.5,6,14,3068,9,2015,4,5
Group 5,RRG,-1.5,6,14,3069,8,2015,8,0
Group 5,RRG,-1.5,6,14,3070,11,2015,5,6
Group 5,RRG,-1.5,6,14,3071,10,2015,7,3
Group 5,RRG,-1.5,6,14,3072,6,2015,8,-2
Group 5,RRG,-1.5,6,14,3073,8,2015,8,0
Group 5,RRG,-1.5,6,14,3074,8,2015,8,0
Group 5,RRG,-1.5,6,14,3075,9,2015,6,3
Group 5,RRG,-1.5,6,14,3076,10,2015,2,8
Group 5,RRG,-1.5,6,14,3077,6,2015,4,2
Group 5,RRG,-1.5,6,14,3078,4,2015,6,-2
Group 5,RRG,-1.5,6,14,3079,5,2015,8,-3
Group 5,RRG,-1.5,6,14,3080,10,2015,6,4
Group 5,RRG,-1.5,6,14,3081,8,2015,10,-2
Group 5,RRG,-1.5,6,14,3082,9,2015,8,1
Group 5,RRG,-1.5,6,14,3083,14,2015,5,9
Group 5,RRG,-1.5,6,14,3084,3,2015,7,-4
Group 5,RRG,-1.5,6,14,3085,10,2015,8,2
Group 5,RRG,-1.5,6,14,3086,11,2015,6,5
Group 5,RRG,-1.5,6,14,3087,11,2015,8,3
Group 5,RRG,-1.5,6,14,3088,5,2015,8,-3
Group 5,RRG,-1.5,6,14,3089,11,2015,6,5
Group 5,RRG,-1.5,6,14,3090,9,2015,9,0
Group 5,RRG,-1.5,6,14,3091,6,2015,8,-2
Group 5,RRG,-1.5,6,14,3092,8,2015,7,1
Group 5,RRG,-1.5,6,14,3093,14,2015,9,5
Group 5,RRG,-1.5,6,14,3094,7,2015,7,0
Group 5,RRG,-1.5,6,14,3095,4,2015,12,-8
Group 5,RRG,-1.5,6,14,3096,10,2015,2,8
Group 5,RRG,-1.5,6,14,3097,8,2015,11,-3
Group 5,RRG,-1.5,6,14,3098,10,2015,5,5
Group 5,RRG,-1.5,6,14,3099,8,2015,8,0
Group 5,RRG,-1.5,6,14,3100,6,2015,6,0
Group 5,RRG,-1.5,6,14,3101,12,2015,8,4
Group 5,RRG,-1.5,6,14,3102,6,2015,8,-2
Group 5,RRG,-1.5,6,14,3103,10,2015,3,7
Group 5,RRG,-1.5,6,14,3104,9,2015,9,0
Group 5,RRG,-1.5,6,14,3105,8,2015,9,-1
Group 5,RRG,-1.5,6,14,3106,8,2015,6,2
Group 5,RRG,-1.5,6,14,3107,8,2015,8,0
Group 5,RRG,-1.5,6,14,3108,11,2015,9,2
Group 5,RRG,-1.5,6,14,3109,12,2015,11,1
Group 5,RRG,-1.5,6,14,3110,8,2015,3,5
Group 5,RRG,-1.5,6,14,3111,10,2015,7,3
Group 5,RRG,-1.5,6,14,3112,7,2015,3,4
Group 5,RRG,-1.5,6,14,3113,10,2015,5,5
Group 5,RRG,-1.5,6,14,3114,13,2015,9,4
Group 5,RRG,-1.5,6,14,3115,12,2015,4,8
Group 5,RRG,-1.5,6,14,3116,7,2015,4,3
Group 5,RRG,-1.5,6,14,3117,10,2015,5,5
Group 5,RRG,-1.5,6,14,3118,14,2015,9,5
Group 5,RRG,-1.5,6,14,3119,9,2015,7,2
Group 5,RRG,-1.5,6,14,3120,12,2015,7,5
Group 5,RRG,-1.5,6,14,3121,9,2015,6,3
Group 5,RRG,-1.5,6,14,3122,11,2015,2,9
Group 5,RRG,-1.5,6,14,3123,9,2015,7,2
Group 5,RRG,-1.5,6,14,3124,7,2015,10,-3
Group 5,RRG,-1.5,6,14,3125,8,2015,8,0
Group 5,RRG,-1.5,6,14,3126,13,2015,3,10
Group 5,RRG,-1.5,6,14,3127,12,2015,6,6
Group 5,RRG,-1.5,6,14,3128,11,2015,6,5
Group 5,RRG,-1.5,6,14,3129,13,2015,4,9
Group 5,RRG,-1.5,6,14,3130,10,2015,4,6
Group 5,RRG,-1.5,6,14,3131,9,2015,8,1
Group 5,RRG,-1.5,6,14,3132,13,2015,8,5
Group 5,RRG,-1.5,6,14,3133,12,2015,7,5
Group 5,RRG,-1.5,6,14,3134,13,2015,8,5
Group 5,RRG,-1.5,6,14,3135,11,2015,6,5
Group 5,RRG,-1.5,6,14,3136,9,2015,2,7
Group 5,RRG,-1.5,6,14,3137,9,2015,5,4
Group 5,RRG,-1.5,6,14,3138,13,2015,9,4
Group 5,RRG,-1.5,6,14,3139,10,2015,3,7
Group 5,RRG,-1.5,6,14,3140,9,2015,7,2
Group 5,RRG,-1.5,6,14,3141,10,2015,7,3
Group 5,RRG,-1.5,6,14,3142,10,2015,5,5
Group 5,RRG,-1.5,6,14,3143,14,2015,5,9
Group 5,RRG,-1.5,6,14,3144,9,2015,9,0
Group 5,RRG,-1.5,6,14,3145,9,2015,10,-1
Group 5,RRG,-1.5,6,14,3146,10,2015,9,1
Group 5,RRG,-1.5,6,14,3147,8,2015,6,2
Group 5,RRG,-1.5,6,14,3148,3,2015,7,-4
Group 5,RRG,-1.5,6,14,3149,11,2015,7,4
Group 5,RRG,-1.5,6,14,3150,7,2015,7,0
Group 5,RRG,-1.5,6,14,3151,8,2015,7,1
Group 5,RRG,-1.5,6,14,3152,11,2015,3,8
Group 5,RRG,-1.5,6,14,3153,12,2015,6,6
Group 5,RRG,-1.5,6,14,3154,11,2015,6,5
Group 5,RRG,-1.5,6,14,3155,9,2015,10,-1
Group 5,RRG,-1.5,6,14,3156,13,2015,10,3
Group 5,RRG,-1.5,6,14,3157,4,2015,11,-7
Group 5,RRG,-1.5,6,14,3158,11,2015,4,7
Group 5,RRG,-1.5,6,14,3159,11,2015,5,6
Group 5,RRG,-1.5,6,14,3160,9,2015,7,2
Group 5,RRG,-1.5,6,14,3161,8,2015,8,0
Group 5,RRG,-1.5,6,14,3162,5,2015,9,-4
Group 5,RRG,-1.5,6,14,3163,5,2015,9,-4
Group 5,RRG,-1.5,6,14,3164,12,2015,9,3
Group 5,RRG,-1.5,6,14,3165,11,2015,9,2
Group 5,RRG,-1.5,6,14,3166,13,2015,6,7
Group 5,RRG,-1.5,6,14,3167,3,2015,3,0
Group 5,RRG,-1.5,6,14,3168,9,2015,6,3
Group 5,RRG,-1.5,6,14,3169,11,2015,11,0
Group 5,RRG,-1.5,6,14,3170,7,2015,12,-5
Group 5,RRG,-1.5,6,14,3171,13,2015,4,9
Group 5,RRG,-1.5,6,14,3172,10,2015,8,2
Group 5,RRG,-1.5,6,14,3173,11,2015,8,3
Group 5,RRG,-1.5,6,14,3174,12,2015,9,3
Group 5,RRG,-1.5,6,14,3175,10,2015,11,-1
Group 5,RRG,-1.5,6,14,3176,13,2015,6,7
Group 5,RRG,-1.5,6,14,3177,13,2015,7,6
Group 5,RRG,-1.5,6,14,3178,7,2015,8,-1
Group 5,RRG,-1.5,6,14,3179,12,2015,7,5
Group 5,RRG,-1.5,6,14,3180,11,2015,8,3
Group 5,RRG,-1.5,6,14,3181,10,2015,3,7
Group 5,RRG,-1.5,6,14,3182,12,2015,10,2
Group 5,RRG,-1.5,6,14,3183,9,2015,6,3
Group 5,RRG,-1.5,6,14,3184,9,2015,10,-1
Group 5,RRG,-1.5,6,14,3185,12,2015,10,2
Group 5,RRG,-1.5,6,14,3186,8,2015,7,1
Group 5,RRG,-1.5,6,14,3187,8,2015,5,3
Group 5,RRG,-1.5,6,14,3188,13,2015,8,5
Group 5,RRG,-1.5,6,14,3189,11,2015,5,6
Group 5,RRG,-1.5,6,14,3190,9,2015,5,4
Group 5,RRG,-1.5,6,14,3191,9,2015,8,1
Group 5,RRG,-1.5,6,14,3192,6,2015,7,-1
Group 5,RRG,-1.5,6,14,3193,9,2015,4,5
Group 5,RRG,-1.5,6,14,3194,11,2015,9,2
Group 5,RRG,-1.5,6,14,3195,9,2015,5,4
Group 5,RRG,-1.5,6,14,3196,8,2015,7,1
Group 5,RRG,-1.5,6,14,3197,10,2015,6,4
Group 5,RRG,-1.5,6,14,3198,10,2015,3,7
Group 5,RRG,-1.5,6,14,3199,9,2015,10,-1
Group 5,RRG,-1.5,6,14,3200,14,2015,6,8
Group 5,RRG,-1.5,6,14,3201,8,2015,7,1
Group 5,RRG,-1.5,6,14,3202,11,2015,5,6
Group 5,RRG,-1.5,6,14,3203,12,2015,11,1
Group 5,RRG,-1.5,6,14,3204,12,2015,8,4
Group 5,RRG,-1.5,6,14,3205,10,2015,4,6
Group 5,RRG,-1.5,6,14,3206,10,2015,6,4
Group 5,RRG,-1.5,6,14,3207,9,2015,7,2
Group 5,RRG,-1.5,6,14,3208,8,2015,3,5
Group 5,RRG,-1.5,6,14,3209,13,2015,13,0
Group 5,RRG,-1.5,6,14,3210,11,2015,5,6
Group 5,RRG,-1.5,6,14,3211,8,2015,10,-2
Group 5,RRG,-1.5,6,14,3212,10,2015,6,4
Group 5,RRG,-1.5,6,14,3213,11,2015,8,3
Group 5,RRG,-1.5,6,14,3214,9,2015,6,3
Group 5,RRG,-1.5,6,14,3215,6,2015,9,-3
Group 5,RRG,-1.5,6,14,3216,9,2015,8,1
Group 5,RRG,-1.5,6,14,3217,9,2015,9,0
Group 5,RRG,-1.5,6,14,3218,9,2015,6,3
Group 5,RRG,-1.5,6,14,3219,12,2015,7,5
Group 5,RRG,-1.5,6,14,3220,10,2015,7,3
Group 5,RRG,-1.5,6,14,3221,11,2015,6,5
Group 5,RRG,-1.5,6,14,3222,5,2015,7,-2
Group 5,RRG,-1.5,6,14,3223,13,2015,6,7
Group 5,RRG,-1.5,6,14,3224,9,2015,6,3
Group 5,RRG,-1.5,6,14,3225,7,2015,1,6
Group 5,RRG,-1.5,6,14,3226,8,2015,8,0
Group 5,RRG,-1.5,6,14,3227,13,2015,13,0
Group 5,RRG,-1.5,6,14,3228,8,2015,7,1
Group 5,RRG,-1.5,6,14,3229,8,2015,5,3
Group 5,RRG,-1.5,6,14,3230,7,2015,7,0
Group 5,RRG,-1.5,6,14,3231,14,2015,8,6
Group 5,RRG,-1.5,6,14,3232,11,2015,5,6
Group 5,RRG,-1.5,6,14,3233,14,2015,12,2
Group 5,RRG,-1.5,6,14,3234,8,2015,5,3
Group 5,RRG,-1.5,6,14,3235,12,2015,9,3
Group 5,RRG,-1.5,6,14,3236,9,2015,8,1
Group 5,RRG,-1.5,6,14,3237,11,2015,9,2
Group 5,RRG,-1.5,6,14,3238,8,2015,14,-6
Group 5,RRG,-1.5,6,14,3239,12,2015,8,4
Group 5,RRG,-1.5,6,14,3240,10,2015,10,0
Group 5,RRG,-1.5,6,14,3241,14,2015,6,8
Group 5,RRG,-1.5,6,14,3242,8,2015,8,0
Group 5,RRG,-1.5,6,14,3243,7,2015,3,4
Group 5,RRG,-1.5,6,14,3244,6,2015,7,-1
Group 5,RRG,-1.5,6,14,3245,11,2015,7,4
Group 5,RRG,-1.5,6,14,3246,13,2015,8,5
Group 5,RRG,-1.5,6,14,3247,8,2015,10,-2
Group 5,RRG,-1.5,6,14,3248,14,2015,9,5
Group 5,RRG,-1.5,6,14,3249,9,2015,7,2
Group 5,RRG,-1.5,6,14,3250,8,2015,7,1
Group 5,RRG,-1.5,6,14,3251,12,2015,8,4
Group 5,RRG,-1.5,6,14,3252,4,2015,5,-1
Group 5,RRG,-1.5,6,14,3253,9,2015,7,2
Group 5,RRG,-1.5,6,14,3254,10,2015,7,3
Group 5,RRG,-1.5,6,14,3255,9,2015,7,2
Group 5,RRG,-1.5,6,14,3256,12,2015,5,7
Group 5,RRG,-1.5,6,14,3257,9,2015,6,3
Group 5,RRG,-1.5,6,14,3258,11,2015,6,5
Group 5,RRG,-1.5,6,14,3259,10,2015,6,4
Group 5,RRG,-1.5,6,14,3260,6,2015,8,-2
Group 5,RRG,-1.5,6,14,3261,9,2015,4,5
Group 5,RRG,-1.5,6,14,3262,7,2015,8,-1
Group 5,RRG,-1.5,6,14,3263,9,2015,8,1
Group 5,RRG,-1.5,6,14,3264,9,2015,9,0
Group 5,RRG,-1.5,6,14,3265,8,2015,5,3
Group 5,RRG,-1.5,6,14,3266,8,2015,6,2
Group 5,RRG,-1.5,6,14,3267,10,2015,6,4
Group 5,RRG,-1.5,6,14,3268,12,2015,7,5
Group 5,RRG,-1.5,6,14,3269,7,2015,9,-2
Group 5,RRG,-1.5,6,14,3270,6,2015,7,-1
Group 5,RRG,-1.5,6,14,3271,7,2015,6,1
Group 5,RRG,-1.5,6,14,3272,8,2015,9,-1
Group 5,RRG,-1.5,6,14,3273,10,2015,10,0
Group 5,RRG,-1.5,6,14,3274,11,2015,10,1
Group 5,RRG,-1.5,6,14,3275,13,2015,10,3
Group 5,RRG,-1.5,6,14,3276,9,2015,6,3
Group 5,RRG,-1.5,6,14,3277,10,2015,5,5
Group 5,RRG,-1.5,6,14,3278,10,2015,6,4
Group 5,RRG,-1.5,6,14,3279,10,2015,6,4
Group 5,RRG,-1.5,6,14,3280,13,2015,5,8
Group 5,RRG,-1.5,6,14,3281,6,2015,9,-3
Group 5,RRG,-1.5,6,14,3282,12,2015,5,7
Group 5,RRG,-1.5,6,14,3283,14,2015,6,8
Group 5,RRG,-1.5,6,14,3284,10,2015,6,4
Group 5,RRG,-1.5,6,14,3285,7,2015,7,0
Group 5,RRG,-1.5,6,14,3286,10,2015,5,5
Group 5,RRG,-1.5,6,14,3287,11,2015,5,6
Group 5,RRG,-1.5,6,14,3288,9,2015,11,-2
Group 5,RRG,-1.5,6,14,3289,11,2015,11,0
Group 5,RRG,-1.5,6,14,3290,11,2015,3,8
Group 5,RRG,-1.5,6,14,3291,8,2015,5,3
Group 5,RRG,-1.5,6,14,3292,9,2015,0,9
Group 5,RRG,-1.5,6,14,3293,11,2015,6,5
Group 5,RRG,-1.5,6,14,3294,11,2015,6,5
Group 5,RRG,-1.5,6,14,3295,7,2015,6,1
Group 5,RRG,-1.5,6,14,3296,11,2015,6,5
Group 5,RRG,-1.5,6,14,3297,10,2015,4,6
Group 5,RRG,-1.5,6,14,3298,12,2015,8,4
Group 5,RRG,-1.5,6,14,3299,11,2015,6,5
Group 5,RRG,-1.5,6,14,3300,8,2015,11,-3
Group 5,RRG,-1.5,6,14,3301,7,2015,4,3
Group 5,RRG,-1.5,6,14,3302,8,2015,10,-2
Group 5,RRG,-1.5,6,14,3303,11,2015,4,7
Group 5,RRG,-1.5,6,14,3304,7,2015,7,0
Group 5,RRG,-1.5,6,14,3305,13,2015,6,7
Group 5,RRG,-1.5,6,14,3306,9,2015,1,8
Group 5,RRG,-1.5,6,14,3307,7,2015,11,-4
Group 5,RRG,-1.5,6,14,3308,3,2015,4,-1
Group 5,RRG,-1.5,6,14,3309,11,2015,7,4
Group 5,RRG,-1.5,6,14,3310,6,2015,10,-4
Group 5,RRG,-1.5,6,14,3311,10,2015,5,5
Group 5,RRG,-1.5,6,14,3312,10,2015,2,8
Group 5,RRG,-1.5,6,14,3313,4,2015,4,0
Group 5,RRG,-1.5,6,14,3314,11,2015,5,6
Group 5,RRG,-1.5,6,14,3315,10,2015,7,3
Group 5,RRG,-1.5,6,14,3316,6,2015,8,-2
Group 5,RRG,-1.5,6,14,3317,9,2015,6,3
Group 5,RRG,-1.5,6,14,3318,8,2015,6,2
Group 5,RRG,-1.5,6,14,3319,11,2015,5,6
Group 5,RRG,-1.5,6,14,3320,7,2015,5,2
Group 5,RRG,-1.5,6,14,3321,4,2015,9,-5
Group 5,RRG,-1.5,6,14,3322,8,2015,7,1
Group 5,RRG,-1.5,6,14,3323,12,2015,8,4
Group 5,RRG,-1.5,6,14,3324,3,2015,6,-3
Group 5,RRG,-1.5,6,14,3325,13,2015,4,9
Group 5,RRG,-1.5,6,14,3326,8,2015,7,1
Group 5,RRG,-1.5,6,14,3327,8,2015,4,4
Group 5,RRG,-1.5,6,14,3328,6,2015,7,-1
Group 5,RRG,-1.5,6,14,3329,11,2015,8,3
Group 5,RRG,-1.5,6,14,3330,8,2015,11,-3
Group 5,RRG,-1.5,6,14,3331,10,2015,9,1
Group 5,RRG,-1.5,6,14,3332,12,2015,6,6
Group 5,RRG,-1.5,6,14,3333,6,2015,7,-1
Group 5,RRG,-1.5,6,14,3334,9,2015,3,6
Group 5,RRG,-1.5,6,14,3335,10,2015,3,7
Group 5,RRG,-1.5,6,14,3336,9,2015,8,1
Group 5,RRG,-1.5,6,14,3337,11,2015,6,5
Group 5,RRG,-1.5,6,14,3338,11,2015,7,4
Group 5,RRG,-1.5,6,14,3339,9,2015,5,4
Group 5,RRG,-1.5,6,14,3340,10,2015,4,6
Group 5,RRG,-1.5,6,14,3341,10,2015,10,0
Group 5,RRG,-1.5,6,14,3342,8,2015,4,4
Group 5,RRG,-1.5,6,14,3343,10,2015,5,5
Group 5,RRG,-1.5,6,14,3344,7,2015,7,0
Group 5,RRG,-1.5,6,14,3345,10,2015,7,3
Group 5,RRG,-1.5,6,14,3346,13,2015,7,6
Group 5,RRG,-1.5,6,14,3347,10,2015,11,-1
Group 5,RRG,-1.5,6,14,3348,11,2015,6,5
Group 5,RRG,-1.5,6,14,3349,8,2015,5,3
Group 5,RRG,-1.5,6,14,3350,3,2015,7,-4
Group 5,RRG,-1.5,6,14,3351,8,2015,11,-3
Group 5,RRG,-1.5,6,14,3352,11,2015,6,5
Group 5,RRG,-1.5,6,14,3353,12,2015,5,7
Group 5,RRG,-1.5,6,14,3354,8,2015,5,3
Group 5,RRG,-1.5,6,14,3355,12,2015,8,4
Group 5,RRG,-1.5,6,14,3356,8,2015,6,2
Group 5,RRG,-1.5,6,14,3357,8,2015,12,-4
Group 5,RRG,-1.5,6,14,3358,8,2015,5,3
Group 5,RRG,-1.5,6,14,3359,5,2015,7,-2
Group 5,RRG,-1.5,6,14,3360,8,2015,6,2
Group 5,RRG,-1.5,6,14,3361,9,2015,9,0
Group 5,RRG,-1.5,6,14,3362,5,2015,10,-5
Group 5,RRG,-1.5,6,14,3363,6,2015,6,0
Group 5,RRG,-1.5,6,14,3364,8,2015,8,0
Group 5,RRG,-1.5,6,14,3365,8,2015,6,2
Group 5,RRG,-1.5,6,14,3366,9,2015,8,1
Group 5,RRG,-1.5,6,14,3367,11,2015,5,6
Group 5,RRG,-1.5,6,14,3368,10,2015,6,4
Group 5,RRG,-1.5,6,14,3369,10,2015,6,4
Group 5,RRG,-1.5,6,14,3370,10,2015,7,3
Group 5,RRG,-1.5,6,14,3371,11,2015,6,5
Group 5,RRG,-1.5,6,14,3372,9,2015,6,3
Group 5,RRG,-1.5,6,14,3373,7,2015,8,-1
Group 5,RRG,-1.5,6,14,3374,10,2015,9,1
Group 5,RRG,-1.5,6,14,3375,9,2015,6,3
Group 5,RRG,-1.5,6,14,3376,6,2015,7,-1
Group 5,RRG,-1.5,6,14,3377,9,2015,5,4
Group 5,RRG,-1.5,6,14,3378,13,2015,7,6
Group 5,RRG,-1.5,6,14,3379,11,2015,4,7
Group 5,RRG,-1.5,6,14,3380,10,2015,12,-2
Group 5,RRG,-1.5,6,14,3381,6,2015,11,-5
Group 5,RRG,-1.5,6,14,3382,7,2015,8,-1
Group 5,RRG,-1.5,6,14,3383,8,2015,7,1
Group 5,RRG,-1.5,6,14,3384,13,2015,8,5
Group 5,RRG,-1.5,6,14,3385,10,2015,11,-1
Group 5,RRG,-1.5,6,14,3386,8,2015,7,1
Group 5,RRG,-1.5,6,14,3387,11,2015,6,5
Group 5,RRG,-1.5,6,14,3388,11,2015,7,4
Group 5,RRG,-1.5,6,14,3389,13,2015,5,8
Group 5,RRG,-1.5,6,14,3390,11,2015,12,-1
Group 5,RRG,-1.5,6,14,3391,12,2015,10,2
Group 5,RRG,-1.5,6,14,3392,12,2015,10,2
Group 5,RRG,-1.5,6,14,3393,7,2015,10,-3
Group 5,RRG,-1.5,6,14,3394,7,2015,8,-1
Group 5,RRG,-1.5,6,14,3395,8,2015,8,0
Group 5,RRG,-1.5,6,14,3396,10,2015,8,2
Group 5,RRG,-1.5,6,14,3397,10,2015,8,2
Group 5,RRG,-1.5,6,14,3398,9,2015,5,4
Group 5,RRG,-1.5,6,14,3399,9,2015,4,5
Group 5,RRG,-1.5,6,14,3400,13,2015,9,4
Group 5,RRG,-1.5,6,14,3401,12,2015,6,6
Group 5,RRG,-1.5,6,14,3402,7,2015,7,0
Group 5,RRG,-1.5,6,14,3403,8,2015,5,3
Group 5,RRG,-1.5,6,14,3404,9,2015,4,5
Group 5,RRG,-1.5,6,14,3405,8,2015,4,4
Group 5,RRG,-1.5,6,14,3406,11,2015,6,5
Group 5,RRG,-1.5,6,14,3407,11,2015,4,7
Group 5,RRG,-1.5,6,14,3408,5,2015,5,0
Group 5,RRG,-1.5,6,14,3409,6,2015,6,0
Group 5,RRG,-1.5,6,14,3410,13,2015,7,6
Group 5,RRG,-1.5,6,14,3411,9,2015,5,4
Group 5,RRG,-1.5,6,14,3412,13,2015,6,7
Group 5,RRG,-1.5,6,14,3413,12,2015,8,4
Group 5,RRG,-1.5,6,14,3414,7,2015,7,0
Group 5,RRG,-1.5,6,14,3415,8,2015,9,-1
Group 5,RRG,-1.5,6,14,3416,10,2015,7,3
Group 5,RRG,-1.5,6,14,3417,11,2015,7,4
Group 5,RRG,-1.5,6,14,3418,5,2015,3,2
Group 5,RRG,-1.5,6,14,3419,10,2015,5,5
Group 5,RRG,-1.5,6,14,3420,7,2015,9,-2
Group 5,RRG,-1.5,6,14,3421,11,2015,6,5
Group 5,RRG,-1.5,6,14,3422,9,2015,6,3
Group 5,RRG,-1.5,6,14,3423,8,2015,9,-1
Group 5,RRG,-1.5,6,14,3424,9,2015,11,-2
Group 5,RRG,-1.5,6,14,3425,14,2015,13,1
Group 5,RRG,-1.5,6,14,3426,12,2015,5,7
Group 5,RRG,-1.5,6,14,3427,10,2015,7,3
Group 5,RRG,-1.5,6,14,3428,12,2015,1,11
Group 5,RRG,-1.5,6,14,3429,4,2015,6,-2
Group 5,RRG,-1.5,6,14,3430,10,2015,7,3
Group 5,RRG,-1.5,6,14,3431,12,2015,9,3
Group 5,RRG,-1.5,6,14,3432,8,2015,2,6
Group 5,RRG,-1.5,6,14,3433,11,2015,6,5
Group 5,RRG,-1.5,6,14,3434,13,2015,6,7
Group 5,RRG,-1.5,6,14,3435,9,2015,2,7
Group 5,RRG,-1.5,6,14,3436,8,2015,10,-2
Group 5,RRG,-1.5,6,14,3437,9,2015,9,0
Group 5,RRG,-1.5,6,14,3438,10,2015,6,4
Group 5,RRG,-1.5,6,14,3439,13,2015,8,5
Group 5,RRG,-1.5,6,14,3440,12,2015,6,6
Group 5,RRG,-1.5,6,14,3441,9,2015,7,2
Group 5,RRG,-1.5,6,14,3442,9,2015,6,3
Group 5,RRG,-1.5,6,14,3443,11,2015,6,5
Group 5,RRG,-1.5,6,14,3444,6,2015,10,-4
Group 5,RRG,-1.5,6,14,3445,11,2015,7,4
Group 5,RRG,-1.5,6,14,3446,10,2015,5,5
Group 5,RRG,-1.5,6,14,3447,7,2015,9,-2
Group 5,RRG,-1.5,6,14,3448,10,2015,7,3
Group 5,RRG,-1.5,6,14,3449,12,2015,6,6
Group 5,RRG,-1.5,6,14,3450,8,2015,7,1
Group 5,RRG,-1.5,6,14,3451,9,2015,7,2
Group 5,RRG,-1.5,6,14,3452,11,2015,3,8
Group 5,RRG,-1.5,6,14,3453,10,2015,7,3
Group 5,RRG,-1.5,6,14,3454,13,2015,5,8
Group 5,RRG,-1.5,6,14,3455,12,2015,7,5
Group 5,RRG,-1.5,6,14,3456,9,2015,8,1
Group 5,RRG,-1.5,6,14,3457,9,2015,2,7
Group 5,RRG,-1.5,6,14,3458,8,2015,3,5
Group 5,RRG,-1.5,6,14,3459,12,2015,11,1
Group 5,RRG,-1.5,6,14,3460,14,2015,9,5
Group 5,RRG,-1.5,6,14,3461,8,2015,7,1
Group 5,RRG,-1.5,6,14,3462,8,2015,5,3
Group 5,RRG,-1.5,6,14,3463,10,2015,4,6
Group 5,RRG,-1.5,6,14,3464,11,2015,5,6
Group 5,RRG,-1.5,6,14,3465,10,2015,7,3
Group 5,RRG,-1.5,6,14,3466,7,2015,9,-2
Group 5,RRG,-1.5,6,14,3467,9,2015,9,0
Group 5,RRG,-1.5,6,14,3468,9,2015,6,3
Group 5,RRG,-1.5,6,14,3469,9,2015,8,1
Group 5,RRG,-1.5,6,14,3470,9,2015,9,0
Group 5,RRG,-1.5,6,14,3471,13,2015,9,4
Group 5,RRG,-1.5,6,14,3472,9,2015,8,1
Group 5,RRG,-1.5,6,14,3473,9,2015,9,0
Group 5,RRG,-1.5,6,14,3474,11,2015,5,6
Group 5,RRG,-1.5,6,14,3475,10,2015,8,2
Group 5,RRG,-1.5,6,14,3476,13,2015,7,6
Group 5,RRG,-1.5,6,14,3477,12,2015,3,9
Group 5,RRG,-1.5,6,14,3478,9,2015,4,5
Group 5,RRG,-1.5,6,14,3479,9,2015,7,2
Group 5,RRG,-1.5,6,14,3480,11,2015,9,2
Group 5,RRG,-1.5,6,14,3481,9,2015,7,2
Group 5,RRG,-1.5,6,14,3482,9,2015,8,1
Group 5,RRG,-1.5,6,14,3483,9,2015,5,4
Group 5,RRG,-1.5,6,14,3484,7,2015,11,-4
Group 5,RRG,-1.5,6,14,3485,11,2015,9,2
Group 5,RRG,-1.5,6,14,3486,10,2015,5,5
Group 5,RRG,-1.5,6,14,3487,12,2015,5,7
Group 5,RRG,-1.5,6,14,3488,4,2015,3,1
Group 5,RRG,-1.5,6,14,3489,10,2015,8,2
Group 5,RRG,-1.5,6,14,3490,9,2015,3,6
Group 5,RRG,-1.5,6,14,3491,11,2015,7,4
Group 5,RRG,-1.5,6,14,3492,9,2015,9,0
Group 5,RRG,-1.5,6,14,3493,10,2015,10,0
Group 5,RRG,-1.5,6,14,3494,7,2015,6,1
Group 5,RRG,-1.5,6,14,3495,6,2015,8,-2
Group 5,RRG,-1.5,6,14,3496,6,2015,8,-2
Group 5,RRG,-1.5,6,14,3497,6,2015,6,0
Group 5,RRG,-1.5,6,14,3498,10,2015,8,2
Group 5,RRG,-1.5,6,14,3499,8,2015,4,4
Group 5,RRG,-1.5,6,14,3500,9,2015,10,-1
Group 5,RRG,-1.5,6,14,3501,8,2015,5,3
Group 5,RRG,-1.5,6,14,3502,10,2015,11,-1
Group 5,RRG,-1.5,6,14,3503,14,2015,9,5
Group 5,RRG,-1.5,6,14,3504,9,2015,6,3
Group 5,RRG,-1.5,6,14,3505,8,2015,1,7
Group 5,RRG,-1.5,6,14,3506,11,2015,7,4
Group 5,RRG,-1.5,6,14,3507,12,2015,4,8
Group 5,RRG,-1.5,6,14,3508,12,2015,5,7
Group 5,RRG,-1.5,6,14,3509,11,2015,5,6
Group 5,RRG,-1.5,6,14,3510,13,2015,5,8
Group 5,RRG,-1.5,6,14,3511,11,2015,11,0
Group 5,RRG,-1.5,6,14,3512,9,2015,5,4
Group 5,RRG,-1.5,6,14,3513,11,2015,9,2
Group 5,RRG,-1.5,6,14,3514,10,2015,6,4
Group 5,RRG,-1.5,6,14,3515,11,2015,5,6
Group 5,RRG,-1.5,6,14,3516,11,2015,7,4
Group 5,RRG,-1.5,6,14,3517,9,2015,5,4
Group 5,RRG,-1.5,6,14,3518,7,2015,6,1
Group 5,RRG,-1.5,6,14,3519,10,2015,5,5
Group 5,RRG,-1.5,6,14,3520,12,2015,8,4
Group 5,RRG,-1.5,6,14,3521,12,2015,3,9
Group 5,RRG,-1.5,6,14,3522,13,2015,5,8
Group 5,RRG,-1.5,6,14,3523,13,2015,3,10
Group 5,RRG,-1.5,6,14,3524,10,2015,3,7
Group 5,RRG,-1.5,6,14,3525,5,2015,10,-5
Group 5,RRG,-1.5,6,14,3526,11,2015,4,7
Group 5,RRG,-1.5,6,14,3527,13,2015,7,6
Group 5,RRG,-1.5,6,14,3528,9,2015,9,0
Group 5,RRG,-1.5,6,14,3529,10,2015,3,7
Group 5,RRG,-1.5,6,14,3530,14,2015,8,6
Group 5,RRG,-1.5,6,14,3531,13,2015,11,2
Group 5,RRG,-1.5,6,14,3532,10,2015,13,-3
Group 5,RRG,-1.5,6,14,3533,9,2015,5,4
Group 5,RRG,-1.5,6,14,3534,10,2015,3,7
Group 5,RRG,-1.5,6,14,3535,13,2015,10,3
Group 5,RRG,-1.5,6,14,3536,12,2015,13,-1
Group 5,RRG,-1.5,6,14,3537,12,2015,8,4
Group 5,RRG,-1.5,6,14,3538,8,2015,11,-3
Group 5,RRG,-1.5,6,14,3539,6,2015,3,3
Group 5,RRG,-1.5,6,14,3540,4,2015,4,0
Group 5,RRG,-1.5,6,14,3541,11,2015,6,5
Group 5,RRG,-1.5,6,14,3542,10,2015,8,2
Group 5,RRG,-1.5,6,14,3543,9,2015,5,4
Group 5,RRG,-1.5,6,14,3544,8,2015,5,3
Group 5,RRG,-1.5,6,14,3545,13,2015,8,5
Group 5,RRG,-1.5,6,14,3546,13,2015,8,5
Group 5,RRG,-1.5,6,14,3547,7,2015,5,2
Group 5,RRG,-1.5,6,14,3548,6,2015,5,1
Group 5,RRG,-1.5,6,14,3549,11,2015,6,5
Group 5,RRG,-1.5,6,14,3550,10,2015,10,0
Group 5,RRG,-1.5,6,14,3551,9,2015,3,6
Group 5,RRG,-1.5,6,14,3552,7,2015,3,4
Group 5,RRG,-1.5,6,14,3553,8,2015,1,7
Group 5,RRG,-1.5,6,14,3554,10,2015,6,4
Group 5,RRG,-1.5,6,14,3555,11,2015,6,5
Group 5,RRG,-1.5,6,14,3556,10,2015,5,5
Group 5,RRG,-1.5,6,14,3557,10,2015,7,3
Group 5,RRG,-1.5,6,14,3558,9,2015,10,-1
Group 5,RRG,-1.5,6,14,3559,11,2015,6,5
Group 5,RRG,-1.5,6,14,3560,10,2015,8,2
Group 5,RRG,-1.5,6,14,3561,10,2015,6,4
Group 5,RRG,-1.5,6,14,3562,13,2015,6,7
Group 5,RRG,-1.5,6,14,3563,6,2015,6,0
Group 5,RRG,-1.5,6,14,3564,6,2015,3,3
Group 5,RRG,-1.5,6,14,3565,11,2015,8,3
Group 5,RRG,-1.5,6,14,3566,6,2015,4,2
Group 5,RRG,-1.5,6,14,3567,12,2015,11,1
Group 5,RRG,-1.5,6,14,3568,10,2015,10,0
Group 5,RRG,-1.5,6,14,3569,9,2015,9,0
Group 5,RRG,-1.5,6,14,3570,8,2015,7,1
Group 5,RRG,-1.5,6,14,3571,11,2015,12,-1
Group 5,RRG,-1.5,6,14,3572,7,2015,8,-1
Group 5,RRG,-1.5,6,14,3573,6,2015,9,-3
Group 5,RRG,-1.5,6,14,3574,11,2015,9,2
Group 5,RRG,-1.5,6,14,3575,11,2015,7,4
Group 5,RRG,-1.5,6,14,3576,12,2015,3,9
Group 5,RRG,-1.5,6,14,3577,6,2015,8,-2
Group 5,RRG,-1.5,6,14,3578,13,2015,7,6
Group 5,RRG,-1.5,6,14,3579,7,2015,5,2
Group 5,RRG,-1.5,6,14,3580,8,2015,7,1
Group 5,RRG,-1.5,6,14,3581,5,2015,8,-3
Group 5,RRG,-1.5,6,14,3582,5,2015,2,3
Group 5,RRG,-1.5,6,14,3583,11,2015,3,8
Group 5,RRG,-1.5,6,14,3584,6,2015,7,-1
Group 5,RRG,-1.5,6,14,3585,8,2015,8,0
Group 5,RRG,-1.5,6,14,3586,11,2015,10,1
Group 5,RRG,-1.5,6,14,3587,8,2015,6,2
Group 5,RRG,-1.5,6,14,3588,14,2015,9,5
Group 5,RRG,-1.5,6,14,3589,12,2015,10,2
Group 5,RRG,-1.5,6,14,3590,10,2015,12,-2
Group 5,RRG,-1.5,6,14,3591,12,2015,4,8
Group 5,RRG,-1.5,6,14,3592,11,2015,8,3
Group 5,RRG,-1.5,6,14,3593,8,2015,8,0
Group 5,RRG,-1.5,6,14,3594,9,2015,8,1
Group 5,RRG,-1.5,6,14,3595,14,2015,7,7
Group 5,RRG,-1.5,6,14,3596,9,2015,9,0
Group 5,RRG,-1.5,6,14,3597,14,2015,4,10
Group 5,RRG,-1.5,6,14,3598,3,2015,1,2
Group 5,RRG,-1.5,6,14,3599,12,2015,9,3
Group 5,RRG,-1.5,6,14,3600,12,2015,9,3
Group 5,RRG,-1.5,6,14,3601,10,2015,9,1
Group 5,RRG,-1.5,6,14,3602,7,2015,5,2
Group 5,RRG,-1.5,6,14,3603,11,2015,5,6
Group 5,RRG,-1.5,6,14,3604,13,2015,6,7
Group 5,RRG,-1.5,6,14,3605,9,2015,7,2
Group 5,RRG,-1.5,6,14,3606,8,2015,4,4
Group 5,RRG,-1.5,6,14,3607,12,2015,9,3
Group 5,RRG,-1.5,6,14,3608,6,2015,6,0
Group 5,RRG,-1.5,6,14,3609,9,2015,8,1
Group 5,RRG,-1.5,6,14,3610,11,2015,5,6
Group 5,RRG,-1.5,6,14,3611,10,2015,8,2
Group 5,RRG,-1.5,6,14,3612,9,2015,8,1
Group 5,RRG,-1.5,6,14,3613,12,2015,7,5
Group 5,RRG,-1.5,6,14,3614,11,2015,12,-1
Group 5,RRG,-1.5,6,14,3615,9,2015,4,5
Group 5,RRG,-1.5,6,14,3616,8,2015,9,-1
Group 5,RRG,-1.5,6,14,3617,9,2015,6,3
Group 5,RRG,-1.5,6,14,3618,3,2015,13,-10
Group 5,RRG,-1.5,6,14,3619,9,2015,5,4
Group 5,RRG,-1.5,6,14,3620,14,2015,10,4
Group 5,RRG,-1.5,6,14,3621,12,2015,3,9
Group 5,RRG,-1.5,6,14,3622,11,2015,8,3
Group 5,RRG,-1.5,6,14,3623,11,2015,4,7
Group 5,RRG,-1.5,6,14,3624,11,2015,7,4
Group 5,RRG,-1.5,6,14,3625,10,2015,6,4
Group 5,RRG,-1.5,6,14,3626,10,2015,6,4
Group 5,RRG,-1.5,6,14,3627,10,2015,7,3
Group 5,RRG,-1.5,6,14,3628,12,2015,11,1
Group 5,RRG,-1.5,6,14,3629,6,2015,9,-3
Group 5,RRG,-1.5,6,14,3630,12,2015,10,2
Group 5,RRG,-1.5,6,14,3631,10,2015,8,2
Group 5,RRG,-1.5,6,14,3632,14,2015,4,10
Group 5,RRG,-1.5,6,14,3633,4,2015,8,-4
Group 5,RRG,-1.5,6,14,3634,10,2015,6,4
Group 5,RRG,-1.5,6,14,3635,4,2015,7,-3
Group 5,RRG,-1.5,6,14,3636,10,2015,7,3
Group 5,RRG,-1.5,6,14,3637,4,2015,3,1
Group 5,RRG,-1.5,6,14,3638,8,2015,7,1
Group 5,RRG,-1.5,6,14,3639,8,2015,10,-2
Group 5,RRG,-1.5,6,14,3640,11,2015,7,4
Group 5,RRG,-1.5,6,14,3641,10,2015,6,4
Group 5,RRG,-1.5,6,14,3642,11,2015,10,1
Group 5,RRG,-1.5,6,14,3643,11,2015,14,-3
Group 5,RRG,-1.5,6,14,3644,8,2015,8,0
Group 5,RRG,-1.5,6,14,3645,10,2015,4,6
Group 5,RRG,-1.5,6,14,3646,6,2015,7,-1
Group 5,RRG,-1.5,6,14,3647,11,2015,7,4
Group 5,RRG,-1.5,6,14,3648,6,2015,8,-2
Group 5,RRG,-1.5,6,14,3649,14,2015,11,3
Group 5,RRG,-1.5,6,14,3650,12,2015,9,3
Group 5,RRG,-1.5,6,14,3651,11,2015,4,7
Group 5,RRG,-1.5,6,14,3652,11,2015,6,5
Group 5,RRG,-1.5,6,14,3653,11,2015,9,2
Group 5,RRG,-1.5,6,14,3654,8,2015,9,-1
Group 5,RRG,-1.5,6,14,3655,8,2015,6,2
Group 5,RRG,-1.5,6,14,3656,12,2015,6,6
Group 5,RRG,-1.5,6,14,3657,11,2015,8,3
Group 5,RRG,-1.5,6,14,3658,6,2015,8,-2
Group 5,RRG,-1.5,6,14,3659,12,2015,3,9
Group 5,RRG,-1.5,6,14,3660,10,2015,9,1
Group 5,RRG,-1.5,6,14,3661,7,2015,10,-3
Group 5,RRG,-1.5,6,14,3662,9,2015,9,0
Group 5,RRG,-1.5,6,14,3663,9,2015,6,3
Group 5,RRG,-1.5,6,14,3664,4,2015,6,-2
Group 5,RRG,-1.5,6,14,3665,8,2015,7,1
Group 5,RRG,-1.5,6,14,3666,12,2015,5,7
Group 5,RRG,-1.5,6,14,3667,9,2015,9,0
Group 5,RRG,-1.5,6,14,3668,7,2015,8,-1
Group 5,RRG,-1.5,6,14,3669,10,2015,3,7
Group 5,RRG,-1.5,6,14,3670,14,2015,5,9
Group 5,RRG,-1.5,6,14,3671,8,2015,6,2
Group 5,RRG,-1.5,6,14,3672,4,2015,4,0
Group 5,RRG,-1.5,6,14,3673,8,2015,6,2
Group 5,RRG,-1.5,6,14,3674,10,2015,6,4
Group 5,RRG,-1.5,6,14,3675,4,2015,4,0
Group 5,RRG,-1.5,6,14,3676,9,2015,10,-1
Group 5,RRG,-1.5,6,14,3677,10,2015,7,3
Group 5,RRG,-1.5,6,14,3678,7,2015,9,-2
Group 5,RRG,-1.5,6,14,3679,10,2015,5,5
Group 5,RRG,-1.5,6,14,3680,6,2015,6,0
Group 5,RRG,-1.5,6,14,3681,13,2015,4,9
Group 5,RRG,-1.5,6,14,3682,8,2015,5,3
Group 5,RRG,-1.5,6,14,3683,11,2015,5,6
Group 5,RRG,-1.5,6,14,3684,9,2015,6,3
Group 5,RRG,-1.5,6,14,3685,8,2015,7,1
Group 5,RRG,-1.5,6,14,3686,7,2015,6,1
Group 5,RRG,-1.5,6,14,3687,8,2015,10,-2
Group 5,RRG,-1.5,6,14,3688,10,2015,7,3
Group 5,RRG,-1.5,6,14,3689,9,2015,8,1
Group 5,RRG,-1.5,6,14,3690,11,2015,10,1
Group 5,RRG,-1.5,6,14,3691,8,2015,3,5
Group 5,RRG,-1.5,6,14,3692,8,2015,10,-2
Group 5,RRG,-1.5,6,14,3693,10,2015,11,-1
Group 5,RRG,-1.5,6,14,3694,8,2015,3,5
Group 5,RRG,-1.5,6,14,3695,6,2015,7,-1
Group 5,RRG,-1.5,6,14,3696,10,2015,6,4
Group 5,RRG,-1.5,6,14,3697,11,2015,6,5
Group 5,RRG,-1.5,6,14,3698,14,2015,9,5
Group 5,RRG,-1.5,6,14,3699,10,2015,7,3
Group 5,RRG,-1.5,6,14,3700,5,2015,4,1
Group 5,RRG,-1.5,6,14,3701,12,2015,1,11
Group 5,RRG,-1.5,6,14,3702,10,2015,11,-1
Group 5,RRG,-1.5,6,14,3703,10,2015,6,4
Group 5,RRG,-1.5,6,14,3704,5,2015,3,2
Group 5,RRG,-1.5,6,14,3705,13,2015,9,4
Group 5,RRG,-1.5,6,14,3706,13,2015,5,8
Group 5,RRG,-1.5,6,14,3707,8,2015,4,4
Group 5,RRG,-1.5,6,14,3708,11,2015,9,2
Group 5,RRG,-1.5,6,14,3709,9,2015,8,1
Group 5,RRG,-1.5,6,14,3710,11,2015,7,4
Group 5,RRG,-1.5,6,14,3711,6,2015,6,0
Group 5,RRG,-1.5,6,14,3712,12,2015,9,3
Group 5,RRG,-1.5,6,14,3713,10,2015,3,7
Group 5,RRG,-1.5,6,14,3714,11,2015,5,6
Group 5,RRG,-1.5,6,14,3715,10,2015,6,4
Group 5,RRG,-1.5,6,14,3716,11,2015,6,5
Group 5,RRG,-1.5,6,14,3717,14,2015,5,9
Group 5,RRG,-1.5,6,14,3718,10,2015,11,-1
Group 5,RRG,-1.5,6,14,3719,9,2015,4,5
Group 5,RRG,-1.5,6,14,3720,12,2015,2,10
Group 5,RRG,-1.5,6,14,3721,11,2015,5,6
Group 5,RRG,-1.5,6,14,3722,9,2015,9,0
Group 5,RRG,-1.5,6,14,3723,8,2015,9,-1
Group 5,RRG,-1.5,6,14,3724,2,2015,7,-5
Group 5,RRG,-1.5,6,14,3725,9,2015,8,1
Group 5,RRG,-1.5,6,14,3726,13,2015,5,8
Group 5,RRG,-1.5,6,14,3727,7,2015,2,5
Group 5,RRG,-1.5,6,14,3728,6,2015,5,1
Group 5,RRG,-1.5,6,14,3729,7,2015,7,0
Group 5,RRG,-1.5,6,14,3730,9,2015,8,1
Group 5,RRG,-1.5,6,14,3731,9,2015,3,6
Group 5,RRG,-1.5,6,14,3732,5,2015,3,2
Group 5,RRG,-1.5,6,14,3733,13,2015,8,5
Group 5,RRG,-1.5,6,14,3734,13,2015,9,4
Group 5,RRG,-1.5,6,14,3735,11,2015,8,3
Group 5,RRG,-1.5,6,14,3736,8,2015,4,4
Group 5,RRG,-1.5,6,14,3737,8,2015,6,2
Group 5,RRG,-1.5,6,14,3738,12,2015,9,3
Group 5,RRG,-1.5,6,14,3739,13,2015,8,5
Group 5,RRG,-1.5,6,14,3740,12,2015,9,3
Group 5,RRG,-1.5,6,14,3741,7,2015,5,2
Group 5,RRG,-1.5,6,14,3742,13,2015,2,11
Group 5,RRG,-1.5,6,14,3743,9,2015,5,4
Group 5,RRG,-1.5,6,14,3744,11,2015,7,4
Group 5,RRG,-1.5,6,14,3745,8,2015,5,3
Group 5,RRG,-1.5,6,14,3746,7,2015,4,3
Group 5,RRG,-1.5,6,14,3747,9,2015,11,-2
Group 5,RRG,-1.5,6,14,3748,9,2015,3,6
Group 5,RRG,-1.5,6,14,3749,10,2015,7,3
Group 5,RRG,-1.5,6,14,3750,9,2015,9,0
Group 5,RRG,-1.5,6,14,3751,12,2015,8,4
Group 5,RRG,-1.5,6,14,3752,11,2015,4,7
Group 5,RRG,-1.5,6,14,3753,11,2015,3,8
Group 5,RRG,-1.5,6,14,3754,12,2015,11,1
Group 5,RRG,-1.5,6,14,3755,11,2015,3,8
Group 5,RRG,-1.5,6,14,3756,8,2015,5,3
Group 5,RRG,-1.5,6,14,3757,8,2015,5,3
Group 5,RRG,-1.5,6,14,3758,7,2015,6,1
Group 5,RRG,-1.5,6,14,3759,7,2015,8,-1
Group 5,RRG,-1.5,6,14,3760,10,2015,8,2
Group 5,RRG,-1.5,6,14,3761,10,2015,8,2
Group 5,RRG,-1.5,6,14,3762,12,2015,9,3
Group 5,RRG,-1.5,6,14,3763,5,2015,4,1
Group 5,RRG,-1.5,6,14,3764,11,2015,9,2
Group 5,RRG,-1.5,6,14,3765,7,2015,5,2
Group 5,RRG,-1.5,6,14,3766,12,2015,6,6
Group 5,RRG,-1.5,6,14,3767,11,2015,9,2
Group 5,RRG,-1.5,6,14,3768,11,2015,8,3
Group 5,RRG,-1.5,6,14,3769,10,2015,8,2
Group 5,RRG,-1.5,6,14,3770,13,2015,10,3
Group 5,RRG,-1.5,6,14,3771,14,2015,12,2
Group 5,RRG,-1.5,6,14,3772,9,2015,5,4
Group 5,RRG,-1.5,6,14,3773,6,2015,6,0
Group 5,RRG,-1.5,6,14,3774,8,2015,4,4
Group 5,RRG,-1.5,6,14,3775,6,2015,5,1
Group 5,RRG,-1.5,6,14,3776,14,2015,8,6
Group 5,RRG,-1.5,6,14,3777,12,2015,7,5
Group 5,RRG,-1.5,6,14,3778,6,2015,8,-2
Group 5,RRG,-1.5,6,14,3779,9,2015,4,5
Group 5,RRG,-1.5,6,14,3780,7,2015,9,-2
Group 5,RRG,-1.5,6,14,3781,12,2015,4,8
Group 5,RRG,-1.5,6,14,3782,11,2015,7,4
Group 5,RRG,-1.5,6,14,3783,6,2015,10,-4
Group 5,RRG,-1.5,6,14,3784,11,2015,5,6
Group 5,RRG,-1.5,6,14,3785,11,2015,6,5
Group 5,RRG,-1.5,6,14,3786,11,2015,2,9
Group 5,RRG,-1.5,6,14,3787,4,2015,6,-2
Group 5,RRG,-1.5,6,14,3788,9,2015,4,5
Group 5,RRG,-1.5,6,14,3789,11,2015,10,1
Group 5,RRG,-1.5,6,14,3790,11,2015,3,8
Group 5,RRG,-1.5,6,14,3791,11,2015,5,6
Group 5,RRG,-1.5,6,14,3792,5,2015,6,-1
Group 5,RRG,-1.5,6,14,3793,10,2015,8,2
Group 5,RRG,-1.5,6,14,3794,11,2015,12,-1
Group 5,RRG,-1.5,6,14,3795,8,2015,8,0
Group 5,RRG,-1.5,6,14,3796,12,2015,6,6
Group 5,RRG,-1.5,6,14,3797,6,2015,12,-6
Group 5,RRG,-1.5,6,14,3798,8,2015,4,4
Group 5,RRG,-1.5,6,14,3799,10,2015,10,0
Group 5,RRG,-1.5,6,14,3800,9,2015,7,2
Group 5,RRG,-1.5,6,14,3801,8,2015,5,3
Group 5,RRG,-1.5,6,14,3802,7,2015,6,1
Group 5,RRG,-1.5,6,14,3803,7,2015,8,-1
Group 5,RRG,-1.5,6,14,3804,7,2015,8,-1
Group 5,RRG,-1.5,6,14,3805,5,2015,6,-1
Group 5,RRG,-1.5,6,14,3806,9,2015,3,6
Group 5,RRG,-1.5,6,14,3807,11,2015,8,3
Group 5,RRG,-1.5,6,14,3808,7,2015,7,0
Group 5,RRG,-1.5,6,14,3809,5,2015,7,-2
Group 5,RRG,-1.5,6,14,3810,11,2015,7,4
Group 5,RRG,-1.5,6,14,3811,7,2015,8,-1
Group 5,RRG,-1.5,6,14,3812,12,2015,10,2
Group 5,RRG,-1.5,6,14,3813,11,2015,10,1
Group 5,RRG,-1.5,6,14,3814,5,2015,5,0
Group 5,RRG,-1.5,6,14,3815,13,2015,5,8
Group 5,RRG,-1.5,6,14,3816,10,2015,5,5
Group 5,RRG,-1.5,6,14,3817,8,2015,5,3
Group 5,RRG,-1.5,6,14,3818,12,2015,5,7
Group 5,RRG,-1.5,6,14,3819,8,2015,9,-1
Group 5,RRG,-1.5,6,14,3820,8,2015,5,3
Group 5,RRG,-1.5,6,14,3821,8,2015,6,2
Group 5,RRG,-1.5,6,14,3822,10,2015,5,5
Group 5,RRG,-1.5,6,14,3823,8,2015,6,2
Group 5,RRG,-1.5,6,14,3824,9,2015,4,5
Group 5,RRG,-1.5,6,14,3825,10,2015,6,4
Group 5,RRG,-1.5,6,14,3826,11,2015,5,6
Group 5,RRG,-1.5,6,14,3827,12,2015,6,6
Group 5,RRG,-1.5,6,14,3828,12,2015,3,9
Group 5,RRG,-1.5,6,14,3829,8,2015,5,3
Group 5,RRG,-1.5,6,14,3830,12,2015,7,5
Group 5,RRG,-1.5,6,14,3831,10,2015,4,6
Group 5,RRG,-1.5,6,14,3832,12,2015,8,4
Group 5,RRG,-1.5,6,14,3833,11,2015,7,4
Group 5,RRG,-1.5,6,14,3834,13,2015,6,7
Group 5,RRG,-1.5,6,14,3835,10,2015,8,2
Group 5,RRG,-1.5,6,14,3836,9,2015,8,1
Group 5,RRG,-1.5,6,14,3837,9,2015,8,1
Group 5,RRG,-1.5,6,14,3838,8,2015,8,0
Group 5,RRG,-1.5,6,14,3839,10,2015,7,3
Group 5,RRG,-1.5,6,14,3840,9,2015,4,5
Group 5,RRG,-1.5,6,14,3841,12,2015,7,5
Group 5,RRG,-1.5,6,14,3842,3,2015,10,-7
Group 5,RRG,-1.5,6,14,3843,13,2015,9,4
Group 5,RRG,-1.5,6,14,3844,11,2015,11,0
Group 5,RRG,-1.5,6,14,3845,11,2015,8,3
Group 5,RRG,-1.5,6,14,3846,10,2015,6,4
Group 5,RRG,-1.5,6,14,3847,11,2015,6,5
Group 5,RRG,-1.5,6,14,3848,12,2015,6,6
Group 5,RRG,-1.5,6,14,3849,9,2015,10,-1
Group 5,RRG,-1.5,6,14,3850,12,2015,7,5
Group 5,RRG,-1.5,6,14,3851,11,2015,7,4
Group 5,RRG,-1.5,6,14,3852,11,2015,8,3
Group 5,RRG,-1.5,6,14,3853,7,2015,5,2
Group 5,RRG,-1.5,6,14,3854,12,2015,8,4
Group 5,RRG,-1.5,6,14,3855,7,2015,11,-4
Group 5,RRG,-1.5,6,14,3856,8,2015,9,-1
Group 5,RRG,-1.5,6,14,3857,6,2015,7,-1
Group 5,RRG,-1.5,6,14,3858,7,2015,8,-1
Group 5,RRG,-1.5,6,14,3859,3,2015,4,-1
Group 5,RRG,-1.5,6,14,3860,14,2015,6,8
Group 5,RRG,-1.5,6,14,3861,12,2015,10,2
Group 5,RRG,-1.5,6,14,3862,12,2015,8,4
Group 5,RRG,-1.5,6,14,3863,14,2015,6,8
Group 5,RRG,-1.5,6,14,3864,13,2015,12,1
Group 5,RRG,-1.5,6,14,3865,9,2015,14,-5
Group 5,RRG,-1.5,6,14,3866,11,2015,8,3
Group 5,RRG,-1.5,6,14,3867,8,2015,4,4
Group 5,RRG,-1.5,6,14,3868,10,2015,5,5
Group 5,RRG,-1.5,6,14,3869,10,2015,2,8
Group 5,RRG,-1.5,6,14,3870,9,2015,6,3
Group 5,RRG,-1.5,6,14,3871,11,2015,4,7
Group 5,RRG,-1.5,6,14,3872,7,2015,10,-3
Group 5,RRG,-1.5,6,14,3873,8,2015,2,6
Group 5,RRG,-1.5,6,14,3874,10,2015,9,1
Group 5,RRG,-1.5,6,14,3875,9,2015,5,4
Group 5,RRG,-1.5,6,14,3876,12,2015,5,7
Group 5,RRG,-1.5,6,14,3877,7,2015,7,0
Group 5,RRG,-1.5,6,14,3878,11,2015,4,7
Group 5,RRG,-1.5,6,14,3879,12,2015,4,8
Group 5,RRG,-1.5,6,14,3880,8,2015,7,1
Group 5,RRG,-1.5,6,14,3881,11,2015,5,6
Group 5,RRG,-1.5,6,14,3882,10,2015,9,1
Group 5,RRG,-1.5,6,14,3883,9,2015,8,1
Group 5,RRG,-1.5,6,14,3884,7,2015,9,-2
Group 5,RRG,-1.5,6,14,3885,13,2015,7,6
Group 5,RRG,-1.5,6,14,3886,6,2015,5,1
Group 5,RRG,-1.5,6,14,3887,6,2015,5,1
Group 5,RRG,-1.5,6,14,3888,12,2015,3,9
Group 5,RRG,-1.5,6,14,3889,11,2015,4,7
Group 5,RRG,-1.5,6,14,3890,8,2015,7,1
Group 5,RRG,-1.5,6,14,3891,7,2015,6,1
Group 5,RRG,-1.5,6,14,3892,11,2015,10,1
Group 5,RRG,-1.5,6,14,3893,9,2015,6,3
Group 5,RRG,-1.5,6,14,3894,9,2015,7,2
Group 5,RRG,-1.5,6,14,3895,11,2015,9,2
Group 5,RRG,-1.5,6,14,3896,11,2015,5,6
Group 5,RRG,-1.5,6,14,3897,6,2015,5,1
Group 5,RRG,-1.5,6,14,3898,8,2015,7,1
Group 5,RRG,-1.5,6,14,3899,9,2015,3,6
Group 5,RRG,-1.5,6,14,3900,7,2015,7,0
Group 5,RRG,-1.5,6,14,3901,7,2015,9,-2
Group 5,RRG,-1.5,6,14,3902,11,2015,11,0
Group 5,RRG,-1.5,6,14,3903,9,2015,7,2
Group 5,RRG,-1.5,6,14,3904,11,2015,10,1
Group 5,RRG,-1.5,6,14,3905,9,2015,8,1
Group 5,RRG,-1.5,6,14,3906,11,2015,5,6
Group 5,RRG,-1.5,6,14,3907,14,2015,6,8
Group 5,RRG,-1.5,6,14,3908,10,2015,9,1
Group 5,RRG,-1.5,6,14,3909,11,2015,5,6
Group 5,RRG,-1.5,6,14,3910,3,2015,9,-6
Group 5,RRG,-1.5,6,14,3911,10,2015,5,5
Group 5,RRG,-1.5,6,14,3912,10,2015,6,4
Group 5,RRG,-1.5,6,14,3913,12,2015,7,5
Group 5,RRG,-1.5,6,14,3914,7,2015,4,3
Group 5,RRG,-1.5,6,14,3915,14,2015,5,9
Group 5,RRG,-1.5,6,14,3916,10,2015,8,2
Group 5,RRG,-1.5,6,14,3917,8,2015,6,2
Group 5,RRG,-1.5,6,14,3918,10,2015,4,6
Group 5,RRG,-1.5,6,14,3919,10,2015,7,3
Group 5,RRG,-1.5,6,14,3920,8,2015,3,5
Group 5,RRG,-1.5,6,14,3921,10,2015,8,2
Group 5,RRG,-1.5,6,14,3922,7,2015,11,-4
Group 5,RRG,-1.5,6,14,3923,9,2015,6,3
Group 5,RRG,-1.5,6,14,3924,12,2015,5,7
Group 5,RRG,-1.5,6,14,3925,7,2015,8,-1
Group 5,RRG,-1.5,6,14,3926,7,2015,8,-1
Group 5,RRG,-1.5,6,14,3927,10,2015,6,4
Group 5,RRG,-1.5,6,14,3928,2,2015,1,1
Group 5,RRG,-1.5,6,14,3929,8,2015,7,1
Group 5,RRG,-1.5,6,14,3930,12,2015,8,4
Group 5,RRG,-1.5,6,14,3931,12,2015,8,4
Group 5,RRG,-1.5,6,14,3932,14,2015,7,7
Group 5,RRG,-1.5,6,14,3933,10,2015,13,-3
Group 5,RRG,-1.5,6,14,3934,11,2015,8,3
Group 5,RRG,-1.5,6,14,3935,12,2015,3,9
Group 5,RRG,-1.5,6,14,3936,8,2015,6,2
Group 5,RRG,-1.5,6,14,3937,10,2015,5,5
Group 5,RRG,-1.5,6,14,3938,3,2015,7,-4
Group 5,RRG,-1.5,6,14,3939,13,2015,6,7
Group 5,RRG,-1.5,6,14,3940,12,2015,5,7
Group 5,RRG,-1.5,6,14,3941,9,2015,11,-2
Group 5,RRG,-1.5,6,14,3942,8,2015,4,4
Group 5,RRG,-1.5,6,14,3943,6,2015,7,-1
Group 5,RRG,-1.5,6,14,3944,6,2015,8,-2
Group 5,RRG,-1.5,6,14,3945,9,2015,9,0
Group 5,RRG,-1.5,6,14,3946,4,2015,7,-3
Group 5,RRG,-1.5,6,14,3947,9,2015,9,0
Group 5,RRG,-1.5,6,14,3948,13,2015,6,7
Group 5,RRG,-1.5,6,14,3949,4,2015,10,-6
Group 5,RRG,-1.5,6,14,3950,5,2015,4,1
Group 5,RRG,-1.5,6,14,3951,10,2015,8,2
Group 5,RRG,-1.5,6,14,3952,10,2015,7,3
Group 5,RRG,-1.5,6,14,3953,7,2015,6,1
Group 5,RRG,-1.5,6,14,3954,10,2015,8,2
Group 5,RRG,-1.5,6,14,3955,10,2015,7,3
Group 5,RRG,-1.5,6,14,3956,8,2015,7,1
Group 5,RRG,-1.5,6,14,3957,10,2015,11,-1
Group 5,RRG,-1.5,6,14,3958,11,2015,5,6
Group 5,RRG,-1.5,6,14,3959,10,2015,6,4
Group 5,RRG,-1.5,6,14,3960,12,2015,7,5
Group 5,RRG,-1.5,6,14,3961,10,2015,5,5
Group 5,RRG,-1.5,6,14,3962,6,2015,11,-5
Group 5,RRG,-1.5,6,14,3963,11,2015,4,7
Group 5,RRG,-1.5,6,14,3964,5,2015,3,2
Group 5,RRG,-1.5,6,14,3965,7,2015,5,2
Group 5,RRG,-1.5,6,14,3966,7,2015,3,4
Group 5,RRG,-1.5,6,14,3967,13,2015,9,4
Group 5,RRG,-1.5,6,14,3968,12,2015,8,4
Group 5,RRG,-1.5,6,14,3969,11,2015,8,3
Group 5,RRG,-1.5,6,14,3970,9,2015,6,3
Group 5,RRG,-1.5,6,14,3971,10,2015,6,4
Group 5,RRG,-1.5,6,14,3972,12,2015,10,2
Group 5,RRG,-1.5,6,14,3973,13,2015,8,5
Group 5,RRG,-1.5,6,14,3974,11,2015,7,4
Group 5,RRG,-1.5,6,14,3975,13,2015,5,8
Group 5,RRG,-1.5,6,14,3976,11,2015,8,3
Group 5,RRG,-1.5,6,14,3977,10,2015,5,5
Group 5,RRG,-1.5,6,14,3978,11,2015,10,1
Group 5,RRG,-1.5,6,14,3979,11,2015,6,5
Group 5,RRG,-1.5,6,14,3980,8,2015,7,1
Group 5,RRG,-1.5,6,14,3981,7,2015,12,-5
Group 5,RRG,-1.5,6,14,3982,12,2015,8,4
Group 5,RRG,-1.5,6,14,3983,11,2015,10,1
Group 5,RRG,-1.5,6,14,3984,8,2015,4,4
Group 5,RRG,-1.5,6,14,3985,6,2015,4,2
Group 5,RRG,-1.5,6,14,3986,6,2015,9,-3
Group 5,RRG,-1.5,6,14,3987,8,2015,2,6
Group 5,RRG,-1.5,6,14,3988,7,2015,6,1
Group 5,RRG,-1.5,6,14,3989,10,2015,6,4
Group 5,RRG,-1.5,6,14,3990,9,2015,7,2
Group 5,RRG,-1.5,6,14,3991,11,2015,9,2
Group 5,RRG,-1.5,6,14,3992,10,2015,9,1
Group 5,RRG,-1.5,6,14,3993,9,2015,9,0
Group 5,RRG,-1.5,6,14,3994,7,2015,4,3
Group 5,RRG,-1.5,6,14,3995,10,2015,9,1
Group 5,RRG,-1.5,6,14,3996,13,2015,6,7
Group 5,RRG,-1.5,6,14,3997,9,2015,4,5
Group 5,RRG,-1.5,6,14,3998,11,2015,6,5
Group 5,RRG,-1.5,6,14,3999,7,2015,5,2
Group 5,RRG,-1.5,6,14,4000,3,2015,7,-4
Group 1,BB,-0.5,8,14,1,9,2016,7,2
Group 1,BB,-0.5,8,14,2,10,2016,8,2
Group 1,BB,-0.5,8,14,3,11,2016,11,0
Group 1,BB,-0.5,8,14,4,8,2016,5,3
Group 1,BB,-0.5,8,14,5,7,2016,7,0
Group 1,BB,-0.5,8,14,6,8,2016,11,-3
Group 1,BB,-0.5,8,14,7,9,2016,11,-2
Group 1,BB,-0.5,8,14,8,6,2016,10,-4
Group 1,BB,-0.5,8,14,9,10,2016,8,2
Group 1,BB,-0.5,8,14,10,9,2016,7,2
Group 1,BB,-0.5,8,14,11,8,2016,10,-2
Group 1,BB,-0.5,8,14,12,12,2016,10,2
Group 1,BB,-0.5,8,14,13,10,2016,11,-1
Group 1,BB,-0.5,8,14,14,9,2016,7,2
Group 1,BB,-0.5,8,14,15,11,2016,9,2
Group 1,BB,-0.5,8,14,16,5,2016,6,-1
Group 1,BB,-0.5,8,14,17,10,2016,4,6
Group 1,BB,-0.5,8,14,18,10,2016,11,-1
Group 1,BB,-0.5,8,14,19,8,2016,5,3
Group 1,BB,-0.5,8,14,20,8,2016,4,4
Group 1,BB,-0.5,8,14,21,9,2016,9,0
Group 1,BB,-0.5,8,14,22,6,2016,7,-1
Group 1,BB,-0.5,8,14,23,9,2016,7,2
Group 1,BB,-0.5,8,14,24,10,2016,10,0
Group 1,BB,-0.5,8,14,25,10,2016,8,2
Group 1,BB,-0.5,8,14,26,8,2016,8,0
Group 1,BB,-0.5,8,14,27,7,2016,9,-2
Group 1,BB,-0.5,8,14,28,8,2016,6,2
Group 1,BB,-0.5,8,14,29,11,2016,7,4
Group 1,BB,-0.5,8,14,30,11,2016,7,4
Group 1,BB,-0.5,8,14,31,11,2016,7,4
Group 1,BB,-0.5,8,14,32,8,2016,9,-1
Group 1,BB,-0.5,8,14,33,11,2016,12,-1
Group 1,BB,-0.5,8,14,34,9,2016,7,2
Group 1,BB,-0.5,8,14,35,8,2016,9,-1
Group 1,BB,-0.5,8,14,36,10,2016,8,2
Group 1,BB,-0.5,8,14,37,11,2016,8,3
Group 1,BB,-0.5,8,14,38,10,2016,13,-3
Group 1,BB,-0.5,8,14,39,10,2016,6,4
Group 1,BB,-0.5,8,14,40,5,2016,9,-4
Group 1,BB,-0.5,8,14,41,7,2016,8,-1
Group 1,BB,-0.5,8,14,42,9,2016,9,0
Group 1,BB,-0.5,8,14,43,11,2016,8,3
Group 1,BB,-0.5,8,14,44,10,2016,10,0
Group 1,BB,-0.5,8,14,45,10,2016,6,4
Group 1,BB,-0.5,8,14,46,7,2016,8,-1
Group 1,BB,-0.5,8,14,47,10,2016,9,1
Group 1,BB,-0.5,8,14,48,7,2016,5,2
Group 1,BB,-0.5,8,14,49,5,2016,5,0
Group 1,BB,-0.5,8,14,50,9,2016,6,3
Group 1,BB,-0.5,8,14,51,10,2016,8,2
Group 1,BB,-0.5,8,14,52,13,2016,7,6
Group 1,BB,-0.5,8,14,53,10,2016,6,4
Group 1,BB,-0.5,8,14,54,5,2016,10,-5
Group 1,BB,-0.5,8,14,55,11,2016,5,6
Group 1,BB,-0.5,8,14,56,9,2016,9,0
Group 1,BB,-0.5,8,14,57,12,2016,6,6
Group 1,BB,-0.5,8,14,58,11,2016,7,4
Group 1,BB,-0.5,8,14,59,11,2016,12,-1
Group 1,BB,-0.5,8,14,60,9,2016,8,1
Group 1,BB,-0.5,8,14,61,13,2016,10,3
Group 1,BB,-0.5,8,14,62,8,2016,5,3
Group 1,BB,-0.5,8,14,63,8,2016,8,0
Group 1,BB,-0.5,8,14,64,10,2016,11,-1
Group 1,BB,-0.5,8,14,65,11,2016,8,3
Group 1,BB,-0.5,8,14,66,6,2016,6,0
Group 1,BB,-0.5,8,14,67,6,2016,8,-2
Group 1,BB,-0.5,8,14,68,10,2016,4,6
Group 1,BB,-0.5,8,14,69,10,2016,6,4
Group 1,BB,-0.5,8,14,70,10,2016,9,1
Group 1,BB,-0.5,8,14,71,10,2016,9,1
Group 1,BB,-0.5,8,14,72,10,2016,9,1
Group 1,BB,-0.5,8,14,73,11,2016,4,7
Group 1,BB,-0.5,8,14,74,11,2016,4,7
Group 1,BB,-0.5,8,14,75,11,2016,9,2
Group 1,BB,-0.5,8,14,76,6,2016,8,-2
Group 1,BB,-0.5,8,14,77,10,2016,8,2
Group 1,BB,-0.5,8,14,78,10,2016,10,0
Group 1,BB,-0.5,8,14,79,6,2016,8,-2
Group 1,BB,-0.5,8,14,80,7,2016,9,-2
Group 1,BB,-0.5,8,14,81,7,2016,12,-5
Group 1,BB,-0.5,8,14,82,10,2016,7,3
Group 1,BB,-0.5,8,14,83,5,2016,8,-3
Group 1,BB,-0.5,8,14,84,10,2016,10,0
Group 1,BB,-0.5,8,14,85,8,2016,6,2
Group 1,BB,-0.5,8,14,86,10,2016,9,1
Group 1,BB,-0.5,8,14,87,8,2016,8,0
Group 1,BB,-0.5,8,14,88,8,2016,7,1
Group 1,BB,-0.5,8,14,89,7,2016,8,-1
Group 1,BB,-0.5,8,14,90,7,2016,10,-3
Group 1,BB,-0.5,8,14,91,8,2016,5,3
Group 1,BB,-0.5,8,14,92,7,2016,7,0
Group 1,BB,-0.5,8,14,93,10,2016,8,2
Group 1,BB,-0.5,8,14,94,6,2016,9,-3
Group 1,BB,-0.5,8,14,95,9,2016,5,4
Group 1,BB,-0.5,8,14,96,10,2016,7,3
Group 1,BB,-0.5,8,14,97,9,2016,7,2
Group 1,BB,-0.5,8,14,98,5,2016,7,-2
Group 1,BB,-0.5,8,14,99,5,2016,7,-2
Group 1,BB,-0.5,8,14,100,8,2016,11,-3
Group 1,BB,-0.5,8,14,101,11,2016,10,1
Group 1,BB,-0.5,8,14,102,12,2016,9,3
Group 1,BB,-0.5,8,14,103,11,2016,7,4
Group 1,BB,-0.5,8,14,104,7,2016,9,-2
Group 1,BB,-0.5,8,14,105,7,2016,11,-4
Group 1,BB,-0.5,8,14,106,10,2016,8,2
Group 1,BB,-0.5,8,14,107,9,2016,8,1
Group 1,BB,-0.5,8,14,108,7,2016,9,-2
Group 1,BB,-0.5,8,14,109,10,2016,9,1
Group 1,BB,-0.5,8,14,110,7,2016,9,-2
Group 1,BB,-0.5,8,14,111,8,2016,5,3
Group 1,BB,-0.5,8,14,112,8,2016,7,1
Group 1,BB,-0.5,8,14,113,6,2016,10,-4
Group 1,BB,-0.5,8,14,114,8,2016,9,-1
Group 1,BB,-0.5,8,14,115,9,2016,6,3
Group 1,BB,-0.5,8,14,116,7,2016,7,0
Group 1,BB,-0.5,8,14,117,11,2016,6,5
Group 1,BB,-0.5,8,14,118,9,2016,10,-1
Group 1,BB,-0.5,8,14,119,9,2016,7,2
Group 1,BB,-0.5,8,14,120,13,2016,6,7
Group 1,BB,-0.5,8,14,121,6,2016,7,-1
Group 1,BB,-0.5,8,14,122,10,2016,10,0
Group 1,BB,-0.5,8,14,123,6,2016,8,-2
Group 1,BB,-0.5,8,14,124,8,2016,6,2
Group 1,BB,-0.5,8,14,125,10,2016,11,-1
Group 1,BB,-0.5,8,14,126,12,2016,6,6
Group 1,BB,-0.5,8,14,127,10,2016,8,2
Group 1,BB,-0.5,8,14,128,9,2016,9,0
Group 1,BB,-0.5,8,14,129,8,2016,9,-1
Group 1,BB,-0.5,8,14,130,7,2016,9,-2
Group 1,BB,-0.5,8,14,131,11,2016,8,3
Group 1,BB,-0.5,8,14,132,11,2016,8,3
Group 1,BB,-0.5,8,14,133,9,2016,3,6
Group 1,BB,-0.5,8,14,134,8,2016,9,-1
Group 1,BB,-0.5,8,14,135,7,2016,10,-3
Group 1,BB,-0.5,8,14,136,6,2016,12,-6
Group 1,BB,-0.5,8,14,137,12,2016,11,1
Group 1,BB,-0.5,8,14,138,10,2016,11,-1
Group 1,BB,-0.5,8,14,139,8,2016,12,-4
Group 1,BB,-0.5,8,14,140,6,2016,3,3
Group 1,BB,-0.5,8,14,141,7,2016,12,-5
Group 1,BB,-0.5,8,14,142,7,2016,9,-2
Group 1,BB,-0.5,8,14,143,11,2016,5,6
Group 1,BB,-0.5,8,14,144,6,2016,9,-3
Group 1,BB,-0.5,8,14,145,8,2016,8,0
Group 1,BB,-0.5,8,14,146,8,2016,7,1
Group 1,BB,-0.5,8,14,147,10,2016,8,2
Group 1,BB,-0.5,8,14,148,8,2016,7,1
Group 1,BB,-0.5,8,14,149,9,2016,11,-2
Group 1,BB,-0.5,8,14,150,7,2016,11,-4
Group 1,BB,-0.5,8,14,151,9,2016,8,1
Group 1,BB,-0.5,8,14,152,10,2016,7,3
Group 1,BB,-0.5,8,14,153,6,2016,13,-7
Group 1,BB,-0.5,8,14,154,6,2016,6,0
Group 1,BB,-0.5,8,14,155,9,2016,8,1
Group 1,BB,-0.5,8,14,156,6,2016,7,-1
Group 1,BB,-0.5,8,14,157,10,2016,4,6
Group 1,BB,-0.5,8,14,158,6,2016,6,0
Group 1,BB,-0.5,8,14,159,7,2016,9,-2
Group 1,BB,-0.5,8,14,160,6,2016,9,-3
Group 1,BB,-0.5,8,14,161,9,2016,8,1
Group 1,BB,-0.5,8,14,162,11,2016,7,4
Group 1,BB,-0.5,8,14,163,7,2016,7,0
Group 1,BB,-0.5,8,14,164,8,2016,5,3
Group 1,BB,-0.5,8,14,165,10,2016,9,1
Group 1,BB,-0.5,8,14,166,6,2016,8,-2
Group 1,BB,-0.5,8,14,167,10,2016,8,2
Group 1,BB,-0.5,8,14,168,7,2016,6,1
Group 1,BB,-0.5,8,14,169,11,2016,6,5
Group 1,BB,-0.5,8,14,170,9,2016,8,1
Group 1,BB,-0.5,8,14,171,8,2016,14,-6
Group 1,BB,-0.5,8,14,172,7,2016,9,-2
Group 1,BB,-0.5,8,14,173,9,2016,8,1
Group 1,BB,-0.5,8,14,174,11,2016,9,2
Group 1,BB,-0.5,8,14,175,8,2016,8,0
Group 1,BB,-0.5,8,14,176,6,2016,12,-6
Group 1,BB,-0.5,8,14,177,7,2016,11,-4
Group 1,BB,-0.5,8,14,178,11,2016,10,1
Group 1,BB,-0.5,8,14,179,7,2016,3,4
Group 1,BB,-0.5,8,14,180,9,2016,5,4
Group 1,BB,-0.5,8,14,181,10,2016,6,4
Group 1,BB,-0.5,8,14,182,8,2016,9,-1
Group 1,BB,-0.5,8,14,183,5,2016,8,-3
Group 1,BB,-0.5,8,14,184,8,2016,8,0
Group 1,BB,-0.5,8,14,185,8,2016,11,-3
Group 1,BB,-0.5,8,14,186,13,2016,8,5
Group 1,BB,-0.5,8,14,187,8,2016,6,2
Group 1,BB,-0.5,8,14,188,5,2016,9,-4
Group 1,BB,-0.5,8,14,189,7,2016,8,-1
Group 1,BB,-0.5,8,14,190,12,2016,10,2
Group 1,BB,-0.5,8,14,191,11,2016,5,6
Group 1,BB,-0.5,8,14,192,6,2016,6,0
Group 1,BB,-0.5,8,14,193,11,2016,9,2
Group 1,BB,-0.5,8,14,194,9,2016,11,-2
Group 1,BB,-0.5,8,14,195,7,2016,5,2
Group 1,BB,-0.5,8,14,196,7,2016,5,2
Group 1,BB,-0.5,8,14,197,11,2016,7,4
Group 1,BB,-0.5,8,14,198,2,2016,5,-3
Group 1,BB,-0.5,8,14,199,11,2016,5,6
Group 1,BB,-0.5,8,14,200,8,2016,9,-1
Group 1,BB,-0.5,8,14,201,6,2016,8,-2
Group 1,BB,-0.5,8,14,202,10,2016,6,4
Group 1,BB,-0.5,8,14,203,8,2016,12,-4
Group 1,BB,-0.5,8,14,204,11,2016,5,6
Group 1,BB,-0.5,8,14,205,11,2016,9,2
Group 1,BB,-0.5,8,14,206,9,2016,4,5
Group 1,BB,-0.5,8,14,207,11,2016,9,2
Group 1,BB,-0.5,8,14,208,7,2016,3,4
Group 1,BB,-0.5,8,14,209,9,2016,8,1
Group 1,BB,-0.5,8,14,210,9,2016,8,1
Group 1,BB,-0.5,8,14,211,11,2016,10,1
Group 1,BB,-0.5,8,14,212,7,2016,10,-3
Group 1,BB,-0.5,8,14,213,7,2016,6,1
Group 1,BB,-0.5,8,14,214,11,2016,13,-2
Group 1,BB,-0.5,8,14,215,10,2016,12,-2
Group 1,BB,-0.5,8,14,216,10,2016,5,5
Group 1,BB,-0.5,8,14,217,9,2016,9,0
Group 1,BB,-0.5,8,14,218,6,2016,7,-1
Group 1,BB,-0.5,8,14,219,4,2016,10,-6
Group 1,BB,-0.5,8,14,220,11,2016,6,5
Group 1,BB,-0.5,8,14,221,7,2016,5,2
Group 1,BB,-0.5,8,14,222,11,2016,11,0
Group 1,BB,-0.5,8,14,223,6,2016,6,0
Group 1,BB,-0.5,8,14,224,8,2016,9,-1
Group 1,BB,-0.5,8,14,225,10,2016,10,0
Group 1,BB,-0.5,8,14,226,7,2016,8,-1
Group 1,BB,-0.5,8,14,227,11,2016,11,0
Group 1,BB,-0.5,8,14,228,9,2016,6,3
Group 1,BB,-0.5,8,14,229,8,2016,10,-2
Group 1,BB,-0.5,8,14,230,8,2016,9,-1
Group 1,BB,-0.5,8,14,231,11,2016,9,2
Group 1,BB,-0.5,8,14,232,7,2016,11,-4
Group 1,BB,-0.5,8,14,233,8,2016,4,4
Group 1,BB,-0.5,8,14,234,9,2016,10,-1
Group 1,BB,-0.5,8,14,235,9,2016,9,0
Group 1,BB,-0.5,8,14,236,8,2016,6,2
Group 1,BB,-0.5,8,14,237,8,2016,8,0
Group 1,BB,-0.5,8,14,238,12,2016,10,2
Group 1,BB,-0.5,8,14,239,9,2016,9,0
Group 1,BB,-0.5,8,14,240,10,2016,7,3
Group 1,BB,-0.5,8,14,241,9,2016,6,3
Group 1,BB,-0.5,8,14,242,9,2016,12,-3
Group 1,BB,-0.5,8,14,243,7,2016,8,-1
Group 1,BB,-0.5,8,14,244,9,2016,5,4
Group 1,BB,-0.5,8,14,245,8,2016,5,3
Group 1,BB,-0.5,8,14,246,9,2016,6,3
Group 1,BB,-0.5,8,14,247,10,2016,12,-2
Group 1,BB,-0.5,8,14,248,10,2016,6,4
Group 1,BB,-0.5,8,14,249,10,2016,11,-1
Group 1,BB,-0.5,8,14,250,9,2016,8,1
Group 1,BB,-0.5,8,14,251,9,2016,10,-1
Group 1,BB,-0.5,8,14,252,9,2016,9,0
Group 1,BB,-0.5,8,14,253,4,2016,8,-4
Group 1,BB,-0.5,8,14,254,8,2016,10,-2
Group 1,BB,-0.5,8,14,255,11,2016,8,3
Group 1,BB,-0.5,8,14,256,13,2016,8,5
Group 1,BB,-0.5,8,14,257,8,2016,5,3
Group 1,BB,-0.5,8,14,258,9,2016,10,-1
Group 1,BB,-0.5,8,14,259,6,2016,9,-3
Group 1,BB,-0.5,8,14,260,11,2016,8,3
Group 1,BB,-0.5,8,14,261,9,2016,9,0
Group 1,BB,-0.5,8,14,262,8,2016,10,-2
Group 1,BB,-0.5,8,14,263,10,2016,9,1
Group 1,BB,-0.5,8,14,264,9,2016,4,5
Group 1,BB,-0.5,8,14,265,6,2016,10,-4
Group 1,BB,-0.5,8,14,266,7,2016,6,1
Group 1,BB,-0.5,8,14,267,10,2016,8,2
Group 1,BB,-0.5,8,14,268,9,2016,10,-1
Group 1,BB,-0.5,8,14,269,10,2016,10,0
Group 1,BB,-0.5,8,14,270,11,2016,7,4
Group 1,BB,-0.5,8,14,271,9,2016,10,-1
Group 1,BB,-0.5,8,14,272,11,2016,8,3
Group 1,BB,-0.5,8,14,273,6,2016,9,-3
Group 1,BB,-0.5,8,14,274,8,2016,8,0
Group 1,BB,-0.5,8,14,275,10,2016,11,-1
Group 1,BB,-0.5,8,14,276,7,2016,10,-3
Group 1,BB,-0.5,8,14,277,9,2016,8,1
Group 1,BB,-0.5,8,14,278,6,2016,6,0
Group 1,BB,-0.5,8,14,279,11,2016,11,0
Group 1,BB,-0.5,8,14,280,12,2016,9,3
Group 1,BB,-0.5,8,14,281,8,2016,8,0
Group 1,BB,-0.5,8,14,282,11,2016,11,0
Group 1,BB,-0.5,8,14,283,6,2016,9,-3
Group 1,BB,-0.5,8,14,284,8,2016,6,2
Group 1,BB,-0.5,8,14,285,8,2016,9,-1
Group 1,BB,-0.5,8,14,286,8,2016,11,-3
Group 1,BB,-0.5,8,14,287,9,2016,9,0
Group 1,BB,-0.5,8,14,288,7,2016,11,-4
Group 1,BB,-0.5,8,14,289,5,2016,9,-4
Group 1,BB,-0.5,8,14,290,6,2016,6,0
Group 1,BB,-0.5,8,14,291,6,2016,11,-5
Group 1,BB,-0.5,8,14,292,9,2016,9,0
Group 1,BB,-0.5,8,14,293,6,2016,9,-3
Group 1,BB,-0.5,8,14,294,13,2016,8,5
Group 1,BB,-0.5,8,14,295,11,2016,6,5
Group 1,BB,-0.5,8,14,296,4,2016,10,-6
Group 1,BB,-0.5,8,14,297,11,2016,9,2
Group 1,BB,-0.5,8,14,298,9,2016,10,-1
Group 1,BB,-0.5,8,14,299,13,2016,6,7
Group 1,BB,-0.5,8,14,300,6,2016,6,0
Group 1,BB,-0.5,8,14,301,5,2016,9,-4
Group 1,BB,-0.5,8,14,302,4,2016,10,-6
Group 1,BB,-0.5,8,14,303,8,2016,8,0
Group 1,BB,-0.5,8,14,304,7,2016,11,-4
Group 1,BB,-0.5,8,14,305,11,2016,13,-2
Group 1,BB,-0.5,8,14,306,6,2016,12,-6
Group 1,BB,-0.5,8,14,307,8,2016,9,-1
Group 1,BB,-0.5,8,14,308,11,2016,12,-1
Group 1,BB,-0.5,8,14,309,11,2016,4,7
Group 1,BB,-0.5,8,14,310,9,2016,12,-3
Group 1,BB,-0.5,8,14,311,10,2016,7,3
Group 1,BB,-0.5,8,14,312,9,2016,6,3
Group 1,BB,-0.5,8,14,313,10,2016,10,0
Group 1,BB,-0.5,8,14,314,6,2016,12,-6
Group 1,BB,-0.5,8,14,315,10,2016,12,-2
Group 1,BB,-0.5,8,14,316,7,2016,10,-3
Group 1,BB,-0.5,8,14,317,9,2016,11,-2
Group 1,BB,-0.5,8,14,318,9,2016,7,2
Group 1,BB,-0.5,8,14,319,8,2016,7,1
Group 1,BB,-0.5,8,14,320,10,2016,11,-1
Group 1,BB,-0.5,8,14,321,11,2016,8,3
Group 1,BB,-0.5,8,14,322,10,2016,13,-3
Group 1,BB,-0.5,8,14,323,8,2016,9,-1
Group 1,BB,-0.5,8,14,324,7,2016,6,1
Group 1,BB,-0.5,8,14,325,9,2016,8,1
Group 1,BB,-0.5,8,14,326,8,2016,6,2
Group 1,BB,-0.5,8,14,327,10,2016,9,1
Group 1,BB,-0.5,8,14,328,6,2016,11,-5
Group 1,BB,-0.5,8,14,329,9,2016,8,1
Group 1,BB,-0.5,8,14,330,11,2016,9,2
Group 1,BB,-0.5,8,14,331,11,2016,10,1
Group 1,BB,-0.5,8,14,332,9,2016,9,0
Group 1,BB,-0.5,8,14,333,6,2016,10,-4
Group 1,BB,-0.5,8,14,334,11,2016,6,5
Group 1,BB,-0.5,8,14,335,9,2016,9,0
Group 1,BB,-0.5,8,14,336,12,2016,7,5
Group 1,BB,-0.5,8,14,337,7,2016,5,2
Group 1,BB,-0.5,8,14,338,7,2016,6,1
Group 1,BB,-0.5,8,14,339,12,2016,5,7
Group 1,BB,-0.5,8,14,340,13,2016,12,1
Group 1,BB,-0.5,8,14,341,11,2016,12,-1
Group 1,BB,-0.5,8,14,342,10,2016,11,-1
Group 1,BB,-0.5,8,14,343,11,2016,9,2
Group 1,BB,-0.5,8,14,344,11,2016,4,7
Group 1,BB,-0.5,8,14,345,9,2016,9,0
Group 1,BB,-0.5,8,14,346,8,2016,10,-2
Group 1,BB,-0.5,8,14,347,7,2016,5,2
Group 1,BB,-0.5,8,14,348,7,2016,4,3
Group 1,BB,-0.5,8,14,349,10,2016,9,1
Group 1,BB,-0.5,8,14,350,10,2016,9,1
Group 1,BB,-0.5,8,14,351,10,2016,11,-1
Group 1,BB,-0.5,8,14,352,9,2016,7,2
Group 1,BB,-0.5,8,14,353,10,2016,9,1
Group 1,BB,-0.5,8,14,354,9,2016,6,3
Group 1,BB,-0.5,8,14,355,11,2016,11,0
Group 1,BB,-0.5,8,14,356,6,2016,4,2
Group 1,BB,-0.5,8,14,357,11,2016,11,0
Group 1,BB,-0.5,8,14,358,6,2016,13,-7
Group 1,BB,-0.5,8,14,359,10,2016,9,1
Group 1,BB,-0.5,8,14,360,10,2016,6,4
Group 1,BB,-0.5,8,14,361,10,2016,6,4
Group 1,BB,-0.5,8,14,362,6,2016,9,-3
Group 1,BB,-0.5,8,14,363,8,2016,9,-1
Group 1,BB,-0.5,8,14,364,8,2016,7,1
Group 1,BB,-0.5,8,14,365,7,2016,8,-1
Group 1,BB,-0.5,8,14,366,10,2016,6,4
Group 1,BB,-0.5,8,14,367,8,2016,7,1
Group 1,BB,-0.5,8,14,368,7,2016,9,-2
Group 1,BB,-0.5,8,14,369,13,2016,7,6
Group 1,BB,-0.5,8,14,370,11,2016,7,4
Group 1,BB,-0.5,8,14,371,10,2016,10,0
Group 1,BB,-0.5,8,14,372,8,2016,9,-1
Group 1,BB,-0.5,8,14,373,9,2016,11,-2
Group 1,BB,-0.5,8,14,374,11,2016,7,4
Group 1,BB,-0.5,8,14,375,6,2016,9,-3
Group 1,BB,-0.5,8,14,376,11,2016,6,5
Group 1,BB,-0.5,8,14,377,8,2016,10,-2
Group 1,BB,-0.5,8,14,378,10,2016,9,1
Group 1,BB,-0.5,8,14,379,10,2016,9,1
Group 1,BB,-0.5,8,14,380,6,2016,8,-2
Group 1,BB,-0.5,8,14,381,9,2016,11,-2
Group 1,BB,-0.5,8,14,382,10,2016,4,6
Group 1,BB,-0.5,8,14,383,11,2016,7,4
Group 1,BB,-0.5,8,14,384,10,2016,9,1
Group 1,BB,-0.5,8,14,385,9,2016,8,1
Group 1,BB,-0.5,8,14,386,9,2016,11,-2
Group 1,BB,-0.5,8,14,387,9,2016,9,0
Group 1,BB,-0.5,8,14,388,13,2016,10,3
Group 1,BB,-0.5,8,14,389,10,2016,9,1
Group 1,BB,-0.5,8,14,390,10,2016,7,3
Group 1,BB,-0.5,8,14,391,10,2016,3,7
Group 1,BB,-0.5,8,14,392,12,2016,9,3
Group 1,BB,-0.5,8,14,393,8,2016,11,-3
Group 1,BB,-0.5,8,14,394,13,2016,6,7
Group 1,BB,-0.5,8,14,395,6,2016,11,-5
Group 1,BB,-0.5,8,14,396,7,2016,6,1
Group 1,BB,-0.5,8,14,397,9,2016,11,-2
Group 1,BB,-0.5,8,14,398,8,2016,7,1
Group 1,BB,-0.5,8,14,399,9,2016,8,1
Group 1,BB,-0.5,8,14,400,8,2016,2,6
Group 1,BB,-0.5,8,14,401,7,2016,6,1
Group 1,BB,-0.5,8,14,402,8,2016,10,-2
Group 1,BB,-0.5,8,14,403,9,2016,7,2
Group 1,BB,-0.5,8,14,404,9,2016,6,3
Group 1,BB,-0.5,8,14,405,6,2016,8,-2
Group 1,BB,-0.5,8,14,406,10,2016,8,2
Group 1,BB,-0.5,8,14,407,8,2016,5,3
Group 1,BB,-0.5,8,14,408,11,2016,4,7
Group 1,BB,-0.5,8,14,409,7,2016,11,-4
Group 1,BB,-0.5,8,14,410,9,2016,7,2
Group 1,BB,-0.5,8,14,411,9,2016,12,-3
Group 1,BB,-0.5,8,14,412,7,2016,11,-4
Group 1,BB,-0.5,8,14,413,8,2016,7,1
Group 1,BB,-0.5,8,14,414,9,2016,9,0
Group 1,BB,-0.5,8,14,415,6,2016,3,3
Group 1,BB,-0.5,8,14,416,10,2016,9,1
Group 1,BB,-0.5,8,14,417,9,2016,6,3
Group 1,BB,-0.5,8,14,418,7,2016,10,-3
Group 1,BB,-0.5,8,14,419,7,2016,4,3
Group 1,BB,-0.5,8,14,420,10,2016,5,5
Group 1,BB,-0.5,8,14,421,7,2016,9,-2
Group 1,BB,-0.5,8,14,422,10,2016,7,3
Group 1,BB,-0.5,8,14,423,5,2016,3,2
Group 1,BB,-0.5,8,14,424,11,2016,7,4
Group 1,BB,-0.5,8,14,425,7,2016,6,1
Group 1,BB,-0.5,8,14,426,8,2016,6,2
Group 1,BB,-0.5,8,14,427,9,2016,7,2
Group 1,BB,-0.5,8,14,428,11,2016,9,2
Group 1,BB,-0.5,8,14,429,9,2016,9,0
Group 1,BB,-0.5,8,14,430,10,2016,6,4
Group 1,BB,-0.5,8,14,431,11,2016,9,2
Group 1,BB,-0.5,8,14,432,8,2016,12,-4
Group 1,BB,-0.5,8,14,433,9,2016,5,4
Group 1,BB,-0.5,8,14,434,5,2016,6,-1
Group 1,BB,-0.5,8,14,435,11,2016,8,3
Group 1,BB,-0.5,8,14,436,4,2016,8,-4
Group 1,BB,-0.5,8,14,437,10,2016,10,0
Group 1,BB,-0.5,8,14,438,10,2016,7,3
Group 1,BB,-0.5,8,14,439,12,2016,11,1
Group 1,BB,-0.5,8,14,440,8,2016,6,2
Group 1,BB,-0.5,8,14,441,8,2016,10,-2
Group 1,BB,-0.5,8,14,442,11,2016,9,2
Group 1,BB,-0.5,8,14,443,8,2016,7,1
Group 1,BB,-0.5,8,14,444,10,2016,8,2
Group 1,BB,-0.5,8,14,445,11,2016,10,1
Group 1,BB,-0.5,8,14,446,8,2016,4,4
Group 1,BB,-0.5,8,14,447,9,2016,10,-1
Group 1,BB,-0.5,8,14,448,8,2016,10,-2
Group 1,BB,-0.5,8,14,449,9,2016,12,-3
Group 1,BB,-0.5,8,14,450,11,2016,10,1
Group 1,BB,-0.5,8,14,451,10,2016,8,2
Group 1,BB,-0.5,8,14,452,10,2016,3,7
Group 1,BB,-0.5,8,14,453,10,2016,12,-2
Group 1,BB,-0.5,8,14,454,10,2016,7,3
Group 1,BB,-0.5,8,14,455,7,2016,5,2
Group 1,BB,-0.5,8,14,456,6,2016,9,-3
Group 1,BB,-0.5,8,14,457,8,2016,8,0
Group 1,BB,-0.5,8,14,458,8,2016,8,0
Group 1,BB,-0.5,8,14,459,8,2016,10,-2
Group 1,BB,-0.5,8,14,460,11,2016,8,3
Group 1,BB,-0.5,8,14,461,7,2016,10,-3
Group 1,BB,-0.5,8,14,462,4,2016,10,-6
Group 1,BB,-0.5,8,14,463,7,2016,9,-2
Group 1,BB,-0.5,8,14,464,8,2016,7,1
Group 1,BB,-0.5,8,14,465,9,2016,5,4
Group 1,BB,-0.5,8,14,466,7,2016,5,2
Group 1,BB,-0.5,8,14,467,9,2016,11,-2
Group 1,BB,-0.5,8,14,468,9,2016,7,2
Group 1,BB,-0.5,8,14,469,11,2016,12,-1
Group 1,BB,-0.5,8,14,470,9,2016,10,-1
Group 1,BB,-0.5,8,14,471,10,2016,5,5
Group 1,BB,-0.5,8,14,472,10,2016,7,3
Group 1,BB,-0.5,8,14,473,8,2016,8,0
Group 1,BB,-0.5,8,14,474,13,2016,7,6
Group 1,BB,-0.5,8,14,475,10,2016,9,1
Group 1,BB,-0.5,8,14,476,9,2016,9,0
Group 1,BB,-0.5,8,14,477,8,2016,11,-3
Group 1,BB,-0.5,8,14,478,8,2016,10,-2
Group 1,BB,-0.5,8,14,479,9,2016,9,0
Group 1,BB,-0.5,8,14,480,6,2016,8,-2
Group 1,BB,-0.5,8,14,481,9,2016,8,1
Group 1,BB,-0.5,8,14,482,7,2016,9,-2
Group 1,BB,-0.5,8,14,483,12,2016,10,2
Group 1,BB,-0.5,8,14,484,10,2016,9,1
Group 1,BB,-0.5,8,14,485,8,2016,12,-4
Group 1,BB,-0.5,8,14,486,8,2016,5,3
Group 1,BB,-0.5,8,14,487,8,2016,7,1
Group 1,BB,-0.5,8,14,488,9,2016,8,1
Group 1,BB,-0.5,8,14,489,9,2016,7,2
Group 1,BB,-0.5,8,14,490,11,2016,5,6
Group 1,BB,-0.5,8,14,491,7,2016,11,-4
Group 1,BB,-0.5,8,14,492,10,2016,8,2
Group 1,BB,-0.5,8,14,493,11,2016,9,2
Group 1,BB,-0.5,8,14,494,5,2016,9,-4
Group 1,BB,-0.5,8,14,495,10,2016,8,2
Group 1,BB,-0.5,8,14,496,11,2016,9,2
Group 1,BB,-0.5,8,14,497,6,2016,6,0
Group 1,BB,-0.5,8,14,498,10,2016,9,1
Group 1,BB,-0.5,8,14,499,13,2016,9,4
Group 1,BB,-0.5,8,14,500,8,2016,7,1
Group 1,BB,-0.5,8,14,501,7,2016,4,3
Group 1,BB,-0.5,8,14,502,8,2016,4,4
Group 1,BB,-0.5,8,14,503,9,2016,11,-2
Group 1,BB,-0.5,8,14,504,8,2016,5,3
Group 1,BB,-0.5,8,14,505,10,2016,5,5
Group 1,BB,-0.5,8,14,506,8,2016,7,1
Group 1,BB,-0.5,8,14,507,10,2016,11,-1
Group 1,BB,-0.5,8,14,508,9,2016,11,-2
Group 1,BB,-0.5,8,14,509,13,2016,9,4
Group 1,BB,-0.5,8,14,510,12,2016,8,4
Group 1,BB,-0.5,8,14,511,10,2016,6,4
Group 1,BB,-0.5,8,14,512,8,2016,11,-3
Group 1,BB,-0.5,8,14,513,8,2016,8,0
Group 1,BB,-0.5,8,14,514,9,2016,9,0
Group 1,BB,-0.5,8,14,515,8,2016,8,0
Group 1,BB,-0.5,8,14,516,5,2016,6,-1
Group 1,BB,-0.5,8,14,517,9,2016,5,4
Group 1,BB,-0.5,8,14,518,6,2016,8,-2
Group 1,BB,-0.5,8,14,519,5,2016,8,-3
Group 1,BB,-0.5,8,14,520,9,2016,5,4
Group 1,BB,-0.5,8,14,521,8,2016,8,0
Group 1,BB,-0.5,8,14,522,9,2016,6,3
Group 1,BB,-0.5,8,14,523,11,2016,9,2
Group 1,BB,-0.5,8,14,524,12,2016,10,2
Group 1,BB,-0.5,8,14,525,10,2016,11,-1
Group 1,BB,-0.5,8,14,526,8,2016,10,-2
Group 1,BB,-0.5,8,14,527,8,2016,7,1
Group 1,BB,-0.5,8,14,528,12,2016,9,3
Group 1,BB,-0.5,8,14,529,8,2016,8,0
Group 1,BB,-0.5,8,14,530,6,2016,9,-3
Group 1,BB,-0.5,8,14,531,7,2016,8,-1
Group 1,BB,-0.5,8,14,532,9,2016,12,-3
Group 1,BB,-0.5,8,14,533,8,2016,9,-1
Group 1,BB,-0.5,8,14,534,8,2016,8,0
Group 1,BB,-0.5,8,14,535,11,2016,11,0
Group 1,BB,-0.5,8,14,536,10,2016,7,3
Group 1,BB,-0.5,8,14,537,10,2016,10,0
Group 1,BB,-0.5,8,14,538,9,2016,11,-2
Group 1,BB,-0.5,8,14,539,10,2016,5,5
Group 1,BB,-0.5,8,14,540,7,2016,10,-3
Group 1,BB,-0.5,8,14,541,10,2016,5,5
Group 1,BB,-0.5,8,14,542,10,2016,7,3
Group 1,BB,-0.5,8,14,543,10,2016,8,2
Group 1,BB,-0.5,8,14,544,8,2016,8,0
Group 1,BB,-0.5,8,14,545,7,2016,7,0
Group 1,BB,-0.5,8,14,546,9,2016,4,5
Group 1,BB,-0.5,8,14,547,8,2016,6,2
Group 1,BB,-0.5,8,14,548,10,2016,6,4
Group 1,BB,-0.5,8,14,549,8,2016,9,-1
Group 1,BB,-0.5,8,14,550,12,2016,9,3
Group 1,BB,-0.5,8,14,551,11,2016,9,2
Group 1,BB,-0.5,8,14,552,9,2016,5,4
Group 1,BB,-0.5,8,14,553,12,2016,10,2
Group 1,BB,-0.5,8,14,554,8,2016,10,-2
Group 1,BB,-0.5,8,14,555,9,2016,10,-1
Group 1,BB,-0.5,8,14,556,4,2016,6,-2
Group 1,BB,-0.5,8,14,557,12,2016,10,2
Group 1,BB,-0.5,8,14,558,7,2016,6,1
Group 1,BB,-0.5,8,14,559,13,2016,8,5
Group 1,BB,-0.5,8,14,560,8,2016,9,-1
Group 1,BB,-0.5,8,14,561,4,2016,10,-6
Group 1,BB,-0.5,8,14,562,8,2016,5,3
Group 1,BB,-0.5,8,14,563,8,2016,10,-2
Group 1,BB,-0.5,8,14,564,6,2016,11,-5
Group 1,BB,-0.5,8,14,565,12,2016,12,0
Group 1,BB,-0.5,8,14,566,9,2016,8,1
Group 1,BB,-0.5,8,14,567,9,2016,5,4
Group 1,BB,-0.5,8,14,568,6,2016,8,-2
Group 1,BB,-0.5,8,14,569,6,2016,13,-7
Group 1,BB,-0.5,8,14,570,10,2016,8,2
Group 1,BB,-0.5,8,14,571,7,2016,6,1
Group 1,BB,-0.5,8,14,572,8,2016,12,-4
Group 1,BB,-0.5,8,14,573,9,2016,7,2
Group 1,BB,-0.5,8,14,574,9,2016,7,2
Group 1,BB,-0.5,8,14,575,7,2016,10,-3
Group 1,BB,-0.5,8,14,576,10,2016,7,3
Group 1,BB,-0.5,8,14,577,10,2016,10,0
Group 1,BB,-0.5,8,14,578,6,2016,8,-2
Group 1,BB,-0.5,8,14,579,6,2016,12,-6
Group 1,BB,-0.5,8,14,580,9,2016,7,2
Group 1,BB,-0.5,8,14,581,13,2016,5,8
Group 1,BB,-0.5,8,14,582,10,2016,4,6
Group 1,BB,-0.5,8,14,583,9,2016,10,-1
Group 1,BB,-0.5,8,14,584,7,2016,5,2
Group 1,BB,-0.5,8,14,585,6,2016,11,-5
Group 1,BB,-0.5,8,14,586,8,2016,10,-2
Group 1,BB,-0.5,8,14,587,10,2016,10,0
Group 1,BB,-0.5,8,14,588,9,2016,7,2
Group 1,BB,-0.5,8,14,589,10,2016,9,1
Group 1,BB,-0.5,8,14,590,9,2016,8,1
Group 1,BB,-0.5,8,14,591,9,2016,10,-1
Group 1,BB,-0.5,8,14,592,6,2016,11,-5
Group 1,BB,-0.5,8,14,593,12,2016,12,0
Group 1,BB,-0.5,8,14,594,7,2016,8,-1
Group 1,BB,-0.5,8,14,595,8,2016,9,-1
Group 1,BB,-0.5,8,14,596,6,2016,8,-2
Group 1,BB,-0.5,8,14,597,10,2016,6,4
Group 1,BB,-0.5,8,14,598,9,2016,6,3
Group 1,BB,-0.5,8,14,599,8,2016,10,-2
Group 1,BB,-0.5,8,14,600,6,2016,7,-1
Group 1,BB,-0.5,8,14,601,8,2016,9,-1
Group 1,BB,-0.5,8,14,602,10,2016,9,1
Group 1,BB,-0.5,8,14,603,12,2016,9,3
Group 1,BB,-0.5,8,14,604,8,2016,9,-1
Group 1,BB,-0.5,8,14,605,9,2016,8,1
Group 1,BB,-0.5,8,14,606,5,2016,9,-4
Group 1,BB,-0.5,8,14,607,9,2016,4,5
Group 1,BB,-0.5,8,14,608,11,2016,5,6
Group 1,BB,-0.5,8,14,609,10,2016,8,2
Group 1,BB,-0.5,8,14,610,10,2016,8,2
Group 1,BB,-0.5,8,14,611,12,2016,7,5
Group 1,BB,-0.5,8,14,612,6,2016,8,-2
Group 1,BB,-0.5,8,14,613,4,2016,9,-5
Group 1,BB,-0.5,8,14,614,8,2016,10,-2
Group 1,BB,-0.5,8,14,615,9,2016,5,4
Group 1,BB,-0.5,8,14,616,6,2016,8,-2
Group 1,BB,-0.5,8,14,617,10,2016,10,0
Group 1,BB,-0.5,8,14,618,9,2016,8,1
Group 1,BB,-0.5,8,14,619,8,2016,10,-2
Group 1,BB,-0.5,8,14,620,8,2016,8,0
Group 1,BB,-0.5,8,14,621,7,2016,7,0
Group 1,BB,-0.5,8,14,622,6,2016,3,3
Group 1,BB,-0.5,8,14,623,5,2016,4,1
Group 1,BB,-0.5,8,14,624,9,2016,7,2
Group 1,BB,-0.5,8,14,625,8,2016,6,2
Group 1,BB,-0.5,8,14,626,9,2016,8,1
Group 1,BB,-0.5,8,14,627,7,2016,5,2
Group 1,BB,-0.5,8,14,628,8,2016,5,3
Group 1,BB,-0.5,8,14,629,12,2016,7,5
Group 1,BB,-0.5,8,14,630,11,2016,5,6
Group 1,BB,-0.5,8,14,631,8,2016,6,2
Group 1,BB,-0.5,8,14,632,12,2016,9,3
Group 1,BB,-0.5,8,14,633,7,2016,6,1
Group 1,BB,-0.5,8,14,634,8,2016,8,0
Group 1,BB,-0.5,8,14,635,8,2016,7,1
Group 1,BB,-0.5,8,14,636,11,2016,9,2
Group 1,BB,-0.5,8,14,637,11,2016,10,1
Group 1,BB,-0.5,8,14,638,10,2016,9,1
Group 1,BB,-0.5,8,14,639,11,2016,8,3
Group 1,BB,-0.5,8,14,640,7,2016,11,-4
Group 1,BB,-0.5,8,14,641,10,2016,9,1
Group 1,BB,-0.5,8,14,642,11,2016,7,4
Group 1,BB,-0.5,8,14,643,9,2016,9,0
Group 1,BB,-0.5,8,14,644,9,2016,8,1
Group 1,BB,-0.5,8,14,645,10,2016,9,1
Group 1,BB,-0.5,8,14,646,11,2016,10,1
Group 1,BB,-0.5,8,14,647,9,2016,12,-3
Group 1,BB,-0.5,8,14,648,7,2016,12,-5
Group 1,BB,-0.5,8,14,649,8,2016,6,2
Group 1,BB,-0.5,8,14,650,7,2016,10,-3
Group 1,BB,-0.5,8,14,651,10,2016,9,1
Group 1,BB,-0.5,8,14,652,9,2016,6,3
Group 1,BB,-0.5,8,14,653,8,2016,7,1
Group 1,BB,-0.5,8,14,654,9,2016,9,0
Group 1,BB,-0.5,8,14,655,11,2016,9,2
Group 1,BB,-0.5,8,14,656,9,2016,7,2
Group 1,BB,-0.5,8,14,657,9,2016,6,3
Group 1,BB,-0.5,8,14,658,10,2016,6,4
Group 1,BB,-0.5,8,14,659,9,2016,11,-2
Group 1,BB,-0.5,8,14,660,7,2016,6,1
Group 1,BB,-0.5,8,14,661,8,2016,10,-2
Group 1,BB,-0.5,8,14,662,10,2016,3,7
Group 1,BB,-0.5,8,14,663,11,2016,7,4
Group 1,BB,-0.5,8,14,664,9,2016,7,2
Group 1,BB,-0.5,8,14,665,6,2016,5,1
Group 1,BB,-0.5,8,14,666,8,2016,9,-1
Group 1,BB,-0.5,8,14,667,6,2016,7,-1
Group 1,BB,-0.5,8,14,668,9,2016,9,0
Group 1,BB,-0.5,8,14,669,9,2016,7,2
Group 1,BB,-0.5,8,14,670,11,2016,9,2
Group 1,BB,-0.5,8,14,671,8,2016,8,0
Group 1,BB,-0.5,8,14,672,9,2016,6,3
Group 1,BB,-0.5,8,14,673,6,2016,6,0
Group 1,BB,-0.5,8,14,674,9,2016,10,-1
Group 1,BB,-0.5,8,14,675,11,2016,9,2
Group 1,BB,-0.5,8,14,676,9,2016,5,4
Group 1,BB,-0.5,8,14,677,9,2016,9,0
Group 1,BB,-0.5,8,14,678,10,2016,8,2
Group 1,BB,-0.5,8,14,679,10,2016,7,3
Group 1,BB,-0.5,8,14,680,9,2016,10,-1
Group 1,BB,-0.5,8,14,681,12,2016,7,5
Group 1,BB,-0.5,8,14,682,11,2016,9,2
Group 1,BB,-0.5,8,14,683,8,2016,7,1
Group 1,BB,-0.5,8,14,684,10,2016,4,6
Group 1,BB,-0.5,8,14,685,10,2016,7,3
Group 1,BB,-0.5,8,14,686,9,2016,11,-2
Group 1,BB,-0.5,8,14,687,9,2016,10,-1
Group 1,BB,-0.5,8,14,688,9,2016,11,-2
Group 1,BB,-0.5,8,14,689,7,2016,5,2
Group 1,BB,-0.5,8,14,690,7,2016,8,-1
Group 1,BB,-0.5,8,14,691,9,2016,8,1
Group 1,BB,-0.5,8,14,692,8,2016,7,1
Group 1,BB,-0.5,8,14,693,10,2016,10,0
Group 1,BB,-0.5,8,14,694,12,2016,10,2
Group 1,BB,-0.5,8,14,695,10,2016,6,4
Group 1,BB,-0.5,8,14,696,5,2016,8,-3
Group 1,BB,-0.5,8,14,697,8,2016,7,1
Group 1,BB,-0.5,8,14,698,6,2016,5,1
Group 1,BB,-0.5,8,14,699,7,2016,5,2
Group 1,BB,-0.5,8,14,700,8,2016,8,0
Group 1,BB,-0.5,8,14,701,8,2016,9,-1
Group 1,BB,-0.5,8,14,702,8,2016,10,-2
Group 1,BB,-0.5,8,14,703,7,2016,7,0
Group 1,BB,-0.5,8,14,704,9,2016,8,1
Group 1,BB,-0.5,8,14,705,8,2016,10,-2
Group 1,BB,-0.5,8,14,706,9,2016,5,4
Group 1,BB,-0.5,8,14,707,8,2016,8,0
Group 1,BB,-0.5,8,14,708,11,2016,7,4
Group 1,BB,-0.5,8,14,709,7,2016,6,1
Group 1,BB,-0.5,8,14,710,8,2016,9,-1
Group 1,BB,-0.5,8,14,711,6,2016,5,1
Group 1,BB,-0.5,8,14,712,8,2016,12,-4
Group 1,BB,-0.5,8,14,713,7,2016,9,-2
Group 1,BB,-0.5,8,14,714,8,2016,10,-2
Group 1,BB,-0.5,8,14,715,11,2016,5,6
Group 1,BB,-0.5,8,14,716,11,2016,7,4
Group 1,BB,-0.5,8,14,717,10,2016,7,3
Group 1,BB,-0.5,8,14,718,6,2016,8,-2
Group 1,BB,-0.5,8,14,719,8,2016,9,-1
Group 1,BB,-0.5,8,14,720,7,2016,9,-2
Group 1,BB,-0.5,8,14,721,11,2016,7,4
Group 1,BB,-0.5,8,14,722,10,2016,9,1
Group 1,BB,-0.5,8,14,723,7,2016,8,-1
Group 1,BB,-0.5,8,14,724,10,2016,9,1
Group 1,BB,-0.5,8,14,725,8,2016,7,1
Group 1,BB,-0.5,8,14,726,10,2016,6,4
Group 1,BB,-0.5,8,14,727,4,2016,5,-1
Group 1,BB,-0.5,8,14,728,11,2016,6,5
Group 1,BB,-0.5,8,14,729,8,2016,7,1
Group 1,BB,-0.5,8,14,730,12,2016,12,0
Group 1,BB,-0.5,8,14,731,9,2016,5,4
Group 1,BB,-0.5,8,14,732,8,2016,7,1
Group 1,BB,-0.5,8,14,733,10,2016,4,6
Group 1,BB,-0.5,8,14,734,11,2016,9,2
Group 1,BB,-0.5,8,14,735,13,2016,10,3
Group 1,BB,-0.5,8,14,736,11,2016,9,2
Group 1,BB,-0.5,8,14,737,10,2016,7,3
Group 1,BB,-0.5,8,14,738,6,2016,9,-3
Group 1,BB,-0.5,8,14,739,8,2016,11,-3
Group 1,BB,-0.5,8,14,740,10,2016,9,1
Group 1,BB,-0.5,8,14,741,10,2016,8,2
Group 1,BB,-0.5,8,14,742,9,2016,8,1
Group 1,BB,-0.5,8,14,743,7,2016,11,-4
Group 1,BB,-0.5,8,14,744,7,2016,9,-2
Group 1,BB,-0.5,8,14,745,9,2016,3,6
Group 1,BB,-0.5,8,14,746,10,2016,5,5
Group 1,BB,-0.5,8,14,747,11,2016,8,3
Group 1,BB,-0.5,8,14,748,10,2016,4,6
Group 1,BB,-0.5,8,14,749,8,2016,8,0
Group 1,BB,-0.5,8,14,750,10,2016,4,6
Group 1,BB,-0.5,8,14,751,9,2016,8,1
Group 1,BB,-0.5,8,14,752,8,2016,6,2
Group 1,BB,-0.5,8,14,753,9,2016,9,0
Group 1,BB,-0.5,8,14,754,10,2016,9,1
Group 1,BB,-0.5,8,14,755,10,2016,6,4
Group 1,BB,-0.5,8,14,756,7,2016,6,1
Group 1,BB,-0.5,8,14,757,10,2016,7,3
Group 1,BB,-0.5,8,14,758,8,2016,9,-1
Group 1,BB,-0.5,8,14,759,6,2016,8,-2
Group 1,BB,-0.5,8,14,760,9,2016,6,3
Group 1,BB,-0.5,8,14,761,11,2016,9,2
Group 1,BB,-0.5,8,14,762,9,2016,8,1
Group 1,BB,-0.5,8,14,763,8,2016,7,1
Group 1,BB,-0.5,8,14,764,12,2016,10,2
Group 1,BB,-0.5,8,14,765,9,2016,10,-1
Group 1,BB,-0.5,8,14,766,11,2016,7,4
Group 1,BB,-0.5,8,14,767,13,2016,9,4
Group 1,BB,-0.5,8,14,768,10,2016,7,3
Group 1,BB,-0.5,8,14,769,9,2016,6,3
Group 1,BB,-0.5,8,14,770,7,2016,7,0
Group 1,BB,-0.5,8,14,771,10,2016,7,3
Group 1,BB,-0.5,8,14,772,11,2016,10,1
Group 1,BB,-0.5,8,14,773,6,2016,7,-1
Group 1,BB,-0.5,8,14,774,7,2016,10,-3
Group 1,BB,-0.5,8,14,775,10,2016,7,3
Group 1,BB,-0.5,8,14,776,6,2016,6,0
Group 1,BB,-0.5,8,14,777,7,2016,7,0
Group 1,BB,-0.5,8,14,778,8,2016,7,1
Group 1,BB,-0.5,8,14,779,8,2016,5,3
Group 1,BB,-0.5,8,14,780,11,2016,5,6
Group 1,BB,-0.5,8,14,781,7,2016,8,-1
Group 1,BB,-0.5,8,14,782,3,2016,10,-7
Group 1,BB,-0.5,8,14,783,7,2016,5,2
Group 1,BB,-0.5,8,14,784,11,2016,9,2
Group 1,BB,-0.5,8,14,785,10,2016,9,1
Group 1,BB,-0.5,8,14,786,10,2016,10,0
Group 1,BB,-0.5,8,14,787,9,2016,7,2
Group 1,BB,-0.5,8,14,788,7,2016,9,-2
Group 1,BB,-0.5,8,14,789,6,2016,8,-2
Group 1,BB,-0.5,8,14,790,6,2016,7,-1
Group 1,BB,-0.5,8,14,791,13,2016,9,4
Group 1,BB,-0.5,8,14,792,11,2016,8,3
Group 1,BB,-0.5,8,14,793,11,2016,6,5
Group 1,BB,-0.5,8,14,794,10,2016,8,2
Group 1,BB,-0.5,8,14,795,5,2016,8,-3
Group 1,BB,-0.5,8,14,796,8,2016,8,0
Group 1,BB,-0.5,8,14,797,10,2016,12,-2
Group 1,BB,-0.5,8,14,798,8,2016,8,0
Group 1,BB,-0.5,8,14,799,11,2016,10,1
Group 1,BB,-0.5,8,14,800,9,2016,8,1
Group 1,BB,-0.5,8,14,801,8,2016,7,1
Group 1,BB,-0.5,8,14,802,10,2016,7,3
Group 1,BB,-0.5,8,14,803,12,2016,6,6
Group 1,BB,-0.5,8,14,804,7,2016,5,2
Group 1,BB,-0.5,8,14,805,7,2016,5,2
Group 1,BB,-0.5,8,14,806,9,2016,6,3
Group 1,BB,-0.5,8,14,807,5,2016,4,1
Group 1,BB,-0.5,8,14,808,10,2016,7,3
Group 1,BB,-0.5,8,14,809,8,2016,10,-2
Group 1,BB,-0.5,8,14,810,6,2016,11,-5
Group 1,BB,-0.5,8,14,811,9,2016,7,2
Group 1,BB,-0.5,8,14,812,9,2016,6,3
Group 1,BB,-0.5,8,14,813,12,2016,6,6
Group 1,BB,-0.5,8,14,814,9,2016,5,4
Group 1,BB,-0.5,8,14,815,7,2016,7,0
Group 1,BB,-0.5,8,14,816,11,2016,8,3
Group 1,BB,-0.5,8,14,817,9,2016,8,1
Group 1,BB,-0.5,8,14,818,10,2016,5,5
Group 1,BB,-0.5,8,14,819,8,2016,9,-1
Group 1,BB,-0.5,8,14,820,9,2016,3,6
Group 1,BB,-0.5,8,14,821,9,2016,5,4
Group 1,BB,-0.5,8,14,822,9,2016,3,6
Group 1,BB,-0.5,8,14,823,14,2016,9,5
Group 1,BB,-0.5,8,14,824,12,2016,8,4
Group 1,BB,-0.5,8,14,825,7,2016,8,-1
Group 1,BB,-0.5,8,14,826,11,2016,6,5
Group 1,BB,-0.5,8,14,827,9,2016,6,3
Group 1,BB,-0.5,8,14,828,8,2016,5,3
Group 1,BB,-0.5,8,14,829,8,2016,5,3
Group 1,BB,-0.5,8,14,830,7,2016,8,-1
Group 1,BB,-0.5,8,14,831,9,2016,7,2
Group 1,BB,-0.5,8,14,832,10,2016,8,2
Group 1,BB,-0.5,8,14,833,10,2016,4,6
Group 1,BB,-0.5,8,14,834,10,2016,9,1
Group 1,BB,-0.5,8,14,835,7,2016,10,-3
Group 1,BB,-0.5,8,14,836,10,2016,10,0
Group 1,BB,-0.5,8,14,837,8,2016,8,0
Group 1,BB,-0.5,8,14,838,9,2016,6,3
Group 1,BB,-0.5,8,14,839,9,2016,8,1
Group 1,BB,-0.5,8,14,840,10,2016,7,3
Group 1,BB,-0.5,8,14,841,10,2016,5,5
Group 1,BB,-0.5,8,14,842,9,2016,8,1
Group 1,BB,-0.5,8,14,843,7,2016,3,4
Group 1,BB,-0.5,8,14,844,6,2016,8,-2
Group 1,BB,-0.5,8,14,845,7,2016,9,-2
Group 1,BB,-0.5,8,14,846,9,2016,5,4
Group 1,BB,-0.5,8,14,847,6,2016,7,-1
Group 1,BB,-0.5,8,14,848,9,2016,5,4
Group 1,BB,-0.5,8,14,849,8,2016,7,1
Group 1,BB,-0.5,8,14,850,11,2016,11,0
Group 1,BB,-0.5,8,14,851,9,2016,5,4
Group 1,BB,-0.5,8,14,852,9,2016,7,2
Group 1,BB,-0.5,8,14,853,9,2016,9,0
Group 1,BB,-0.5,8,14,854,9,2016,6,3
Group 1,BB,-0.5,8,14,855,9,2016,7,2
Group 1,BB,-0.5,8,14,856,8,2016,8,0
Group 1,BB,-0.5,8,14,857,8,2016,6,2
Group 1,BB,-0.5,8,14,858,10,2016,12,-2
Group 1,BB,-0.5,8,14,859,12,2016,10,2
Group 1,BB,-0.5,8,14,860,9,2016,8,1
Group 1,BB,-0.5,8,14,861,7,2016,10,-3
Group 1,BB,-0.5,8,14,862,12,2016,9,3
Group 1,BB,-0.5,8,14,863,9,2016,6,3
Group 1,BB,-0.5,8,14,864,11,2016,7,4
Group 1,BB,-0.5,8,14,865,6,2016,7,-1
Group 1,BB,-0.5,8,14,866,6,2016,9,-3
Group 1,BB,-0.5,8,14,867,5,2016,5,0
Group 1,BB,-0.5,8,14,868,7,2016,7,0
Group 1,BB,-0.5,8,14,869,10,2016,9,1
Group 1,BB,-0.5,8,14,870,11,2016,7,4
Group 1,BB,-0.5,8,14,871,11,2016,7,4
Group 1,BB,-0.5,8,14,872,7,2016,5,2
Group 1,BB,-0.5,8,14,873,7,2016,10,-3
Group 1,BB,-0.5,8,14,874,8,2016,7,1
Group 1,BB,-0.5,8,14,875,4,2016,8,-4
Group 1,BB,-0.5,8,14,876,11,2016,11,0
Group 1,BB,-0.5,8,14,877,9,2016,9,0
Group 1,BB,-0.5,8,14,878,8,2016,5,3
Group 1,BB,-0.5,8,14,879,5,2016,6,-1
Group 1,BB,-0.5,8,14,880,7,2016,7,0
Group 1,BB,-0.5,8,14,881,8,2016,2,6
Group 1,BB,-0.5,8,14,882,9,2016,7,2
Group 1,BB,-0.5,8,14,883,8,2016,9,-1
Group 1,BB,-0.5,8,14,884,8,2016,7,1
Group 1,BB,-0.5,8,14,885,10,2016,8,2
Group 1,BB,-0.5,8,14,886,7,2016,8,-1
Group 1,BB,-0.5,8,14,887,7,2016,8,-1
Group 1,BB,-0.5,8,14,888,8,2016,10,-2
Group 1,BB,-0.5,8,14,889,9,2016,10,-1
Group 1,BB,-0.5,8,14,890,11,2016,7,4
Group 1,BB,-0.5,8,14,891,9,2016,7,2
Group 1,BB,-0.5,8,14,892,10,2016,7,3
Group 1,BB,-0.5,8,14,893,9,2016,7,2
Group 1,BB,-0.5,8,14,894,6,2016,7,-1
Group 1,BB,-0.5,8,14,895,11,2016,11,0
Group 1,BB,-0.5,8,14,896,11,2016,13,-2
Group 1,BB,-0.5,8,14,897,8,2016,6,2
Group 1,BB,-0.5,8,14,898,7,2016,5,2
Group 1,BB,-0.5,8,14,899,9,2016,6,3
Group 1,BB,-0.5,8,14,900,7,2016,13,-6
Group 1,BB,-0.5,8,14,901,8,2016,5,3
Group 1,BB,-0.5,8,14,902,9,2016,10,-1
Group 1,BB,-0.5,8,14,903,6,2016,7,-1
Group 1,BB,-0.5,8,14,904,12,2016,8,4
Group 1,BB,-0.5,8,14,905,9,2016,9,0
Group 1,BB,-0.5,8,14,906,9,2016,3,6
Group 1,BB,-0.5,8,14,907,9,2016,8,1
Group 1,BB,-0.5,8,14,908,9,2016,7,2
Group 1,BB,-0.5,8,14,909,9,2016,10,-1
Group 1,BB,-0.5,8,14,910,9,2016,10,-1
Group 1,BB,-0.5,8,14,911,9,2016,8,1
Group 1,BB,-0.5,8,14,912,9,2016,10,-1
Group 1,BB,-0.5,8,14,913,9,2016,5,4
Group 1,BB,-0.5,8,14,914,12,2016,8,4
Group 1,BB,-0.5,8,14,915,11,2016,5,6
Group 1,BB,-0.5,8,14,916,8,2016,5,3
Group 1,BB,-0.5,8,14,917,11,2016,5,6
Group 1,BB,-0.5,8,14,918,9,2016,7,2
Group 1,BB,-0.5,8,14,919,10,2016,10,0
Group 1,BB,-0.5,8,14,920,9,2016,7,2
Group 1,BB,-0.5,8,14,921,11,2016,5,6
Group 1,BB,-0.5,8,14,922,11,2016,5,6
Group 1,BB,-0.5,8,14,923,8,2016,11,-3
Group 1,BB,-0.5,8,14,924,10,2016,9,1
Group 1,BB,-0.5,8,14,925,9,2016,6,3
Group 1,BB,-0.5,8,14,926,8,2016,8,0
Group 1,BB,-0.5,8,14,927,12,2016,5,7
Group 1,BB,-0.5,8,14,928,9,2016,4,5
Group 1,BB,-0.5,8,14,929,10,2016,4,6
Group 1,BB,-0.5,8,14,930,9,2016,9,0
Group 1,BB,-0.5,8,14,931,11,2016,8,3
Group 1,BB,-0.5,8,14,932,9,2016,10,-1
Group 1,BB,-0.5,8,14,933,5,2016,9,-4
Group 1,BB,-0.5,8,14,934,11,2016,9,2
Group 1,BB,-0.5,8,14,935,7,2016,9,-2
Group 1,BB,-0.5,8,14,936,11,2016,7,4
Group 1,BB,-0.5,8,14,937,10,2016,8,2
Group 1,BB,-0.5,8,14,938,9,2016,12,-3
Group 1,BB,-0.5,8,14,939,7,2016,8,-1
Group 1,BB,-0.5,8,14,940,5,2016,7,-2
Group 1,BB,-0.5,8,14,941,10,2016,7,3
Group 1,BB,-0.5,8,14,942,11,2016,9,2
Group 1,BB,-0.5,8,14,943,10,2016,10,0
Group 1,BB,-0.5,8,14,944,8,2016,11,-3
Group 1,BB,-0.5,8,14,945,9,2016,12,-3
Group 1,BB,-0.5,8,14,946,7,2016,8,-1
Group 1,BB,-0.5,8,14,947,10,2016,12,-2
Group 1,BB,-0.5,8,14,948,9,2016,8,1
Group 1,BB,-0.5,8,14,949,9,2016,9,0
Group 1,BB,-0.5,8,14,950,5,2016,7,-2
Group 1,BB,-0.5,8,14,951,9,2016,10,-1
Group 1,BB,-0.5,8,14,952,13,2016,7,6
Group 1,BB,-0.5,8,14,953,8,2016,5,3
Group 1,BB,-0.5,8,14,954,8,2016,6,2
Group 1,BB,-0.5,8,14,955,10,2016,4,6
Group 1,BB,-0.5,8,14,956,9,2016,8,1
Group 1,BB,-0.5,8,14,957,12,2016,6,6
Group 1,BB,-0.5,8,14,958,9,2016,8,1
Group 1,BB,-0.5,8,14,959,6,2016,9,-3
Group 1,BB,-0.5,8,14,960,9,2016,12,-3
Group 1,BB,-0.5,8,14,961,12,2016,6,6
Group 1,BB,-0.5,8,14,962,10,2016,10,0
Group 1,BB,-0.5,8,14,963,9,2016,9,0
Group 1,BB,-0.5,8,14,964,8,2016,6,2
Group 1,BB,-0.5,8,14,965,8,2016,6,2
Group 1,BB,-0.5,8,14,966,9,2016,11,-2
Group 1,BB,-0.5,8,14,967,8,2016,6,2
Group 1,BB,-0.5,8,14,968,4,2016,9,-5
Group 1,BB,-0.5,8,14,969,7,2016,9,-2
Group 1,BB,-0.5,8,14,970,10,2016,5,5
Group 1,BB,-0.5,8,14,971,8,2016,10,-2
Group 1,BB,-0.5,8,14,972,12,2016,10,2
Group 1,BB,-0.5,8,14,973,12,2016,8,4
Group 1,BB,-0.5,8,14,974,10,2016,10,0
Group 1,BB,-0.5,8,14,975,7,2016,11,-4
Group 1,BB,-0.5,8,14,976,8,2016,9,-1
Group 1,BB,-0.5,8,14,977,9,2016,7,2
Group 1,BB,-0.5,8,14,978,6,2016,5,1
Group 1,BB,-0.5,8,14,979,6,2016,7,-1
Group 1,BB,-0.5,8,14,980,9,2016,9,0
Group 1,BB,-0.5,8,14,981,10,2016,5,5
Group 1,BB,-0.5,8,14,982,7,2016,6,1
Group 1,BB,-0.5,8,14,983,8,2016,5,3
Group 1,BB,-0.5,8,14,984,12,2016,8,4
Group 1,BB,-0.5,8,14,985,9,2016,11,-2
Group 1,BB,-0.5,8,14,986,8,2016,8,0
Group 1,BB,-0.5,8,14,987,9,2016,9,0
Group 1,BB,-0.5,8,14,988,5,2016,11,-6
Group 1,BB,-0.5,8,14,989,11,2016,8,3
Group 1,BB,-0.5,8,14,990,8,2016,7,1
Group 1,BB,-0.5,8,14,991,7,2016,11,-4
Group 1,BB,-0.5,8,14,992,9,2016,10,-1
Group 1,BB,-0.5,8,14,993,6,2016,10,-4
Group 1,BB,-0.5,8,14,994,10,2016,8,2
Group 1,BB,-0.5,8,14,995,9,2016,6,3
Group 1,BB,-0.5,8,14,996,9,2016,9,0
Group 1,BB,-0.5,8,14,997,11,2016,6,5
Group 1,BB,-0.5,8,14,998,9,2016,8,1
Group 1,BB,-0.5,8,14,999,8,2016,12,-4
Group 1,BB,-0.5,8,14,1000,6,2016,6,0
Group 1,BB,-0.5,8,14,1001,6,2016,9,-3
Group 1,BB,-0.5,8,14,1002,7,2016,9,-2
Group 1,BB,-0.5,8,14,1003,7,2016,8,-1
Group 1,BB,-0.5,8,14,1004,11,2016,8,3
Group 1,BB,-0.5,8,14,1005,8,2016,6,2
Group 1,BB,-0.5,8,14,1006,9,2016,3,6
Group 1,BB,-0.5,8,14,1007,7,2016,7,0
Group 1,BB,-0.5,8,14,1008,9,2016,5,4
Group 1,BB,-0.5,8,14,1009,8,2016,6,2
Group 1,BB,-0.5,8,14,1010,10,2016,8,2
Group 1,BB,-0.5,8,14,1011,11,2016,5,6
Group 1,BB,-0.5,8,14,1012,10,2016,5,5
Group 1,BB,-0.5,8,14,1013,11,2016,7,4
Group 1,BB,-0.5,8,14,1014,8,2016,9,-1
Group 1,BB,-0.5,8,14,1015,5,2016,6,-1
Group 1,BB,-0.5,8,14,1016,10,2016,8,2
Group 1,BB,-0.5,8,14,1017,7,2016,7,0
Group 1,BB,-0.5,8,14,1018,12,2016,8,4
Group 1,BB,-0.5,8,14,1019,7,2016,10,-3
Group 1,BB,-0.5,8,14,1020,10,2016,6,4
Group 1,BB,-0.5,8,14,1021,10,2016,7,3
Group 1,BB,-0.5,8,14,1022,11,2016,7,4
Group 1,BB,-0.5,8,14,1023,10,2016,6,4
Group 1,BB,-0.5,8,14,1024,10,2016,8,2
Group 1,BB,-0.5,8,14,1025,9,2016,9,0
Group 1,BB,-0.5,8,14,1026,9,2016,9,0
Group 1,BB,-0.5,8,14,1027,10,2016,8,2
Group 1,BB,-0.5,8,14,1028,11,2016,9,2
Group 1,BB,-0.5,8,14,1029,12,2016,7,5
Group 1,BB,-0.5,8,14,1030,5,2016,8,-3
Group 1,BB,-0.5,8,14,1031,8,2016,7,1
Group 1,BB,-0.5,8,14,1032,11,2016,7,4
Group 1,BB,-0.5,8,14,1033,8,2016,6,2
Group 1,BB,-0.5,8,14,1034,6,2016,9,-3
Group 1,BB,-0.5,8,14,1035,10,2016,3,7
Group 1,BB,-0.5,8,14,1036,5,2016,12,-7
Group 1,BB,-0.5,8,14,1037,9,2016,6,3
Group 1,BB,-0.5,8,14,1038,6,2016,12,-6
Group 1,BB,-0.5,8,14,1039,8,2016,12,-4
Group 1,BB,-0.5,8,14,1040,9,2016,5,4
Group 1,BB,-0.5,8,14,1041,9,2016,8,1
Group 1,BB,-0.5,8,14,1042,7,2016,9,-2
Group 1,BB,-0.5,8,14,1043,7,2016,8,-1
Group 1,BB,-0.5,8,14,1044,7,2016,7,0
Group 1,BB,-0.5,8,14,1045,10,2016,9,1
Group 1,BB,-0.5,8,14,1046,9,2016,7,2
Group 1,BB,-0.5,8,14,1047,9,2016,8,1
Group 1,BB,-0.5,8,14,1048,5,2016,11,-6
Group 1,BB,-0.5,8,14,1049,7,2016,7,0
Group 1,BB,-0.5,8,14,1050,8,2016,6,2
Group 1,BB,-0.5,8,14,1051,8,2016,9,-1
Group 1,BB,-0.5,8,14,1052,5,2016,10,-5
Group 1,BB,-0.5,8,14,1053,8,2016,11,-3
Group 1,BB,-0.5,8,14,1054,6,2016,10,-4
Group 1,BB,-0.5,8,14,1055,8,2016,7,1
Group 1,BB,-0.5,8,14,1056,6,2016,9,-3
Group 1,BB,-0.5,8,14,1057,9,2016,9,0
Group 1,BB,-0.5,8,14,1058,8,2016,8,0
Group 1,BB,-0.5,8,14,1059,10,2016,6,4
Group 1,BB,-0.5,8,14,1060,12,2016,12,0
Group 1,BB,-0.5,8,14,1061,9,2016,12,-3
Group 1,BB,-0.5,8,14,1062,8,2016,9,-1
Group 1,BB,-0.5,8,14,1063,8,2016,7,1
Group 1,BB,-0.5,8,14,1064,6,2016,10,-4
Group 1,BB,-0.5,8,14,1065,11,2016,5,6
Group 1,BB,-0.5,8,14,1066,8,2016,7,1
Group 1,BB,-0.5,8,14,1067,7,2016,10,-3
Group 1,BB,-0.5,8,14,1068,9,2016,8,1
Group 1,BB,-0.5,8,14,1069,7,2016,8,-1
Group 1,BB,-0.5,8,14,1070,10,2016,9,1
Group 1,BB,-0.5,8,14,1071,9,2016,8,1
Group 1,BB,-0.5,8,14,1072,9,2016,7,2
Group 1,BB,-0.5,8,14,1073,7,2016,9,-2
Group 1,BB,-0.5,8,14,1074,8,2016,8,0
Group 1,BB,-0.5,8,14,1075,9,2016,5,4
Group 1,BB,-0.5,8,14,1076,7,2016,9,-2
Group 1,BB,-0.5,8,14,1077,7,2016,7,0
Group 1,BB,-0.5,8,14,1078,6,2016,6,0
Group 1,BB,-0.5,8,14,1079,8,2016,8,0
Group 1,BB,-0.5,8,14,1080,12,2016,10,2
Group 1,BB,-0.5,8,14,1081,11,2016,7,4
Group 1,BB,-0.5,8,14,1082,7,2016,6,1
Group 1,BB,-0.5,8,14,1083,8,2016,10,-2
Group 1,BB,-0.5,8,14,1084,7,2016,11,-4
Group 1,BB,-0.5,8,14,1085,8,2016,12,-4
Group 1,BB,-0.5,8,14,1086,12,2016,6,6
Group 1,BB,-0.5,8,14,1087,6,2016,6,0
Group 1,BB,-0.5,8,14,1088,8,2016,8,0
Group 1,BB,-0.5,8,14,1089,11,2016,8,3
Group 1,BB,-0.5,8,14,1090,10,2016,9,1
Group 1,BB,-0.5,8,14,1091,9,2016,10,-1
Group 1,BB,-0.5,8,14,1092,8,2016,12,-4
Group 1,BB,-0.5,8,14,1093,6,2016,5,1
Group 1,BB,-0.5,8,14,1094,8,2016,7,1
Group 1,BB,-0.5,8,14,1095,9,2016,6,3
Group 1,BB,-0.5,8,14,1096,8,2016,5,3
Group 1,BB,-0.5,8,14,1097,11,2016,8,3
Group 1,BB,-0.5,8,14,1098,9,2016,7,2
Group 1,BB,-0.5,8,14,1099,11,2016,9,2
Group 1,BB,-0.5,8,14,1100,8,2016,14,-6
Group 1,BB,-0.5,8,14,1101,11,2016,12,-1
Group 1,BB,-0.5,8,14,1102,12,2016,8,4
Group 1,BB,-0.5,8,14,1103,8,2016,8,0
Group 1,BB,-0.5,8,14,1104,9,2016,6,3
Group 1,BB,-0.5,8,14,1105,7,2016,9,-2
Group 1,BB,-0.5,8,14,1106,2,2016,10,-8
Group 1,BB,-0.5,8,14,1107,11,2016,7,4
Group 1,BB,-0.5,8,14,1108,8,2016,6,2
Group 1,BB,-0.5,8,14,1109,9,2016,9,0
Group 1,BB,-0.5,8,14,1110,9,2016,11,-2
Group 1,BB,-0.5,8,14,1111,9,2016,10,-1
Group 1,BB,-0.5,8,14,1112,12,2016,10,2
Group 1,BB,-0.5,8,14,1113,8,2016,4,4
Group 1,BB,-0.5,8,14,1114,4,2016,8,-4
Group 1,BB,-0.5,8,14,1115,9,2016,5,4
Group 1,BB,-0.5,8,14,1116,7,2016,6,1
Group 1,BB,-0.5,8,14,1117,6,2016,5,1
Group 1,BB,-0.5,8,14,1118,7,2016,7,0
Group 1,BB,-0.5,8,14,1119,8,2016,9,-1
Group 1,BB,-0.5,8,14,1120,7,2016,10,-3
Group 1,BB,-0.5,8,14,1121,8,2016,6,2
Group 1,BB,-0.5,8,14,1122,5,2016,6,-1
Group 1,BB,-0.5,8,14,1123,10,2016,5,5
Group 1,BB,-0.5,8,14,1124,10,2016,10,0
Group 1,BB,-0.5,8,14,1125,8,2016,6,2
Group 1,BB,-0.5,8,14,1126,11,2016,7,4
Group 1,BB,-0.5,8,14,1127,7,2016,3,4
Group 1,BB,-0.5,8,14,1128,11,2016,8,3
Group 1,BB,-0.5,8,14,1129,10,2016,7,3
Group 1,BB,-0.5,8,14,1130,7,2016,11,-4
Group 1,BB,-0.5,8,14,1131,6,2016,9,-3
Group 1,BB,-0.5,8,14,1132,11,2016,7,4
Group 1,BB,-0.5,8,14,1133,11,2016,8,3
Group 1,BB,-0.5,8,14,1134,9,2016,8,1
Group 1,BB,-0.5,8,14,1135,8,2016,10,-2
Group 1,BB,-0.5,8,14,1136,8,2016,4,4
Group 1,BB,-0.5,8,14,1137,10,2016,8,2
Group 1,BB,-0.5,8,14,1138,5,2016,8,-3
Group 1,BB,-0.5,8,14,1139,9,2016,5,4
Group 1,BB,-0.5,8,14,1140,11,2016,3,8
Group 1,BB,-0.5,8,14,1141,6,2016,11,-5
Group 1,BB,-0.5,8,14,1142,9,2016,7,2
Group 1,BB,-0.5,8,14,1143,10,2016,8,2
Group 1,BB,-0.5,8,14,1144,5,2016,9,-4
Group 1,BB,-0.5,8,14,1145,8,2016,5,3
Group 1,BB,-0.5,8,14,1146,10,2016,11,-1
Group 1,BB,-0.5,8,14,1147,12,2016,5,7
Group 1,BB,-0.5,8,14,1148,7,2016,11,-4
Group 1,BB,-0.5,8,14,1149,8,2016,9,-1
Group 1,BB,-0.5,8,14,1150,11,2016,9,2
Group 1,BB,-0.5,8,14,1151,10,2016,12,-2
Group 1,BB,-0.5,8,14,1152,9,2016,7,2
Group 1,BB,-0.5,8,14,1153,11,2016,4,7
Group 1,BB,-0.5,8,14,1154,8,2016,7,1
Group 1,BB,-0.5,8,14,1155,6,2016,5,1
Group 1,BB,-0.5,8,14,1156,7,2016,7,0
Group 1,BB,-0.5,8,14,1157,9,2016,10,-1
Group 1,BB,-0.5,8,14,1158,7,2016,8,-1
Group 1,BB,-0.5,8,14,1159,5,2016,12,-7
Group 1,BB,-0.5,8,14,1160,8,2016,9,-1
Group 1,BB,-0.5,8,14,1161,9,2016,10,-1
Group 1,BB,-0.5,8,14,1162,9,2016,6,3
Group 1,BB,-0.5,8,14,1163,9,2016,10,-1
Group 1,BB,-0.5,8,14,1164,5,2016,8,-3
Group 1,BB,-0.5,8,14,1165,8,2016,6,2
Group 1,BB,-0.5,8,14,1166,11,2016,10,1
Group 1,BB,-0.5,8,14,1167,12,2016,7,5
Group 1,BB,-0.5,8,14,1168,6,2016,9,-3
Group 1,BB,-0.5,8,14,1169,8,2016,8,0
Group 1,BB,-0.5,8,14,1170,8,2016,9,-1
Group 1,BB,-0.5,8,14,1171,9,2016,10,-1
Group 1,BB,-0.5,8,14,1172,10,2016,11,-1
Group 1,BB,-0.5,8,14,1173,5,2016,5,0
Group 1,BB,-0.5,8,14,1174,10,2016,9,1
Group 1,BB,-0.5,8,14,1175,7,2016,7,0
Group 1,BB,-0.5,8,14,1176,10,2016,11,-1
Group 1,BB,-0.5,8,14,1177,8,2016,11,-3
Group 1,BB,-0.5,8,14,1178,5,2016,10,-5
Group 1,BB,-0.5,8,14,1179,10,2016,9,1
Group 1,BB,-0.5,8,14,1180,9,2016,12,-3
Group 1,BB,-0.5,8,14,1181,9,2016,11,-2
Group 1,BB,-0.5,8,14,1182,10,2016,7,3
Group 1,BB,-0.5,8,14,1183,11,2016,7,4
Group 1,BB,-0.5,8,14,1184,10,2016,9,1
Group 1,BB,-0.5,8,14,1185,11,2016,10,1
Group 1,BB,-0.5,8,14,1186,8,2016,8,0
Group 1,BB,-0.5,8,14,1187,7,2016,6,1
Group 1,BB,-0.5,8,14,1188,10,2016,3,7
Group 1,BB,-0.5,8,14,1189,12,2016,9,3
Group 1,BB,-0.5,8,14,1190,8,2016,7,1
Group 1,BB,-0.5,8,14,1191,9,2016,6,3
Group 1,BB,-0.5,8,14,1192,11,2016,8,3
Group 1,BB,-0.5,8,14,1193,8,2016,9,-1
Group 1,BB,-0.5,8,14,1194,10,2016,8,2
Group 1,BB,-0.5,8,14,1195,7,2016,11,-4
Group 1,BB,-0.5,8,14,1196,6,2016,7,-1
Group 1,BB,-0.5,8,14,1197,7,2016,10,-3
Group 1,BB,-0.5,8,14,1198,11,2016,5,6
Group 1,BB,-0.5,8,14,1199,7,2016,6,1
Group 1,BB,-0.5,8,14,1200,8,2016,5,3
Group 1,BB,-0.5,8,14,1201,8,2016,9,-1
Group 1,BB,-0.5,8,14,1202,11,2016,6,5
Group 1,BB,-0.5,8,14,1203,9,2016,4,5
Group 1,BB,-0.5,8,14,1204,13,2016,8,5
Group 1,BB,-0.5,8,14,1205,5,2016,7,-2
Group 1,BB,-0.5,8,14,1206,8,2016,7,1
Group 1,BB,-0.5,8,14,1207,11,2016,10,1
Group 1,BB,-0.5,8,14,1208,3,2016,8,-5
Group 1,BB,-0.5,8,14,1209,10,2016,9,1
Group 1,BB,-0.5,8,14,1210,6,2016,9,-3
Group 1,BB,-0.5,8,14,1211,6,2016,6,0
Group 1,BB,-0.5,8,14,1212,6,2016,10,-4
Group 1,BB,-0.5,8,14,1213,9,2016,7,2
Group 1,BB,-0.5,8,14,1214,7,2016,11,-4
Group 1,BB,-0.5,8,14,1215,10,2016,8,2
Group 1,BB,-0.5,8,14,1216,9,2016,6,3
Group 1,BB,-0.5,8,14,1217,6,2016,7,-1
Group 1,BB,-0.5,8,14,1218,9,2016,10,-1
Group 1,BB,-0.5,8,14,1219,8,2016,13,-5
Group 1,BB,-0.5,8,14,1220,10,2016,11,-1
Group 1,BB,-0.5,8,14,1221,10,2016,7,3
Group 1,BB,-0.5,8,14,1222,8,2016,9,-1
Group 1,BB,-0.5,8,14,1223,10,2016,5,5
Group 1,BB,-0.5,8,14,1224,10,2016,13,-3
Group 1,BB,-0.5,8,14,1225,11,2016,8,3
Group 1,BB,-0.5,8,14,1226,5,2016,9,-4
Group 1,BB,-0.5,8,14,1227,9,2016,10,-1
Group 1,BB,-0.5,8,14,1228,10,2016,10,0
Group 1,BB,-0.5,8,14,1229,7,2016,7,0
Group 1,BB,-0.5,8,14,1230,11,2016,9,2
Group 1,BB,-0.5,8,14,1231,9,2016,8,1
Group 1,BB,-0.5,8,14,1232,10,2016,7,3
Group 1,BB,-0.5,8,14,1233,11,2016,9,2
Group 1,BB,-0.5,8,14,1234,9,2016,11,-2
Group 1,BB,-0.5,8,14,1235,8,2016,8,0
Group 1,BB,-0.5,8,14,1236,7,2016,5,2
Group 1,BB,-0.5,8,14,1237,7,2016,10,-3
Group 1,BB,-0.5,8,14,1238,8,2016,12,-4
Group 1,BB,-0.5,8,14,1239,11,2016,7,4
Group 1,BB,-0.5,8,14,1240,6,2016,6,0
Group 1,BB,-0.5,8,14,1241,4,2016,10,-6
Group 1,BB,-0.5,8,14,1242,10,2016,4,6
Group 1,BB,-0.5,8,14,1243,10,2016,4,6
Group 1,BB,-0.5,8,14,1244,6,2016,8,-2
Group 1,BB,-0.5,8,14,1245,9,2016,10,-1
Group 1,BB,-0.5,8,14,1246,9,2016,10,-1
Group 1,BB,-0.5,8,14,1247,10,2016,12,-2
Group 1,BB,-0.5,8,14,1248,7,2016,9,-2
Group 1,BB,-0.5,8,14,1249,5,2016,6,-1
Group 1,BB,-0.5,8,14,1250,11,2016,9,2
Group 1,BB,-0.5,8,14,1251,9,2016,8,1
Group 1,BB,-0.5,8,14,1252,9,2016,12,-3
Group 1,BB,-0.5,8,14,1253,10,2016,4,6
Group 1,BB,-0.5,8,14,1254,10,2016,5,5
Group 1,BB,-0.5,8,14,1255,8,2016,7,1
Group 1,BB,-0.5,8,14,1256,8,2016,7,1
Group 1,BB,-0.5,8,14,1257,7,2016,10,-3
Group 1,BB,-0.5,8,14,1258,8,2016,7,1
Group 1,BB,-0.5,8,14,1259,9,2016,6,3
Group 1,BB,-0.5,8,14,1260,10,2016,8,2
Group 1,BB,-0.5,8,14,1261,10,2016,8,2
Group 1,BB,-0.5,8,14,1262,7,2016,5,2
Group 1,BB,-0.5,8,14,1263,11,2016,6,5
Group 1,BB,-0.5,8,14,1264,10,2016,9,1
Group 1,BB,-0.5,8,14,1265,8,2016,6,2
Group 1,BB,-0.5,8,14,1266,8,2016,10,-2
Group 1,BB,-0.5,8,14,1267,6,2016,10,-4
Group 1,BB,-0.5,8,14,1268,7,2016,8,-1
Group 1,BB,-0.5,8,14,1269,9,2016,11,-2
Group 1,BB,-0.5,8,14,1270,9,2016,7,2
Group 1,BB,-0.5,8,14,1271,11,2016,7,4
Group 1,BB,-0.5,8,14,1272,8,2016,9,-1
Group 1,BB,-0.5,8,14,1273,8,2016,11,-3
Group 1,BB,-0.5,8,14,1274,5,2016,6,-1
Group 1,BB,-0.5,8,14,1275,9,2016,8,1
Group 1,BB,-0.5,8,14,1276,5,2016,7,-2
Group 1,BB,-0.5,8,14,1277,7,2016,9,-2
Group 1,BB,-0.5,8,14,1278,8,2016,10,-2
Group 1,BB,-0.5,8,14,1279,8,2016,10,-2
Group 1,BB,-0.5,8,14,1280,7,2016,7,0
Group 1,BB,-0.5,8,14,1281,8,2016,8,0
Group 1,BB,-0.5,8,14,1282,8,2016,8,0
Group 1,BB,-0.5,8,14,1283,10,2016,8,2
Group 1,BB,-0.5,8,14,1284,8,2016,9,-1
Group 1,BB,-0.5,8,14,1285,6,2016,12,-6
Group 1,BB,-0.5,8,14,1286,10,2016,6,4
Group 1,BB,-0.5,8,14,1287,9,2016,9,0
Group 1,BB,-0.5,8,14,1288,7,2016,6,1
Group 1,BB,-0.5,8,14,1289,8,2016,9,-1
Group 1,BB,-0.5,8,14,1290,11,2016,8,3
Group 1,BB,-0.5,8,14,1291,7,2016,10,-3
Group 1,BB,-0.5,8,14,1292,6,2016,6,0
Group 1,BB,-0.5,8,14,1293,9,2016,5,4
Group 1,BB,-0.5,8,14,1294,10,2016,5,5
Group 1,BB,-0.5,8,14,1295,9,2016,12,-3
Group 1,BB,-0.5,8,14,1296,7,2016,11,-4
Group 1,BB,-0.5,8,14,1297,8,2016,11,-3
Group 1,BB,-0.5,8,14,1298,8,2016,12,-4
Group 1,BB,-0.5,8,14,1299,9,2016,10,-1
Group 1,BB,-0.5,8,14,1300,9,2016,10,-1
Group 1,BB,-0.5,8,14,1301,7,2016,13,-6
Group 1,BB,-0.5,8,14,1302,9,2016,7,2
Group 1,BB,-0.5,8,14,1303,8,2016,9,-1
Group 1,BB,-0.5,8,14,1304,7,2016,9,-2
Group 1,BB,-0.5,8,14,1305,6,2016,7,-1
Group 1,BB,-0.5,8,14,1306,8,2016,4,4
Group 1,BB,-0.5,8,14,1307,8,2016,10,-2
Group 1,BB,-0.5,8,14,1308,7,2016,3,4
Group 1,BB,-0.5,8,14,1309,9,2016,11,-2
Group 1,BB,-0.5,8,14,1310,11,2016,10,1
Group 1,BB,-0.5,8,14,1311,10,2016,7,3
Group 1,BB,-0.5,8,14,1312,12,2016,8,4
Group 1,BB,-0.5,8,14,1313,8,2016,7,1
Group 1,BB,-0.5,8,14,1314,9,2016,6,3
Group 1,BB,-0.5,8,14,1315,11,2016,8,3
Group 1,BB,-0.5,8,14,1316,9,2016,9,0
Group 1,BB,-0.5,8,14,1317,9,2016,6,3
Group 1,BB,-0.5,8,14,1318,9,2016,5,4
Group 1,BB,-0.5,8,14,1319,8,2016,9,-1
Group 1,BB,-0.5,8,14,1320,8,2016,11,-3
Group 1,BB,-0.5,8,14,1321,8,2016,7,1
Group 1,BB,-0.5,8,14,1322,8,2016,8,0
Group 1,BB,-0.5,8,14,1323,9,2016,4,5
Group 1,BB,-0.5,8,14,1324,8,2016,5,3
Group 1,BB,-0.5,8,14,1325,12,2016,6,6
Group 1,BB,-0.5,8,14,1326,12,2016,2,10
Group 1,BB,-0.5,8,14,1327,9,2016,9,0
Group 1,BB,-0.5,8,14,1328,11,2016,6,5
Group 1,BB,-0.5,8,14,1329,11,2016,8,3
Group 1,BB,-0.5,8,14,1330,11,2016,11,0
Group 1,BB,-0.5,8,14,1331,10,2016,5,5
Group 1,BB,-0.5,8,14,1332,9,2016,4,5
Group 1,BB,-0.5,8,14,1333,6,2016,7,-1
Group 1,BB,-0.5,8,14,1334,5,2016,3,2
Group 1,BB,-0.5,8,14,1335,10,2016,8,2
Group 1,BB,-0.5,8,14,1336,9,2016,8,1
Group 1,BB,-0.5,8,14,1337,10,2016,5,5
Group 1,BB,-0.5,8,14,1338,11,2016,10,1
Group 1,BB,-0.5,8,14,1339,9,2016,9,0
Group 1,BB,-0.5,8,14,1340,7,2016,9,-2
Group 1,BB,-0.5,8,14,1341,12,2016,8,4
Group 1,BB,-0.5,8,14,1342,5,2016,8,-3
Group 1,BB,-0.5,8,14,1343,8,2016,9,-1
Group 1,BB,-0.5,8,14,1344,10,2016,4,6
Group 1,BB,-0.5,8,14,1345,7,2016,8,-1
Group 1,BB,-0.5,8,14,1346,8,2016,8,0
Group 1,BB,-0.5,8,14,1347,12,2016,10,2
Group 1,BB,-0.5,8,14,1348,8,2016,9,-1
Group 1,BB,-0.5,8,14,1349,9,2016,8,1
Group 1,BB,-0.5,8,14,1350,8,2016,8,0
Group 1,BB,-0.5,8,14,1351,9,2016,5,4
Group 1,BB,-0.5,8,14,1352,11,2016,8,3
Group 1,BB,-0.5,8,14,1353,7,2016,5,2
Group 1,BB,-0.5,8,14,1354,7,2016,8,-1
Group 1,BB,-0.5,8,14,1355,11,2016,7,4
Group 1,BB,-0.5,8,14,1356,10,2016,10,0
Group 1,BB,-0.5,8,14,1357,11,2016,7,4
Group 1,BB,-0.5,8,14,1358,11,2016,9,2
Group 1,BB,-0.5,8,14,1359,7,2016,5,2
Group 1,BB,-0.5,8,14,1360,4,2016,7,-3
Group 1,BB,-0.5,8,14,1361,6,2016,7,-1
Group 1,BB,-0.5,8,14,1362,8,2016,11,-3
Group 1,BB,-0.5,8,14,1363,8,2016,10,-2
Group 1,BB,-0.5,8,14,1364,9,2016,8,1
Group 1,BB,-0.5,8,14,1365,9,2016,9,0
Group 1,BB,-0.5,8,14,1366,10,2016,8,2
Group 1,BB,-0.5,8,14,1367,10,2016,6,4
Group 1,BB,-0.5,8,14,1368,11,2016,10,1
Group 1,BB,-0.5,8,14,1369,7,2016,9,-2
Group 1,BB,-0.5,8,14,1370,7,2016,10,-3
Group 1,BB,-0.5,8,14,1371,7,2016,8,-1
Group 1,BB,-0.5,8,14,1372,9,2016,12,-3
Group 1,BB,-0.5,8,14,1373,12,2016,6,6
Group 1,BB,-0.5,8,14,1374,10,2016,8,2
Group 1,BB,-0.5,8,14,1375,7,2016,7,0
Group 1,BB,-0.5,8,14,1376,11,2016,8,3
Group 1,BB,-0.5,8,14,1377,7,2016,8,-1
Group 1,BB,-0.5,8,14,1378,11,2016,7,4
Group 1,BB,-0.5,8,14,1379,9,2016,5,4
Group 1,BB,-0.5,8,14,1380,5,2016,7,-2
Group 1,BB,-0.5,8,14,1381,11,2016,7,4
Group 1,BB,-0.5,8,14,1382,7,2016,7,0
Group 1,BB,-0.5,8,14,1383,11,2016,7,4
Group 1,BB,-0.5,8,14,1384,10,2016,11,-1
Group 1,BB,-0.5,8,14,1385,8,2016,12,-4
Group 1,BB,-0.5,8,14,1386,8,2016,7,1
Group 1,BB,-0.5,8,14,1387,10,2016,9,1
Group 1,BB,-0.5,8,14,1388,10,2016,10,0
Group 1,BB,-0.5,8,14,1389,6,2016,6,0
Group 1,BB,-0.5,8,14,1390,8,2016,6,2
Group 1,BB,-0.5,8,14,1391,9,2016,3,6
Group 1,BB,-0.5,8,14,1392,9,2016,9,0
Group 1,BB,-0.5,8,14,1393,9,2016,10,-1
Group 1,BB,-0.5,8,14,1394,9,2016,7,2
Group 1,BB,-0.5,8,14,1395,8,2016,9,-1
Group 1,BB,-0.5,8,14,1396,11,2016,8,3
Group 1,BB,-0.5,8,14,1397,11,2016,6,5
Group 1,BB,-0.5,8,14,1398,10,2016,11,-1
Group 1,BB,-0.5,8,14,1399,5,2016,10,-5
Group 1,BB,-0.5,8,14,1400,12,2016,9,3
Group 1,BB,-0.5,8,14,1401,8,2016,4,4
Group 1,BB,-0.5,8,14,1402,9,2016,7,2
Group 1,BB,-0.5,8,14,1403,9,2016,9,0
Group 1,BB,-0.5,8,14,1404,8,2016,7,1
Group 1,BB,-0.5,8,14,1405,8,2016,6,2
Group 1,BB,-0.5,8,14,1406,9,2016,8,1
Group 1,BB,-0.5,8,14,1407,8,2016,6,2
Group 1,BB,-0.5,8,14,1408,9,2016,5,4
Group 1,BB,-0.5,8,14,1409,8,2016,5,3
Group 1,BB,-0.5,8,14,1410,9,2016,9,0
Group 1,BB,-0.5,8,14,1411,8,2016,2,6
Group 1,BB,-0.5,8,14,1412,8,2016,11,-3
Group 1,BB,-0.5,8,14,1413,9,2016,8,1
Group 1,BB,-0.5,8,14,1414,11,2016,11,0
Group 1,BB,-0.5,8,14,1415,12,2016,7,5
Group 1,BB,-0.5,8,14,1416,5,2016,4,1
Group 1,BB,-0.5,8,14,1417,10,2016,12,-2
Group 1,BB,-0.5,8,14,1418,10,2016,6,4
Group 1,BB,-0.5,8,14,1419,9,2016,10,-1
Group 1,BB,-0.5,8,14,1420,10,2016,10,0
Group 1,BB,-0.5,8,14,1421,9,2016,7,2
Group 1,BB,-0.5,8,14,1422,10,2016,9,1
Group 1,BB,-0.5,8,14,1423,12,2016,5,7
Group 1,BB,-0.5,8,14,1424,10,2016,8,2
Group 1,BB,-0.5,8,14,1425,9,2016,9,0
Group 1,BB,-0.5,8,14,1426,10,2016,8,2
Group 1,BB,-0.5,8,14,1427,9,2016,12,-3
Group 1,BB,-0.5,8,14,1428,5,2016,11,-6
Group 1,BB,-0.5,8,14,1429,10,2016,13,-3
Group 1,BB,-0.5,8,14,1430,8,2016,7,1
Group 1,BB,-0.5,8,14,1431,13,2016,4,9
Group 1,BB,-0.5,8,14,1432,10,2016,4,6
Group 1,BB,-0.5,8,14,1433,5,2016,9,-4
Group 1,BB,-0.5,8,14,1434,11,2016,9,2
Group 1,BB,-0.5,8,14,1435,11,2016,9,2
Group 1,BB,-0.5,8,14,1436,6,2016,8,-2
Group 1,BB,-0.5,8,14,1437,10,2016,10,0
Group 1,BB,-0.5,8,14,1438,8,2016,9,-1
Group 1,BB,-0.5,8,14,1439,7,2016,9,-2
Group 1,BB,-0.5,8,14,1440,10,2016,10,0
Group 1,BB,-0.5,8,14,1441,11,2016,12,-1
Group 1,BB,-0.5,8,14,1442,10,2016,6,4
Group 1,BB,-0.5,8,14,1443,5,2016,4,1
Group 1,BB,-0.5,8,14,1444,8,2016,6,2
Group 1,BB,-0.5,8,14,1445,6,2016,10,-4
Group 1,BB,-0.5,8,14,1446,7,2016,10,-3
Group 1,BB,-0.5,8,14,1447,11,2016,6,5
Group 1,BB,-0.5,8,14,1448,10,2016,4,6
Group 1,BB,-0.5,8,14,1449,7,2016,7,0
Group 1,BB,-0.5,8,14,1450,11,2016,9,2
Group 1,BB,-0.5,8,14,1451,9,2016,6,3
Group 1,BB,-0.5,8,14,1452,9,2016,8,1
Group 1,BB,-0.5,8,14,1453,7,2016,8,-1
Group 1,BB,-0.5,8,14,1454,11,2016,8,3
Group 1,BB,-0.5,8,14,1455,10,2016,10,0
Group 1,BB,-0.5,8,14,1456,8,2016,6,2
Group 1,BB,-0.5,8,14,1457,13,2016,8,5
Group 1,BB,-0.5,8,14,1458,12,2016,8,4
Group 1,BB,-0.5,8,14,1459,11,2016,10,1
Group 1,BB,-0.5,8,14,1460,10,2016,3,7
Group 1,BB,-0.5,8,14,1461,8,2016,7,1
Group 1,BB,-0.5,8,14,1462,5,2016,8,-3
Group 1,BB,-0.5,8,14,1463,9,2016,6,3
Group 1,BB,-0.5,8,14,1464,9,2016,7,2
Group 1,BB,-0.5,8,14,1465,7,2016,10,-3
Group 1,BB,-0.5,8,14,1466,11,2016,8,3
Group 1,BB,-0.5,8,14,1467,13,2016,6,7
Group 1,BB,-0.5,8,14,1468,6,2016,7,-1
Group 1,BB,-0.5,8,14,1469,6,2016,5,1
Group 1,BB,-0.5,8,14,1470,9,2016,6,3
Group 1,BB,-0.5,8,14,1471,7,2016,7,0
Group 1,BB,-0.5,8,14,1472,10,2016,6,4
Group 1,BB,-0.5,8,14,1473,11,2016,6,5
Group 1,BB,-0.5,8,14,1474,10,2016,7,3
Group 1,BB,-0.5,8,14,1475,9,2016,7,2
Group 1,BB,-0.5,8,14,1476,8,2016,10,-2
Group 1,BB,-0.5,8,14,1477,9,2016,6,3
Group 1,BB,-0.5,8,14,1478,9,2016,4,5
Group 1,BB,-0.5,8,14,1479,11,2016,7,4
Group 1,BB,-0.5,8,14,1480,8,2016,13,-5
Group 1,BB,-0.5,8,14,1481,10,2016,8,2
Group 1,BB,-0.5,8,14,1482,8,2016,9,-1
Group 1,BB,-0.5,8,14,1483,8,2016,9,-1
Group 1,BB,-0.5,8,14,1484,8,2016,8,0
Group 1,BB,-0.5,8,14,1485,11,2016,9,2
Group 1,BB,-0.5,8,14,1486,5,2016,9,-4
Group 1,BB,-0.5,8,14,1487,10,2016,8,2
Group 1,BB,-0.5,8,14,1488,12,2016,4,8
Group 1,BB,-0.5,8,14,1489,7,2016,10,-3
Group 1,BB,-0.5,8,14,1490,9,2016,9,0
Group 1,BB,-0.5,8,14,1491,7,2016,6,1
Group 1,BB,-0.5,8,14,1492,8,2016,4,4
Group 1,BB,-0.5,8,14,1493,10,2016,7,3
Group 1,BB,-0.5,8,14,1494,11,2016,9,2
Group 1,BB,-0.5,8,14,1495,10,2016,10,0
Group 1,BB,-0.5,8,14,1496,9,2016,5,4
Group 1,BB,-0.5,8,14,1497,8,2016,7,1
Group 1,BB,-0.5,8,14,1498,9,2016,10,-1
Group 1,BB,-0.5,8,14,1499,8,2016,6,2
Group 1,BB,-0.5,8,14,1500,8,2016,9,-1
Group 1,BB,-0.5,8,14,1501,10,2016,11,-1
Group 1,BB,-0.5,8,14,1502,11,2016,8,3
Group 1,BB,-0.5,8,14,1503,7,2016,10,-3
Group 1,BB,-0.5,8,14,1504,11,2016,10,1
Group 1,BB,-0.5,8,14,1505,7,2016,10,-3
Group 1,BB,-0.5,8,14,1506,11,2016,4,7
Group 1,BB,-0.5,8,14,1507,8,2016,11,-3
Group 1,BB,-0.5,8,14,1508,9,2016,10,-1
Group 1,BB,-0.5,8,14,1509,9,2016,6,3
Group 1,BB,-0.5,8,14,1510,8,2016,8,0
Group 1,BB,-0.5,8,14,1511,10,2016,13,-3
Group 1,BB,-0.5,8,14,1512,9,2016,10,-1
Group 1,BB,-0.5,8,14,1513,13,2016,7,6
Group 1,BB,-0.5,8,14,1514,9,2016,13,-4
Group 1,BB,-0.5,8,14,1515,12,2016,10,2
Group 1,BB,-0.5,8,14,1516,9,2016,8,1
Group 1,BB,-0.5,8,14,1517,7,2016,4,3
Group 1,BB,-0.5,8,14,1518,7,2016,9,-2
Group 1,BB,-0.5,8,14,1519,6,2016,7,-1
Group 1,BB,-0.5,8,14,1520,10,2016,7,3
Group 1,BB,-0.5,8,14,1521,6,2016,8,-2
Group 1,BB,-0.5,8,14,1522,10,2016,8,2
Group 1,BB,-0.5,8,14,1523,7,2016,8,-1
Group 1,BB,-0.5,8,14,1524,8,2016,8,0
Group 1,BB,-0.5,8,14,1525,7,2016,12,-5
Group 1,BB,-0.5,8,14,1526,5,2016,7,-2
Group 1,BB,-0.5,8,14,1527,7,2016,9,-2
Group 1,BB,-0.5,8,14,1528,8,2016,6,2
Group 1,BB,-0.5,8,14,1529,10,2016,8,2
Group 1,BB,-0.5,8,14,1530,6,2016,10,-4
Group 1,BB,-0.5,8,14,1531,10,2016,5,5
Group 1,BB,-0.5,8,14,1532,8,2016,10,-2
Group 1,BB,-0.5,8,14,1533,10,2016,7,3
Group 1,BB,-0.5,8,14,1534,11,2016,9,2
Group 1,BB,-0.5,8,14,1535,11,2016,4,7
Group 1,BB,-0.5,8,14,1536,6,2016,9,-3
Group 1,BB,-0.5,8,14,1537,11,2016,9,2
Group 1,BB,-0.5,8,14,1538,10,2016,9,1
Group 1,BB,-0.5,8,14,1539,7,2016,9,-2
Group 1,BB,-0.5,8,14,1540,8,2016,6,2
Group 1,BB,-0.5,8,14,1541,8,2016,8,0
Group 1,BB,-0.5,8,14,1542,8,2016,7,1
Group 1,BB,-0.5,8,14,1543,8,2016,7,1
Group 1,BB,-0.5,8,14,1544,8,2016,4,4
Group 1,BB,-0.5,8,14,1545,12,2016,9,3
Group 1,BB,-0.5,8,14,1546,8,2016,9,-1
Group 1,BB,-0.5,8,14,1547,10,2016,8,2
Group 1,BB,-0.5,8,14,1548,8,2016,9,-1
Group 1,BB,-0.5,8,14,1549,7,2016,10,-3
Group 1,BB,-0.5,8,14,1550,6,2016,11,-5
Group 1,BB,-0.5,8,14,1551,8,2016,10,-2
Group 1,BB,-0.5,8,14,1552,8,2016,6,2
Group 1,BB,-0.5,8,14,1553,8,2016,8,0
Group 1,BB,-0.5,8,14,1554,10,2016,9,1
Group 1,BB,-0.5,8,14,1555,9,2016,7,2
Group 1,BB,-0.5,8,14,1556,7,2016,8,-1
Group 1,BB,-0.5,8,14,1557,9,2016,6,3
Group 1,BB,-0.5,8,14,1558,12,2016,13,-1
Group 1,BB,-0.5,8,14,1559,9,2016,5,4
Group 1,BB,-0.5,8,14,1560,6,2016,8,-2
Group 1,BB,-0.5,8,14,1561,10,2016,5,5
Group 1,BB,-0.5,8,14,1562,6,2016,10,-4
Group 1,BB,-0.5,8,14,1563,9,2016,4,5
Group 1,BB,-0.5,8,14,1564,7,2016,5,2
Group 1,BB,-0.5,8,14,1565,10,2016,7,3
Group 1,BB,-0.5,8,14,1566,10,2016,9,1
Group 1,BB,-0.5,8,14,1567,11,2016,8,3
Group 1,BB,-0.5,8,14,1568,9,2016,5,4
Group 1,BB,-0.5,8,14,1569,8,2016,6,2
Group 1,BB,-0.5,8,14,1570,7,2016,7,0
Group 1,BB,-0.5,8,14,1571,12,2016,8,4
Group 1,BB,-0.5,8,14,1572,8,2016,8,0
Group 1,BB,-0.5,8,14,1573,6,2016,7,-1
Group 1,BB,-0.5,8,14,1574,8,2016,10,-2
Group 1,BB,-0.5,8,14,1575,7,2016,11,-4
Group 1,BB,-0.5,8,14,1576,10,2016,11,-1
Group 1,BB,-0.5,8,14,1577,6,2016,11,-5
Group 1,BB,-0.5,8,14,1578,10,2016,8,2
Group 1,BB,-0.5,8,14,1579,11,2016,11,0
Group 1,BB,-0.5,8,14,1580,11,2016,6,5
Group 1,BB,-0.5,8,14,1581,9,2016,8,1
Group 1,BB,-0.5,8,14,1582,7,2016,6,1
Group 1,BB,-0.5,8,14,1583,10,2016,9,1
Group 1,BB,-0.5,8,14,1584,11,2016,11,0
Group 1,BB,-0.5,8,14,1585,7,2016,12,-5
Group 1,BB,-0.5,8,14,1586,12,2016,7,5
Group 1,BB,-0.5,8,14,1587,9,2016,4,5
Group 1,BB,-0.5,8,14,1588,8,2016,9,-1
Group 1,BB,-0.5,8,14,1589,9,2016,10,-1
Group 1,BB,-0.5,8,14,1590,8,2016,9,-1
Group 1,BB,-0.5,8,14,1591,9,2016,9,0
Group 1,BB,-0.5,8,14,1592,10,2016,7,3
Group 1,BB,-0.5,8,14,1593,9,2016,7,2
Group 1,BB,-0.5,8,14,1594,7,2016,10,-3
Group 1,BB,-0.5,8,14,1595,6,2016,8,-2
Group 1,BB,-0.5,8,14,1596,8,2016,7,1
Group 1,BB,-0.5,8,14,1597,12,2016,6,6
Group 1,BB,-0.5,8,14,1598,9,2016,8,1
Group 1,BB,-0.5,8,14,1599,10,2016,10,0
Group 1,BB,-0.5,8,14,1600,8,2016,10,-2
Group 1,BB,-0.5,8,14,1601,10,2016,6,4
Group 1,BB,-0.5,8,14,1602,10,2016,6,4
Group 1,BB,-0.5,8,14,1603,5,2016,10,-5
Group 1,BB,-0.5,8,14,1604,7,2016,9,-2
Group 1,BB,-0.5,8,14,1605,6,2016,11,-5
Group 1,BB,-0.5,8,14,1606,10,2016,9,1
Group 1,BB,-0.5,8,14,1607,10,2016,9,1
Group 1,BB,-0.5,8,14,1608,8,2016,7,1
Group 1,BB,-0.5,8,14,1609,8,2016,10,-2
Group 1,BB,-0.5,8,14,1610,8,2016,8,0
Group 1,BB,-0.5,8,14,1611,6,2016,6,0
Group 1,BB,-0.5,8,14,1612,8,2016,12,-4
Group 1,BB,-0.5,8,14,1613,10,2016,7,3
Group 1,BB,-0.5,8,14,1614,9,2016,7,2
Group 1,BB,-0.5,8,14,1615,8,2016,9,-1
Group 1,BB,-0.5,8,14,1616,7,2016,11,-4
Group 1,BB,-0.5,8,14,1617,9,2016,10,-1
Group 1,BB,-0.5,8,14,1618,8,2016,10,-2
Group 1,BB,-0.5,8,14,1619,8,2016,7,1
Group 1,BB,-0.5,8,14,1620,8,2016,9,-1
Group 1,BB,-0.5,8,14,1621,9,2016,10,-1
Group 1,BB,-0.5,8,14,1622,9,2016,7,2
Group 1,BB,-0.5,8,14,1623,7,2016,6,1
Group 1,BB,-0.5,8,14,1624,12,2016,9,3
Group 1,BB,-0.5,8,14,1625,8,2016,10,-2
Group 1,BB,-0.5,8,14,1626,10,2016,7,3
Group 1,BB,-0.5,8,14,1627,7,2016,9,-2
Group 1,BB,-0.5,8,14,1628,9,2016,11,-2
Group 1,BB,-0.5,8,14,1629,10,2016,10,0
Group 1,BB,-0.5,8,14,1630,8,2016,5,3
Group 1,BB,-0.5,8,14,1631,10,2016,4,6
Group 1,BB,-0.5,8,14,1632,9,2016,9,0
Group 1,BB,-0.5,8,14,1633,12,2016,11,1
Group 1,BB,-0.5,8,14,1634,7,2016,8,-1
Group 1,BB,-0.5,8,14,1635,12,2016,7,5
Group 1,BB,-0.5,8,14,1636,5,2016,4,1
Group 1,BB,-0.5,8,14,1637,6,2016,11,-5
Group 1,BB,-0.5,8,14,1638,7,2016,12,-5
Group 1,BB,-0.5,8,14,1639,7,2016,8,-1
Group 1,BB,-0.5,8,14,1640,3,2016,6,-3
Group 1,BB,-0.5,8,14,1641,10,2016,5,5
Group 1,BB,-0.5,8,14,1642,10,2016,11,-1
Group 1,BB,-0.5,8,14,1643,11,2016,9,2
Group 1,BB,-0.5,8,14,1644,6,2016,10,-4
Group 1,BB,-0.5,8,14,1645,11,2016,6,5
Group 1,BB,-0.5,8,14,1646,9,2016,7,2
Group 1,BB,-0.5,8,14,1647,11,2016,10,1
Group 1,BB,-0.5,8,14,1648,8,2016,6,2
Group 1,BB,-0.5,8,14,1649,8,2016,8,0
Group 1,BB,-0.5,8,14,1650,9,2016,11,-2
Group 1,BB,-0.5,8,14,1651,11,2016,10,1
Group 1,BB,-0.5,8,14,1652,9,2016,8,1
Group 1,BB,-0.5,8,14,1653,5,2016,6,-1
Group 1,BB,-0.5,8,14,1654,8,2016,4,4
Group 1,BB,-0.5,8,14,1655,5,2016,9,-4
Group 1,BB,-0.5,8,14,1656,8,2016,8,0
Group 1,BB,-0.5,8,14,1657,8,2016,8,0
Group 1,BB,-0.5,8,14,1658,10,2016,11,-1
Group 1,BB,-0.5,8,14,1659,9,2016,10,-1
Group 1,BB,-0.5,8,14,1660,11,2016,11,0
Group 1,BB,-0.5,8,14,1661,7,2016,8,-1
Group 1,BB,-0.5,8,14,1662,7,2016,5,2
Group 1,BB,-0.5,8,14,1663,9,2016,6,3
Group 1,BB,-0.5,8,14,1664,10,2016,8,2
Group 1,BB,-0.5,8,14,1665,8,2016,7,1
Group 1,BB,-0.5,8,14,1666,10,2016,10,0
Group 1,BB,-0.5,8,14,1667,7,2016,7,0
Group 1,BB,-0.5,8,14,1668,9,2016,11,-2
Group 1,BB,-0.5,8,14,1669,4,2016,11,-7
Group 1,BB,-0.5,8,14,1670,11,2016,11,0
Group 1,BB,-0.5,8,14,1671,9,2016,9,0
Group 1,BB,-0.5,8,14,1672,9,2016,10,-1
Group 1,BB,-0.5,8,14,1673,8,2016,7,1
Group 1,BB,-0.5,8,14,1674,3,2016,10,-7
Group 1,BB,-0.5,8,14,1675,9,2016,7,2
Group 1,BB,-0.5,8,14,1676,10,2016,8,2
Group 1,BB,-0.5,8,14,1677,8,2016,11,-3
Group 1,BB,-0.5,8,14,1678,8,2016,11,-3
Group 1,BB,-0.5,8,14,1679,7,2016,9,-2
Group 1,BB,-0.5,8,14,1680,9,2016,7,2
Group 1,BB,-0.5,8,14,1681,10,2016,13,-3
Group 1,BB,-0.5,8,14,1682,11,2016,9,2
Group 1,BB,-0.5,8,14,1683,9,2016,12,-3
Group 1,BB,-0.5,8,14,1684,9,2016,10,-1
Group 1,BB,-0.5,8,14,1685,10,2016,8,2
Group 1,BB,-0.5,8,14,1686,8,2016,7,1
Group 1,BB,-0.5,8,14,1687,9,2016,9,0
Group 1,BB,-0.5,8,14,1688,9,2016,5,4
Group 1,BB,-0.5,8,14,1689,9,2016,6,3
Group 1,BB,-0.5,8,14,1690,9,2016,8,1
Group 1,BB,-0.5,8,14,1691,6,2016,11,-5
Group 1,BB,-0.5,8,14,1692,11,2016,11,0
Group 1,BB,-0.5,8,14,1693,9,2016,8,1
Group 1,BB,-0.5,8,14,1694,6,2016,9,-3
Group 1,BB,-0.5,8,14,1695,7,2016,6,1
Group 1,BB,-0.5,8,14,1696,12,2016,8,4
Group 1,BB,-0.5,8,14,1697,11,2016,9,2
Group 1,BB,-0.5,8,14,1698,6,2016,6,0
Group 1,BB,-0.5,8,14,1699,11,2016,9,2
Group 1,BB,-0.5,8,14,1700,9,2016,9,0
Group 1,BB,-0.5,8,14,1701,11,2016,10,1
Group 1,BB,-0.5,8,14,1702,11,2016,10,1
Group 1,BB,-0.5,8,14,1703,11,2016,7,4
Group 1,BB,-0.5,8,14,1704,6,2016,7,-1
Group 1,BB,-0.5,8,14,1705,6,2016,7,-1
Group 1,BB,-0.5,8,14,1706,8,2016,10,-2
Group 1,BB,-0.5,8,14,1707,9,2016,9,0
Group 1,BB,-0.5,8,14,1708,11,2016,9,2
Group 1,BB,-0.5,8,14,1709,8,2016,9,-1
Group 1,BB,-0.5,8,14,1710,7,2016,10,-3
Group 1,BB,-0.5,8,14,1711,8,2016,8,0
Group 1,BB,-0.5,8,14,1712,7,2016,8,-1
Group 1,BB,-0.5,8,14,1713,6,2016,11,-5
Group 1,BB,-0.5,8,14,1714,3,2016,7,-4
Group 1,BB,-0.5,8,14,1715,8,2016,12,-4
Group 1,BB,-0.5,8,14,1716,7,2016,8,-1
Group 1,BB,-0.5,8,14,1717,8,2016,7,1
Group 1,BB,-0.5,8,14,1718,10,2016,11,-1
Group 1,BB,-0.5,8,14,1719,8,2016,9,-1
Group 1,BB,-0.5,8,14,1720,11,2016,5,6
Group 1,BB,-0.5,8,14,1721,12,2016,8,4
Group 1,BB,-0.5,8,14,1722,13,2016,7,6
Group 1,BB,-0.5,8,14,1723,8,2016,8,0
Group 1,BB,-0.5,8,14,1724,10,2016,7,3
Group 1,BB,-0.5,8,14,1725,11,2016,8,3
Group 1,BB,-0.5,8,14,1726,5,2016,10,-5
Group 1,BB,-0.5,8,14,1727,10,2016,5,5
Group 1,BB,-0.5,8,14,1728,9,2016,8,1
Group 1,BB,-0.5,8,14,1729,10,2016,11,-1
Group 1,BB,-0.5,8,14,1730,9,2016,10,-1
Group 1,BB,-0.5,8,14,1731,7,2016,6,1
Group 1,BB,-0.5,8,14,1732,10,2016,8,2
Group 1,BB,-0.5,8,14,1733,10,2016,9,1
Group 1,BB,-0.5,8,14,1734,10,2016,11,-1
Group 1,BB,-0.5,8,14,1735,6,2016,8,-2
Group 1,BB,-0.5,8,14,1736,10,2016,4,6
Group 1,BB,-0.5,8,14,1737,10,2016,10,0
Group 1,BB,-0.5,8,14,1738,6,2016,9,-3
Group 1,BB,-0.5,8,14,1739,7,2016,11,-4
Group 1,BB,-0.5,8,14,1740,7,2016,12,-5
Group 1,BB,-0.5,8,14,1741,9,2016,12,-3
Group 1,BB,-0.5,8,14,1742,7,2016,7,0
Group 1,BB,-0.5,8,14,1743,11,2016,8,3
Group 1,BB,-0.5,8,14,1744,10,2016,8,2
Group 1,BB,-0.5,8,14,1745,8,2016,11,-3
Group 1,BB,-0.5,8,14,1746,7,2016,9,-2
Group 1,BB,-0.5,8,14,1747,8,2016,9,-1
Group 1,BB,-0.5,8,14,1748,9,2016,7,2
Group 1,BB,-0.5,8,14,1749,7,2016,7,0
Group 1,BB,-0.5,8,14,1750,11,2016,5,6
Group 1,BB,-0.5,8,14,1751,8,2016,8,0
Group 1,BB,-0.5,8,14,1752,9,2016,12,-3
Group 1,BB,-0.5,8,14,1753,8,2016,9,-1
Group 1,BB,-0.5,8,14,1754,4,2016,6,-2
Group 1,BB,-0.5,8,14,1755,9,2016,7,2
Group 1,BB,-0.5,8,14,1756,9,2016,7,2
Group 1,BB,-0.5,8,14,1757,12,2016,5,7
Group 1,BB,-0.5,8,14,1758,6,2016,5,1
Group 1,BB,-0.5,8,14,1759,10,2016,5,5
Group 1,BB,-0.5,8,14,1760,7,2016,7,0
Group 1,BB,-0.5,8,14,1761,8,2016,5,3
Group 1,BB,-0.5,8,14,1762,9,2016,7,2
Group 1,BB,-0.5,8,14,1763,7,2016,10,-3
Group 1,BB,-0.5,8,14,1764,7,2016,4,3
Group 1,BB,-0.5,8,14,1765,6,2016,9,-3
Group 1,BB,-0.5,8,14,1766,5,2016,12,-7
Group 1,BB,-0.5,8,14,1767,12,2016,9,3
Group 1,BB,-0.5,8,14,1768,10,2016,9,1
Group 1,BB,-0.5,8,14,1769,12,2016,9,3
Group 1,BB,-0.5,8,14,1770,10,2016,5,5
Group 1,BB,-0.5,8,14,1771,5,2016,5,0
Group 1,BB,-0.5,8,14,1772,8,2016,7,1
Group 1,BB,-0.5,8,14,1773,3,2016,10,-7
Group 1,BB,-0.5,8,14,1774,9,2016,6,3
Group 1,BB,-0.5,8,14,1775,10,2016,7,3
Group 1,BB,-0.5,8,14,1776,6,2016,12,-6
Group 1,BB,-0.5,8,14,1777,9,2016,6,3
Group 1,BB,-0.5,8,14,1778,10,2016,9,1
Group 1,BB,-0.5,8,14,1779,7,2016,10,-3
Group 1,BB,-0.5,8,14,1780,11,2016,7,4
Group 1,BB,-0.5,8,14,1781,12,2016,12,0
Group 1,BB,-0.5,8,14,1782,12,2016,7,5
Group 1,BB,-0.5,8,14,1783,11,2016,8,3
Group 1,BB,-0.5,8,14,1784,10,2016,10,0
Group 1,BB,-0.5,8,14,1785,11,2016,9,2
Group 1,BB,-0.5,8,14,1786,12,2016,8,4
Group 1,BB,-0.5,8,14,1787,8,2016,8,0
Group 1,BB,-0.5,8,14,1788,6,2016,9,-3
Group 1,BB,-0.5,8,14,1789,6,2016,12,-6
Group 1,BB,-0.5,8,14,1790,8,2016,7,1
Group 1,BB,-0.5,8,14,1791,7,2016,6,1
Group 1,BB,-0.5,8,14,1792,8,2016,8,0
Group 1,BB,-0.5,8,14,1793,11,2016,11,0
Group 1,BB,-0.5,8,14,1794,11,2016,4,7
Group 1,BB,-0.5,8,14,1795,6,2016,6,0
Group 1,BB,-0.5,8,14,1796,8,2016,6,2
Group 1,BB,-0.5,8,14,1797,9,2016,7,2
Group 1,BB,-0.5,8,14,1798,10,2016,6,4
Group 1,BB,-0.5,8,14,1799,8,2016,9,-1
Group 1,BB,-0.5,8,14,1800,11,2016,10,1
Group 1,BB,-0.5,8,14,1801,9,2016,7,2
Group 1,BB,-0.5,8,14,1802,4,2016,5,-1
Group 1,BB,-0.5,8,14,1803,6,2016,7,-1
Group 1,BB,-0.5,8,14,1804,7,2016,7,0
Group 1,BB,-0.5,8,14,1805,9,2016,8,1
Group 1,BB,-0.5,8,14,1806,8,2016,7,1
Group 1,BB,-0.5,8,14,1807,7,2016,4,3
Group 1,BB,-0.5,8,14,1808,12,2016,7,5
Group 1,BB,-0.5,8,14,1809,13,2016,5,8
Group 1,BB,-0.5,8,14,1810,12,2016,6,6
Group 1,BB,-0.5,8,14,1811,11,2016,5,6
Group 1,BB,-0.5,8,14,1812,11,2016,11,0
Group 1,BB,-0.5,8,14,1813,11,2016,6,5
Group 1,BB,-0.5,8,14,1814,12,2016,6,6
Group 1,BB,-0.5,8,14,1815,8,2016,6,2
Group 1,BB,-0.5,8,14,1816,12,2016,9,3
Group 1,BB,-0.5,8,14,1817,12,2016,10,2
Group 1,BB,-0.5,8,14,1818,9,2016,8,1
Group 1,BB,-0.5,8,14,1819,8,2016,6,2
Group 1,BB,-0.5,8,14,1820,10,2016,6,4
Group 1,BB,-0.5,8,14,1821,9,2016,7,2
Group 1,BB,-0.5,8,14,1822,7,2016,7,0
Group 1,BB,-0.5,8,14,1823,7,2016,6,1
Group 1,BB,-0.5,8,14,1824,6,2016,10,-4
Group 1,BB,-0.5,8,14,1825,6,2016,6,0
Group 1,BB,-0.5,8,14,1826,9,2016,6,3
Group 1,BB,-0.5,8,14,1827,10,2016,6,4
Group 1,BB,-0.5,8,14,1828,11,2016,8,3
Group 1,BB,-0.5,8,14,1829,7,2016,6,1
Group 1,BB,-0.5,8,14,1830,7,2016,7,0
Group 1,BB,-0.5,8,14,1831,7,2016,6,1
Group 1,BB,-0.5,8,14,1832,8,2016,9,-1
Group 1,BB,-0.5,8,14,1833,10,2016,6,4
Group 1,BB,-0.5,8,14,1834,6,2016,7,-1
Group 1,BB,-0.5,8,14,1835,10,2016,8,2
Group 1,BB,-0.5,8,14,1836,10,2016,9,1
Group 1,BB,-0.5,8,14,1837,6,2016,9,-3
Group 1,BB,-0.5,8,14,1838,7,2016,11,-4
Group 1,BB,-0.5,8,14,1839,9,2016,9,0
Group 1,BB,-0.5,8,14,1840,11,2016,5,6
Group 1,BB,-0.5,8,14,1841,8,2016,8,0
Group 1,BB,-0.5,8,14,1842,9,2016,9,0
Group 1,BB,-0.5,8,14,1843,10,2016,6,4
Group 1,BB,-0.5,8,14,1844,11,2016,9,2
Group 1,BB,-0.5,8,14,1845,10,2016,11,-1
Group 1,BB,-0.5,8,14,1846,8,2016,14,-6
Group 1,BB,-0.5,8,14,1847,9,2016,3,6
Group 1,BB,-0.5,8,14,1848,10,2016,3,7
Group 1,BB,-0.5,8,14,1849,10,2016,6,4
Group 1,BB,-0.5,8,14,1850,8,2016,7,1
Group 1,BB,-0.5,8,14,1851,7,2016,7,0
Group 1,BB,-0.5,8,14,1852,9,2016,11,-2
Group 1,BB,-0.5,8,14,1853,10,2016,9,1
Group 1,BB,-0.5,8,14,1854,5,2016,8,-3
Group 1,BB,-0.5,8,14,1855,11,2016,9,2
Group 1,BB,-0.5,8,14,1856,11,2016,9,2
Group 1,BB,-0.5,8,14,1857,8,2016,6,2
Group 1,BB,-0.5,8,14,1858,7,2016,6,1
Group 1,BB,-0.5,8,14,1859,12,2016,6,6
Group 1,BB,-0.5,8,14,1860,7,2016,9,-2
Group 1,BB,-0.5,8,14,1861,10,2016,7,3
Group 1,BB,-0.5,8,14,1862,5,2016,7,-2
Group 1,BB,-0.5,8,14,1863,9,2016,8,1
Group 1,BB,-0.5,8,14,1864,8,2016,6,2
Group 1,BB,-0.5,8,14,1865,11,2016,5,6
Group 1,BB,-0.5,8,14,1866,7,2016,7,0
Group 1,BB,-0.5,8,14,1867,11,2016,10,1
Group 1,BB,-0.5,8,14,1868,9,2016,8,1
Group 1,BB,-0.5,8,14,1869,11,2016,8,3
Group 1,BB,-0.5,8,14,1870,9,2016,12,-3
Group 1,BB,-0.5,8,14,1871,9,2016,6,3
Group 1,BB,-0.5,8,14,1872,8,2016,10,-2
Group 1,BB,-0.5,8,14,1873,9,2016,8,1
Group 1,BB,-0.5,8,14,1874,6,2016,8,-2
Group 1,BB,-0.5,8,14,1875,9,2016,8,1
Group 1,BB,-0.5,8,14,1876,8,2016,8,0
Group 1,BB,-0.5,8,14,1877,11,2016,6,5
Group 1,BB,-0.5,8,14,1878,11,2016,11,0
Group 1,BB,-0.5,8,14,1879,9,2016,14,-5
Group 1,BB,-0.5,8,14,1880,10,2016,11,-1
Group 1,BB,-0.5,8,14,1881,9,2016,10,-1
Group 1,BB,-0.5,8,14,1882,7,2016,8,-1
Group 1,BB,-0.5,8,14,1883,7,2016,11,-4
Group 1,BB,-0.5,8,14,1884,8,2016,7,1
Group 1,BB,-0.5,8,14,1885,8,2016,8,0
Group 1,BB,-0.5,8,14,1886,8,2016,7,1
Group 1,BB,-0.5,8,14,1887,9,2016,3,6
Group 1,BB,-0.5,8,14,1888,12,2016,7,5
Group 1,BB,-0.5,8,14,1889,7,2016,9,-2
Group 1,BB,-0.5,8,14,1890,8,2016,10,-2
Group 1,BB,-0.5,8,14,1891,9,2016,6,3
Group 1,BB,-0.5,8,14,1892,7,2016,8,-1
Group 1,BB,-0.5,8,14,1893,7,2016,7,0
Group 1,BB,-0.5,8,14,1894,7,2016,7,0
Group 1,BB,-0.5,8,14,1895,5,2016,9,-4
Group 1,BB,-0.5,8,14,1896,8,2016,8,0
Group 1,BB,-0.5,8,14,1897,13,2016,10,3
Group 1,BB,-0.5,8,14,1898,10,2016,7,3
Group 1,BB,-0.5,8,14,1899,11,2016,6,5
Group 1,BB,-0.5,8,14,1900,8,2016,8,0
Group 1,BB,-0.5,8,14,1901,10,2016,6,4
Group 1,BB,-0.5,8,14,1902,12,2016,6,6
Group 1,BB,-0.5,8,14,1903,7,2016,10,-3
Group 1,BB,-0.5,8,14,1904,10,2016,10,0
Group 1,BB,-0.5,8,14,1905,10,2016,9,1
Group 1,BB,-0.5,8,14,1906,10,2016,9,1
Group 1,BB,-0.5,8,14,1907,9,2016,9,0
Group 1,BB,-0.5,8,14,1908,9,2016,8,1
Group 1,BB,-0.5,8,14,1909,8,2016,6,2
Group 1,BB,-0.5,8,14,1910,10,2016,10,0
Group 1,BB,-0.5,8,14,1911,8,2016,12,-4
Group 1,BB,-0.5,8,14,1912,9,2016,7,2
Group 1,BB,-0.5,8,14,1913,11,2016,11,0
Group 1,BB,-0.5,8,14,1914,9,2016,4,5
Group 1,BB,-0.5,8,14,1915,5,2016,5,0
Group 1,BB,-0.5,8,14,1916,11,2016,11,0
Group 1,BB,-0.5,8,14,1917,8,2016,11,-3
Group 1,BB,-0.5,8,14,1918,3,2016,8,-5
Group 1,BB,-0.5,8,14,1919,8,2016,7,1
Group 1,BB,-0.5,8,14,1920,9,2016,7,2
Group 1,BB,-0.5,8,14,1921,10,2016,5,5
Group 1,BB,-0.5,8,14,1922,9,2016,6,3
Group 1,BB,-0.5,8,14,1923,6,2016,8,-2
Group 1,BB,-0.5,8,14,1924,11,2016,10,1
Group 1,BB,-0.5,8,14,1925,9,2016,6,3
Group 1,BB,-0.5,8,14,1926,7,2016,10,-3
Group 1,BB,-0.5,8,14,1927,6,2016,6,0
Group 1,BB,-0.5,8,14,1928,12,2016,7,5
Group 1,BB,-0.5,8,14,1929,6,2016,10,-4
Group 1,BB,-0.5,8,14,1930,9,2016,7,2
Group 1,BB,-0.5,8,14,1931,11,2016,6,5
Group 1,BB,-0.5,8,14,1932,9,2016,9,0
Group 1,BB,-0.5,8,14,1933,9,2016,9,0
Group 1,BB,-0.5,8,14,1934,6,2016,8,-2
Group 1,BB,-0.5,8,14,1935,9,2016,9,0
Group 1,BB,-0.5,8,14,1936,10,2016,10,0
Group 1,BB,-0.5,8,14,1937,9,2016,9,0
Group 1,BB,-0.5,8,14,1938,11,2016,13,-2
Group 1,BB,-0.5,8,14,1939,10,2016,5,5
Group 1,BB,-0.5,8,14,1940,12,2016,7,5
Group 1,BB,-0.5,8,14,1941,10,2016,9,1
Group 1,BB,-0.5,8,14,1942,7,2016,9,-2
Group 1,BB,-0.5,8,14,1943,10,2016,8,2
Group 1,BB,-0.5,8,14,1944,9,2016,6,3
Group 1,BB,-0.5,8,14,1945,7,2016,11,-4
Group 1,BB,-0.5,8,14,1946,11,2016,8,3
Group 1,BB,-0.5,8,14,1947,11,2016,6,5
Group 1,BB,-0.5,8,14,1948,6,2016,10,-4
Group 1,BB,-0.5,8,14,1949,9,2016,9,0
Group 1,BB,-0.5,8,14,1950,7,2016,8,-1
Group 1,BB,-0.5,8,14,1951,11,2016,9,2
Group 1,BB,-0.5,8,14,1952,8,2016,7,1
Group 1,BB,-0.5,8,14,1953,11,2016,5,6
Group 1,BB,-0.5,8,14,1954,10,2016,11,-1
Group 1,BB,-0.5,8,14,1955,8,2016,9,-1
Group 1,BB,-0.5,8,14,1956,7,2016,7,0
Group 1,BB,-0.5,8,14,1957,7,2016,8,-1
Group 1,BB,-0.5,8,14,1958,7,2016,6,1
Group 1,BB,-0.5,8,14,1959,8,2016,6,2
Group 1,BB,-0.5,8,14,1960,9,2016,8,1
Group 1,BB,-0.5,8,14,1961,8,2016,8,0
Group 1,BB,-0.5,8,14,1962,7,2016,3,4
Group 1,BB,-0.5,8,14,1963,11,2016,6,5
Group 1,BB,-0.5,8,14,1964,6,2016,9,-3
Group 1,BB,-0.5,8,14,1965,9,2016,5,4
Group 1,BB,-0.5,8,14,1966,8,2016,9,-1
Group 1,BB,-0.5,8,14,1967,10,2016,8,2
Group 1,BB,-0.5,8,14,1968,10,2016,10,0
Group 1,BB,-0.5,8,14,1969,9,2016,10,-1
Group 1,BB,-0.5,8,14,1970,7,2016,9,-2
Group 1,BB,-0.5,8,14,1971,4,2016,5,-1
Group 1,BB,-0.5,8,14,1972,7,2016,8,-1
Group 1,BB,-0.5,8,14,1973,11,2016,8,3
Group 1,BB,-0.5,8,14,1974,7,2016,9,-2
Group 1,BB,-0.5,8,14,1975,6,2016,5,1
Group 1,BB,-0.5,8,14,1976,13,2016,4,9
Group 1,BB,-0.5,8,14,1977,8,2016,5,3
Group 1,BB,-0.5,8,14,1978,6,2016,8,-2
Group 1,BB,-0.5,8,14,1979,11,2016,10,1
Group 1,BB,-0.5,8,14,1980,9,2016,8,1
Group 1,BB,-0.5,8,14,1981,7,2016,8,-1
Group 1,BB,-0.5,8,14,1982,11,2016,8,3
Group 1,BB,-0.5,8,14,1983,8,2016,10,-2
Group 1,BB,-0.5,8,14,1984,6,2016,12,-6
Group 1,BB,-0.5,8,14,1985,8,2016,12,-4
Group 1,BB,-0.5,8,14,1986,9,2016,5,4
Group 1,BB,-0.5,8,14,1987,5,2016,13,-8
Group 1,BB,-0.5,8,14,1988,10,2016,10,0
Group 1,BB,-0.5,8,14,1989,7,2016,3,4
Group 1,BB,-0.5,8,14,1990,8,2016,8,0
Group 1,BB,-0.5,8,14,1991,7,2016,8,-1
Group 1,BB,-0.5,8,14,1992,9,2016,9,0
Group 1,BB,-0.5,8,14,1993,9,2016,7,2
Group 1,BB,-0.5,8,14,1994,7,2016,6,1
Group 1,BB,-0.5,8,14,1995,11,2016,9,2
Group 1,BB,-0.5,8,14,1996,6,2016,9,-3
Group 1,BB,-0.5,8,14,1997,5,2016,5,0
Group 1,BB,-0.5,8,14,1998,9,2016,8,1
Group 1,BB,-0.5,8,14,1999,8,2016,9,-1
Group 1,BB,-0.5,8,14,2000,7,2016,10,-3
Group 1,BB,-0.5,8,14,2001,13,2016,11,2
Group 1,BB,-0.5,8,14,2002,11,2016,10,1
Group 1,BB,-0.5,8,14,2003,9,2016,12,-3
Group 1,BB,-0.5,8,14,2004,11,2016,8,3
Group 1,BB,-0.5,8,14,2005,8,2016,8,0
Group 1,BB,-0.5,8,14,2006,9,2016,7,2
Group 1,BB,-0.5,8,14,2007,7,2016,11,-4
Group 1,BB,-0.5,8,14,2008,8,2016,7,1
Group 1,BB,-0.5,8,14,2009,12,2016,6,6
Group 1,BB,-0.5,8,14,2010,8,2016,10,-2
Group 1,BB,-0.5,8,14,2011,10,2016,9,1
Group 1,BB,-0.5,8,14,2012,11,2016,5,6
Group 1,BB,-0.5,8,14,2013,7,2016,10,-3
Group 1,BB,-0.5,8,14,2014,9,2016,10,-1
Group 1,BB,-0.5,8,14,2015,7,2016,8,-1
Group 1,BB,-0.5,8,14,2016,8,2016,8,0
Group 1,BB,-0.5,8,14,2017,8,2016,7,1
Group 1,BB,-0.5,8,14,2018,12,2016,4,8
Group 1,BB,-0.5,8,14,2019,12,2016,9,3
Group 1,BB,-0.5,8,14,2020,10,2016,8,2
Group 1,BB,-0.5,8,14,2021,9,2016,4,5
Group 1,BB,-0.5,8,14,2022,6,2016,8,-2
Group 1,BB,-0.5,8,14,2023,9,2016,11,-2
Group 1,BB,-0.5,8,14,2024,8,2016,10,-2
Group 1,BB,-0.5,8,14,2025,10,2016,11,-1
Group 1,BB,-0.5,8,14,2026,10,2016,10,0
Group 1,BB,-0.5,8,14,2027,9,2016,11,-2
Group 1,BB,-0.5,8,14,2028,10,2016,10,0
Group 1,BB,-0.5,8,14,2029,7,2016,6,1
Group 1,BB,-0.5,8,14,2030,7,2016,12,-5
Group 1,BB,-0.5,8,14,2031,10,2016,5,5
Group 1,BB,-0.5,8,14,2032,3,2016,9,-6
Group 1,BB,-0.5,8,14,2033,7,2016,9,-2
Group 1,BB,-0.5,8,14,2034,7,2016,9,-2
Group 1,BB,-0.5,8,14,2035,7,2016,7,0
Group 1,BB,-0.5,8,14,2036,11,2016,7,4
Group 1,BB,-0.5,8,14,2037,9,2016,9,0
Group 1,BB,-0.5,8,14,2038,10,2016,9,1
Group 1,BB,-0.5,8,14,2039,12,2016,9,3
Group 1,BB,-0.5,8,14,2040,10,2016,6,4
Group 1,BB,-0.5,8,14,2041,7,2016,8,-1
Group 1,BB,-0.5,8,14,2042,10,2016,7,3
Group 1,BB,-0.5,8,14,2043,10,2016,6,4
Group 1,BB,-0.5,8,14,2044,9,2016,6,3
Group 1,BB,-0.5,8,14,2045,12,2016,7,5
Group 1,BB,-0.5,8,14,2046,8,2016,8,0
Group 1,BB,-0.5,8,14,2047,7,2016,3,4
Group 1,BB,-0.5,8,14,2048,7,2016,8,-1
Group 1,BB,-0.5,8,14,2049,11,2016,7,4
Group 1,BB,-0.5,8,14,2050,11,2016,9,2
Group 1,BB,-0.5,8,14,2051,8,2016,10,-2
Group 1,BB,-0.5,8,14,2052,12,2016,9,3
Group 1,BB,-0.5,8,14,2053,12,2016,7,5
Group 1,BB,-0.5,8,14,2054,10,2016,10,0
Group 1,BB,-0.5,8,14,2055,9,2016,8,1
Group 1,BB,-0.5,8,14,2056,9,2016,8,1
Group 1,BB,-0.5,8,14,2057,8,2016,9,-1
Group 1,BB,-0.5,8,14,2058,9,2016,10,-1
Group 1,BB,-0.5,8,14,2059,8,2016,8,0
Group 1,BB,-0.5,8,14,2060,6,2016,10,-4
Group 1,BB,-0.5,8,14,2061,9,2016,11,-2
Group 1,BB,-0.5,8,14,2062,8,2016,7,1
Group 1,BB,-0.5,8,14,2063,5,2016,8,-3
Group 1,BB,-0.5,8,14,2064,10,2016,4,6
Group 1,BB,-0.5,8,14,2065,7,2016,5,2
Group 1,BB,-0.5,8,14,2066,8,2016,10,-2
Group 1,BB,-0.5,8,14,2067,5,2016,9,-4
Group 1,BB,-0.5,8,14,2068,6,2016,11,-5
Group 1,BB,-0.5,8,14,2069,6,2016,8,-2
Group 1,BB,-0.5,8,14,2070,6,2016,7,-1
Group 1,BB,-0.5,8,14,2071,7,2016,9,-2
Group 1,BB,-0.5,8,14,2072,6,2016,7,-1
Group 1,BB,-0.5,8,14,2073,7,2016,8,-1
Group 1,BB,-0.5,8,14,2074,11,2016,6,5
Group 1,BB,-0.5,8,14,2075,9,2016,7,2
Group 1,BB,-0.5,8,14,2076,9,2016,9,0
Group 1,BB,-0.5,8,14,2077,7,2016,8,-1
Group 1,BB,-0.5,8,14,2078,8,2016,9,-1
Group 1,BB,-0.5,8,14,2079,7,2016,8,-1
Group 1,BB,-0.5,8,14,2080,9,2016,4,5
Group 1,BB,-0.5,8,14,2081,12,2016,7,5
Group 1,BB,-0.5,8,14,2082,9,2016,8,1
Group 1,BB,-0.5,8,14,2083,7,2016,5,2
Group 1,BB,-0.5,8,14,2084,9,2016,5,4
Group 1,BB,-0.5,8,14,2085,7,2016,7,0
Group 1,BB,-0.5,8,14,2086,8,2016,8,0
Group 1,BB,-0.5,8,14,2087,5,2016,9,-4
Group 1,BB,-0.5,8,14,2088,6,2016,6,0
Group 1,BB,-0.5,8,14,2089,5,2016,8,-3
Group 1,BB,-0.5,8,14,2090,8,2016,9,-1
Group 1,BB,-0.5,8,14,2091,7,2016,6,1
Group 1,BB,-0.5,8,14,2092,9,2016,11,-2
Group 1,BB,-0.5,8,14,2093,10,2016,8,2
Group 1,BB,-0.5,8,14,2094,8,2016,11,-3
Group 1,BB,-0.5,8,14,2095,11,2016,8,3
Group 1,BB,-0.5,8,14,2096,10,2016,9,1
Group 1,BB,-0.5,8,14,2097,8,2016,7,1
Group 1,BB,-0.5,8,14,2098,5,2016,9,-4
Group 1,BB,-0.5,8,14,2099,7,2016,8,-1
Group 1,BB,-0.5,8,14,2100,6,2016,7,-1
Group 1,BB,-0.5,8,14,2101,11,2016,9,2
Group 1,BB,-0.5,8,14,2102,8,2016,8,0
Group 1,BB,-0.5,8,14,2103,6,2016,11,-5
Group 1,BB,-0.5,8,14,2104,10,2016,11,-1
Group 1,BB,-0.5,8,14,2105,9,2016,10,-1
Group 1,BB,-0.5,8,14,2106,7,2016,8,-1
Group 1,BB,-0.5,8,14,2107,11,2016,9,2
Group 1,BB,-0.5,8,14,2108,9,2016,7,2
Group 1,BB,-0.5,8,14,2109,8,2016,8,0
Group 1,BB,-0.5,8,14,2110,10,2016,10,0
Group 1,BB,-0.5,8,14,2111,8,2016,11,-3
Group 1,BB,-0.5,8,14,2112,10,2016,7,3
Group 1,BB,-0.5,8,14,2113,9,2016,9,0
Group 1,BB,-0.5,8,14,2114,8,2016,6,2
Group 1,BB,-0.5,8,14,2115,6,2016,4,2
Group 1,BB,-0.5,8,14,2116,8,2016,7,1
Group 1,BB,-0.5,8,14,2117,8,2016,7,1
Group 1,BB,-0.5,8,14,2118,5,2016,8,-3
Group 1,BB,-0.5,8,14,2119,7,2016,7,0
Group 1,BB,-0.5,8,14,2120,9,2016,9,0
Group 1,BB,-0.5,8,14,2121,10,2016,9,1
Group 1,BB,-0.5,8,14,2122,14,2016,12,2
Group 1,BB,-0.5,8,14,2123,5,2016,9,-4
Group 1,BB,-0.5,8,14,2124,8,2016,10,-2
Group 1,BB,-0.5,8,14,2125,9,2016,9,0
Group 1,BB,-0.5,8,14,2126,11,2016,10,1
Group 1,BB,-0.5,8,14,2127,11,2016,11,0
Group 1,BB,-0.5,8,14,2128,9,2016,10,-1
Group 1,BB,-0.5,8,14,2129,11,2016,9,2
Group 1,BB,-0.5,8,14,2130,8,2016,8,0
Group 1,BB,-0.5,8,14,2131,10,2016,6,4
Group 1,BB,-0.5,8,14,2132,10,2016,3,7
Group 1,BB,-0.5,8,14,2133,13,2016,3,10
Group 1,BB,-0.5,8,14,2134,12,2016,4,8
Group 1,BB,-0.5,8,14,2135,11,2016,6,5
Group 1,BB,-0.5,8,14,2136,10,2016,7,3
Group 1,BB,-0.5,8,14,2137,7,2016,7,0
Group 1,BB,-0.5,8,14,2138,10,2016,5,5
Group 1,BB,-0.5,8,14,2139,10,2016,10,0
Group 1,BB,-0.5,8,14,2140,8,2016,5,3
Group 1,BB,-0.5,8,14,2141,8,2016,10,-2
Group 1,BB,-0.5,8,14,2142,6,2016,5,1
Group 1,BB,-0.5,8,14,2143,7,2016,8,-1
Group 1,BB,-0.5,8,14,2144,9,2016,8,1
Group 1,BB,-0.5,8,14,2145,9,2016,6,3
Group 1,BB,-0.5,8,14,2146,6,2016,10,-4
Group 1,BB,-0.5,8,14,2147,11,2016,9,2
Group 1,BB,-0.5,8,14,2148,7,2016,9,-2
Group 1,BB,-0.5,8,14,2149,9,2016,4,5
Group 1,BB,-0.5,8,14,2150,8,2016,7,1
Group 1,BB,-0.5,8,14,2151,11,2016,6,5
Group 1,BB,-0.5,8,14,2152,10,2016,11,-1
Group 1,BB,-0.5,8,14,2153,11,2016,11,0
Group 1,BB,-0.5,8,14,2154,7,2016,10,-3
Group 1,BB,-0.5,8,14,2155,11,2016,6,5
Group 1,BB,-0.5,8,14,2156,8,2016,8,0
Group 1,BB,-0.5,8,14,2157,9,2016,6,3
Group 1,BB,-0.5,8,14,2158,10,2016,10,0
Group 1,BB,-0.5,8,14,2159,7,2016,7,0
Group 1,BB,-0.5,8,14,2160,6,2016,7,-1
Group 1,BB,-0.5,8,14,2161,8,2016,10,-2
Group 1,BB,-0.5,8,14,2162,7,2016,9,-2
Group 1,BB,-0.5,8,14,2163,8,2016,11,-3
Group 1,BB,-0.5,8,14,2164,9,2016,13,-4
Group 1,BB,-0.5,8,14,2165,4,2016,7,-3
Group 1,BB,-0.5,8,14,2166,12,2016,11,1
Group 1,BB,-0.5,8,14,2167,11,2016,8,3
Group 1,BB,-0.5,8,14,2168,10,2016,9,1
Group 1,BB,-0.5,8,14,2169,7,2016,4,3
Group 1,BB,-0.5,8,14,2170,8,2016,4,4
Group 1,BB,-0.5,8,14,2171,11,2016,1,10
Group 1,BB,-0.5,8,14,2172,12,2016,6,6
Group 1,BB,-0.5,8,14,2173,10,2016,9,1
Group 1,BB,-0.5,8,14,2174,8,2016,8,0
Group 1,BB,-0.5,8,14,2175,9,2016,12,-3
Group 1,BB,-0.5,8,14,2176,12,2016,8,4
Group 1,BB,-0.5,8,14,2177,10,2016,10,0
Group 1,BB,-0.5,8,14,2178,10,2016,10,0
Group 1,BB,-0.5,8,14,2179,11,2016,7,4
Group 1,BB,-0.5,8,14,2180,10,2016,7,3
Group 1,BB,-0.5,8,14,2181,8,2016,7,1
Group 1,BB,-0.5,8,14,2182,10,2016,9,1
Group 1,BB,-0.5,8,14,2183,9,2016,7,2
Group 1,BB,-0.5,8,14,2184,10,2016,10,0
Group 1,BB,-0.5,8,14,2185,7,2016,8,-1
Group 1,BB,-0.5,8,14,2186,5,2016,5,0
Group 1,BB,-0.5,8,14,2187,9,2016,8,1
Group 1,BB,-0.5,8,14,2188,7,2016,6,1
Group 1,BB,-0.5,8,14,2189,6,2016,6,0
Group 1,BB,-0.5,8,14,2190,12,2016,10,2
Group 1,BB,-0.5,8,14,2191,8,2016,11,-3
Group 1,BB,-0.5,8,14,2192,7,2016,8,-1
Group 1,BB,-0.5,8,14,2193,10,2016,7,3
Group 1,BB,-0.5,8,14,2194,9,2016,8,1
Group 1,BB,-0.5,8,14,2195,8,2016,9,-1
Group 1,BB,-0.5,8,14,2196,11,2016,8,3
Group 1,BB,-0.5,8,14,2197,9,2016,8,1
Group 1,BB,-0.5,8,14,2198,6,2016,9,-3
Group 1,BB,-0.5,8,14,2199,7,2016,9,-2
Group 1,BB,-0.5,8,14,2200,7,2016,9,-2
Group 1,BB,-0.5,8,14,2201,6,2016,4,2
Group 1,BB,-0.5,8,14,2202,12,2016,13,-1
Group 1,BB,-0.5,8,14,2203,9,2016,9,0
Group 1,BB,-0.5,8,14,2204,9,2016,10,-1
Group 1,BB,-0.5,8,14,2205,10,2016,9,1
Group 1,BB,-0.5,8,14,2206,11,2016,9,2
Group 1,BB,-0.5,8,14,2207,12,2016,9,3
Group 1,BB,-0.5,8,14,2208,13,2016,5,8
Group 1,BB,-0.5,8,14,2209,10,2016,6,4
Group 1,BB,-0.5,8,14,2210,8,2016,9,-1
Group 1,BB,-0.5,8,14,2211,8,2016,11,-3
Group 1,BB,-0.5,8,14,2212,11,2016,10,1
Group 1,BB,-0.5,8,14,2213,7,2016,8,-1
Group 1,BB,-0.5,8,14,2214,6,2016,7,-1
Group 1,BB,-0.5,8,14,2215,8,2016,8,0
Group 1,BB,-0.5,8,14,2216,12,2016,7,5
Group 1,BB,-0.5,8,14,2217,10,2016,9,1
Group 1,BB,-0.5,8,14,2218,11,2016,9,2
Group 1,BB,-0.5,8,14,2219,6,2016,8,-2
Group 1,BB,-0.5,8,14,2220,11,2016,9,2
Group 1,BB,-0.5,8,14,2221,8,2016,8,0
Group 1,BB,-0.5,8,14,2222,10,2016,11,-1
Group 1,BB,-0.5,8,14,2223,8,2016,5,3
Group 1,BB,-0.5,8,14,2224,10,2016,10,0
Group 1,BB,-0.5,8,14,2225,9,2016,11,-2
Group 1,BB,-0.5,8,14,2226,10,2016,3,7
Group 1,BB,-0.5,8,14,2227,9,2016,8,1
Group 1,BB,-0.5,8,14,2228,7,2016,10,-3
Group 1,BB,-0.5,8,14,2229,10,2016,11,-1
Group 1,BB,-0.5,8,14,2230,10,2016,10,0
Group 1,BB,-0.5,8,14,2231,10,2016,6,4
Group 1,BB,-0.5,8,14,2232,9,2016,7,2
Group 1,BB,-0.5,8,14,2233,11,2016,5,6
Group 1,BB,-0.5,8,14,2234,10,2016,8,2
Group 1,BB,-0.5,8,14,2235,8,2016,11,-3
Group 1,BB,-0.5,8,14,2236,8,2016,9,-1
Group 1,BB,-0.5,8,14,2237,12,2016,10,2
Group 1,BB,-0.5,8,14,2238,8,2016,9,-1
Group 1,BB,-0.5,8,14,2239,11,2016,9,2
Group 1,BB,-0.5,8,14,2240,7,2016,10,-3
Group 1,BB,-0.5,8,14,2241,4,2016,7,-3
Group 1,BB,-0.5,8,14,2242,9,2016,7,2
Group 1,BB,-0.5,8,14,2243,9,2016,5,4
Group 1,BB,-0.5,8,14,2244,8,2016,9,-1
Group 1,BB,-0.5,8,14,2245,6,2016,9,-3
Group 1,BB,-0.5,8,14,2246,11,2016,8,3
Group 1,BB,-0.5,8,14,2247,9,2016,9,0
Group 1,BB,-0.5,8,14,2248,8,2016,11,-3
Group 1,BB,-0.5,8,14,2249,6,2016,9,-3
Group 1,BB,-0.5,8,14,2250,11,2016,11,0
Group 1,BB,-0.5,8,14,2251,9,2016,6,3
Group 1,BB,-0.5,8,14,2252,8,2016,8,0
Group 1,BB,-0.5,8,14,2253,9,2016,6,3
Group 1,BB,-0.5,8,14,2254,10,2016,10,0
Group 1,BB,-0.5,8,14,2255,12,2016,8,4
Group 1,BB,-0.5,8,14,2256,11,2016,10,1
Group 1,BB,-0.5,8,14,2257,11,2016,9,2
Group 1,BB,-0.5,8,14,2258,7,2016,8,-1
Group 1,BB,-0.5,8,14,2259,12,2016,4,8
Group 1,BB,-0.5,8,14,2260,5,2016,6,-1
Group 1,BB,-0.5,8,14,2261,10,2016,6,4
Group 1,BB,-0.5,8,14,2262,9,2016,7,2
Group 1,BB,-0.5,8,14,2263,10,2016,10,0
Group 1,BB,-0.5,8,14,2264,9,2016,8,1
Group 1,BB,-0.5,8,14,2265,12,2016,6,6
Group 1,BB,-0.5,8,14,2266,11,2016,6,5
Group 1,BB,-0.5,8,14,2267,7,2016,10,-3
Group 1,BB,-0.5,8,14,2268,8,2016,8,0
Group 1,BB,-0.5,8,14,2269,9,2016,9,0
Group 1,BB,-0.5,8,14,2270,9,2016,10,-1
Group 1,BB,-0.5,8,14,2271,11,2016,7,4
Group 1,BB,-0.5,8,14,2272,10,2016,8,2
Group 1,BB,-0.5,8,14,2273,12,2016,2,10
Group 1,BB,-0.5,8,14,2274,13,2016,6,7
Group 1,BB,-0.5,8,14,2275,12,2016,7,5
Group 1,BB,-0.5,8,14,2276,9,2016,10,-1
Group 1,BB,-0.5,8,14,2277,11,2016,9,2
Group 1,BB,-0.5,8,14,2278,7,2016,4,3
Group 1,BB,-0.5,8,14,2279,8,2016,7,1
Group 1,BB,-0.5,8,14,2280,9,2016,5,4
Group 1,BB,-0.5,8,14,2281,10,2016,6,4
Group 1,BB,-0.5,8,14,2282,8,2016,6,2
Group 1,BB,-0.5,8,14,2283,10,2016,7,3
Group 1,BB,-0.5,8,14,2284,12,2016,9,3
Group 1,BB,-0.5,8,14,2285,11,2016,11,0
Group 1,BB,-0.5,8,14,2286,11,2016,9,2
Group 1,BB,-0.5,8,14,2287,8,2016,7,1
Group 1,BB,-0.5,8,14,2288,8,2016,8,0
Group 1,BB,-0.5,8,14,2289,4,2016,7,-3
Group 1,BB,-0.5,8,14,2290,11,2016,8,3
Group 1,BB,-0.5,8,14,2291,7,2016,4,3
Group 1,BB,-0.5,8,14,2292,9,2016,8,1
Group 1,BB,-0.5,8,14,2293,6,2016,8,-2
Group 1,BB,-0.5,8,14,2294,6,2016,9,-3
Group 1,BB,-0.5,8,14,2295,12,2016,7,5
Group 1,BB,-0.5,8,14,2296,11,2016,6,5
Group 1,BB,-0.5,8,14,2297,9,2016,10,-1
Group 1,BB,-0.5,8,14,2298,11,2016,8,3
Group 1,BB,-0.5,8,14,2299,7,2016,7,0
Group 1,BB,-0.5,8,14,2300,10,2016,3,7
Group 1,BB,-0.5,8,14,2301,10,2016,9,1
Group 1,BB,-0.5,8,14,2302,12,2016,8,4
Group 1,BB,-0.5,8,14,2303,11,2016,7,4
Group 1,BB,-0.5,8,14,2304,12,2016,7,5
Group 1,BB,-0.5,8,14,2305,6,2016,11,-5
Group 1,BB,-0.5,8,14,2306,9,2016,4,5
Group 1,BB,-0.5,8,14,2307,6,2016,9,-3
Group 1,BB,-0.5,8,14,2308,10,2016,10,0
Group 1,BB,-0.5,8,14,2309,7,2016,8,-1
Group 1,BB,-0.5,8,14,2310,8,2016,12,-4
Group 1,BB,-0.5,8,14,2311,7,2016,8,-1
Group 1,BB,-0.5,8,14,2312,11,2016,10,1
Group 1,BB,-0.5,8,14,2313,7,2016,8,-1
Group 1,BB,-0.5,8,14,2314,8,2016,7,1
Group 1,BB,-0.5,8,14,2315,9,2016,7,2
Group 1,BB,-0.5,8,14,2316,8,2016,9,-1
Group 1,BB,-0.5,8,14,2317,8,2016,9,-1
Group 1,BB,-0.5,8,14,2318,6,2016,9,-3
Group 1,BB,-0.5,8,14,2319,8,2016,9,-1
Group 1,BB,-0.5,8,14,2320,7,2016,8,-1
Group 1,BB,-0.5,8,14,2321,9,2016,11,-2
Group 1,BB,-0.5,8,14,2322,10,2016,8,2
Group 1,BB,-0.5,8,14,2323,10,2016,12,-2
Group 1,BB,-0.5,8,14,2324,7,2016,9,-2
Group 1,BB,-0.5,8,14,2325,6,2016,8,-2
Group 1,BB,-0.5,8,14,2326,10,2016,8,2
Group 1,BB,-0.5,8,14,2327,8,2016,5,3
Group 1,BB,-0.5,8,14,2328,11,2016,10,1
Group 1,BB,-0.5,8,14,2329,9,2016,4,5
Group 1,BB,-0.5,8,14,2330,9,2016,7,2
Group 1,BB,-0.5,8,14,2331,9,2016,7,2
Group 1,BB,-0.5,8,14,2332,9,2016,13,-4
Group 1,BB,-0.5,8,14,2333,9,2016,11,-2
Group 1,BB,-0.5,8,14,2334,9,2016,9,0
Group 1,BB,-0.5,8,14,2335,9,2016,8,1
Group 1,BB,-0.5,8,14,2336,8,2016,8,0
Group 1,BB,-0.5,8,14,2337,10,2016,9,1
Group 1,BB,-0.5,8,14,2338,8,2016,11,-3
Group 1,BB,-0.5,8,14,2339,12,2016,9,3
Group 1,BB,-0.5,8,14,2340,9,2016,2,7
Group 1,BB,-0.5,8,14,2341,8,2016,9,-1
Group 1,BB,-0.5,8,14,2342,11,2016,8,3
Group 1,BB,-0.5,8,14,2343,8,2016,9,-1
Group 1,BB,-0.5,8,14,2344,7,2016,7,0
Group 1,BB,-0.5,8,14,2345,10,2016,8,2
Group 1,BB,-0.5,8,14,2346,12,2016,11,1
Group 1,BB,-0.5,8,14,2347,10,2016,10,0
Group 1,BB,-0.5,8,14,2348,10,2016,7,3
Group 1,BB,-0.5,8,14,2349,12,2016,5,7
Group 1,BB,-0.5,8,14,2350,6,2016,11,-5
Group 1,BB,-0.5,8,14,2351,9,2016,7,2
Group 1,BB,-0.5,8,14,2352,9,2016,6,3
Group 1,BB,-0.5,8,14,2353,8,2016,7,1
Group 1,BB,-0.5,8,14,2354,7,2016,9,-2
Group 1,BB,-0.5,8,14,2355,9,2016,11,-2
Group 1,BB,-0.5,8,14,2356,8,2016,11,-3
Group 1,BB,-0.5,8,14,2357,7,2016,6,1
Group 1,BB,-0.5,8,14,2358,7,2016,8,-1
Group 1,BB,-0.5,8,14,2359,12,2016,12,0
Group 1,BB,-0.5,8,14,2360,9,2016,8,1
Group 1,BB,-0.5,8,14,2361,7,2016,9,-2
Group 1,BB,-0.5,8,14,2362,9,2016,9,0
Group 1,BB,-0.5,8,14,2363,8,2016,4,4
Group 1,BB,-0.5,8,14,2364,8,2016,9,-1
Group 1,BB,-0.5,8,14,2365,7,2016,6,1
Group 1,BB,-0.5,8,14,2366,8,2016,3,5
Group 1,BB,-0.5,8,14,2367,9,2016,9,0
Group 1,BB,-0.5,8,14,2368,11,2016,13,-2
Group 1,BB,-0.5,8,14,2369,8,2016,12,-4
Group 1,BB,-0.5,8,14,2370,6,2016,9,-3
Group 1,BB,-0.5,8,14,2371,4,2016,9,-5
Group 1,BB,-0.5,8,14,2372,9,2016,11,-2
Group 1,BB,-0.5,8,14,2373,8,2016,5,3
Group 1,BB,-0.5,8,14,2374,11,2016,7,4
Group 1,BB,-0.5,8,14,2375,7,2016,9,-2
Group 1,BB,-0.5,8,14,2376,9,2016,9,0
Group 1,BB,-0.5,8,14,2377,8,2016,11,-3
Group 1,BB,-0.5,8,14,2378,9,2016,7,2
Group 1,BB,-0.5,8,14,2379,12,2016,8,4
Group 1,BB,-0.5,8,14,2380,9,2016,12,-3
Group 1,BB,-0.5,8,14,2381,7,2016,7,0
Group 1,BB,-0.5,8,14,2382,6,2016,5,1
Group 1,BB,-0.5,8,14,2383,12,2016,6,6
Group 1,BB,-0.5,8,14,2384,9,2016,8,1
Group 1,BB,-0.5,8,14,2385,8,2016,8,0
Group 1,BB,-0.5,8,14,2386,6,2016,9,-3
Group 1,BB,-0.5,8,14,2387,9,2016,6,3
Group 1,BB,-0.5,8,14,2388,12,2016,8,4
Group 1,BB,-0.5,8,14,2389,10,2016,7,3
Group 1,BB,-0.5,8,14,2390,8,2016,11,-3
Group 1,BB,-0.5,8,14,2391,6,2016,9,-3
Group 1,BB,-0.5,8,14,2392,5,2016,8,-3
Group 1,BB,-0.5,8,14,2393,12,2016,7,5
Group 1,BB,-0.5,8,14,2394,10,2016,5,5
Group 1,BB,-0.5,8,14,2395,6,2016,4,2
Group 1,BB,-0.5,8,14,2396,8,2016,7,1
Group 1,BB,-0.5,8,14,2397,10,2016,5,5
Group 1,BB,-0.5,8,14,2398,6,2016,10,-4
Group 1,BB,-0.5,8,14,2399,7,2016,5,2
Group 1,BB,-0.5,8,14,2400,12,2016,13,-1
Group 1,BB,-0.5,8,14,2401,10,2016,7,3
Group 1,BB,-0.5,8,14,2402,10,2016,2,8
Group 1,BB,-0.5,8,14,2403,8,2016,9,-1
Group 1,BB,-0.5,8,14,2404,6,2016,8,-2
Group 1,BB,-0.5,8,14,2405,6,2016,4,2
Group 1,BB,-0.5,8,14,2406,7,2016,12,-5
Group 1,BB,-0.5,8,14,2407,7,2016,10,-3
Group 1,BB,-0.5,8,14,2408,7,2016,8,-1
Group 1,BB,-0.5,8,14,2409,10,2016,8,2
Group 1,BB,-0.5,8,14,2410,7,2016,9,-2
Group 1,BB,-0.5,8,14,2411,5,2016,9,-4
Group 1,BB,-0.5,8,14,2412,7,2016,13,-6
Group 1,BB,-0.5,8,14,2413,9,2016,5,4
Group 1,BB,-0.5,8,14,2414,8,2016,9,-1
Group 1,BB,-0.5,8,14,2415,6,2016,8,-2
Group 1,BB,-0.5,8,14,2416,11,2016,7,4
Group 1,BB,-0.5,8,14,2417,9,2016,9,0
Group 1,BB,-0.5,8,14,2418,9,2016,9,0
Group 1,BB,-0.5,8,14,2419,9,2016,6,3
Group 1,BB,-0.5,8,14,2420,6,2016,6,0
Group 1,BB,-0.5,8,14,2421,8,2016,6,2
Group 1,BB,-0.5,8,14,2422,8,2016,8,0
Group 1,BB,-0.5,8,14,2423,6,2016,8,-2
Group 1,BB,-0.5,8,14,2424,7,2016,10,-3
Group 1,BB,-0.5,8,14,2425,8,2016,7,1
Group 1,BB,-0.5,8,14,2426,12,2016,7,5
Group 1,BB,-0.5,8,14,2427,9,2016,10,-1
Group 1,BB,-0.5,8,14,2428,7,2016,8,-1
Group 1,BB,-0.5,8,14,2429,9,2016,8,1
Group 1,BB,-0.5,8,14,2430,11,2016,11,0
Group 1,BB,-0.5,8,14,2431,7,2016,7,0
Group 1,BB,-0.5,8,14,2432,9,2016,6,3
Group 1,BB,-0.5,8,14,2433,9,2016,9,0
Group 1,BB,-0.5,8,14,2434,8,2016,5,3
Group 1,BB,-0.5,8,14,2435,8,2016,9,-1
Group 1,BB,-0.5,8,14,2436,8,2016,6,2
Group 1,BB,-0.5,8,14,2437,7,2016,10,-3
Group 1,BB,-0.5,8,14,2438,8,2016,10,-2
Group 1,BB,-0.5,8,14,2439,9,2016,7,2
Group 1,BB,-0.5,8,14,2440,9,2016,10,-1
Group 1,BB,-0.5,8,14,2441,11,2016,4,7
Group 1,BB,-0.5,8,14,2442,6,2016,9,-3
Group 1,BB,-0.5,8,14,2443,9,2016,9,0
Group 1,BB,-0.5,8,14,2444,8,2016,8,0
Group 1,BB,-0.5,8,14,2445,9,2016,9,0
Group 1,BB,-0.5,8,14,2446,12,2016,11,1
Group 1,BB,-0.5,8,14,2447,7,2016,10,-3
Group 1,BB,-0.5,8,14,2448,6,2016,9,-3
Group 1,BB,-0.5,8,14,2449,7,2016,7,0
Group 1,BB,-0.5,8,14,2450,9,2016,5,4
Group 1,BB,-0.5,8,14,2451,9,2016,11,-2
Group 1,BB,-0.5,8,14,2452,8,2016,11,-3
Group 1,BB,-0.5,8,14,2453,10,2016,9,1
Group 1,BB,-0.5,8,14,2454,11,2016,11,0
Group 1,BB,-0.5,8,14,2455,10,2016,9,1
Group 1,BB,-0.5,8,14,2456,10,2016,8,2
Group 1,BB,-0.5,8,14,2457,10,2016,12,-2
Group 1,BB,-0.5,8,14,2458,11,2016,12,-1
Group 1,BB,-0.5,8,14,2459,10,2016,8,2
Group 1,BB,-0.5,8,14,2460,10,2016,10,0
Group 1,BB,-0.5,8,14,2461,7,2016,10,-3
Group 1,BB,-0.5,8,14,2462,7,2016,6,1
Group 1,BB,-0.5,8,14,2463,10,2016,9,1
Group 1,BB,-0.5,8,14,2464,9,2016,9,0
Group 1,BB,-0.5,8,14,2465,10,2016,7,3
Group 1,BB,-0.5,8,14,2466,9,2016,7,2
Group 1,BB,-0.5,8,14,2467,11,2016,9,2
Group 1,BB,-0.5,8,14,2468,10,2016,8,2
Group 1,BB,-0.5,8,14,2469,7,2016,9,-2
Group 1,BB,-0.5,8,14,2470,9,2016,10,-1
Group 1,BB,-0.5,8,14,2471,8,2016,10,-2
Group 1,BB,-0.5,8,14,2472,8,2016,9,-1
Group 1,BB,-0.5,8,14,2473,11,2016,5,6
Group 1,BB,-0.5,8,14,2474,12,2016,9,3
Group 1,BB,-0.5,8,14,2475,13,2016,11,2
Group 1,BB,-0.5,8,14,2476,12,2016,5,7
Group 1,BB,-0.5,8,14,2477,8,2016,10,-2
Group 1,BB,-0.5,8,14,2478,11,2016,7,4
Group 1,BB,-0.5,8,14,2479,7,2016,5,2
Group 1,BB,-0.5,8,14,2480,4,2016,9,-5
Group 1,BB,-0.5,8,14,2481,4,2016,5,-1
Group 1,BB,-0.5,8,14,2482,8,2016,9,-1
Group 1,BB,-0.5,8,14,2483,8,2016,7,1
Group 1,BB,-0.5,8,14,2484,8,2016,8,0
Group 1,BB,-0.5,8,14,2485,12,2016,6,6
Group 1,BB,-0.5,8,14,2486,13,2016,8,5
Group 1,BB,-0.5,8,14,2487,7,2016,7,0
Group 1,BB,-0.5,8,14,2488,8,2016,8,0
Group 1,BB,-0.5,8,14,2489,10,2016,9,1
Group 1,BB,-0.5,8,14,2490,9,2016,10,-1
Group 1,BB,-0.5,8,14,2491,7,2016,5,2
Group 1,BB,-0.5,8,14,2492,12,2016,10,2
Group 1,BB,-0.5,8,14,2493,10,2016,9,1
Group 1,BB,-0.5,8,14,2494,12,2016,7,5
Group 1,BB,-0.5,8,14,2495,10,2016,7,3
Group 1,BB,-0.5,8,14,2496,8,2016,11,-3
Group 1,BB,-0.5,8,14,2497,7,2016,8,-1
Group 1,BB,-0.5,8,14,2498,3,2016,6,-3
Group 1,BB,-0.5,8,14,2499,12,2016,10,2
Group 1,BB,-0.5,8,14,2500,10,2016,10,0
Group 1,BB,-0.5,8,14,2501,10,2016,6,4
Group 1,BB,-0.5,8,14,2502,11,2016,7,4
Group 1,BB,-0.5,8,14,2503,9,2016,10,-1
Group 1,BB,-0.5,8,14,2504,5,2016,12,-7
Group 1,BB,-0.5,8,14,2505,7,2016,6,1
Group 1,BB,-0.5,8,14,2506,9,2016,6,3
Group 1,BB,-0.5,8,14,2507,7,2016,5,2
Group 1,BB,-0.5,8,14,2508,7,2016,12,-5
Group 1,BB,-0.5,8,14,2509,9,2016,11,-2
Group 1,BB,-0.5,8,14,2510,8,2016,11,-3
Group 1,BB,-0.5,8,14,2511,8,2016,10,-2
Group 1,BB,-0.5,8,14,2512,9,2016,9,0
Group 1,BB,-0.5,8,14,2513,10,2016,8,2
Group 1,BB,-0.5,8,14,2514,11,2016,12,-1
Group 1,BB,-0.5,8,14,2515,6,2016,10,-4
Group 1,BB,-0.5,8,14,2516,11,2016,7,4
Group 1,BB,-0.5,8,14,2517,13,2016,7,6
Group 1,BB,-0.5,8,14,2518,9,2016,11,-2
Group 1,BB,-0.5,8,14,2519,7,2016,8,-1
Group 1,BB,-0.5,8,14,2520,8,2016,12,-4
Group 1,BB,-0.5,8,14,2521,8,2016,9,-1
Group 1,BB,-0.5,8,14,2522,7,2016,7,0
Group 1,BB,-0.5,8,14,2523,11,2016,9,2
Group 1,BB,-0.5,8,14,2524,8,2016,8,0
Group 1,BB,-0.5,8,14,2525,6,2016,9,-3
Group 1,BB,-0.5,8,14,2526,8,2016,10,-2
Group 1,BB,-0.5,8,14,2527,8,2016,11,-3
Group 1,BB,-0.5,8,14,2528,5,2016,11,-6
Group 1,BB,-0.5,8,14,2529,7,2016,10,-3
Group 1,BB,-0.5,8,14,2530,7,2016,11,-4
Group 1,BB,-0.5,8,14,2531,8,2016,8,0
Group 1,BB,-0.5,8,14,2532,10,2016,10,0
Group 1,BB,-0.5,8,14,2533,10,2016,8,2
Group 1,BB,-0.5,8,14,2534,9,2016,13,-4
Group 1,BB,-0.5,8,14,2535,9,2016,9,0
Group 1,BB,-0.5,8,14,2536,10,2016,8,2
Group 1,BB,-0.5,8,14,2537,10,2016,10,0
Group 1,BB,-0.5,8,14,2538,9,2016,9,0
Group 1,BB,-0.5,8,14,2539,11,2016,12,-1
Group 1,BB,-0.5,8,14,2540,9,2016,9,0
Group 1,BB,-0.5,8,14,2541,11,2016,7,4
Group 1,BB,-0.5,8,14,2542,6,2016,9,-3
Group 1,BB,-0.5,8,14,2543,9,2016,7,2
Group 1,BB,-0.5,8,14,2544,9,2016,9,0
Group 1,BB,-0.5,8,14,2545,12,2016,9,3
Group 1,BB,-0.5,8,14,2546,8,2016,4,4
Group 1,BB,-0.5,8,14,2547,7,2016,9,-2
Group 1,BB,-0.5,8,14,2548,8,2016,11,-3
Group 1,BB,-0.5,8,14,2549,9,2016,10,-1
Group 1,BB,-0.5,8,14,2550,8,2016,10,-2
Group 1,BB,-0.5,8,14,2551,7,2016,9,-2
Group 1,BB,-0.5,8,14,2552,6,2016,12,-6
Group 1,BB,-0.5,8,14,2553,9,2016,11,-2
Group 1,BB,-0.5,8,14,2554,11,2016,10,1
Group 1,BB,-0.5,8,14,2555,5,2016,8,-3
Group 1,BB,-0.5,8,14,2556,10,2016,8,2
Group 1,BB,-0.5,8,14,2557,8,2016,6,2
Group 1,BB,-0.5,8,14,2558,3,2016,5,-2
Group 1,BB,-0.5,8,14,2559,9,2016,10,-1
Group 1,BB,-0.5,8,14,2560,6,2016,8,-2
Group 1,BB,-0.5,8,14,2561,8,2016,8,0
Group 1,BB,-0.5,8,14,2562,9,2016,9,0
Group 1,BB,-0.5,8,14,2563,6,2016,10,-4
Group 1,BB,-0.5,8,14,2564,10,2016,8,2
Group 1,BB,-0.5,8,14,2565,9,2016,8,1
Group 1,BB,-0.5,8,14,2566,7,2016,8,-1
Group 1,BB,-0.5,8,14,2567,13,2016,10,3
Group 1,BB,-0.5,8,14,2568,9,2016,7,2
Group 1,BB,-0.5,8,14,2569,10,2016,8,2
Group 1,BB,-0.5,8,14,2570,12,2016,9,3
Group 1,BB,-0.5,8,14,2571,7,2016,6,1
Group 1,BB,-0.5,8,14,2572,10,2016,6,4
Group 1,BB,-0.5,8,14,2573,11,2016,10,1
Group 1,BB,-0.5,8,14,2574,9,2016,9,0
Group 1,BB,-0.5,8,14,2575,10,2016,5,5
Group 1,BB,-0.5,8,14,2576,7,2016,12,-5
Group 1,BB,-0.5,8,14,2577,10,2016,10,0
Group 1,BB,-0.5,8,14,2578,10,2016,5,5
Group 1,BB,-0.5,8,14,2579,11,2016,4,7
Group 1,BB,-0.5,8,14,2580,9,2016,5,4
Group 1,BB,-0.5,8,14,2581,8,2016,8,0
Group 1,BB,-0.5,8,14,2582,11,2016,9,2
Group 1,BB,-0.5,8,14,2583,8,2016,7,1
Group 1,BB,-0.5,8,14,2584,10,2016,9,1
Group 1,BB,-0.5,8,14,2585,6,2016,9,-3
Group 1,BB,-0.5,8,14,2586,10,2016,8,2
Group 1,BB,-0.5,8,14,2587,9,2016,8,1
Group 1,BB,-0.5,8,14,2588,4,2016,8,-4
Group 1,BB,-0.5,8,14,2589,12,2016,11,1
Group 1,BB,-0.5,8,14,2590,8,2016,9,-1
Group 1,BB,-0.5,8,14,2591,11,2016,11,0
Group 1,BB,-0.5,8,14,2592,9,2016,9,0
Group 1,BB,-0.5,8,14,2593,3,2016,4,-1
Group 1,BB,-0.5,8,14,2594,9,2016,8,1
Group 1,BB,-0.5,8,14,2595,8,2016,7,1
Group 1,BB,-0.5,8,14,2596,10,2016,9,1
Group 1,BB,-0.5,8,14,2597,13,2016,9,4
Group 1,BB,-0.5,8,14,2598,10,2016,9,1
Group 1,BB,-0.5,8,14,2599,12,2016,6,6
Group 1,BB,-0.5,8,14,2600,11,2016,9,2
Group 1,BB,-0.5,8,14,2601,8,2016,4,4
Group 1,BB,-0.5,8,14,2602,9,2016,6,3
Group 1,BB,-0.5,8,14,2603,10,2016,5,5
Group 1,BB,-0.5,8,14,2604,5,2016,8,-3
Group 1,BB,-0.5,8,14,2605,9,2016,9,0
Group 1,BB,-0.5,8,14,2606,12,2016,10,2
Group 1,BB,-0.5,8,14,2607,9,2016,9,0
Group 1,BB,-0.5,8,14,2608,7,2016,9,-2
Group 1,BB,-0.5,8,14,2609,7,2016,9,-2
Group 1,BB,-0.5,8,14,2610,7,2016,8,-1
Group 1,BB,-0.5,8,14,2611,8,2016,6,2
Group 1,BB,-0.5,8,14,2612,11,2016,8,3
Group 1,BB,-0.5,8,14,2613,8,2016,10,-2
Group 1,BB,-0.5,8,14,2614,6,2016,7,-1
Group 1,BB,-0.5,8,14,2615,7,2016,8,-1
Group 1,BB,-0.5,8,14,2616,8,2016,6,2
Group 1,BB,-0.5,8,14,2617,7,2016,9,-2
Group 1,BB,-0.5,8,14,2618,10,2016,7,3
Group 1,BB,-0.5,8,14,2619,11,2016,7,4
Group 1,BB,-0.5,8,14,2620,8,2016,8,0
Group 1,BB,-0.5,8,14,2621,11,2016,8,3
Group 1,BB,-0.5,8,14,2622,5,2016,12,-7
Group 1,BB,-0.5,8,14,2623,8,2016,7,1
Group 1,BB,-0.5,8,14,2624,9,2016,8,1
Group 1,BB,-0.5,8,14,2625,8,2016,8,0
Group 1,BB,-0.5,8,14,2626,9,2016,8,1
Group 1,BB,-0.5,8,14,2627,8,2016,12,-4
Group 1,BB,-0.5,8,14,2628,4,2016,10,-6
Group 1,BB,-0.5,8,14,2629,9,2016,5,4
Group 1,BB,-0.5,8,14,2630,10,2016,7,3
Group 1,BB,-0.5,8,14,2631,10,2016,9,1
Group 1,BB,-0.5,8,14,2632,7,2016,9,-2
Group 1,BB,-0.5,8,14,2633,8,2016,5,3
Group 1,BB,-0.5,8,14,2634,10,2016,9,1
Group 1,BB,-0.5,8,14,2635,10,2016,8,2
Group 1,BB,-0.5,8,14,2636,5,2016,5,0
Group 1,BB,-0.5,8,14,2637,7,2016,7,0
Group 1,BB,-0.5,8,14,2638,10,2016,9,1
Group 1,BB,-0.5,8,14,2639,9,2016,10,-1
Group 1,BB,-0.5,8,14,2640,5,2016,8,-3
Group 1,BB,-0.5,8,14,2641,8,2016,8,0
Group 1,BB,-0.5,8,14,2642,10,2016,8,2
Group 1,BB,-0.5,8,14,2643,7,2016,9,-2
Group 1,BB,-0.5,8,14,2644,6,2016,4,2
Group 1,BB,-0.5,8,14,2645,5,2016,7,-2
Group 1,BB,-0.5,8,14,2646,8,2016,9,-1
Group 1,BB,-0.5,8,14,2647,9,2016,12,-3
Group 1,BB,-0.5,8,14,2648,9,2016,9,0
Group 1,BB,-0.5,8,14,2649,9,2016,7,2
Group 1,BB,-0.5,8,14,2650,7,2016,11,-4
Group 1,BB,-0.5,8,14,2651,7,2016,9,-2
Group 1,BB,-0.5,8,14,2652,8,2016,8,0
Group 1,BB,-0.5,8,14,2653,8,2016,9,-1
Group 1,BB,-0.5,8,14,2654,9,2016,9,0
Group 1,BB,-0.5,8,14,2655,9,2016,9,0
Group 1,BB,-0.5,8,14,2656,8,2016,7,1
Group 1,BB,-0.5,8,14,2657,6,2016,9,-3
Group 1,BB,-0.5,8,14,2658,12,2016,4,8
Group 1,BB,-0.5,8,14,2659,8,2016,9,-1
Group 1,BB,-0.5,8,14,2660,7,2016,11,-4
Group 1,BB,-0.5,8,14,2661,10,2016,9,1
Group 1,BB,-0.5,8,14,2662,8,2016,7,1
Group 1,BB,-0.5,8,14,2663,10,2016,7,3
Group 1,BB,-0.5,8,14,2664,8,2016,8,0
Group 1,BB,-0.5,8,14,2665,9,2016,8,1
Group 1,BB,-0.5,8,14,2666,10,2016,8,2
Group 1,BB,-0.5,8,14,2667,9,2016,6,3
Group 1,BB,-0.5,8,14,2668,8,2016,11,-3
Group 1,BB,-0.5,8,14,2669,5,2016,10,-5
Group 1,BB,-0.5,8,14,2670,6,2016,10,-4
Group 1,BB,-0.5,8,14,2671,8,2016,10,-2
Group 1,BB,-0.5,8,14,2672,11,2016,6,5
Group 1,BB,-0.5,8,14,2673,12,2016,7,5
Group 1,BB,-0.5,8,14,2674,10,2016,3,7
Group 1,BB,-0.5,8,14,2675,9,2016,9,0
Group 1,BB,-0.5,8,14,2676,9,2016,3,6
Group 1,BB,-0.5,8,14,2677,9,2016,9,0
Group 1,BB,-0.5,8,14,2678,9,2016,7,2
Group 1,BB,-0.5,8,14,2679,11,2016,6,5
Group 1,BB,-0.5,8,14,2680,6,2016,12,-6
Group 1,BB,-0.5,8,14,2681,10,2016,7,3
Group 1,BB,-0.5,8,14,2682,11,2016,11,0
Group 1,BB,-0.5,8,14,2683,10,2016,7,3
Group 1,BB,-0.5,8,14,2684,9,2016,8,1
Group 1,BB,-0.5,8,14,2685,11,2016,6,5
Group 1,BB,-0.5,8,14,2686,10,2016,3,7
Group 1,BB,-0.5,8,14,2687,10,2016,9,1
Group 1,BB,-0.5,8,14,2688,10,2016,3,7
Group 1,BB,-0.5,8,14,2689,8,2016,11,-3
Group 1,BB,-0.5,8,14,2690,10,2016,10,0
Group 1,BB,-0.5,8,14,2691,9,2016,10,-1
Group 1,BB,-0.5,8,14,2692,9,2016,10,-1
Group 1,BB,-0.5,8,14,2693,9,2016,5,4
Group 1,BB,-0.5,8,14,2694,10,2016,7,3
Group 1,BB,-0.5,8,14,2695,11,2016,4,7
Group 1,BB,-0.5,8,14,2696,9,2016,8,1
Group 1,BB,-0.5,8,14,2697,8,2016,8,0
Group 1,BB,-0.5,8,14,2698,7,2016,8,-1
Group 1,BB,-0.5,8,14,2699,12,2016,9,3
Group 1,BB,-0.5,8,14,2700,12,2016,6,6
Group 1,BB,-0.5,8,14,2701,5,2016,6,-1
Group 1,BB,-0.5,8,14,2702,14,2016,6,8
Group 1,BB,-0.5,8,14,2703,8,2016,9,-1
Group 1,BB,-0.5,8,14,2704,9,2016,8,1
Group 1,BB,-0.5,8,14,2705,8,2016,7,1
Group 1,BB,-0.5,8,14,2706,10,2016,6,4
Group 1,BB,-0.5,8,14,2707,8,2016,7,1
Group 1,BB,-0.5,8,14,2708,7,2016,12,-5
Group 1,BB,-0.5,8,14,2709,11,2016,8,3
Group 1,BB,-0.5,8,14,2710,10,2016,7,3
Group 1,BB,-0.5,8,14,2711,6,2016,9,-3
Group 1,BB,-0.5,8,14,2712,9,2016,11,-2
Group 1,BB,-0.5,8,14,2713,7,2016,11,-4
Group 1,BB,-0.5,8,14,2714,11,2016,7,4
Group 1,BB,-0.5,8,14,2715,6,2016,6,0
Group 1,BB,-0.5,8,14,2716,7,2016,7,0
Group 1,BB,-0.5,8,14,2717,12,2016,10,2
Group 1,BB,-0.5,8,14,2718,6,2016,9,-3
Group 1,BB,-0.5,8,14,2719,10,2016,9,1
Group 1,BB,-0.5,8,14,2720,3,2016,9,-6
Group 1,BB,-0.5,8,14,2721,10,2016,11,-1
Group 1,BB,-0.5,8,14,2722,7,2016,7,0
Group 1,BB,-0.5,8,14,2723,8,2016,6,2
Group 1,BB,-0.5,8,14,2724,10,2016,9,1
Group 1,BB,-0.5,8,14,2725,11,2016,12,-1
Group 1,BB,-0.5,8,14,2726,5,2016,7,-2
Group 1,BB,-0.5,8,14,2727,7,2016,10,-3
Group 1,BB,-0.5,8,14,2728,6,2016,11,-5
Group 1,BB,-0.5,8,14,2729,7,2016,9,-2
Group 1,BB,-0.5,8,14,2730,11,2016,8,3
Group 1,BB,-0.5,8,14,2731,7,2016,11,-4
Group 1,BB,-0.5,8,14,2732,8,2016,10,-2
Group 1,BB,-0.5,8,14,2733,10,2016,8,2
Group 1,BB,-0.5,8,14,2734,9,2016,10,-1
Group 1,BB,-0.5,8,14,2735,7,2016,11,-4
Group 1,BB,-0.5,8,14,2736,6,2016,6,0
Group 1,BB,-0.5,8,14,2737,9,2016,9,0
Group 1,BB,-0.5,8,14,2738,8,2016,9,-1
Group 1,BB,-0.5,8,14,2739,12,2016,9,3
Group 1,BB,-0.5,8,14,2740,9,2016,5,4
Group 1,BB,-0.5,8,14,2741,11,2016,7,4
Group 1,BB,-0.5,8,14,2742,10,2016,7,3
Group 1,BB,-0.5,8,14,2743,9,2016,9,0
Group 1,BB,-0.5,8,14,2744,9,2016,8,1
Group 1,BB,-0.5,8,14,2745,7,2016,6,1
Group 1,BB,-0.5,8,14,2746,7,2016,7,0
Group 1,BB,-0.5,8,14,2747,12,2016,5,7
Group 1,BB,-0.5,8,14,2748,7,2016,7,0
Group 1,BB,-0.5,8,14,2749,9,2016,8,1
Group 1,BB,-0.5,8,14,2750,10,2016,7,3
Group 1,BB,-0.5,8,14,2751,11,2016,8,3
Group 1,BB,-0.5,8,14,2752,11,2016,9,2
Group 1,BB,-0.5,8,14,2753,9,2016,8,1
Group 1,BB,-0.5,8,14,2754,10,2016,7,3
Group 1,BB,-0.5,8,14,2755,9,2016,8,1
Group 1,BB,-0.5,8,14,2756,8,2016,6,2
Group 1,BB,-0.5,8,14,2757,7,2016,11,-4
Group 1,BB,-0.5,8,14,2758,10,2016,8,2
Group 1,BB,-0.5,8,14,2759,7,2016,5,2
Group 1,BB,-0.5,8,14,2760,8,2016,6,2
Group 1,BB,-0.5,8,14,2761,8,2016,5,3
Group 1,BB,-0.5,8,14,2762,9,2016,8,1
Group 1,BB,-0.5,8,14,2763,8,2016,9,-1
Group 1,BB,-0.5,8,14,2764,8,2016,7,1
Group 1,BB,-0.5,8,14,2765,7,2016,6,1
Group 1,BB,-0.5,8,14,2766,8,2016,8,0
Group 1,BB,-0.5,8,14,2767,8,2016,9,-1
Group 1,BB,-0.5,8,14,2768,5,2016,7,-2
Group 1,BB,-0.5,8,14,2769,9,2016,8,1
Group 1,BB,-0.5,8,14,2770,7,2016,7,0
Group 1,BB,-0.5,8,14,2771,6,2016,6,0
Group 1,BB,-0.5,8,14,2772,8,2016,11,-3
Group 1,BB,-0.5,8,14,2773,7,2016,8,-1
Group 1,BB,-0.5,8,14,2774,12,2016,10,2
Group 1,BB,-0.5,8,14,2775,5,2016,8,-3
Group 1,BB,-0.5,8,14,2776,7,2016,11,-4
Group 1,BB,-0.5,8,14,2777,9,2016,9,0
Group 1,BB,-0.5,8,14,2778,8,2016,10,-2
Group 1,BB,-0.5,8,14,2779,13,2016,8,5
Group 1,BB,-0.5,8,14,2780,10,2016,11,-1
Group 1,BB,-0.5,8,14,2781,7,2016,9,-2
Group 1,BB,-0.5,8,14,2782,10,2016,7,3
Group 1,BB,-0.5,8,14,2783,9,2016,6,3
Group 1,BB,-0.5,8,14,2784,8,2016,6,2
Group 1,BB,-0.5,8,14,2785,11,2016,12,-1
Group 1,BB,-0.5,8,14,2786,10,2016,7,3
Group 1,BB,-0.5,8,14,2787,8,2016,8,0
Group 1,BB,-0.5,8,14,2788,9,2016,8,1
Group 1,BB,-0.5,8,14,2789,10,2016,9,1
Group 1,BB,-0.5,8,14,2790,7,2016,12,-5
Group 1,BB,-0.5,8,14,2791,7,2016,8,-1
Group 1,BB,-0.5,8,14,2792,4,2016,9,-5
Group 1,BB,-0.5,8,14,2793,6,2016,8,-2
Group 1,BB,-0.5,8,14,2794,8,2016,9,-1
Group 1,BB,-0.5,8,14,2795,8,2016,6,2
Group 1,BB,-0.5,8,14,2796,9,2016,5,4
Group 1,BB,-0.5,8,14,2797,8,2016,7,1
Group 1,BB,-0.5,8,14,2798,12,2016,13,-1
Group 1,BB,-0.5,8,14,2799,10,2016,6,4
Group 1,BB,-0.5,8,14,2800,9,2016,8,1
Group 1,BB,-0.5,8,14,2801,12,2016,7,5
Group 1,BB,-0.5,8,14,2802,12,2016,6,6
Group 1,BB,-0.5,8,14,2803,8,2016,9,-1
Group 1,BB,-0.5,8,14,2804,10,2016,11,-1
Group 1,BB,-0.5,8,14,2805,10,2016,7,3
Group 1,BB,-0.5,8,14,2806,8,2016,6,2
Group 1,BB,-0.5,8,14,2807,7,2016,5,2
Group 1,BB,-0.5,8,14,2808,6,2016,8,-2
Group 1,BB,-0.5,8,14,2809,10,2016,5,5
Group 1,BB,-0.5,8,14,2810,10,2016,8,2
Group 1,BB,-0.5,8,14,2811,8,2016,9,-1
Group 1,BB,-0.5,8,14,2812,7,2016,12,-5
Group 1,BB,-0.5,8,14,2813,11,2016,8,3
Group 1,BB,-0.5,8,14,2814,10,2016,6,4
Group 1,BB,-0.5,8,14,2815,8,2016,8,0
Group 1,BB,-0.5,8,14,2816,8,2016,7,1
Group 1,BB,-0.5,8,14,2817,12,2016,8,4
Group 1,BB,-0.5,8,14,2818,7,2016,9,-2
Group 1,BB,-0.5,8,14,2819,8,2016,8,0
Group 1,BB,-0.5,8,14,2820,8,2016,11,-3
Group 1,BB,-0.5,8,14,2821,12,2016,8,4
Group 1,BB,-0.5,8,14,2822,10,2016,9,1
Group 1,BB,-0.5,8,14,2823,9,2016,7,2
Group 1,BB,-0.5,8,14,2824,8,2016,7,1
Group 1,BB,-0.5,8,14,2825,7,2016,8,-1
Group 1,BB,-0.5,8,14,2826,7,2016,8,-1
Group 1,BB,-0.5,8,14,2827,3,2016,7,-4
Group 1,BB,-0.5,8,14,2828,9,2016,11,-2
Group 1,BB,-0.5,8,14,2829,11,2016,6,5
Group 1,BB,-0.5,8,14,2830,10,2016,9,1
Group 1,BB,-0.5,8,14,2831,11,2016,4,7
Group 1,BB,-0.5,8,14,2832,9,2016,7,2
Group 1,BB,-0.5,8,14,2833,4,2016,6,-2
Group 1,BB,-0.5,8,14,2834,9,2016,8,1
Group 1,BB,-0.5,8,14,2835,9,2016,7,2
Group 1,BB,-0.5,8,14,2836,10,2016,7,3
Group 1,BB,-0.5,8,14,2837,9,2016,8,1
Group 1,BB,-0.5,8,14,2838,7,2016,10,-3
Group 1,BB,-0.5,8,14,2839,9,2016,9,0
Group 1,BB,-0.5,8,14,2840,7,2016,10,-3
Group 1,BB,-0.5,8,14,2841,9,2016,12,-3
Group 1,BB,-0.5,8,14,2842,13,2016,5,8
Group 1,BB,-0.5,8,14,2843,10,2016,9,1
Group 1,BB,-0.5,8,14,2844,7,2016,7,0
Group 1,BB,-0.5,8,14,2845,8,2016,8,0
Group 1,BB,-0.5,8,14,2846,11,2016,5,6
Group 1,BB,-0.5,8,14,2847,9,2016,13,-4
Group 1,BB,-0.5,8,14,2848,7,2016,8,-1
Group 1,BB,-0.5,8,14,2849,5,2016,9,-4
Group 1,BB,-0.5,8,14,2850,13,2016,8,5
Group 1,BB,-0.5,8,14,2851,12,2016,7,5
Group 1,BB,-0.5,8,14,2852,12,2016,12,0
Group 1,BB,-0.5,8,14,2853,9,2016,8,1
Group 1,BB,-0.5,8,14,2854,11,2016,4,7
Group 1,BB,-0.5,8,14,2855,12,2016,11,1
Group 1,BB,-0.5,8,14,2856,12,2016,10,2
Group 1,BB,-0.5,8,14,2857,9,2016,4,5
Group 1,BB,-0.5,8,14,2858,9,2016,12,-3
Group 1,BB,-0.5,8,14,2859,10,2016,5,5
Group 1,BB,-0.5,8,14,2860,8,2016,5,3
Group 1,BB,-0.5,8,14,2861,10,2016,10,0
Group 1,BB,-0.5,8,14,2862,10,2016,9,1
Group 1,BB,-0.5,8,14,2863,10,2016,5,5
Group 1,BB,-0.5,8,14,2864,7,2016,7,0
Group 1,BB,-0.5,8,14,2865,11,2016,10,1
Group 1,BB,-0.5,8,14,2866,10,2016,8,2
Group 1,BB,-0.5,8,14,2867,7,2016,9,-2
Group 1,BB,-0.5,8,14,2868,8,2016,10,-2
Group 1,BB,-0.5,8,14,2869,7,2016,6,1
Group 1,BB,-0.5,8,14,2870,8,2016,11,-3
Group 1,BB,-0.5,8,14,2871,9,2016,9,0
Group 1,BB,-0.5,8,14,2872,9,2016,11,-2
Group 1,BB,-0.5,8,14,2873,8,2016,11,-3
Group 1,BB,-0.5,8,14,2874,10,2016,11,-1
Group 1,BB,-0.5,8,14,2875,9,2016,7,2
Group 1,BB,-0.5,8,14,2876,12,2016,5,7
Group 1,BB,-0.5,8,14,2877,10,2016,11,-1
Group 1,BB,-0.5,8,14,2878,12,2016,5,7
Group 1,BB,-0.5,8,14,2879,8,2016,6,2
Group 1,BB,-0.5,8,14,2880,9,2016,3,6
Group 1,BB,-0.5,8,14,2881,8,2016,4,4
Group 1,BB,-0.5,8,14,2882,12,2016,11,1
Group 1,BB,-0.5,8,14,2883,9,2016,9,0
Group 1,BB,-0.5,8,14,2884,8,2016,3,5
Group 1,BB,-0.5,8,14,2885,9,2016,10,-1
Group 1,BB,-0.5,8,14,2886,9,2016,4,5
Group 1,BB,-0.5,8,14,2887,11,2016,7,4
Group 1,BB,-0.5,8,14,2888,9,2016,6,3
Group 1,BB,-0.5,8,14,2889,5,2016,7,-2
Group 1,BB,-0.5,8,14,2890,8,2016,10,-2
Group 1,BB,-0.5,8,14,2891,10,2016,8,2
Group 1,BB,-0.5,8,14,2892,8,2016,6,2
Group 1,BB,-0.5,8,14,2893,12,2016,9,3
Group 1,BB,-0.5,8,14,2894,8,2016,8,0
Group 1,BB,-0.5,8,14,2895,9,2016,5,4
Group 1,BB,-0.5,8,14,2896,9,2016,6,3
Group 1,BB,-0.5,8,14,2897,9,2016,9,0
Group 1,BB,-0.5,8,14,2898,8,2016,6,2
Group 1,BB,-0.5,8,14,2899,8,2016,8,0
Group 1,BB,-0.5,8,14,2900,8,2016,11,-3
Group 1,BB,-0.5,8,14,2901,9,2016,8,1
Group 1,BB,-0.5,8,14,2902,11,2016,7,4
Group 1,BB,-0.5,8,14,2903,10,2016,8,2
Group 1,BB,-0.5,8,14,2904,8,2016,6,2
Group 1,BB,-0.5,8,14,2905,4,2016,9,-5
Group 1,BB,-0.5,8,14,2906,9,2016,8,1
Group 1,BB,-0.5,8,14,2907,7,2016,9,-2
Group 1,BB,-0.5,8,14,2908,6,2016,5,1
Group 1,BB,-0.5,8,14,2909,5,2016,6,-1
Group 1,BB,-0.5,8,14,2910,10,2016,10,0
Group 1,BB,-0.5,8,14,2911,9,2016,8,1
Group 1,BB,-0.5,8,14,2912,9,2016,4,5
Group 1,BB,-0.5,8,14,2913,7,2016,6,1
Group 1,BB,-0.5,8,14,2914,10,2016,5,5
Group 1,BB,-0.5,8,14,2915,7,2016,5,2
Group 1,BB,-0.5,8,14,2916,10,2016,9,1
Group 1,BB,-0.5,8,14,2917,7,2016,9,-2
Group 1,BB,-0.5,8,14,2918,10,2016,13,-3
Group 1,BB,-0.5,8,14,2919,10,2016,10,0
Group 1,BB,-0.5,8,14,2920,9,2016,9,0
Group 1,BB,-0.5,8,14,2921,8,2016,9,-1
Group 1,BB,-0.5,8,14,2922,12,2016,5,7
Group 1,BB,-0.5,8,14,2923,12,2016,8,4
Group 1,BB,-0.5,8,14,2924,5,2016,5,0
Group 1,BB,-0.5,8,14,2925,12,2016,9,3
Group 1,BB,-0.5,8,14,2926,8,2016,4,4
Group 1,BB,-0.5,8,14,2927,6,2016,7,-1
Group 1,BB,-0.5,8,14,2928,10,2016,8,2
Group 1,BB,-0.5,8,14,2929,10,2016,8,2
Group 1,BB,-0.5,8,14,2930,10,2016,7,3
Group 1,BB,-0.5,8,14,2931,8,2016,9,-1
Group 1,BB,-0.5,8,14,2932,10,2016,8,2
Group 1,BB,-0.5,8,14,2933,7,2016,5,2
Group 1,BB,-0.5,8,14,2934,7,2016,7,0
Group 1,BB,-0.5,8,14,2935,8,2016,11,-3
Group 1,BB,-0.5,8,14,2936,11,2016,8,3
Group 1,BB,-0.5,8,14,2937,7,2016,8,-1
Group 1,BB,-0.5,8,14,2938,6,2016,8,-2
Group 1,BB,-0.5,8,14,2939,7,2016,5,2
Group 1,BB,-0.5,8,14,2940,6,2016,8,-2
Group 1,BB,-0.5,8,14,2941,13,2016,8,5
Group 1,BB,-0.5,8,14,2942,9,2016,12,-3
Group 1,BB,-0.5,8,14,2943,8,2016,6,2
Group 1,BB,-0.5,8,14,2944,9,2016,9,0
Group 1,BB,-0.5,8,14,2945,10,2016,6,4
Group 1,BB,-0.5,8,14,2946,12,2016,10,2
Group 1,BB,-0.5,8,14,2947,6,2016,11,-5
Group 1,BB,-0.5,8,14,2948,11,2016,7,4
Group 1,BB,-0.5,8,14,2949,12,2016,8,4
Group 1,BB,-0.5,8,14,2950,10,2016,10,0
Group 1,BB,-0.5,8,14,2951,11,2016,8,3
Group 1,BB,-0.5,8,14,2952,10,2016,8,2
Group 1,BB,-0.5,8,14,2953,9,2016,5,4
Group 1,BB,-0.5,8,14,2954,9,2016,8,1
Group 1,BB,-0.5,8,14,2955,6,2016,8,-2
Group 1,BB,-0.5,8,14,2956,11,2016,10,1
Group 1,BB,-0.5,8,14,2957,8,2016,10,-2
Group 1,BB,-0.5,8,14,2958,10,2016,7,3
Group 1,BB,-0.5,8,14,2959,8,2016,7,1
Group 1,BB,-0.5,8,14,2960,12,2016,10,2
Group 1,BB,-0.5,8,14,2961,9,2016,10,-1
Group 1,BB,-0.5,8,14,2962,7,2016,6,1
Group 1,BB,-0.5,8,14,2963,12,2016,7,5
Group 1,BB,-0.5,8,14,2964,8,2016,7,1
Group 1,BB,-0.5,8,14,2965,9,2016,5,4
Group 1,BB,-0.5,8,14,2966,9,2016,7,2
Group 1,BB,-0.5,8,14,2967,7,2016,9,-2
Group 1,BB,-0.5,8,14,2968,11,2016,9,2
Group 1,BB,-0.5,8,14,2969,6,2016,4,2
Group 1,BB,-0.5,8,14,2970,10,2016,5,5
Group 1,BB,-0.5,8,14,2971,12,2016,6,6
Group 1,BB,-0.5,8,14,2972,5,2016,6,-1
Group 1,BB,-0.5,8,14,2973,6,2016,9,-3
Group 1,BB,-0.5,8,14,2974,12,2016,7,5
Group 1,BB,-0.5,8,14,2975,10,2016,8,2
Group 1,BB,-0.5,8,14,2976,9,2016,6,3
Group 1,BB,-0.5,8,14,2977,10,2016,7,3
Group 1,BB,-0.5,8,14,2978,11,2016,9,2
Group 1,BB,-0.5,8,14,2979,9,2016,9,0
Group 1,BB,-0.5,8,14,2980,9,2016,11,-2
Group 1,BB,-0.5,8,14,2981,10,2016,10,0
Group 1,BB,-0.5,8,14,2982,7,2016,11,-4
Group 1,BB,-0.5,8,14,2983,11,2016,5,6
Group 1,BB,-0.5,8,14,2984,8,2016,6,2
Group 1,BB,-0.5,8,14,2985,9,2016,10,-1
Group 1,BB,-0.5,8,14,2986,9,2016,10,-1
Group 1,BB,-0.5,8,14,2987,12,2016,9,3
Group 1,BB,-0.5,8,14,2988,9,2016,6,3
Group 1,BB,-0.5,8,14,2989,10,2016,9,1
Group 1,BB,-0.5,8,14,2990,8,2016,5,3
Group 1,BB,-0.5,8,14,2991,10,2016,10,0
Group 1,BB,-0.5,8,14,2992,10,2016,9,1
Group 1,BB,-0.5,8,14,2993,10,2016,10,0
Group 1,BB,-0.5,8,14,2994,12,2016,6,6
Group 1,BB,-0.5,8,14,2995,7,2016,12,-5
Group 1,BB,-0.5,8,14,2996,10,2016,10,0
Group 1,BB,-0.5,8,14,2997,10,2016,11,-1
Group 1,BB,-0.5,8,14,2998,9,2016,13,-4
Group 1,BB,-0.5,8,14,2999,6,2016,10,-4
Group 1,BB,-0.5,8,14,3000,7,2016,11,-4
Group 1,BB,-0.5,8,14,3001,12,2016,9,3
Group 1,BB,-0.5,8,14,3002,9,2016,9,0
Group 1,BB,-0.5,8,14,3003,10,2016,12,-2
Group 1,BB,-0.5,8,14,3004,10,2016,7,3
Group 1,BB,-0.5,8,14,3005,9,2016,7,2
Group 1,BB,-0.5,8,14,3006,9,2016,5,4
Group 1,BB,-0.5,8,14,3007,7,2016,8,-1
Group 1,BB,-0.5,8,14,3008,7,2016,12,-5
Group 1,BB,-0.5,8,14,3009,11,2016,10,1
Group 1,BB,-0.5,8,14,3010,9,2016,9,0
Group 1,BB,-0.5,8,14,3011,7,2016,8,-1
Group 1,BB,-0.5,8,14,3012,10,2016,10,0
Group 1,BB,-0.5,8,14,3013,9,2016,11,-2
Group 1,BB,-0.5,8,14,3014,10,2016,7,3
Group 1,BB,-0.5,8,14,3015,7,2016,9,-2
Group 1,BB,-0.5,8,14,3016,12,2016,8,4
Group 1,BB,-0.5,8,14,3017,11,2016,8,3
Group 1,BB,-0.5,8,14,3018,10,2016,8,2
Group 1,BB,-0.5,8,14,3019,10,2016,8,2
Group 1,BB,-0.5,8,14,3020,6,2016,7,-1
Group 1,BB,-0.5,8,14,3021,10,2016,8,2
Group 1,BB,-0.5,8,14,3022,6,2016,5,1
Group 1,BB,-0.5,8,14,3023,7,2016,7,0
Group 1,BB,-0.5,8,14,3024,3,2016,10,-7
Group 1,BB,-0.5,8,14,3025,10,2016,9,1
Group 1,BB,-0.5,8,14,3026,10,2016,7,3
Group 1,BB,-0.5,8,14,3027,7,2016,11,-4
Group 1,BB,-0.5,8,14,3028,9,2016,13,-4
Group 1,BB,-0.5,8,14,3029,7,2016,11,-4
Group 1,BB,-0.5,8,14,3030,11,2016,8,3
Group 1,BB,-0.5,8,14,3031,10,2016,10,0
Group 1,BB,-0.5,8,14,3032,9,2016,9,0
Group 1,BB,-0.5,8,14,3033,9,2016,8,1
Group 1,BB,-0.5,8,14,3034,7,2016,10,-3
Group 1,BB,-0.5,8,14,3035,8,2016,9,-1
Group 1,BB,-0.5,8,14,3036,9,2016,10,-1
Group 1,BB,-0.5,8,14,3037,10,2016,5,5
Group 1,BB,-0.5,8,14,3038,7,2016,11,-4
Group 1,BB,-0.5,8,14,3039,11,2016,7,4
Group 1,BB,-0.5,8,14,3040,6,2016,7,-1
Group 1,BB,-0.5,8,14,3041,8,2016,8,0
Group 1,BB,-0.5,8,14,3042,9,2016,9,0
Group 1,BB,-0.5,8,14,3043,10,2016,10,0
Group 1,BB,-0.5,8,14,3044,10,2016,3,7
Group 1,BB,-0.5,8,14,3045,9,2016,9,0
Group 1,BB,-0.5,8,14,3046,10,2016,4,6
Group 1,BB,-0.5,8,14,3047,12,2016,6,6
Group 1,BB,-0.5,8,14,3048,8,2016,7,1
Group 1,BB,-0.5,8,14,3049,7,2016,9,-2
Group 1,BB,-0.5,8,14,3050,8,2016,10,-2
Group 1,BB,-0.5,8,14,3051,9,2016,9,0
Group 1,BB,-0.5,8,14,3052,8,2016,10,-2
Group 1,BB,-0.5,8,14,3053,9,2016,7,2
Group 1,BB,-0.5,8,14,3054,9,2016,10,-1
Group 1,BB,-0.5,8,14,3055,9,2016,9,0
Group 1,BB,-0.5,8,14,3056,9,2016,6,3
Group 1,BB,-0.5,8,14,3057,11,2016,8,3
Group 1,BB,-0.5,8,14,3058,10,2016,7,3
Group 1,BB,-0.5,8,14,3059,11,2016,8,3
Group 1,BB,-0.5,8,14,3060,11,2016,3,8
Group 1,BB,-0.5,8,14,3061,9,2016,5,4
Group 1,BB,-0.5,8,14,3062,9,2016,7,2
Group 1,BB,-0.5,8,14,3063,11,2016,8,3
Group 1,BB,-0.5,8,14,3064,8,2016,9,-1
Group 1,BB,-0.5,8,14,3065,8,2016,11,-3
Group 1,BB,-0.5,8,14,3066,8,2016,9,-1
Group 1,BB,-0.5,8,14,3067,13,2016,9,4
Group 1,BB,-0.5,8,14,3068,6,2016,6,0
Group 1,BB,-0.5,8,14,3069,7,2016,3,4
Group 1,BB,-0.5,8,14,3070,6,2016,7,-1
Group 1,BB,-0.5,8,14,3071,7,2016,13,-6
Group 1,BB,-0.5,8,14,3072,12,2016,11,1
Group 1,BB,-0.5,8,14,3073,9,2016,10,-1
Group 1,BB,-0.5,8,14,3074,4,2016,3,1
Group 1,BB,-0.5,8,14,3075,7,2016,8,-1
Group 1,BB,-0.5,8,14,3076,7,2016,5,2
Group 1,BB,-0.5,8,14,3077,7,2016,6,1
Group 1,BB,-0.5,8,14,3078,10,2016,9,1
Group 1,BB,-0.5,8,14,3079,9,2016,9,0
Group 1,BB,-0.5,8,14,3080,9,2016,9,0
Group 1,BB,-0.5,8,14,3081,9,2016,11,-2
Group 1,BB,-0.5,8,14,3082,7,2016,5,2
Group 1,BB,-0.5,8,14,3083,6,2016,9,-3
Group 1,BB,-0.5,8,14,3084,10,2016,9,1
Group 1,BB,-0.5,8,14,3085,9,2016,6,3
Group 1,BB,-0.5,8,14,3086,8,2016,10,-2
Group 1,BB,-0.5,8,14,3087,7,2016,8,-1
Group 1,BB,-0.5,8,14,3088,11,2016,6,5
Group 1,BB,-0.5,8,14,3089,6,2016,8,-2
Group 1,BB,-0.5,8,14,3090,8,2016,11,-3
Group 1,BB,-0.5,8,14,3091,9,2016,10,-1
Group 1,BB,-0.5,8,14,3092,8,2016,10,-2
Group 1,BB,-0.5,8,14,3093,11,2016,3,8
Group 1,BB,-0.5,8,14,3094,10,2016,9,1
Group 1,BB,-0.5,8,14,3095,8,2016,10,-2
Group 1,BB,-0.5,8,14,3096,10,2016,11,-1
Group 1,BB,-0.5,8,14,3097,8,2016,9,-1
Group 1,BB,-0.5,8,14,3098,6,2016,8,-2
Group 1,BB,-0.5,8,14,3099,10,2016,6,4
Group 1,BB,-0.5,8,14,3100,9,2016,7,2
Group 1,BB,-0.5,8,14,3101,6,2016,11,-5
Group 1,BB,-0.5,8,14,3102,9,2016,5,4
Group 1,BB,-0.5,8,14,3103,6,2016,4,2
Group 1,BB,-0.5,8,14,3104,10,2016,7,3
Group 1,BB,-0.5,8,14,3105,10,2016,6,4
Group 1,BB,-0.5,8,14,3106,11,2016,8,3
Group 1,BB,-0.5,8,14,3107,9,2016,11,-2
Group 1,BB,-0.5,8,14,3108,10,2016,8,2
Group 1,BB,-0.5,8,14,3109,3,2016,10,-7
Group 1,BB,-0.5,8,14,3110,7,2016,9,-2
Group 1,BB,-0.5,8,14,3111,9,2016,6,3
Group 1,BB,-0.5,8,14,3112,6,2016,9,-3
Group 1,BB,-0.5,8,14,3113,11,2016,10,1
Group 1,BB,-0.5,8,14,3114,8,2016,8,0
Group 1,BB,-0.5,8,14,3115,8,2016,10,-2
Group 1,BB,-0.5,8,14,3116,10,2016,7,3
Group 1,BB,-0.5,8,14,3117,11,2016,10,1
Group 1,BB,-0.5,8,14,3118,9,2016,5,4
Group 1,BB,-0.5,8,14,3119,8,2016,9,-1
Group 1,BB,-0.5,8,14,3120,6,2016,8,-2
Group 1,BB,-0.5,8,14,3121,10,2016,8,2
Group 1,BB,-0.5,8,14,3122,8,2016,7,1
Group 1,BB,-0.5,8,14,3123,12,2016,9,3
Group 1,BB,-0.5,8,14,3124,10,2016,11,-1
Group 1,BB,-0.5,8,14,3125,9,2016,10,-1
Group 1,BB,-0.5,8,14,3126,10,2016,9,1
Group 1,BB,-0.5,8,14,3127,8,2016,9,-1
Group 1,BB,-0.5,8,14,3128,12,2016,11,1
Group 1,BB,-0.5,8,14,3129,8,2016,12,-4
Group 1,BB,-0.5,8,14,3130,8,2016,11,-3
Group 1,BB,-0.5,8,14,3131,9,2016,8,1
Group 1,BB,-0.5,8,14,3132,4,2016,4,0
Group 1,BB,-0.5,8,14,3133,8,2016,8,0
Group 1,BB,-0.5,8,14,3134,8,2016,7,1
Group 1,BB,-0.5,8,14,3135,8,2016,8,0
Group 1,BB,-0.5,8,14,3136,12,2016,5,7
Group 1,BB,-0.5,8,14,3137,11,2016,10,1
Group 1,BB,-0.5,8,14,3138,10,2016,6,4
Group 1,BB,-0.5,8,14,3139,11,2016,6,5
Group 1,BB,-0.5,8,14,3140,9,2016,7,2
Group 1,BB,-0.5,8,14,3141,11,2016,11,0
Group 1,BB,-0.5,8,14,3142,5,2016,8,-3
Group 1,BB,-0.5,8,14,3143,9,2016,14,-5
Group 1,BB,-0.5,8,14,3144,8,2016,3,5
Group 1,BB,-0.5,8,14,3145,6,2016,1,5
Group 1,BB,-0.5,8,14,3146,10,2016,0,10
Group 1,BB,-0.5,8,14,3147,8,2016,11,-3
Group 1,BB,-0.5,8,14,3148,7,2016,8,-1
Group 1,BB,-0.5,8,14,3149,9,2016,8,1
Group 1,BB,-0.5,8,14,3150,9,2016,6,3
Group 1,BB,-0.5,8,14,3151,10,2016,4,6
Group 1,BB,-0.5,8,14,3152,11,2016,3,8
Group 1,BB,-0.5,8,14,3153,7,2016,9,-2
Group 1,BB,-0.5,8,14,3154,8,2016,8,0
Group 1,BB,-0.5,8,14,3155,7,2016,7,0
Group 1,BB,-0.5,8,14,3156,8,2016,10,-2
Group 1,BB,-0.5,8,14,3157,6,2016,10,-4
Group 1,BB,-0.5,8,14,3158,9,2016,10,-1
Group 1,BB,-0.5,8,14,3159,9,2016,9,0
Group 1,BB,-0.5,8,14,3160,10,2016,10,0
Group 1,BB,-0.5,8,14,3161,9,2016,10,-1
Group 1,BB,-0.5,8,14,3162,9,2016,5,4
Group 1,BB,-0.5,8,14,3163,9,2016,5,4
Group 1,BB,-0.5,8,14,3164,9,2016,8,1
Group 1,BB,-0.5,8,14,3165,10,2016,11,-1
Group 1,BB,-0.5,8,14,3166,7,2016,7,0
Group 1,BB,-0.5,8,14,3167,9,2016,9,0
Group 1,BB,-0.5,8,14,3168,8,2016,8,0
Group 1,BB,-0.5,8,14,3169,5,2016,8,-3
Group 1,BB,-0.5,8,14,3170,8,2016,8,0
Group 1,BB,-0.5,8,14,3171,5,2016,8,-3
Group 1,BB,-0.5,8,14,3172,9,2016,8,1
Group 1,BB,-0.5,8,14,3173,7,2016,8,-1
Group 1,BB,-0.5,8,14,3174,7,2016,11,-4
Group 1,BB,-0.5,8,14,3175,9,2016,8,1
Group 1,BB,-0.5,8,14,3176,5,2016,6,-1
Group 1,BB,-0.5,8,14,3177,11,2016,5,6
Group 1,BB,-0.5,8,14,3178,7,2016,7,0
Group 1,BB,-0.5,8,14,3179,11,2016,7,4
Group 1,BB,-0.5,8,14,3180,7,2016,10,-3
Group 1,BB,-0.5,8,14,3181,10,2016,4,6
Group 1,BB,-0.5,8,14,3182,11,2016,6,5
Group 1,BB,-0.5,8,14,3183,8,2016,5,3
Group 1,BB,-0.5,8,14,3184,9,2016,7,2
Group 1,BB,-0.5,8,14,3185,10,2016,4,6
Group 1,BB,-0.5,8,14,3186,7,2016,8,-1
Group 1,BB,-0.5,8,14,3187,11,2016,9,2
Group 1,BB,-0.5,8,14,3188,8,2016,7,1
Group 1,BB,-0.5,8,14,3189,9,2016,3,6
Group 1,BB,-0.5,8,14,3190,8,2016,5,3
Group 1,BB,-0.5,8,14,3191,8,2016,5,3
Group 1,BB,-0.5,8,14,3192,7,2016,3,4
Group 1,BB,-0.5,8,14,3193,11,2016,7,4
Group 1,BB,-0.5,8,14,3194,6,2016,2,4
Group 1,BB,-0.5,8,14,3195,6,2016,6,0
Group 1,BB,-0.5,8,14,3196,10,2016,8,2
Group 1,BB,-0.5,8,14,3197,9,2016,5,4
Group 1,BB,-0.5,8,14,3198,9,2016,6,3
Group 1,BB,-0.5,8,14,3199,7,2016,8,-1
Group 1,BB,-0.5,8,14,3200,5,2016,7,-2
Group 1,BB,-0.5,8,14,3201,8,2016,9,-1
Group 1,BB,-0.5,8,14,3202,9,2016,10,-1
Group 1,BB,-0.5,8,14,3203,7,2016,8,-1
Group 1,BB,-0.5,8,14,3204,7,2016,10,-3
Group 1,BB,-0.5,8,14,3205,9,2016,7,2
Group 1,BB,-0.5,8,14,3206,9,2016,7,2
Group 1,BB,-0.5,8,14,3207,7,2016,8,-1
Group 1,BB,-0.5,8,14,3208,8,2016,9,-1
Group 1,BB,-0.5,8,14,3209,10,2016,8,2
Group 1,BB,-0.5,8,14,3210,6,2016,9,-3
Group 1,BB,-0.5,8,14,3211,8,2016,5,3
Group 1,BB,-0.5,8,14,3212,7,2016,11,-4
Group 1,BB,-0.5,8,14,3213,11,2016,7,4
Group 1,BB,-0.5,8,14,3214,6,2016,7,-1
Group 1,BB,-0.5,8,14,3215,12,2016,10,2
Group 1,BB,-0.5,8,14,3216,8,2016,4,4
Group 1,BB,-0.5,8,14,3217,10,2016,9,1
Group 1,BB,-0.5,8,14,3218,9,2016,6,3
Group 1,BB,-0.5,8,14,3219,9,2016,8,1
Group 1,BB,-0.5,8,14,3220,10,2016,7,3
Group 1,BB,-0.5,8,14,3221,12,2016,10,2
Group 1,BB,-0.5,8,14,3222,11,2016,7,4
Group 1,BB,-0.5,8,14,3223,6,2016,10,-4
Group 1,BB,-0.5,8,14,3224,7,2016,9,-2
Group 1,BB,-0.5,8,14,3225,8,2016,6,2
Group 1,BB,-0.5,8,14,3226,10,2016,10,0
Group 1,BB,-0.5,8,14,3227,6,2016,8,-2
Group 1,BB,-0.5,8,14,3228,8,2016,7,1
Group 1,BB,-0.5,8,14,3229,9,2016,10,-1
Group 1,BB,-0.5,8,14,3230,9,2016,8,1
Group 1,BB,-0.5,8,14,3231,9,2016,4,5
Group 1,BB,-0.5,8,14,3232,9,2016,8,1
Group 1,BB,-0.5,8,14,3233,9,2016,9,0
Group 1,BB,-0.5,8,14,3234,10,2016,10,0
Group 1,BB,-0.5,8,14,3235,12,2016,9,3
Group 1,BB,-0.5,8,14,3236,9,2016,5,4
Group 1,BB,-0.5,8,14,3237,12,2016,7,5
Group 1,BB,-0.5,8,14,3238,7,2016,5,2
Group 1,BB,-0.5,8,14,3239,12,2016,7,5
Group 1,BB,-0.5,8,14,3240,11,2016,9,2
Group 1,BB,-0.5,8,14,3241,8,2016,9,-1
Group 1,BB,-0.5,8,14,3242,6,2016,7,-1
Group 1,BB,-0.5,8,14,3243,10,2016,6,4
Group 1,BB,-0.5,8,14,3244,9,2016,8,1
Group 1,BB,-0.5,8,14,3245,9,2016,9,0
Group 1,BB,-0.5,8,14,3246,7,2016,5,2
Group 1,BB,-0.5,8,14,3247,7,2016,9,-2
Group 1,BB,-0.5,8,14,3248,8,2016,6,2
Group 1,BB,-0.5,8,14,3249,11,2016,9,2
Group 1,BB,-0.5,8,14,3250,10,2016,9,1
Group 1,BB,-0.5,8,14,3251,9,2016,8,1
Group 1,BB,-0.5,8,14,3252,8,2016,10,-2
Group 1,BB,-0.5,8,14,3253,4,2016,6,-2
Group 1,BB,-0.5,8,14,3254,9,2016,8,1
Group 1,BB,-0.5,8,14,3255,11,2016,5,6
Group 1,BB,-0.5,8,14,3256,8,2016,7,1
Group 1,BB,-0.5,8,14,3257,9,2016,7,2
Group 1,BB,-0.5,8,14,3258,7,2016,9,-2
Group 1,BB,-0.5,8,14,3259,11,2016,10,1
Group 1,BB,-0.5,8,14,3260,10,2016,11,-1
Group 1,BB,-0.5,8,14,3261,10,2016,12,-2
Group 1,BB,-0.5,8,14,3262,10,2016,7,3
Group 1,BB,-0.5,8,14,3263,11,2016,8,3
Group 1,BB,-0.5,8,14,3264,6,2016,4,2
Group 1,BB,-0.5,8,14,3265,10,2016,7,3
Group 1,BB,-0.5,8,14,3266,11,2016,10,1
Group 1,BB,-0.5,8,14,3267,9,2016,10,-1
Group 1,BB,-0.5,8,14,3268,7,2016,6,1
Group 1,BB,-0.5,8,14,3269,8,2016,6,2
Group 1,BB,-0.5,8,14,3270,9,2016,4,5
Group 1,BB,-0.5,8,14,3271,13,2016,11,2
Group 1,BB,-0.5,8,14,3272,8,2016,7,1
Group 1,BB,-0.5,8,14,3273,10,2016,7,3
Group 1,BB,-0.5,8,14,3274,6,2016,7,-1
Group 1,BB,-0.5,8,14,3275,7,2016,7,0
Group 1,BB,-0.5,8,14,3276,5,2016,8,-3
Group 1,BB,-0.5,8,14,3277,6,2016,6,0
Group 1,BB,-0.5,8,14,3278,5,2016,8,-3
Group 1,BB,-0.5,8,14,3279,7,2016,7,0
Group 1,BB,-0.5,8,14,3280,7,2016,8,-1
Group 1,BB,-0.5,8,14,3281,11,2016,12,-1
Group 1,BB,-0.5,8,14,3282,9,2016,10,-1
Group 1,BB,-0.5,8,14,3283,9,2016,6,3
Group 1,BB,-0.5,8,14,3284,10,2016,10,0
Group 1,BB,-0.5,8,14,3285,11,2016,5,6
Group 1,BB,-0.5,8,14,3286,7,2016,9,-2
Group 1,BB,-0.5,8,14,3287,12,2016,5,7
Group 1,BB,-0.5,8,14,3288,9,2016,5,4
Group 1,BB,-0.5,8,14,3289,7,2016,10,-3
Group 1,BB,-0.5,8,14,3290,8,2016,11,-3
Group 1,BB,-0.5,8,14,3291,10,2016,11,-1
Group 1,BB,-0.5,8,14,3292,12,2016,6,6
Group 1,BB,-0.5,8,14,3293,6,2016,9,-3
Group 1,BB,-0.5,8,14,3294,11,2016,11,0
Group 1,BB,-0.5,8,14,3295,7,2016,10,-3
Group 1,BB,-0.5,8,14,3296,10,2016,8,2
Group 1,BB,-0.5,8,14,3297,6,2016,11,-5
Group 1,BB,-0.5,8,14,3298,9,2016,11,-2
Group 1,BB,-0.5,8,14,3299,9,2016,10,-1
Group 1,BB,-0.5,8,14,3300,10,2016,13,-3
Group 1,BB,-0.5,8,14,3301,9,2016,10,-1
Group 1,BB,-0.5,8,14,3302,7,2016,8,-1
Group 1,BB,-0.5,8,14,3303,5,2016,7,-2
Group 1,BB,-0.5,8,14,3304,8,2016,13,-5
Group 1,BB,-0.5,8,14,3305,10,2016,12,-2
Group 1,BB,-0.5,8,14,3306,3,2016,9,-6
Group 1,BB,-0.5,8,14,3307,12,2016,5,7
Group 1,BB,-0.5,8,14,3308,10,2016,8,2
Group 1,BB,-0.5,8,14,3309,6,2016,7,-1
Group 1,BB,-0.5,8,14,3310,9,2016,11,-2
Group 1,BB,-0.5,8,14,3311,10,2016,10,0
Group 1,BB,-0.5,8,14,3312,13,2016,6,7
Group 1,BB,-0.5,8,14,3313,12,2016,6,6
Group 1,BB,-0.5,8,14,3314,5,2016,7,-2
Group 1,BB,-0.5,8,14,3315,7,2016,10,-3
Group 1,BB,-0.5,8,14,3316,7,2016,6,1
Group 1,BB,-0.5,8,14,3317,7,2016,7,0
Group 1,BB,-0.5,8,14,3318,7,2016,10,-3
Group 1,BB,-0.5,8,14,3319,8,2016,6,2
Group 1,BB,-0.5,8,14,3320,8,2016,10,-2
Group 1,BB,-0.5,8,14,3321,11,2016,8,3
Group 1,BB,-0.5,8,14,3322,10,2016,10,0
Group 1,BB,-0.5,8,14,3323,9,2016,8,1
Group 1,BB,-0.5,8,14,3324,8,2016,11,-3
Group 1,BB,-0.5,8,14,3325,11,2016,6,5
Group 1,BB,-0.5,8,14,3326,10,2016,7,3
Group 1,BB,-0.5,8,14,3327,9,2016,9,0
Group 1,BB,-0.5,8,14,3328,8,2016,5,3
Group 1,BB,-0.5,8,14,3329,9,2016,9,0
Group 1,BB,-0.5,8,14,3330,9,2016,6,3
Group 1,BB,-0.5,8,14,3331,10,2016,7,3
Group 1,BB,-0.5,8,14,3332,12,2016,7,5
Group 1,BB,-0.5,8,14,3333,10,2016,8,2
Group 1,BB,-0.5,8,14,3334,6,2016,5,1
Group 1,BB,-0.5,8,14,3335,7,2016,7,0
Group 1,BB,-0.5,8,14,3336,7,2016,6,1
Group 1,BB,-0.5,8,14,3337,9,2016,7,2
Group 1,BB,-0.5,8,14,3338,10,2016,8,2
Group 1,BB,-0.5,8,14,3339,8,2016,9,-1
Group 1,BB,-0.5,8,14,3340,9,2016,6,3
Group 1,BB,-0.5,8,14,3341,11,2016,6,5
Group 1,BB,-0.5,8,14,3342,10,2016,6,4
Group 1,BB,-0.5,8,14,3343,8,2016,9,-1
Group 1,BB,-0.5,8,14,3344,11,2016,11,0
Group 1,BB,-0.5,8,14,3345,8,2016,10,-2
Group 1,BB,-0.5,8,14,3346,12,2016,9,3
Group 1,BB,-0.5,8,14,3347,10,2016,8,2
Group 1,BB,-0.5,8,14,3348,4,2016,10,-6
Group 1,BB,-0.5,8,14,3349,11,2016,7,4
Group 1,BB,-0.5,8,14,3350,10,2016,7,3
Group 1,BB,-0.5,8,14,3351,11,2016,7,4
Group 1,BB,-0.5,8,14,3352,8,2016,10,-2
Group 1,BB,-0.5,8,14,3353,9,2016,9,0
Group 1,BB,-0.5,8,14,3354,12,2016,9,3
Group 1,BB,-0.5,8,14,3355,5,2016,7,-2
Group 1,BB,-0.5,8,14,3356,9,2016,9,0
Group 1,BB,-0.5,8,14,3357,7,2016,6,1
Group 1,BB,-0.5,8,14,3358,10,2016,6,4
Group 1,BB,-0.5,8,14,3359,9,2016,8,1
Group 1,BB,-0.5,8,14,3360,4,2016,3,1
Group 1,BB,-0.5,8,14,3361,7,2016,6,1
Group 1,BB,-0.5,8,14,3362,10,2016,7,3
Group 1,BB,-0.5,8,14,3363,8,2016,5,3
Group 1,BB,-0.5,8,14,3364,7,2016,8,-1
Group 1,BB,-0.5,8,14,3365,13,2016,9,4
Group 1,BB,-0.5,8,14,3366,11,2016,5,6
Group 1,BB,-0.5,8,14,3367,8,2016,10,-2
Group 1,BB,-0.5,8,14,3368,10,2016,7,3
Group 1,BB,-0.5,8,14,3369,5,2016,9,-4
Group 1,BB,-0.5,8,14,3370,11,2016,13,-2
Group 1,BB,-0.5,8,14,3371,5,2016,11,-6
Group 1,BB,-0.5,8,14,3372,4,2016,8,-4
Group 1,BB,-0.5,8,14,3373,7,2016,11,-4
Group 1,BB,-0.5,8,14,3374,10,2016,8,2
Group 1,BB,-0.5,8,14,3375,9,2016,10,-1
Group 1,BB,-0.5,8,14,3376,7,2016,9,-2
Group 1,BB,-0.5,8,14,3377,10,2016,8,2
Group 1,BB,-0.5,8,14,3378,7,2016,7,0
Group 1,BB,-0.5,8,14,3379,10,2016,8,2
Group 1,BB,-0.5,8,14,3380,11,2016,5,6
Group 1,BB,-0.5,8,14,3381,12,2016,7,5
Group 1,BB,-0.5,8,14,3382,11,2016,3,8
Group 1,BB,-0.5,8,14,3383,9,2016,9,0
Group 1,BB,-0.5,8,14,3384,10,2016,9,1
Group 1,BB,-0.5,8,14,3385,9,2016,3,6
Group 1,BB,-0.5,8,14,3386,8,2016,4,4
Group 1,BB,-0.5,8,14,3387,8,2016,8,0
Group 1,BB,-0.5,8,14,3388,5,2016,5,0
Group 1,BB,-0.5,8,14,3389,9,2016,6,3
Group 1,BB,-0.5,8,14,3390,6,2016,8,-2
Group 1,BB,-0.5,8,14,3391,11,2016,11,0
Group 1,BB,-0.5,8,14,3392,8,2016,10,-2
Group 1,BB,-0.5,8,14,3393,10,2016,11,-1
Group 1,BB,-0.5,8,14,3394,9,2016,6,3
Group 1,BB,-0.5,8,14,3395,10,2016,6,4
Group 1,BB,-0.5,8,14,3396,6,2016,8,-2
Group 1,BB,-0.5,8,14,3397,6,2016,8,-2
Group 1,BB,-0.5,8,14,3398,8,2016,7,1
Group 1,BB,-0.5,8,14,3399,11,2016,10,1
Group 1,BB,-0.5,8,14,3400,7,2016,5,2
Group 1,BB,-0.5,8,14,3401,9,2016,10,-1
Group 1,BB,-0.5,8,14,3402,10,2016,8,2
Group 1,BB,-0.5,8,14,3403,9,2016,8,1
Group 1,BB,-0.5,8,14,3404,4,2016,7,-3
Group 1,BB,-0.5,8,14,3405,8,2016,8,0
Group 1,BB,-0.5,8,14,3406,10,2016,6,4
Group 1,BB,-0.5,8,14,3407,9,2016,6,3
Group 1,BB,-0.5,8,14,3408,10,2016,10,0
Group 1,BB,-0.5,8,14,3409,7,2016,6,1
Group 1,BB,-0.5,8,14,3410,9,2016,12,-3
Group 1,BB,-0.5,8,14,3411,6,2016,8,-2
Group 1,BB,-0.5,8,14,3412,5,2016,6,-1
Group 1,BB,-0.5,8,14,3413,11,2016,11,0
Group 1,BB,-0.5,8,14,3414,10,2016,7,3
Group 1,BB,-0.5,8,14,3415,11,2016,7,4
Group 1,BB,-0.5,8,14,3416,7,2016,11,-4
Group 1,BB,-0.5,8,14,3417,8,2016,7,1
Group 1,BB,-0.5,8,14,3418,6,2016,7,-1
Group 1,BB,-0.5,8,14,3419,9,2016,7,2
Group 1,BB,-0.5,8,14,3420,9,2016,7,2
Group 1,BB,-0.5,8,14,3421,9,2016,10,-1
Group 1,BB,-0.5,8,14,3422,8,2016,7,1
Group 1,BB,-0.5,8,14,3423,7,2016,6,1
Group 1,BB,-0.5,8,14,3424,7,2016,6,1
Group 1,BB,-0.5,8,14,3425,8,2016,8,0
Group 1,BB,-0.5,8,14,3426,10,2016,6,4
Group 1,BB,-0.5,8,14,3427,10,2016,7,3
Group 1,BB,-0.5,8,14,3428,10,2016,8,2
Group 1,BB,-0.5,8,14,3429,6,2016,5,1
Group 1,BB,-0.5,8,14,3430,7,2016,5,2
Group 1,BB,-0.5,8,14,3431,8,2016,7,1
Group 1,BB,-0.5,8,14,3432,10,2016,4,6
Group 1,BB,-0.5,8,14,3433,7,2016,6,1
Group 1,BB,-0.5,8,14,3434,6,2016,10,-4
Group 1,BB,-0.5,8,14,3435,10,2016,6,4
Group 1,BB,-0.5,8,14,3436,10,2016,7,3
Group 1,BB,-0.5,8,14,3437,12,2016,8,4
Group 1,BB,-0.5,8,14,3438,5,2016,5,0
Group 1,BB,-0.5,8,14,3439,14,2016,5,9
Group 1,BB,-0.5,8,14,3440,11,2016,9,2
Group 1,BB,-0.5,8,14,3441,10,2016,7,3
Group 1,BB,-0.5,8,14,3442,10,2016,6,4
Group 1,BB,-0.5,8,14,3443,7,2016,10,-3
Group 1,BB,-0.5,8,14,3444,9,2016,9,0
Group 1,BB,-0.5,8,14,3445,12,2016,11,1
Group 1,BB,-0.5,8,14,3446,10,2016,10,0
Group 1,BB,-0.5,8,14,3447,10,2016,11,-1
Group 1,BB,-0.5,8,14,3448,12,2016,8,4
Group 1,BB,-0.5,8,14,3449,5,2016,9,-4
Group 1,BB,-0.5,8,14,3450,8,2016,10,-2
Group 1,BB,-0.5,8,14,3451,9,2016,10,-1
Group 1,BB,-0.5,8,14,3452,11,2016,8,3
Group 1,BB,-0.5,8,14,3453,8,2016,11,-3
Group 1,BB,-0.5,8,14,3454,12,2016,10,2
Group 1,BB,-0.5,8,14,3455,6,2016,10,-4
Group 1,BB,-0.5,8,14,3456,9,2016,7,2
Group 1,BB,-0.5,8,14,3457,8,2016,8,0
Group 1,BB,-0.5,8,14,3458,5,2016,9,-4
Group 1,BB,-0.5,8,14,3459,10,2016,10,0
Group 1,BB,-0.5,8,14,3460,8,2016,8,0
Group 1,BB,-0.5,8,14,3461,8,2016,10,-2
Group 1,BB,-0.5,8,14,3462,10,2016,8,2
Group 1,BB,-0.5,8,14,3463,10,2016,9,1
Group 1,BB,-0.5,8,14,3464,10,2016,9,1
Group 1,BB,-0.5,8,14,3465,13,2016,7,6
Group 1,BB,-0.5,8,14,3466,14,2016,9,5
Group 1,BB,-0.5,8,14,3467,10,2016,9,1
Group 1,BB,-0.5,8,14,3468,11,2016,7,4
Group 1,BB,-0.5,8,14,3469,10,2016,7,3
Group 1,BB,-0.5,8,14,3470,10,2016,10,0
Group 1,BB,-0.5,8,14,3471,8,2016,9,-1
Group 1,BB,-0.5,8,14,3472,6,2016,6,0
Group 1,BB,-0.5,8,14,3473,10,2016,5,5
Group 1,BB,-0.5,8,14,3474,7,2016,8,-1
Group 1,BB,-0.5,8,14,3475,5,2016,7,-2
Group 1,BB,-0.5,8,14,3476,10,2016,11,-1
Group 1,BB,-0.5,8,14,3477,8,2016,7,1
Group 1,BB,-0.5,8,14,3478,7,2016,9,-2
Group 1,BB,-0.5,8,14,3479,12,2016,9,3
Group 1,BB,-0.5,8,14,3480,9,2016,11,-2
Group 1,BB,-0.5,8,14,3481,9,2016,4,5
Group 1,BB,-0.5,8,14,3482,9,2016,7,2
Group 1,BB,-0.5,8,14,3483,7,2016,10,-3
Group 1,BB,-0.5,8,14,3484,5,2016,4,1
Group 1,BB,-0.5,8,14,3485,7,2016,6,1
Group 1,BB,-0.5,8,14,3486,11,2016,7,4
Group 1,BB,-0.5,8,14,3487,10,2016,6,4
Group 1,BB,-0.5,8,14,3488,8,2016,9,-1
Group 1,BB,-0.5,8,14,3489,10,2016,7,3
Group 1,BB,-0.5,8,14,3490,8,2016,7,1
Group 1,BB,-0.5,8,14,3491,11,2016,12,-1
Group 1,BB,-0.5,8,14,3492,8,2016,8,0
Group 1,BB,-0.5,8,14,3493,8,2016,8,0
Group 1,BB,-0.5,8,14,3494,9,2016,6,3
Group 1,BB,-0.5,8,14,3495,11,2016,10,1
Group 1,BB,-0.5,8,14,3496,10,2016,13,-3
Group 1,BB,-0.5,8,14,3497,9,2016,10,-1
Group 1,BB,-0.5,8,14,3498,6,2016,9,-3
Group 1,BB,-0.5,8,14,3499,8,2016,6,2
Group 1,BB,-0.5,8,14,3500,7,2016,11,-4
Group 1,BB,-0.5,8,14,3501,7,2016,7,0
Group 1,BB,-0.5,8,14,3502,5,2016,8,-3
Group 1,BB,-0.5,8,14,3503,8,2016,9,-1
Group 1,BB,-0.5,8,14,3504,9,2016,7,2
Group 1,BB,-0.5,8,14,3505,6,2016,9,-3
Group 1,BB,-0.5,8,14,3506,7,2016,13,-6
Group 1,BB,-0.5,8,14,3507,12,2016,6,6
Group 1,BB,-0.5,8,14,3508,9,2016,7,2
Group 1,BB,-0.5,8,14,3509,11,2016,13,-2
Group 1,BB,-0.5,8,14,3510,9,2016,10,-1
Group 1,BB,-0.5,8,14,3511,8,2016,9,-1
Group 1,BB,-0.5,8,14,3512,10,2016,7,3
Group 1,BB,-0.5,8,14,3513,8,2016,9,-1
Group 1,BB,-0.5,8,14,3514,7,2016,6,1
Group 1,BB,-0.5,8,14,3515,9,2016,11,-2
Group 1,BB,-0.5,8,14,3516,13,2016,7,6
Group 1,BB,-0.5,8,14,3517,7,2016,9,-2
Group 1,BB,-0.5,8,14,3518,7,2016,5,2
Group 1,BB,-0.5,8,14,3519,7,2016,6,1
Group 1,BB,-0.5,8,14,3520,10,2016,7,3
Group 1,BB,-0.5,8,14,3521,10,2016,7,3
Group 1,BB,-0.5,8,14,3522,4,2016,11,-7
Group 1,BB,-0.5,8,14,3523,6,2016,9,-3
Group 1,BB,-0.5,8,14,3524,10,2016,10,0
Group 1,BB,-0.5,8,14,3525,11,2016,9,2
Group 1,BB,-0.5,8,14,3526,6,2016,9,-3
Group 1,BB,-0.5,8,14,3527,8,2016,8,0
Group 1,BB,-0.5,8,14,3528,9,2016,11,-2
Group 1,BB,-0.5,8,14,3529,7,2016,3,4
Group 1,BB,-0.5,8,14,3530,11,2016,5,6
Group 1,BB,-0.5,8,14,3531,9,2016,8,1
Group 1,BB,-0.5,8,14,3532,9,2016,4,5
Group 1,BB,-0.5,8,14,3533,10,2016,6,4
Group 1,BB,-0.5,8,14,3534,9,2016,9,0
Group 1,BB,-0.5,8,14,3535,7,2016,4,3
Group 1,BB,-0.5,8,14,3536,8,2016,9,-1
Group 1,BB,-0.5,8,14,3537,11,2016,11,0
Group 1,BB,-0.5,8,14,3538,8,2016,10,-2
Group 1,BB,-0.5,8,14,3539,10,2016,13,-3
Group 1,BB,-0.5,8,14,3540,12,2016,12,0
Group 1,BB,-0.5,8,14,3541,10,2016,5,5
Group 1,BB,-0.5,8,14,3542,6,2016,7,-1
Group 1,BB,-0.5,8,14,3543,8,2016,11,-3
Group 1,BB,-0.5,8,14,3544,8,2016,5,3
Group 1,BB,-0.5,8,14,3545,7,2016,10,-3
Group 1,BB,-0.5,8,14,3546,6,2016,11,-5
Group 1,BB,-0.5,8,14,3547,11,2016,5,6
Group 1,BB,-0.5,8,14,3548,9,2016,6,3
Group 1,BB,-0.5,8,14,3549,10,2016,7,3
Group 1,BB,-0.5,8,14,3550,11,2016,6,5
Group 1,BB,-0.5,8,14,3551,9,2016,7,2
Group 1,BB,-0.5,8,14,3552,9,2016,10,-1
Group 1,BB,-0.5,8,14,3553,12,2016,5,7
Group 1,BB,-0.5,8,14,3554,9,2016,7,2
Group 1,BB,-0.5,8,14,3555,10,2016,5,5
Group 1,BB,-0.5,8,14,3556,10,2016,9,1
Group 1,BB,-0.5,8,14,3557,10,2016,10,0
Group 1,BB,-0.5,8,14,3558,9,2016,7,2
Group 1,BB,-0.5,8,14,3559,12,2016,10,2
Group 1,BB,-0.5,8,14,3560,7,2016,8,-1
Group 1,BB,-0.5,8,14,3561,9,2016,11,-2
Group 1,BB,-0.5,8,14,3562,9,2016,11,-2
Group 1,BB,-0.5,8,14,3563,8,2016,4,4
Group 1,BB,-0.5,8,14,3564,9,2016,11,-2
Group 1,BB,-0.5,8,14,3565,11,2016,9,2
Group 1,BB,-0.5,8,14,3566,8,2016,9,-1
Group 1,BB,-0.5,8,14,3567,8,2016,7,1
Group 1,BB,-0.5,8,14,3568,10,2016,7,3
Group 1,BB,-0.5,8,14,3569,9,2016,8,1
Group 1,BB,-0.5,8,14,3570,6,2016,10,-4
Group 1,BB,-0.5,8,14,3571,12,2016,6,6
Group 1,BB,-0.5,8,14,3572,8,2016,8,0
Group 1,BB,-0.5,8,14,3573,9,2016,9,0
Group 1,BB,-0.5,8,14,3574,9,2016,7,2
Group 1,BB,-0.5,8,14,3575,5,2016,11,-6
Group 1,BB,-0.5,8,14,3576,10,2016,6,4
Group 1,BB,-0.5,8,14,3577,5,2016,8,-3
Group 1,BB,-0.5,8,14,3578,8,2016,8,0
Group 1,BB,-0.5,8,14,3579,12,2016,4,8
Group 1,BB,-0.5,8,14,3580,8,2016,12,-4
Group 1,BB,-0.5,8,14,3581,9,2016,10,-1
Group 1,BB,-0.5,8,14,3582,11,2016,9,2
Group 1,BB,-0.5,8,14,3583,9,2016,7,2
Group 1,BB,-0.5,8,14,3584,8,2016,7,1
Group 1,BB,-0.5,8,14,3585,8,2016,4,4
Group 1,BB,-0.5,8,14,3586,9,2016,8,1
Group 1,BB,-0.5,8,14,3587,11,2016,4,7
Group 1,BB,-0.5,8,14,3588,11,2016,3,8
Group 1,BB,-0.5,8,14,3589,8,2016,5,3
Group 1,BB,-0.5,8,14,3590,12,2016,8,4
Group 1,BB,-0.5,8,14,3591,11,2016,10,1
Group 1,BB,-0.5,8,14,3592,7,2016,8,-1
Group 1,BB,-0.5,8,14,3593,12,2016,9,3
Group 1,BB,-0.5,8,14,3594,11,2016,6,5
Group 1,BB,-0.5,8,14,3595,12,2016,6,6
Group 1,BB,-0.5,8,14,3596,8,2016,8,0
Group 1,BB,-0.5,8,14,3597,8,2016,7,1
Group 1,BB,-0.5,8,14,3598,7,2016,8,-1
Group 1,BB,-0.5,8,14,3599,10,2016,6,4
Group 1,BB,-0.5,8,14,3600,10,2016,8,2
Group 1,BB,-0.5,8,14,3601,10,2016,10,0
Group 1,BB,-0.5,8,14,3602,9,2016,6,3
Group 1,BB,-0.5,8,14,3603,7,2016,7,0
Group 1,BB,-0.5,8,14,3604,10,2016,12,-2
Group 1,BB,-0.5,8,14,3605,9,2016,9,0
Group 1,BB,-0.5,8,14,3606,8,2016,4,4
Group 1,BB,-0.5,8,14,3607,11,2016,6,5
Group 1,BB,-0.5,8,14,3608,5,2016,5,0
Group 1,BB,-0.5,8,14,3609,11,2016,11,0
Group 1,BB,-0.5,8,14,3610,8,2016,6,2
Group 1,BB,-0.5,8,14,3611,9,2016,6,3
Group 1,BB,-0.5,8,14,3612,11,2016,4,7
Group 1,BB,-0.5,8,14,3613,7,2016,6,1
Group 1,BB,-0.5,8,14,3614,9,2016,10,-1
Group 1,BB,-0.5,8,14,3615,6,2016,9,-3
Group 1,BB,-0.5,8,14,3616,11,2016,9,2
Group 1,BB,-0.5,8,14,3617,9,2016,7,2
Group 1,BB,-0.5,8,14,3618,7,2016,8,-1
Group 1,BB,-0.5,8,14,3619,7,2016,10,-3
Group 1,BB,-0.5,8,14,3620,6,2016,8,-2
Group 1,BB,-0.5,8,14,3621,11,2016,9,2
Group 1,BB,-0.5,8,14,3622,11,2016,10,1
Group 1,BB,-0.5,8,14,3623,9,2016,9,0
Group 1,BB,-0.5,8,14,3624,8,2016,10,-2
Group 1,BB,-0.5,8,14,3625,11,2016,6,5
Group 1,BB,-0.5,8,14,3626,8,2016,8,0
Group 1,BB,-0.5,8,14,3627,5,2016,13,-8
Group 1,BB,-0.5,8,14,3628,11,2016,9,2
Group 1,BB,-0.5,8,14,3629,8,2016,11,-3
Group 1,BB,-0.5,8,14,3630,8,2016,8,0
Group 1,BB,-0.5,8,14,3631,6,2016,10,-4
Group 1,BB,-0.5,8,14,3632,7,2016,12,-5
Group 1,BB,-0.5,8,14,3633,7,2016,3,4
Group 1,BB,-0.5,8,14,3634,10,2016,10,0
Group 1,BB,-0.5,8,14,3635,5,2016,9,-4
Group 1,BB,-0.5,8,14,3636,7,2016,5,2
Group 1,BB,-0.5,8,14,3637,11,2016,9,2
Group 1,BB,-0.5,8,14,3638,10,2016,6,4
Group 1,BB,-0.5,8,14,3639,10,2016,6,4
Group 1,BB,-0.5,8,14,3640,13,2016,6,7
Group 1,BB,-0.5,8,14,3641,9,2016,7,2
Group 1,BB,-0.5,8,14,3642,9,2016,7,2
Group 1,BB,-0.5,8,14,3643,9,2016,10,-1
Group 1,BB,-0.5,8,14,3644,9,2016,10,-1
Group 1,BB,-0.5,8,14,3645,9,2016,7,2
Group 1,BB,-0.5,8,14,3646,7,2016,6,1
Group 1,BB,-0.5,8,14,3647,5,2016,12,-7
Group 1,BB,-0.5,8,14,3648,9,2016,7,2
Group 1,BB,-0.5,8,14,3649,7,2016,9,-2
Group 1,BB,-0.5,8,14,3650,8,2016,12,-4
Group 1,BB,-0.5,8,14,3651,10,2016,9,1
Group 1,BB,-0.5,8,14,3652,9,2016,10,-1
Group 1,BB,-0.5,8,14,3653,6,2016,8,-2
Group 1,BB,-0.5,8,14,3654,7,2016,7,0
Group 1,BB,-0.5,8,14,3655,10,2016,9,1
Group 1,BB,-0.5,8,14,3656,7,2016,8,-1
Group 1,BB,-0.5,8,14,3657,10,2016,9,1
Group 1,BB,-0.5,8,14,3658,11,2016,7,4
Group 1,BB,-0.5,8,14,3659,10,2016,10,0
Group 1,BB,-0.5,8,14,3660,10,2016,7,3
Group 1,BB,-0.5,8,14,3661,11,2016,5,6
Group 1,BB,-0.5,8,14,3662,10,2016,8,2
Group 1,BB,-0.5,8,14,3663,9,2016,6,3
Group 1,BB,-0.5,8,14,3664,9,2016,4,5
Group 1,BB,-0.5,8,14,3665,10,2016,8,2
Group 1,BB,-0.5,8,14,3666,10,2016,10,0
Group 1,BB,-0.5,8,14,3667,10,2016,9,1
Group 1,BB,-0.5,8,14,3668,12,2016,9,3
Group 1,BB,-0.5,8,14,3669,7,2016,9,-2
Group 1,BB,-0.5,8,14,3670,10,2016,11,-1
Group 1,BB,-0.5,8,14,3671,10,2016,7,3
Group 1,BB,-0.5,8,14,3672,8,2016,11,-3
Group 1,BB,-0.5,8,14,3673,11,2016,9,2
Group 1,BB,-0.5,8,14,3674,10,2016,14,-4
Group 1,BB,-0.5,8,14,3675,7,2016,11,-4
Group 1,BB,-0.5,8,14,3676,9,2016,8,1
Group 1,BB,-0.5,8,14,3677,7,2016,7,0
Group 1,BB,-0.5,8,14,3678,7,2016,8,-1
Group 1,BB,-0.5,8,14,3679,7,2016,8,-1
Group 1,BB,-0.5,8,14,3680,7,2016,5,2
Group 1,BB,-0.5,8,14,3681,4,2016,5,-1
Group 1,BB,-0.5,8,14,3682,9,2016,9,0
Group 1,BB,-0.5,8,14,3683,9,2016,8,1
Group 1,BB,-0.5,8,14,3684,10,2016,8,2
Group 1,BB,-0.5,8,14,3685,8,2016,5,3
Group 1,BB,-0.5,8,14,3686,11,2016,8,3
Group 1,BB,-0.5,8,14,3687,8,2016,7,1
Group 1,BB,-0.5,8,14,3688,3,2016,8,-5
Group 1,BB,-0.5,8,14,3689,6,2016,7,-1
Group 1,BB,-0.5,8,14,3690,8,2016,7,1
Group 1,BB,-0.5,8,14,3691,10,2016,4,6
Group 1,BB,-0.5,8,14,3692,8,2016,7,1
Group 1,BB,-0.5,8,14,3693,9,2016,7,2
Group 1,BB,-0.5,8,14,3694,11,2016,7,4
Group 1,BB,-0.5,8,14,3695,11,2016,9,2
Group 1,BB,-0.5,8,14,3696,6,2016,8,-2
Group 1,BB,-0.5,8,14,3697,9,2016,8,1
Group 1,BB,-0.5,8,14,3698,8,2016,8,0
Group 1,BB,-0.5,8,14,3699,11,2016,6,5
Group 1,BB,-0.5,8,14,3700,7,2016,11,-4
Group 1,BB,-0.5,8,14,3701,10,2016,12,-2
Group 1,BB,-0.5,8,14,3702,8,2016,5,3
Group 1,BB,-0.5,8,14,3703,10,2016,9,1
Group 1,BB,-0.5,8,14,3704,11,2016,8,3
Group 1,BB,-0.5,8,14,3705,8,2016,10,-2
Group 1,BB,-0.5,8,14,3706,7,2016,10,-3
Group 1,BB,-0.5,8,14,3707,9,2016,9,0
Group 1,BB,-0.5,8,14,3708,8,2016,8,0
Group 1,BB,-0.5,8,14,3709,6,2016,6,0
Group 1,BB,-0.5,8,14,3710,9,2016,7,2
Group 1,BB,-0.5,8,14,3711,7,2016,10,-3
Group 1,BB,-0.5,8,14,3712,7,2016,10,-3
Group 1,BB,-0.5,8,14,3713,9,2016,6,3
Group 1,BB,-0.5,8,14,3714,7,2016,8,-1
Group 1,BB,-0.5,8,14,3715,5,2016,9,-4
Group 1,BB,-0.5,8,14,3716,8,2016,7,1
Group 1,BB,-0.5,8,14,3717,10,2016,11,-1
Group 1,BB,-0.5,8,14,3718,9,2016,9,0
Group 1,BB,-0.5,8,14,3719,10,2016,5,5
Group 1,BB,-0.5,8,14,3720,12,2016,8,4
Group 1,BB,-0.5,8,14,3721,11,2016,7,4
Group 1,BB,-0.5,8,14,3722,11,2016,8,3
Group 1,BB,-0.5,8,14,3723,8,2016,7,1
Group 1,BB,-0.5,8,14,3724,11,2016,9,2
Group 1,BB,-0.5,8,14,3725,7,2016,6,1
Group 1,BB,-0.5,8,14,3726,12,2016,7,5
Group 1,BB,-0.5,8,14,3727,6,2016,3,3
Group 1,BB,-0.5,8,14,3728,10,2016,7,3
Group 1,BB,-0.5,8,14,3729,10,2016,6,4
Group 1,BB,-0.5,8,14,3730,11,2016,5,6
Group 1,BB,-0.5,8,14,3731,8,2016,10,-2
Group 1,BB,-0.5,8,14,3732,11,2016,4,7
Group 1,BB,-0.5,8,14,3733,6,2016,7,-1
Group 1,BB,-0.5,8,14,3734,11,2016,10,1
Group 1,BB,-0.5,8,14,3735,7,2016,12,-5
Group 1,BB,-0.5,8,14,3736,9,2016,8,1
Group 1,BB,-0.5,8,14,3737,9,2016,10,-1
Group 1,BB,-0.5,8,14,3738,5,2016,7,-2
Group 1,BB,-0.5,8,14,3739,4,2016,7,-3
Group 1,BB,-0.5,8,14,3740,8,2016,7,1
Group 1,BB,-0.5,8,14,3741,9,2016,9,0
Group 1,BB,-0.5,8,14,3742,10,2016,9,1
Group 1,BB,-0.5,8,14,3743,8,2016,7,1
Group 1,BB,-0.5,8,14,3744,9,2016,6,3
Group 1,BB,-0.5,8,14,3745,12,2016,6,6
Group 1,BB,-0.5,8,14,3746,5,2016,10,-5
Group 1,BB,-0.5,8,14,3747,7,2016,4,3
Group 1,BB,-0.5,8,14,3748,6,2016,10,-4
Group 1,BB,-0.5,8,14,3749,11,2016,10,1
Group 1,BB,-0.5,8,14,3750,11,2016,7,4
Group 1,BB,-0.5,8,14,3751,11,2016,8,3
Group 1,BB,-0.5,8,14,3752,14,2016,7,7
Group 1,BB,-0.5,8,14,3753,10,2016,7,3
Group 1,BB,-0.5,8,14,3754,5,2016,8,-3
Group 1,BB,-0.5,8,14,3755,6,2016,8,-2
Group 1,BB,-0.5,8,14,3756,6,2016,8,-2
Group 1,BB,-0.5,8,14,3757,8,2016,10,-2
Group 1,BB,-0.5,8,14,3758,6,2016,10,-4
Group 1,BB,-0.5,8,14,3759,5,2016,7,-2
Group 1,BB,-0.5,8,14,3760,11,2016,7,4
Group 1,BB,-0.5,8,14,3761,10,2016,9,1
Group 1,BB,-0.5,8,14,3762,11,2016,7,4
Group 1,BB,-0.5,8,14,3763,8,2016,11,-3
Group 1,BB,-0.5,8,14,3764,4,2016,9,-5
Group 1,BB,-0.5,8,14,3765,6,2016,8,-2
Group 1,BB,-0.5,8,14,3766,11,2016,5,6
Group 1,BB,-0.5,8,14,3767,6,2016,7,-1
Group 1,BB,-0.5,8,14,3768,9,2016,8,1
Group 1,BB,-0.5,8,14,3769,7,2016,9,-2
Group 1,BB,-0.5,8,14,3770,12,2016,13,-1
Group 1,BB,-0.5,8,14,3771,7,2016,12,-5
Group 1,BB,-0.5,8,14,3772,9,2016,12,-3
Group 1,BB,-0.5,8,14,3773,9,2016,8,1
Group 1,BB,-0.5,8,14,3774,12,2016,10,2
Group 1,BB,-0.5,8,14,3775,10,2016,11,-1
Group 1,BB,-0.5,8,14,3776,11,2016,5,6
Group 1,BB,-0.5,8,14,3777,4,2016,4,0
Group 1,BB,-0.5,8,14,3778,9,2016,1,8
Group 1,BB,-0.5,8,14,3779,10,2016,8,2
Group 1,BB,-0.5,8,14,3780,4,2016,5,-1
Group 1,BB,-0.5,8,14,3781,8,2016,10,-2
Group 1,BB,-0.5,8,14,3782,8,2016,11,-3
Group 1,BB,-0.5,8,14,3783,9,2016,7,2
Group 1,BB,-0.5,8,14,3784,9,2016,10,-1
Group 1,BB,-0.5,8,14,3785,11,2016,10,1
Group 1,BB,-0.5,8,14,3786,8,2016,7,1
Group 1,BB,-0.5,8,14,3787,10,2016,8,2
Group 1,BB,-0.5,8,14,3788,8,2016,9,-1
Group 1,BB,-0.5,8,14,3789,10,2016,11,-1
Group 1,BB,-0.5,8,14,3790,9,2016,8,1
Group 1,BB,-0.5,8,14,3791,11,2016,8,3
Group 1,BB,-0.5,8,14,3792,10,2016,6,4
Group 1,BB,-0.5,8,14,3793,8,2016,9,-1
Group 1,BB,-0.5,8,14,3794,9,2016,5,4
Group 1,BB,-0.5,8,14,3795,7,2016,12,-5
Group 1,BB,-0.5,8,14,3796,8,2016,9,-1
Group 1,BB,-0.5,8,14,3797,11,2016,8,3
Group 1,BB,-0.5,8,14,3798,10,2016,5,5
Group 1,BB,-0.5,8,14,3799,10,2016,10,0
Group 1,BB,-0.5,8,14,3800,9,2016,9,0
Group 1,BB,-0.5,8,14,3801,6,2016,9,-3
Group 1,BB,-0.5,8,14,3802,12,2016,7,5
Group 1,BB,-0.5,8,14,3803,6,2016,11,-5
Group 1,BB,-0.5,8,14,3804,5,2016,6,-1
Group 1,BB,-0.5,8,14,3805,6,2016,5,1
Group 1,BB,-0.5,8,14,3806,10,2016,7,3
Group 1,BB,-0.5,8,14,3807,10,2016,8,2
Group 1,BB,-0.5,8,14,3808,11,2016,9,2
Group 1,BB,-0.5,8,14,3809,12,2016,8,4
Group 1,BB,-0.5,8,14,3810,5,2016,6,-1
Group 1,BB,-0.5,8,14,3811,8,2016,9,-1
Group 1,BB,-0.5,8,14,3812,11,2016,10,1
Group 1,BB,-0.5,8,14,3813,6,2016,11,-5
Group 1,BB,-0.5,8,14,3814,9,2016,9,0
Group 1,BB,-0.5,8,14,3815,8,2016,9,-1
Group 1,BB,-0.5,8,14,3816,9,2016,8,1
Group 1,BB,-0.5,8,14,3817,7,2016,7,0
Group 1,BB,-0.5,8,14,3818,7,2016,9,-2
Group 1,BB,-0.5,8,14,3819,11,2016,7,4
Group 1,BB,-0.5,8,14,3820,11,2016,6,5
Group 1,BB,-0.5,8,14,3821,11,2016,11,0
Group 1,BB,-0.5,8,14,3822,11,2016,9,2
Group 1,BB,-0.5,8,14,3823,10,2016,11,-1
Group 1,BB,-0.5,8,14,3824,8,2016,4,4
Group 1,BB,-0.5,8,14,3825,9,2016,9,0
Group 1,BB,-0.5,8,14,3826,9,2016,12,-3
Group 1,BB,-0.5,8,14,3827,5,2016,8,-3
Group 1,BB,-0.5,8,14,3828,4,2016,5,-1
Group 1,BB,-0.5,8,14,3829,6,2016,4,2
Group 1,BB,-0.5,8,14,3830,12,2016,9,3
Group 1,BB,-0.5,8,14,3831,10,2016,9,1
Group 1,BB,-0.5,8,14,3832,7,2016,9,-2
Group 1,BB,-0.5,8,14,3833,5,2016,7,-2
Group 1,BB,-0.5,8,14,3834,6,2016,7,-1
Group 1,BB,-0.5,8,14,3835,11,2016,10,1
Group 1,BB,-0.5,8,14,3836,6,2016,8,-2
Group 1,BB,-0.5,8,14,3837,9,2016,8,1
Group 1,BB,-0.5,8,14,3838,9,2016,6,3
Group 1,BB,-0.5,8,14,3839,11,2016,8,3
Group 1,BB,-0.5,8,14,3840,10,2016,7,3
Group 1,BB,-0.5,8,14,3841,6,2016,7,-1
Group 1,BB,-0.5,8,14,3842,9,2016,7,2
Group 1,BB,-0.5,8,14,3843,8,2016,9,-1
Group 1,BB,-0.5,8,14,3844,8,2016,12,-4
Group 1,BB,-0.5,8,14,3845,8,2016,9,-1
Group 1,BB,-0.5,8,14,3846,8,2016,9,-1
Group 1,BB,-0.5,8,14,3847,8,2016,8,0
Group 1,BB,-0.5,8,14,3848,8,2016,6,2
Group 1,BB,-0.5,8,14,3849,4,2016,11,-7
Group 1,BB,-0.5,8,14,3850,10,2016,7,3
Group 1,BB,-0.5,8,14,3851,12,2016,12,0
Group 1,BB,-0.5,8,14,3852,7,2016,10,-3
Group 1,BB,-0.5,8,14,3853,11,2016,7,4
Group 1,BB,-0.5,8,14,3854,12,2016,10,2
Group 1,BB,-0.5,8,14,3855,7,2016,6,1
Group 1,BB,-0.5,8,14,3856,5,2016,9,-4
Group 1,BB,-0.5,8,14,3857,10,2016,9,1
Group 1,BB,-0.5,8,14,3858,7,2016,8,-1
Group 1,BB,-0.5,8,14,3859,4,2016,8,-4
Group 1,BB,-0.5,8,14,3860,7,2016,8,-1
Group 1,BB,-0.5,8,14,3861,7,2016,11,-4
Group 1,BB,-0.5,8,14,3862,7,2016,9,-2
Group 1,BB,-0.5,8,14,3863,8,2016,10,-2
Group 1,BB,-0.5,8,14,3864,8,2016,6,2
Group 1,BB,-0.5,8,14,3865,7,2016,7,0
Group 1,BB,-0.5,8,14,3866,13,2016,10,3
Group 1,BB,-0.5,8,14,3867,11,2016,9,2
Group 1,BB,-0.5,8,14,3868,10,2016,11,-1
Group 1,BB,-0.5,8,14,3869,11,2016,9,2
Group 1,BB,-0.5,8,14,3870,8,2016,7,1
Group 1,BB,-0.5,8,14,3871,9,2016,8,1
Group 1,BB,-0.5,8,14,3872,9,2016,10,-1
Group 1,BB,-0.5,8,14,3873,10,2016,10,0
Group 1,BB,-0.5,8,14,3874,8,2016,8,0
Group 1,BB,-0.5,8,14,3875,12,2016,7,5
Group 1,BB,-0.5,8,14,3876,9,2016,7,2
Group 1,BB,-0.5,8,14,3877,7,2016,9,-2
Group 1,BB,-0.5,8,14,3878,7,2016,6,1
Group 1,BB,-0.5,8,14,3879,7,2016,8,-1
Group 1,BB,-0.5,8,14,3880,12,2016,8,4
Group 1,BB,-0.5,8,14,3881,7,2016,7,0
Group 1,BB,-0.5,8,14,3882,3,2016,6,-3
Group 1,BB,-0.5,8,14,3883,7,2016,10,-3
Group 1,BB,-0.5,8,14,3884,12,2016,8,4
Group 1,BB,-0.5,8,14,3885,9,2016,7,2
Group 1,BB,-0.5,8,14,3886,8,2016,9,-1
Group 1,BB,-0.5,8,14,3887,7,2016,10,-3
Group 1,BB,-0.5,8,14,3888,8,2016,12,-4
Group 1,BB,-0.5,8,14,3889,5,2016,8,-3
Group 1,BB,-0.5,8,14,3890,9,2016,5,4
Group 1,BB,-0.5,8,14,3891,12,2016,9,3
Group 1,BB,-0.5,8,14,3892,8,2016,10,-2
Group 1,BB,-0.5,8,14,3893,8,2016,9,-1
Group 1,BB,-0.5,8,14,3894,11,2016,6,5
Group 1,BB,-0.5,8,14,3895,8,2016,5,3
Group 1,BB,-0.5,8,14,3896,6,2016,9,-3
Group 1,BB,-0.5,8,14,3897,10,2016,7,3
Group 1,BB,-0.5,8,14,3898,9,2016,7,2
Group 1,BB,-0.5,8,14,3899,9,2016,3,6
Group 1,BB,-0.5,8,14,3900,10,2016,9,1
Group 1,BB,-0.5,8,14,3901,8,2016,5,3
Group 1,BB,-0.5,8,14,3902,11,2016,8,3
Group 1,BB,-0.5,8,14,3903,12,2016,10,2
Group 1,BB,-0.5,8,14,3904,9,2016,6,3
Group 1,BB,-0.5,8,14,3905,6,2016,8,-2
Group 1,BB,-0.5,8,14,3906,9,2016,6,3
Group 1,BB,-0.5,8,14,3907,5,2016,10,-5
Group 1,BB,-0.5,8,14,3908,6,2016,9,-3
Group 1,BB,-0.5,8,14,3909,5,2016,11,-6
Group 1,BB,-0.5,8,14,3910,11,2016,9,2
Group 1,BB,-0.5,8,14,3911,8,2016,6,2
Group 1,BB,-0.5,8,14,3912,9,2016,9,0
Group 1,BB,-0.5,8,14,3913,6,2016,5,1
Group 1,BB,-0.5,8,14,3914,9,2016,9,0
Group 1,BB,-0.5,8,14,3915,8,2016,3,5
Group 1,BB,-0.5,8,14,3916,9,2016,8,1
Group 1,BB,-0.5,8,14,3917,4,2016,6,-2
Group 1,BB,-0.5,8,14,3918,10,2016,7,3
Group 1,BB,-0.5,8,14,3919,12,2016,7,5
Group 1,BB,-0.5,8,14,3920,11,2016,4,7
Group 1,BB,-0.5,8,14,3921,9,2016,9,0
Group 1,BB,-0.5,8,14,3922,9,2016,10,-1
Group 1,BB,-0.5,8,14,3923,9,2016,7,2
Group 1,BB,-0.5,8,14,3924,6,2016,8,-2
Group 1,BB,-0.5,8,14,3925,12,2016,13,-1
Group 1,BB,-0.5,8,14,3926,8,2016,9,-1
Group 1,BB,-0.5,8,14,3927,10,2016,10,0
Group 1,BB,-0.5,8,14,3928,10,2016,7,3
Group 1,BB,-0.5,8,14,3929,11,2016,6,5
Group 1,BB,-0.5,8,14,3930,10,2016,11,-1
Group 1,BB,-0.5,8,14,3931,8,2016,6,2
Group 1,BB,-0.5,8,14,3932,8,2016,7,1
Group 1,BB,-0.5,8,14,3933,10,2016,6,4
Group 1,BB,-0.5,8,14,3934,10,2016,8,2
Group 1,BB,-0.5,8,14,3935,8,2016,5,3
Group 1,BB,-0.5,8,14,3936,6,2016,5,1
Group 1,BB,-0.5,8,14,3937,7,2016,6,1
Group 1,BB,-0.5,8,14,3938,6,2016,9,-3
Group 1,BB,-0.5,8,14,3939,7,2016,9,-2
Group 1,BB,-0.5,8,14,3940,7,2016,7,0
Group 1,BB,-0.5,8,14,3941,12,2016,12,0
Group 1,BB,-0.5,8,14,3942,10,2016,9,1
Group 1,BB,-0.5,8,14,3943,10,2016,6,4
Group 1,BB,-0.5,8,14,3944,10,2016,9,1
Group 1,BB,-0.5,8,14,3945,5,2016,7,-2
Group 1,BB,-0.5,8,14,3946,6,2016,5,1
Group 1,BB,-0.5,8,14,3947,8,2016,4,4
Group 1,BB,-0.5,8,14,3948,4,2016,7,-3
Group 1,BB,-0.5,8,14,3949,8,2016,7,1
Group 1,BB,-0.5,8,14,3950,8,2016,9,-1
Group 1,BB,-0.5,8,14,3951,8,2016,7,1
Group 1,BB,-0.5,8,14,3952,10,2016,6,4
Group 1,BB,-0.5,8,14,3953,10,2016,3,7
Group 1,BB,-0.5,8,14,3954,8,2016,8,0
Group 1,BB,-0.5,8,14,3955,8,2016,5,3
Group 1,BB,-0.5,8,14,3956,11,2016,3,8
Group 1,BB,-0.5,8,14,3957,9,2016,8,1
Group 1,BB,-0.5,8,14,3958,12,2016,7,5
Group 1,BB,-0.5,8,14,3959,11,2016,2,9
Group 1,BB,-0.5,8,14,3960,6,2016,5,1
Group 1,BB,-0.5,8,14,3961,12,2016,5,7
Group 1,BB,-0.5,8,14,3962,10,2016,11,-1
Group 1,BB,-0.5,8,14,3963,9,2016,8,1
Group 1,BB,-0.5,8,14,3964,8,2016,9,-1
Group 1,BB,-0.5,8,14,3965,8,2016,6,2
Group 1,BB,-0.5,8,14,3966,7,2016,7,0
Group 1,BB,-0.5,8,14,3967,9,2016,11,-2
Group 1,BB,-0.5,8,14,3968,8,2016,9,-1
Group 1,BB,-0.5,8,14,3969,10,2016,5,5
Group 1,BB,-0.5,8,14,3970,10,2016,6,4
Group 1,BB,-0.5,8,14,3971,7,2016,8,-1
Group 1,BB,-0.5,8,14,3972,6,2016,9,-3
Group 1,BB,-0.5,8,14,3973,5,2016,11,-6
Group 1,BB,-0.5,8,14,3974,10,2016,9,1
Group 1,BB,-0.5,8,14,3975,8,2016,9,-1
Group 1,BB,-0.5,8,14,3976,6,2016,8,-2
Group 1,BB,-0.5,8,14,3977,6,2016,6,0
Group 1,BB,-0.5,8,14,3978,9,2016,8,1
Group 1,BB,-0.5,8,14,3979,9,2016,7,2
Group 1,BB,-0.5,8,14,3980,7,2016,11,-4
Group 1,BB,-0.5,8,14,3981,7,2016,6,1
Group 1,BB,-0.5,8,14,3982,10,2016,4,6
Group 1,BB,-0.5,8,14,3983,8,2016,9,-1
Group 1,BB,-0.5,8,14,3984,10,2016,7,3
Group 1,BB,-0.5,8,14,3985,5,2016,4,1
Group 1,BB,-0.5,8,14,3986,10,2016,7,3
Group 1,BB,-0.5,8,14,3987,10,2016,7,3
Group 1,BB,-0.5,8,14,3988,6,2016,6,0
Group 1,BB,-0.5,8,14,3989,11,2016,7,4
Group 1,BB,-0.5,8,14,3990,9,2016,9,0
Group 1,BB,-0.5,8,14,3991,9,2016,7,2
Group 1,BB,-0.5,8,14,3992,9,2016,8,1
Group 1,BB,-0.5,8,14,3993,8,2016,10,-2
Group 1,BB,-0.5,8,14,3994,9,2016,9,0
Group 1,BB,-0.5,8,14,3995,7,2016,11,-4
Group 1,BB,-0.5,8,14,3996,9,2016,9,0
Group 1,BB,-0.5,8,14,3997,11,2016,6,5
Group 1,BB,-0.5,8,14,3998,9,2016,8,1
Group 1,BB,-0.5,8,14,3999,8,2016,5,3
Group 1,BB,-0.5,8,14,4000,7,2016,4,3
Group 3,BB,-0.5,9,14,1,8,2016,7,1
Group 3,BB,-0.5,9,14,2,11,2016,8,3
Group 3,BB,-0.5,9,14,3,10,2016,11,-1
Group 3,BB,-0.5,9,14,4,9,2016,5,4
Group 3,BB,-0.5,9,14,5,8,2016,7,1
Group 3,BB,-0.5,9,14,6,7,2016,11,-4
Group 3,BB,-0.5,9,14,7,13,2016,11,2
Group 3,BB,-0.5,9,14,8,7,2016,10,-3
Group 3,BB,-0.5,9,14,9,9,2016,8,1
Group 3,BB,-0.5,9,14,10,8,2016,7,1
Group 3,BB,-0.5,9,14,11,10,2016,10,0
Group 3,BB,-0.5,9,14,12,8,2016,10,-2
Group 3,BB,-0.5,9,14,13,7,2016,11,-4
Group 3,BB,-0.5,9,14,14,11,2016,7,4
Group 3,BB,-0.5,9,14,15,8,2016,9,-1
Group 3,BB,-0.5,9,14,16,10,2016,6,4
Group 3,BB,-0.5,9,14,17,11,2016,4,7
Group 3,BB,-0.5,9,14,18,8,2016,11,-3
Group 3,BB,-0.5,9,14,19,11,2016,5,6
Group 3,BB,-0.5,9,14,20,8,2016,4,4
Group 3,BB,-0.5,9,14,21,14,2016,9,5
Group 3,BB,-0.5,9,14,22,8,2016,7,1
Group 3,BB,-0.5,9,14,23,5,2016,7,-2
Group 3,BB,-0.5,9,14,24,11,2016,10,1
Group 3,BB,-0.5,9,14,25,6,2016,8,-2
Group 3,BB,-0.5,9,14,26,4,2016,8,-4
Group 3,BB,-0.5,9,14,27,10,2016,9,1
Group 3,BB,-0.5,9,14,28,9,2016,6,3
Group 3,BB,-0.5,9,14,29,8,2016,7,1
Group 3,BB,-0.5,9,14,30,8,2016,7,1
Group 3,BB,-0.5,9,14,31,8,2016,7,1
Group 3,BB,-0.5,9,14,32,9,2016,9,0
Group 3,BB,-0.5,9,14,33,10,2016,12,-2
Group 3,BB,-0.5,9,14,34,11,2016,7,4
Group 3,BB,-0.5,9,14,35,11,2016,9,2
Group 3,BB,-0.5,9,14,36,9,2016,8,1
Group 3,BB,-0.5,9,14,37,9,2016,8,1
Group 3,BB,-0.5,9,14,38,6,2016,13,-7
Group 3,BB,-0.5,9,14,39,11,2016,6,5
Group 3,BB,-0.5,9,14,40,10,2016,9,1
Group 3,BB,-0.5,9,14,41,4,2016,8,-4
Group 3,BB,-0.5,9,14,42,12,2016,9,3
Group 3,BB,-0.5,9,14,43,10,2016,8,2
Group 3,BB,-0.5,9,14,44,8,2016,10,-2
Group 3,BB,-0.5,9,14,45,12,2016,6,6
Group 3,BB,-0.5,9,14,46,8,2016,8,0
Group 3,BB,-0.5,9,14,47,8,2016,9,-1
Group 3,BB,-0.5,9,14,48,10,2016,5,5
Group 3,BB,-0.5,9,14,49,10,2016,5,5
Group 3,BB,-0.5,9,14,50,7,2016,6,1
Group 3,BB,-0.5,9,14,51,4,2016,8,-4
Group 3,BB,-0.5,9,14,52,7,2016,7,0
Group 3,BB,-0.5,9,14,53,7,2016,6,1
Group 3,BB,-0.5,9,14,54,4,2016,10,-6
Group 3,BB,-0.5,9,14,55,11,2016,5,6
Group 3,BB,-0.5,9,14,56,7,2016,9,-2
Group 3,BB,-0.5,9,14,57,8,2016,6,2
Group 3,BB,-0.5,9,14,58,7,2016,7,0
Group 3,BB,-0.5,9,14,59,6,2016,12,-6
Group 3,BB,-0.5,9,14,60,8,2016,8,0
Group 3,BB,-0.5,9,14,61,11,2016,10,1
Group 3,BB,-0.5,9,14,62,11,2016,5,6
Group 3,BB,-0.5,9,14,63,12,2016,8,4
Group 3,BB,-0.5,9,14,64,8,2016,11,-3
Group 3,BB,-0.5,9,14,65,10,2016,8,2
Group 3,BB,-0.5,9,14,66,12,2016,6,6
Group 3,BB,-0.5,9,14,67,6,2016,8,-2
Group 3,BB,-0.5,9,14,68,8,2016,4,4
Group 3,BB,-0.5,9,14,69,11,2016,6,5
Group 3,BB,-0.5,9,14,70,7,2016,9,-2
Group 3,BB,-0.5,9,14,71,10,2016,9,1
Group 3,BB,-0.5,9,14,72,8,2016,9,-1
Group 3,BB,-0.5,9,14,73,9,2016,4,5
Group 3,BB,-0.5,9,14,74,7,2016,4,3
Group 3,BB,-0.5,9,14,75,7,2016,9,-2
Group 3,BB,-0.5,9,14,76,14,2016,8,6
Group 3,BB,-0.5,9,14,77,7,2016,8,-1
Group 3,BB,-0.5,9,14,78,6,2016,10,-4
Group 3,BB,-0.5,9,14,79,5,2016,8,-3
Group 3,BB,-0.5,9,14,80,7,2016,9,-2
Group 3,BB,-0.5,9,14,81,10,2016,12,-2
Group 3,BB,-0.5,9,14,82,6,2016,7,-1
Group 3,BB,-0.5,9,14,83,8,2016,8,0
Group 3,BB,-0.5,9,14,84,11,2016,10,1
Group 3,BB,-0.5,9,14,85,10,2016,6,4
Group 3,BB,-0.5,9,14,86,7,2016,9,-2
Group 3,BB,-0.5,9,14,87,11,2016,8,3
Group 3,BB,-0.5,9,14,88,5,2016,7,-2
Group 3,BB,-0.5,9,14,89,10,2016,8,2
Group 3,BB,-0.5,9,14,90,9,2016,10,-1
Group 3,BB,-0.5,9,14,91,8,2016,5,3
Group 3,BB,-0.5,9,14,92,10,2016,7,3
Group 3,BB,-0.5,9,14,93,7,2016,8,-1
Group 3,BB,-0.5,9,14,94,9,2016,9,0
Group 3,BB,-0.5,9,14,95,10,2016,5,5
Group 3,BB,-0.5,9,14,96,11,2016,7,4
Group 3,BB,-0.5,9,14,97,10,2016,7,3
Group 3,BB,-0.5,9,14,98,12,2016,7,5
Group 3,BB,-0.5,9,14,99,10,2016,7,3
Group 3,BB,-0.5,9,14,100,10,2016,11,-1
Group 3,BB,-0.5,9,14,101,14,2016,10,4
Group 3,BB,-0.5,9,14,102,8,2016,9,-1
Group 3,BB,-0.5,9,14,103,8,2016,7,1
Group 3,BB,-0.5,9,14,104,13,2016,9,4
Group 3,BB,-0.5,9,14,105,9,2016,11,-2
Group 3,BB,-0.5,9,14,106,9,2016,8,1
Group 3,BB,-0.5,9,14,107,7,2016,8,-1
Group 3,BB,-0.5,9,14,108,6,2016,9,-3
Group 3,BB,-0.5,9,14,109,11,2016,9,2
Group 3,BB,-0.5,9,14,110,6,2016,9,-3
Group 3,BB,-0.5,9,14,111,9,2016,5,4
Group 3,BB,-0.5,9,14,112,11,2016,7,4
Group 3,BB,-0.5,9,14,113,6,2016,10,-4
Group 3,BB,-0.5,9,14,114,7,2016,9,-2
Group 3,BB,-0.5,9,14,115,6,2016,6,0
Group 3,BB,-0.5,9,14,116,7,2016,7,0
Group 3,BB,-0.5,9,14,117,8,2016,6,2
Group 3,BB,-0.5,9,14,118,7,2016,10,-3
Group 3,BB,-0.5,9,14,119,9,2016,7,2
Group 3,BB,-0.5,9,14,120,8,2016,6,2
Group 3,BB,-0.5,9,14,121,10,2016,7,3
Group 3,BB,-0.5,9,14,122,8,2016,10,-2
Group 3,BB,-0.5,9,14,123,8,2016,8,0
Group 3,BB,-0.5,9,14,124,13,2016,6,7
Group 3,BB,-0.5,9,14,125,8,2016,11,-3
Group 3,BB,-0.5,9,14,126,11,2016,6,5
Group 3,BB,-0.5,9,14,127,10,2016,8,2
Group 3,BB,-0.5,9,14,128,11,2016,9,2
Group 3,BB,-0.5,9,14,129,6,2016,9,-3
Group 3,BB,-0.5,9,14,130,10,2016,9,1
Group 3,BB,-0.5,9,14,131,8,2016,8,0
Group 3,BB,-0.5,9,14,132,10,2016,8,2
Group 3,BB,-0.5,9,14,133,11,2016,3,8
Group 3,BB,-0.5,9,14,134,11,2016,9,2
Group 3,BB,-0.5,9,14,135,9,2016,10,-1
Group 3,BB,-0.5,9,14,136,8,2016,12,-4
Group 3,BB,-0.5,9,14,137,10,2016,11,-1
Group 3,BB,-0.5,9,14,138,10,2016,11,-1
Group 3,BB,-0.5,9,14,139,7,2016,12,-5
Group 3,BB,-0.5,9,14,140,11,2016,3,8
Group 3,BB,-0.5,9,14,141,7,2016,12,-5
Group 3,BB,-0.5,9,14,142,12,2016,9,3
Group 3,BB,-0.5,9,14,143,10,2016,5,5
Group 3,BB,-0.5,9,14,144,9,2016,9,0
Group 3,BB,-0.5,9,14,145,10,2016,8,2
Group 3,BB,-0.5,9,14,146,12,2016,7,5
Group 3,BB,-0.5,9,14,147,7,2016,8,-1
Group 3,BB,-0.5,9,14,148,9,2016,7,2
Group 3,BB,-0.5,9,14,149,9,2016,11,-2
Group 3,BB,-0.5,9,14,150,9,2016,11,-2
Group 3,BB,-0.5,9,14,151,9,2016,8,1
Group 3,BB,-0.5,9,14,152,4,2016,7,-3
Group 3,BB,-0.5,9,14,153,10,2016,13,-3
Group 3,BB,-0.5,9,14,154,6,2016,6,0
Group 3,BB,-0.5,9,14,155,6,2016,8,-2
Group 3,BB,-0.5,9,14,156,12,2016,7,5
Group 3,BB,-0.5,9,14,157,10,2016,4,6
Group 3,BB,-0.5,9,14,158,9,2016,6,3
Group 3,BB,-0.5,9,14,159,8,2016,9,-1
Group 3,BB,-0.5,9,14,160,12,2016,9,3
Group 3,BB,-0.5,9,14,161,7,2016,8,-1
Group 3,BB,-0.5,9,14,162,3,2016,7,-4
Group 3,BB,-0.5,9,14,163,7,2016,7,0
Group 3,BB,-0.5,9,14,164,9,2016,5,4
Group 3,BB,-0.5,9,14,165,9,2016,9,0
Group 3,BB,-0.5,9,14,166,6,2016,8,-2
Group 3,BB,-0.5,9,14,167,10,2016,8,2
Group 3,BB,-0.5,9,14,168,7,2016,6,1
Group 3,BB,-0.5,9,14,169,9,2016,6,3
Group 3,BB,-0.5,9,14,170,10,2016,8,2
Group 3,BB,-0.5,9,14,171,12,2016,14,-2
Group 3,BB,-0.5,9,14,172,12,2016,9,3
Group 3,BB,-0.5,9,14,173,9,2016,8,1
Group 3,BB,-0.5,9,14,174,7,2016,9,-2
Group 3,BB,-0.5,9,14,175,9,2016,8,1
Group 3,BB,-0.5,9,14,176,10,2016,12,-2
Group 3,BB,-0.5,9,14,177,9,2016,11,-2
Group 3,BB,-0.5,9,14,178,8,2016,10,-2
Group 3,BB,-0.5,9,14,179,11,2016,3,8
Group 3,BB,-0.5,9,14,180,6,2016,5,1
Group 3,BB,-0.5,9,14,181,8,2016,6,2
Group 3,BB,-0.5,9,14,182,7,2016,9,-2
Group 3,BB,-0.5,9,14,183,7,2016,8,-1
Group 3,BB,-0.5,9,14,184,8,2016,8,0
Group 3,BB,-0.5,9,14,185,7,2016,11,-4
Group 3,BB,-0.5,9,14,186,12,2016,8,4
Group 3,BB,-0.5,9,14,187,8,2016,6,2
Group 3,BB,-0.5,9,14,188,8,2016,9,-1
Group 3,BB,-0.5,9,14,189,10,2016,8,2
Group 3,BB,-0.5,9,14,190,12,2016,10,2
Group 3,BB,-0.5,9,14,191,7,2016,5,2
Group 3,BB,-0.5,9,14,192,12,2016,6,6
Group 3,BB,-0.5,9,14,193,5,2016,9,-4
Group 3,BB,-0.5,9,14,194,9,2016,11,-2
Group 3,BB,-0.5,9,14,195,9,2016,5,4
Group 3,BB,-0.5,9,14,196,9,2016,5,4
Group 3,BB,-0.5,9,14,197,13,2016,7,6
Group 3,BB,-0.5,9,14,198,9,2016,5,4
Group 3,BB,-0.5,9,14,199,8,2016,5,3
Group 3,BB,-0.5,9,14,200,7,2016,9,-2
Group 3,BB,-0.5,9,14,201,9,2016,8,1
Group 3,BB,-0.5,9,14,202,9,2016,6,3
Group 3,BB,-0.5,9,14,203,12,2016,12,0
Group 3,BB,-0.5,9,14,204,9,2016,5,4
Group 3,BB,-0.5,9,14,205,12,2016,9,3
Group 3,BB,-0.5,9,14,206,7,2016,4,3
Group 3,BB,-0.5,9,14,207,12,2016,9,3
Group 3,BB,-0.5,9,14,208,12,2016,3,9
Group 3,BB,-0.5,9,14,209,11,2016,8,3
Group 3,BB,-0.5,9,14,210,7,2016,8,-1
Group 3,BB,-0.5,9,14,211,8,2016,10,-2
Group 3,BB,-0.5,9,14,212,10,2016,10,0
Group 3,BB,-0.5,9,14,213,5,2016,6,-1
Group 3,BB,-0.5,9,14,214,8,2016,13,-5
Group 3,BB,-0.5,9,14,215,8,2016,12,-4
Group 3,BB,-0.5,9,14,216,8,2016,5,3
Group 3,BB,-0.5,9,14,217,8,2016,9,-1
Group 3,BB,-0.5,9,14,218,8,2016,7,1
Group 3,BB,-0.5,9,14,219,11,2016,10,1
Group 3,BB,-0.5,9,14,220,9,2016,6,3
Group 3,BB,-0.5,9,14,221,12,2016,5,7
Group 3,BB,-0.5,9,14,222,10,2016,11,-1
Group 3,BB,-0.5,9,14,223,6,2016,6,0
Group 3,BB,-0.5,9,14,224,10,2016,9,1
Group 3,BB,-0.5,9,14,225,9,2016,10,-1
Group 3,BB,-0.5,9,14,226,10,2016,8,2
Group 3,BB,-0.5,9,14,227,8,2016,11,-3
Group 3,BB,-0.5,9,14,228,9,2016,6,3
Group 3,BB,-0.5,9,14,229,13,2016,10,3
Group 3,BB,-0.5,9,14,230,11,2016,9,2
Group 3,BB,-0.5,9,14,231,12,2016,9,3
Group 3,BB,-0.5,9,14,232,12,2016,11,1
Group 3,BB,-0.5,9,14,233,8,2016,4,4
Group 3,BB,-0.5,9,14,234,9,2016,10,-1
Group 3,BB,-0.5,9,14,235,9,2016,9,0
Group 3,BB,-0.5,9,14,236,10,2016,6,4
Group 3,BB,-0.5,9,14,237,12,2016,8,4
Group 3,BB,-0.5,9,14,238,10,2016,10,0
Group 3,BB,-0.5,9,14,239,8,2016,9,-1
Group 3,BB,-0.5,9,14,240,8,2016,7,1
Group 3,BB,-0.5,9,14,241,9,2016,6,3
Group 3,BB,-0.5,9,14,242,8,2016,12,-4
Group 3,BB,-0.5,9,14,243,12,2016,8,4
Group 3,BB,-0.5,9,14,244,9,2016,5,4
Group 3,BB,-0.5,9,14,245,8,2016,5,3
Group 3,BB,-0.5,9,14,246,10,2016,6,4
Group 3,BB,-0.5,9,14,247,8,2016,12,-4
Group 3,BB,-0.5,9,14,248,9,2016,6,3
Group 3,BB,-0.5,9,14,249,7,2016,11,-4
Group 3,BB,-0.5,9,14,250,9,2016,8,1
Group 3,BB,-0.5,9,14,251,11,2016,10,1
Group 3,BB,-0.5,9,14,252,13,2016,9,4
Group 3,BB,-0.5,9,14,253,12,2016,8,4
Group 3,BB,-0.5,9,14,254,8,2016,10,-2
Group 3,BB,-0.5,9,14,255,5,2016,8,-3
Group 3,BB,-0.5,9,14,256,6,2016,8,-2
Group 3,BB,-0.5,9,14,257,12,2016,5,7
Group 3,BB,-0.5,9,14,258,8,2016,10,-2
Group 3,BB,-0.5,9,14,259,7,2016,9,-2
Group 3,BB,-0.5,9,14,260,8,2016,8,0
Group 3,BB,-0.5,9,14,261,8,2016,9,-1
Group 3,BB,-0.5,9,14,262,10,2016,10,0
Group 3,BB,-0.5,9,14,263,9,2016,9,0
Group 3,BB,-0.5,9,14,264,12,2016,4,8
Group 3,BB,-0.5,9,14,265,8,2016,10,-2
Group 3,BB,-0.5,9,14,266,7,2016,6,1
Group 3,BB,-0.5,9,14,267,5,2016,8,-3
Group 3,BB,-0.5,9,14,268,12,2016,10,2
Group 3,BB,-0.5,9,14,269,7,2016,10,-3
Group 3,BB,-0.5,9,14,270,12,2016,7,5
Group 3,BB,-0.5,9,14,271,13,2016,10,3
Group 3,BB,-0.5,9,14,272,10,2016,8,2
Group 3,BB,-0.5,9,14,273,12,2016,9,3
Group 3,BB,-0.5,9,14,274,11,2016,8,3
Group 3,BB,-0.5,9,14,275,7,2016,11,-4
Group 3,BB,-0.5,9,14,276,5,2016,10,-5
Group 3,BB,-0.5,9,14,277,7,2016,8,-1
Group 3,BB,-0.5,9,14,278,11,2016,6,5
Group 3,BB,-0.5,9,14,279,11,2016,11,0
Group 3,BB,-0.5,9,14,280,11,2016,9,2
Group 3,BB,-0.5,9,14,281,6,2016,8,-2
Group 3,BB,-0.5,9,14,282,12,2016,11,1
Group 3,BB,-0.5,9,14,283,5,2016,9,-4
Group 3,BB,-0.5,9,14,284,9,2016,6,3
Group 3,BB,-0.5,9,14,285,9,2016,9,0
Group 3,BB,-0.5,9,14,286,11,2016,11,0
Group 3,BB,-0.5,9,14,287,8,2016,9,-1
Group 3,BB,-0.5,9,14,288,9,2016,11,-2
Group 3,BB,-0.5,9,14,289,8,2016,9,-1
Group 3,BB,-0.5,9,14,290,12,2016,6,6
Group 3,BB,-0.5,9,14,291,10,2016,11,-1
Group 3,BB,-0.5,9,14,292,9,2016,9,0
Group 3,BB,-0.5,9,14,293,7,2016,9,-2
Group 3,BB,-0.5,9,14,294,9,2016,8,1
Group 3,BB,-0.5,9,14,295,11,2016,6,5
Group 3,BB,-0.5,9,14,296,11,2016,10,1
Group 3,BB,-0.5,9,14,297,12,2016,9,3
Group 3,BB,-0.5,9,14,298,10,2016,10,0
Group 3,BB,-0.5,9,14,299,8,2016,6,2
Group 3,BB,-0.5,9,14,300,10,2016,6,4
Group 3,BB,-0.5,9,14,301,9,2016,9,0
Group 3,BB,-0.5,9,14,302,11,2016,10,1
Group 3,BB,-0.5,9,14,303,12,2016,8,4
Group 3,BB,-0.5,9,14,304,11,2016,11,0
Group 3,BB,-0.5,9,14,305,7,2016,13,-6
Group 3,BB,-0.5,9,14,306,6,2016,12,-6
Group 3,BB,-0.5,9,14,307,12,2016,9,3
Group 3,BB,-0.5,9,14,308,6,2016,12,-6
Group 3,BB,-0.5,9,14,309,11,2016,4,7
Group 3,BB,-0.5,9,14,310,11,2016,12,-1
Group 3,BB,-0.5,9,14,311,10,2016,7,3
Group 3,BB,-0.5,9,14,312,12,2016,6,6
Group 3,BB,-0.5,9,14,313,11,2016,10,1
Group 3,BB,-0.5,9,14,314,8,2016,12,-4
Group 3,BB,-0.5,9,14,315,14,2016,12,2
Group 3,BB,-0.5,9,14,316,13,2016,10,3
Group 3,BB,-0.5,9,14,317,12,2016,11,1
Group 3,BB,-0.5,9,14,318,7,2016,7,0
Group 3,BB,-0.5,9,14,319,7,2016,7,0
Group 3,BB,-0.5,9,14,320,9,2016,11,-2
Group 3,BB,-0.5,9,14,321,11,2016,8,3
Group 3,BB,-0.5,9,14,322,7,2016,13,-6
Group 3,BB,-0.5,9,14,323,11,2016,9,2
Group 3,BB,-0.5,9,14,324,13,2016,6,7
Group 3,BB,-0.5,9,14,325,5,2016,8,-3
Group 3,BB,-0.5,9,14,326,10,2016,6,4
Group 3,BB,-0.5,9,14,327,12,2016,9,3
Group 3,BB,-0.5,9,14,328,5,2016,11,-6
Group 3,BB,-0.5,9,14,329,9,2016,8,1
Group 3,BB,-0.5,9,14,330,10,2016,9,1
Group 3,BB,-0.5,9,14,331,6,2016,10,-4
Group 3,BB,-0.5,9,14,332,8,2016,9,-1
Group 3,BB,-0.5,9,14,333,12,2016,10,2
Group 3,BB,-0.5,9,14,334,10,2016,6,4
Group 3,BB,-0.5,9,14,335,8,2016,9,-1
Group 3,BB,-0.5,9,14,336,9,2016,7,2
Group 3,BB,-0.5,9,14,337,12,2016,5,7
Group 3,BB,-0.5,9,14,338,13,2016,6,7
Group 3,BB,-0.5,9,14,339,11,2016,5,6
Group 3,BB,-0.5,9,14,340,11,2016,12,-1
Group 3,BB,-0.5,9,14,341,8,2016,12,-4
Group 3,BB,-0.5,9,14,342,8,2016,11,-3
Group 3,BB,-0.5,9,14,343,9,2016,9,0
Group 3,BB,-0.5,9,14,344,12,2016,4,8
Group 3,BB,-0.5,9,14,345,5,2016,9,-4
Group 3,BB,-0.5,9,14,346,5,2016,10,-5
Group 3,BB,-0.5,9,14,347,5,2016,5,0
Group 3,BB,-0.5,9,14,348,8,2016,4,4
Group 3,BB,-0.5,9,14,349,11,2016,9,2
Group 3,BB,-0.5,9,14,350,9,2016,9,0
Group 3,BB,-0.5,9,14,351,8,2016,11,-3
Group 3,BB,-0.5,9,14,352,9,2016,7,2
Group 3,BB,-0.5,9,14,353,12,2016,9,3
Group 3,BB,-0.5,9,14,354,11,2016,6,5
Group 3,BB,-0.5,9,14,355,8,2016,11,-3
Group 3,BB,-0.5,9,14,356,7,2016,4,3
Group 3,BB,-0.5,9,14,357,9,2016,11,-2
Group 3,BB,-0.5,9,14,358,11,2016,13,-2
Group 3,BB,-0.5,9,14,359,9,2016,9,0
Group 3,BB,-0.5,9,14,360,8,2016,6,2
Group 3,BB,-0.5,9,14,361,11,2016,6,5
Group 3,BB,-0.5,9,14,362,9,2016,9,0
Group 3,BB,-0.5,9,14,363,12,2016,9,3
Group 3,BB,-0.5,9,14,364,11,2016,7,4
Group 3,BB,-0.5,9,14,365,12,2016,8,4
Group 3,BB,-0.5,9,14,366,6,2016,6,0
Group 3,BB,-0.5,9,14,367,6,2016,7,-1
Group 3,BB,-0.5,9,14,368,10,2016,9,1
Group 3,BB,-0.5,9,14,369,12,2016,7,5
Group 3,BB,-0.5,9,14,370,10,2016,7,3
Group 3,BB,-0.5,9,14,371,3,2016,10,-7
Group 3,BB,-0.5,9,14,372,11,2016,9,2
Group 3,BB,-0.5,9,14,373,10,2016,11,-1
Group 3,BB,-0.5,9,14,374,6,2016,7,-1
Group 3,BB,-0.5,9,14,375,9,2016,9,0
Group 3,BB,-0.5,9,14,376,9,2016,6,3
Group 3,BB,-0.5,9,14,377,8,2016,10,-2
Group 3,BB,-0.5,9,14,378,9,2016,9,0
Group 3,BB,-0.5,9,14,379,8,2016,9,-1
Group 3,BB,-0.5,9,14,380,10,2016,8,2
Group 3,BB,-0.5,9,14,381,8,2016,11,-3
Group 3,BB,-0.5,9,14,382,8,2016,4,4
Group 3,BB,-0.5,9,14,383,7,2016,7,0
Group 3,BB,-0.5,9,14,384,8,2016,9,-1
Group 3,BB,-0.5,9,14,385,9,2016,8,1
Group 3,BB,-0.5,9,14,386,7,2016,11,-4
Group 3,BB,-0.5,9,14,387,11,2016,9,2
Group 3,BB,-0.5,9,14,388,7,2016,10,-3
Group 3,BB,-0.5,9,14,389,12,2016,9,3
Group 3,BB,-0.5,9,14,390,6,2016,7,-1
Group 3,BB,-0.5,9,14,391,5,2016,3,2
Group 3,BB,-0.5,9,14,392,12,2016,9,3
Group 3,BB,-0.5,9,14,393,7,2016,11,-4
Group 3,BB,-0.5,9,14,394,12,2016,6,6
Group 3,BB,-0.5,9,14,395,10,2016,11,-1
Group 3,BB,-0.5,9,14,396,2,2016,6,-4
Group 3,BB,-0.5,9,14,397,9,2016,11,-2
Group 3,BB,-0.5,9,14,398,14,2016,7,7
Group 3,BB,-0.5,9,14,399,12,2016,8,4
Group 3,BB,-0.5,9,14,400,10,2016,2,8
Group 3,BB,-0.5,9,14,401,10,2016,6,4
Group 3,BB,-0.5,9,14,402,14,2016,10,4
Group 3,BB,-0.5,9,14,403,9,2016,7,2
Group 3,BB,-0.5,9,14,404,8,2016,6,2
Group 3,BB,-0.5,9,14,405,9,2016,8,1
Group 3,BB,-0.5,9,14,406,11,2016,8,3
Group 3,BB,-0.5,9,14,407,11,2016,5,6
Group 3,BB,-0.5,9,14,408,10,2016,4,6
Group 3,BB,-0.5,9,14,409,11,2016,11,0
Group 3,BB,-0.5,9,14,410,10,2016,7,3
Group 3,BB,-0.5,9,14,411,11,2016,12,-1
Group 3,BB,-0.5,9,14,412,8,2016,11,-3
Group 3,BB,-0.5,9,14,413,7,2016,7,0
Group 3,BB,-0.5,9,14,414,12,2016,9,3
Group 3,BB,-0.5,9,14,415,11,2016,3,8
Group 3,BB,-0.5,9,14,416,5,2016,9,-4
Group 3,BB,-0.5,9,14,417,8,2016,6,2
Group 3,BB,-0.5,9,14,418,5,2016,10,-5
Group 3,BB,-0.5,9,14,419,10,2016,4,6
Group 3,BB,-0.5,9,14,420,11,2016,5,6
Group 3,BB,-0.5,9,14,421,4,2016,9,-5
Group 3,BB,-0.5,9,14,422,8,2016,7,1
Group 3,BB,-0.5,9,14,423,4,2016,3,1
Group 3,BB,-0.5,9,14,424,12,2016,7,5
Group 3,BB,-0.5,9,14,425,7,2016,6,1
Group 3,BB,-0.5,9,14,426,8,2016,6,2
Group 3,BB,-0.5,9,14,427,6,2016,7,-1
Group 3,BB,-0.5,9,14,428,9,2016,9,0
Group 3,BB,-0.5,9,14,429,10,2016,9,1
Group 3,BB,-0.5,9,14,430,8,2016,6,2
Group 3,BB,-0.5,9,14,431,11,2016,9,2
Group 3,BB,-0.5,9,14,432,8,2016,12,-4
Group 3,BB,-0.5,9,14,433,10,2016,5,5
Group 3,BB,-0.5,9,14,434,9,2016,6,3
Group 3,BB,-0.5,9,14,435,7,2016,8,-1
Group 3,BB,-0.5,9,14,436,12,2016,8,4
Group 3,BB,-0.5,9,14,437,8,2016,10,-2
Group 3,BB,-0.5,9,14,438,11,2016,7,4
Group 3,BB,-0.5,9,14,439,12,2016,11,1
Group 3,BB,-0.5,9,14,440,8,2016,6,2
Group 3,BB,-0.5,9,14,441,11,2016,10,1
Group 3,BB,-0.5,9,14,442,13,2016,9,4
Group 3,BB,-0.5,9,14,443,7,2016,7,0
Group 3,BB,-0.5,9,14,444,10,2016,8,2
Group 3,BB,-0.5,9,14,445,6,2016,10,-4
Group 3,BB,-0.5,9,14,446,11,2016,4,7
Group 3,BB,-0.5,9,14,447,10,2016,10,0
Group 3,BB,-0.5,9,14,448,9,2016,10,-1
Group 3,BB,-0.5,9,14,449,9,2016,12,-3
Group 3,BB,-0.5,9,14,450,10,2016,10,0
Group 3,BB,-0.5,9,14,451,10,2016,8,2
Group 3,BB,-0.5,9,14,452,9,2016,3,6
Group 3,BB,-0.5,9,14,453,11,2016,12,-1
Group 3,BB,-0.5,9,14,454,10,2016,7,3
Group 3,BB,-0.5,9,14,455,9,2016,5,4
Group 3,BB,-0.5,9,14,456,9,2016,9,0
Group 3,BB,-0.5,9,14,457,9,2016,8,1
Group 3,BB,-0.5,9,14,458,8,2016,8,0
Group 3,BB,-0.5,9,14,459,10,2016,10,0
Group 3,BB,-0.5,9,14,460,9,2016,8,1
Group 3,BB,-0.5,9,14,461,8,2016,10,-2
Group 3,BB,-0.5,9,14,462,12,2016,10,2
Group 3,BB,-0.5,9,14,463,8,2016,9,-1
Group 3,BB,-0.5,9,14,464,8,2016,7,1
Group 3,BB,-0.5,9,14,465,12,2016,5,7
Group 3,BB,-0.5,9,14,466,5,2016,5,0
Group 3,BB,-0.5,9,14,467,12,2016,11,1
Group 3,BB,-0.5,9,14,468,3,2016,7,-4
Group 3,BB,-0.5,9,14,469,11,2016,12,-1
Group 3,BB,-0.5,9,14,470,10,2016,10,0
Group 3,BB,-0.5,9,14,471,11,2016,5,6
Group 3,BB,-0.5,9,14,472,12,2016,7,5
Group 3,BB,-0.5,9,14,473,7,2016,8,-1
Group 3,BB,-0.5,9,14,474,10,2016,7,3
Group 3,BB,-0.5,9,14,475,10,2016,9,1
Group 3,BB,-0.5,9,14,476,7,2016,9,-2
Group 3,BB,-0.5,9,14,477,7,2016,11,-4
Group 3,BB,-0.5,9,14,478,10,2016,10,0
Group 3,BB,-0.5,9,14,479,8,2016,9,-1
Group 3,BB,-0.5,9,14,480,10,2016,8,2
Group 3,BB,-0.5,9,14,481,12,2016,8,4
Group 3,BB,-0.5,9,14,482,10,2016,9,1
Group 3,BB,-0.5,9,14,483,9,2016,10,-1
Group 3,BB,-0.5,9,14,484,10,2016,9,1
Group 3,BB,-0.5,9,14,485,7,2016,12,-5
Group 3,BB,-0.5,9,14,486,9,2016,5,4
Group 3,BB,-0.5,9,14,487,7,2016,7,0
Group 3,BB,-0.5,9,14,488,7,2016,8,-1
Group 3,BB,-0.5,9,14,489,9,2016,7,2
Group 3,BB,-0.5,9,14,490,7,2016,5,2
Group 3,BB,-0.5,9,14,491,9,2016,11,-2
Group 3,BB,-0.5,9,14,492,6,2016,8,-2
Group 3,BB,-0.5,9,14,493,10,2016,9,1
Group 3,BB,-0.5,9,14,494,9,2016,9,0
Group 3,BB,-0.5,9,14,495,6,2016,8,-2
Group 3,BB,-0.5,9,14,496,11,2016,9,2
Group 3,BB,-0.5,9,14,497,6,2016,6,0
Group 3,BB,-0.5,9,14,498,12,2016,9,3
Group 3,BB,-0.5,9,14,499,13,2016,9,4
Group 3,BB,-0.5,9,14,500,11,2016,7,4
Group 3,BB,-0.5,9,14,501,13,2016,4,9
Group 3,BB,-0.5,9,14,502,9,2016,4,5
Group 3,BB,-0.5,9,14,503,11,2016,11,0
Group 3,BB,-0.5,9,14,504,10,2016,5,5
Group 3,BB,-0.5,9,14,505,6,2016,5,1
Group 3,BB,-0.5,9,14,506,10,2016,7,3
Group 3,BB,-0.5,9,14,507,9,2016,11,-2
Group 3,BB,-0.5,9,14,508,7,2016,11,-4
Group 3,BB,-0.5,9,14,509,6,2016,9,-3
Group 3,BB,-0.5,9,14,510,9,2016,8,1
Group 3,BB,-0.5,9,14,511,11,2016,6,5
Group 3,BB,-0.5,9,14,512,10,2016,11,-1
Group 3,BB,-0.5,9,14,513,4,2016,8,-4
Group 3,BB,-0.5,9,14,514,11,2016,9,2
Group 3,BB,-0.5,9,14,515,12,2016,8,4
Group 3,BB,-0.5,9,14,516,6,2016,6,0
Group 3,BB,-0.5,9,14,517,8,2016,5,3
Group 3,BB,-0.5,9,14,518,10,2016,8,2
Group 3,BB,-0.5,9,14,519,12,2016,8,4
Group 3,BB,-0.5,9,14,520,12,2016,5,7
Group 3,BB,-0.5,9,14,521,9,2016,8,1
Group 3,BB,-0.5,9,14,522,10,2016,6,4
Group 3,BB,-0.5,9,14,523,10,2016,9,1
Group 3,BB,-0.5,9,14,524,8,2016,10,-2
Group 3,BB,-0.5,9,14,525,6,2016,11,-5
Group 3,BB,-0.5,9,14,526,11,2016,10,1
Group 3,BB,-0.5,9,14,527,8,2016,7,1
Group 3,BB,-0.5,9,14,528,9,2016,9,0
Group 3,BB,-0.5,9,14,529,10,2016,8,2
Group 3,BB,-0.5,9,14,530,10,2016,9,1
Group 3,BB,-0.5,9,14,531,10,2016,8,2
Group 3,BB,-0.5,9,14,532,7,2016,12,-5
Group 3,BB,-0.5,9,14,533,6,2016,9,-3
Group 3,BB,-0.5,9,14,534,9,2016,8,1
Group 3,BB,-0.5,9,14,535,7,2016,11,-4
Group 3,BB,-0.5,9,14,536,12,2016,7,5
Group 3,BB,-0.5,9,14,537,11,2016,10,1
Group 3,BB,-0.5,9,14,538,11,2016,11,0
Group 3,BB,-0.5,9,14,539,7,2016,5,2
Group 3,BB,-0.5,9,14,540,12,2016,10,2
Group 3,BB,-0.5,9,14,541,6,2016,5,1
Group 3,BB,-0.5,9,14,542,6,2016,7,-1
Group 3,BB,-0.5,9,14,543,8,2016,8,0
Group 3,BB,-0.5,9,14,544,9,2016,8,1
Group 3,BB,-0.5,9,14,545,9,2016,7,2
Group 3,BB,-0.5,9,14,546,12,2016,4,8
Group 3,BB,-0.5,9,14,547,9,2016,6,3
Group 3,BB,-0.5,9,14,548,9,2016,6,3
Group 3,BB,-0.5,9,14,549,12,2016,9,3
Group 3,BB,-0.5,9,14,550,7,2016,9,-2
Group 3,BB,-0.5,9,14,551,10,2016,9,1
Group 3,BB,-0.5,9,14,552,7,2016,5,2
Group 3,BB,-0.5,9,14,553,8,2016,10,-2
Group 3,BB,-0.5,9,14,554,8,2016,10,-2
Group 3,BB,-0.5,9,14,555,7,2016,10,-3
Group 3,BB,-0.5,9,14,556,11,2016,6,5
Group 3,BB,-0.5,9,14,557,9,2016,10,-1
Group 3,BB,-0.5,9,14,558,5,2016,6,-1
Group 3,BB,-0.5,9,14,559,11,2016,8,3
Group 3,BB,-0.5,9,14,560,5,2016,9,-4
Group 3,BB,-0.5,9,14,561,8,2016,10,-2
Group 3,BB,-0.5,9,14,562,9,2016,5,4
Group 3,BB,-0.5,9,14,563,10,2016,10,0
Group 3,BB,-0.5,9,14,564,11,2016,11,0
Group 3,BB,-0.5,9,14,565,10,2016,12,-2
Group 3,BB,-0.5,9,14,566,9,2016,8,1
Group 3,BB,-0.5,9,14,567,9,2016,5,4
Group 3,BB,-0.5,9,14,568,11,2016,8,3
Group 3,BB,-0.5,9,14,569,11,2016,13,-2
Group 3,BB,-0.5,9,14,570,9,2016,8,1
Group 3,BB,-0.5,9,14,571,9,2016,6,3
Group 3,BB,-0.5,9,14,572,12,2016,12,0
Group 3,BB,-0.5,9,14,573,9,2016,7,2
Group 3,BB,-0.5,9,14,574,10,2016,7,3
Group 3,BB,-0.5,9,14,575,11,2016,10,1
Group 3,BB,-0.5,9,14,576,5,2016,7,-2
Group 3,BB,-0.5,9,14,577,6,2016,10,-4
Group 3,BB,-0.5,9,14,578,13,2016,8,5
Group 3,BB,-0.5,9,14,579,7,2016,12,-5
Group 3,BB,-0.5,9,14,580,9,2016,7,2
Group 3,BB,-0.5,9,14,581,11,2016,5,6
Group 3,BB,-0.5,9,14,582,10,2016,4,6
Group 3,BB,-0.5,9,14,583,6,2016,10,-4
Group 3,BB,-0.5,9,14,584,8,2016,5,3
Group 3,BB,-0.5,9,14,585,8,2016,11,-3
Group 3,BB,-0.5,9,14,586,6,2016,10,-4
Group 3,BB,-0.5,9,14,587,5,2016,10,-5
Group 3,BB,-0.5,9,14,588,6,2016,7,-1
Group 3,BB,-0.5,9,14,589,9,2016,9,0
Group 3,BB,-0.5,9,14,590,11,2016,8,3
Group 3,BB,-0.5,9,14,591,11,2016,10,1
Group 3,BB,-0.5,9,14,592,11,2016,11,0
Group 3,BB,-0.5,9,14,593,7,2016,12,-5
Group 3,BB,-0.5,9,14,594,10,2016,8,2
Group 3,BB,-0.5,9,14,595,11,2016,9,2
Group 3,BB,-0.5,9,14,596,11,2016,8,3
Group 3,BB,-0.5,9,14,597,4,2016,6,-2
Group 3,BB,-0.5,9,14,598,9,2016,6,3
Group 3,BB,-0.5,9,14,599,7,2016,10,-3
Group 3,BB,-0.5,9,14,600,12,2016,7,5
Group 3,BB,-0.5,9,14,601,8,2016,9,-1
Group 3,BB,-0.5,9,14,602,7,2016,9,-2
Group 3,BB,-0.5,9,14,603,12,2016,9,3
Group 3,BB,-0.5,9,14,604,8,2016,9,-1
Group 3,BB,-0.5,9,14,605,7,2016,8,-1
Group 3,BB,-0.5,9,14,606,7,2016,9,-2
Group 3,BB,-0.5,9,14,607,8,2016,4,4
Group 3,BB,-0.5,9,14,608,8,2016,5,3
Group 3,BB,-0.5,9,14,609,12,2016,8,4
Group 3,BB,-0.5,9,14,610,12,2016,8,4
Group 3,BB,-0.5,9,14,611,10,2016,7,3
Group 3,BB,-0.5,9,14,612,10,2016,8,2
Group 3,BB,-0.5,9,14,613,10,2016,9,1
Group 3,BB,-0.5,9,14,614,9,2016,10,-1
Group 3,BB,-0.5,9,14,615,9,2016,5,4
Group 3,BB,-0.5,9,14,616,8,2016,8,0
Group 3,BB,-0.5,9,14,617,9,2016,10,-1
Group 3,BB,-0.5,9,14,618,13,2016,8,5
Group 3,BB,-0.5,9,14,619,5,2016,10,-5
Group 3,BB,-0.5,9,14,620,9,2016,8,1
Group 3,BB,-0.5,9,14,621,5,2016,7,-2
Group 3,BB,-0.5,9,14,622,5,2016,3,2
Group 3,BB,-0.5,9,14,623,11,2016,4,7
Group 3,BB,-0.5,9,14,624,8,2016,7,1
Group 3,BB,-0.5,9,14,625,11,2016,6,5
Group 3,BB,-0.5,9,14,626,9,2016,8,1
Group 3,BB,-0.5,9,14,627,7,2016,5,2
Group 3,BB,-0.5,9,14,628,12,2016,5,7
Group 3,BB,-0.5,9,14,629,8,2016,7,1
Group 3,BB,-0.5,9,14,630,10,2016,5,5
Group 3,BB,-0.5,9,14,631,7,2016,6,1
Group 3,BB,-0.5,9,14,632,9,2016,9,0
Group 3,BB,-0.5,9,14,633,9,2016,6,3
Group 3,BB,-0.5,9,14,634,11,2016,8,3
Group 3,BB,-0.5,9,14,635,7,2016,7,0
Group 3,BB,-0.5,9,14,636,7,2016,9,-2
Group 3,BB,-0.5,9,14,637,8,2016,10,-2
Group 3,BB,-0.5,9,14,638,13,2016,9,4
Group 3,BB,-0.5,9,14,639,8,2016,8,0
Group 3,BB,-0.5,9,14,640,7,2016,11,-4
Group 3,BB,-0.5,9,14,641,6,2016,9,-3
Group 3,BB,-0.5,9,14,642,8,2016,7,1
Group 3,BB,-0.5,9,14,643,7,2016,9,-2
Group 3,BB,-0.5,9,14,644,7,2016,8,-1
Group 3,BB,-0.5,9,14,645,8,2016,9,-1
Group 3,BB,-0.5,9,14,646,7,2016,10,-3
Group 3,BB,-0.5,9,14,647,5,2016,12,-7
Group 3,BB,-0.5,9,14,648,9,2016,12,-3
Group 3,BB,-0.5,9,14,649,11,2016,6,5
Group 3,BB,-0.5,9,14,650,8,2016,10,-2
Group 3,BB,-0.5,9,14,651,9,2016,9,0
Group 3,BB,-0.5,9,14,652,10,2016,6,4
Group 3,BB,-0.5,9,14,653,11,2016,7,4
Group 3,BB,-0.5,9,14,654,5,2016,9,-4
Group 3,BB,-0.5,9,14,655,6,2016,9,-3
Group 3,BB,-0.5,9,14,656,9,2016,7,2
Group 3,BB,-0.5,9,14,657,9,2016,6,3
Group 3,BB,-0.5,9,14,658,9,2016,6,3
Group 3,BB,-0.5,9,14,659,11,2016,11,0
Group 3,BB,-0.5,9,14,660,10,2016,6,4
Group 3,BB,-0.5,9,14,661,11,2016,10,1
Group 3,BB,-0.5,9,14,662,12,2016,3,9
Group 3,BB,-0.5,9,14,663,11,2016,7,4
Group 3,BB,-0.5,9,14,664,12,2016,7,5
Group 3,BB,-0.5,9,14,665,9,2016,5,4
Group 3,BB,-0.5,9,14,666,6,2016,9,-3
Group 3,BB,-0.5,9,14,667,10,2016,7,3
Group 3,BB,-0.5,9,14,668,9,2016,9,0
Group 3,BB,-0.5,9,14,669,10,2016,7,3
Group 3,BB,-0.5,9,14,670,10,2016,9,1
Group 3,BB,-0.5,9,14,671,9,2016,8,1
Group 3,BB,-0.5,9,14,672,8,2016,6,2
Group 3,BB,-0.5,9,14,673,10,2016,6,4
Group 3,BB,-0.5,9,14,674,5,2016,10,-5
Group 3,BB,-0.5,9,14,675,11,2016,9,2
Group 3,BB,-0.5,9,14,676,12,2016,5,7
Group 3,BB,-0.5,9,14,677,11,2016,9,2
Group 3,BB,-0.5,9,14,678,8,2016,8,0
Group 3,BB,-0.5,9,14,679,9,2016,7,2
Group 3,BB,-0.5,9,14,680,8,2016,10,-2
Group 3,BB,-0.5,9,14,681,9,2016,7,2
Group 3,BB,-0.5,9,14,682,6,2016,9,-3
Group 3,BB,-0.5,9,14,683,8,2016,7,1
Group 3,BB,-0.5,9,14,684,11,2016,4,7
Group 3,BB,-0.5,9,14,685,9,2016,7,2
Group 3,BB,-0.5,9,14,686,8,2016,11,-3
Group 3,BB,-0.5,9,14,687,6,2016,10,-4
Group 3,BB,-0.5,9,14,688,11,2016,11,0
Group 3,BB,-0.5,9,14,689,12,2016,5,7
Group 3,BB,-0.5,9,14,690,12,2016,8,4
Group 3,BB,-0.5,9,14,691,11,2016,8,3
Group 3,BB,-0.5,9,14,692,10,2016,7,3
Group 3,BB,-0.5,9,14,693,8,2016,10,-2
Group 3,BB,-0.5,9,14,694,8,2016,10,-2
Group 3,BB,-0.5,9,14,695,10,2016,6,4
Group 3,BB,-0.5,9,14,696,8,2016,8,0
Group 3,BB,-0.5,9,14,697,6,2016,7,-1
Group 3,BB,-0.5,9,14,698,11,2016,5,6
Group 3,BB,-0.5,9,14,699,5,2016,5,0
Group 3,BB,-0.5,9,14,700,12,2016,8,4
Group 3,BB,-0.5,9,14,701,9,2016,9,0
Group 3,BB,-0.5,9,14,702,11,2016,10,1
Group 3,BB,-0.5,9,14,703,9,2016,7,2
Group 3,BB,-0.5,9,14,704,6,2016,8,-2
Group 3,BB,-0.5,9,14,705,9,2016,10,-1
Group 3,BB,-0.5,9,14,706,13,2016,5,8
Group 3,BB,-0.5,9,14,707,7,2016,8,-1
Group 3,BB,-0.5,9,14,708,8,2016,7,1
Group 3,BB,-0.5,9,14,709,10,2016,6,4
Group 3,BB,-0.5,9,14,710,9,2016,9,0
Group 3,BB,-0.5,9,14,711,9,2016,5,4
Group 3,BB,-0.5,9,14,712,7,2016,12,-5
Group 3,BB,-0.5,9,14,713,11,2016,9,2
Group 3,BB,-0.5,9,14,714,12,2016,10,2
Group 3,BB,-0.5,9,14,715,4,2016,5,-1
Group 3,BB,-0.5,9,14,716,11,2016,7,4
Group 3,BB,-0.5,9,14,717,10,2016,7,3
Group 3,BB,-0.5,9,14,718,9,2016,8,1
Group 3,BB,-0.5,9,14,719,7,2016,9,-2
Group 3,BB,-0.5,9,14,720,12,2016,9,3
Group 3,BB,-0.5,9,14,721,8,2016,7,1
Group 3,BB,-0.5,9,14,722,10,2016,9,1
Group 3,BB,-0.5,9,14,723,12,2016,8,4
Group 3,BB,-0.5,9,14,724,9,2016,9,0
Group 3,BB,-0.5,9,14,725,11,2016,7,4
Group 3,BB,-0.5,9,14,726,10,2016,6,4
Group 3,BB,-0.5,9,14,727,9,2016,5,4
Group 3,BB,-0.5,9,14,728,9,2016,6,3
Group 3,BB,-0.5,9,14,729,10,2016,7,3
Group 3,BB,-0.5,9,14,730,5,2016,12,-7
Group 3,BB,-0.5,9,14,731,10,2016,5,5
Group 3,BB,-0.5,9,14,732,11,2016,7,4
Group 3,BB,-0.5,9,14,733,10,2016,4,6
Group 3,BB,-0.5,9,14,734,12,2016,9,3
Group 3,BB,-0.5,9,14,735,10,2016,10,0
Group 3,BB,-0.5,9,14,736,8,2016,9,-1
Group 3,BB,-0.5,9,14,737,9,2016,7,2
Group 3,BB,-0.5,9,14,738,7,2016,9,-2
Group 3,BB,-0.5,9,14,739,11,2016,11,0
Group 3,BB,-0.5,9,14,740,7,2016,9,-2
Group 3,BB,-0.5,9,14,741,12,2016,8,4
Group 3,BB,-0.5,9,14,742,7,2016,8,-1
Group 3,BB,-0.5,9,14,743,10,2016,11,-1
Group 3,BB,-0.5,9,14,744,10,2016,9,1
Group 3,BB,-0.5,9,14,745,8,2016,3,5
Group 3,BB,-0.5,9,14,746,8,2016,5,3
Group 3,BB,-0.5,9,14,747,10,2016,8,2
Group 3,BB,-0.5,9,14,748,7,2016,4,3
Group 3,BB,-0.5,9,14,749,9,2016,8,1
Group 3,BB,-0.5,9,14,750,8,2016,4,4
Group 3,BB,-0.5,9,14,751,10,2016,8,2
Group 3,BB,-0.5,9,14,752,8,2016,6,2
Group 3,BB,-0.5,9,14,753,7,2016,9,-2
Group 3,BB,-0.5,9,14,754,8,2016,9,-1
Group 3,BB,-0.5,9,14,755,10,2016,6,4
Group 3,BB,-0.5,9,14,756,7,2016,6,1
Group 3,BB,-0.5,9,14,757,10,2016,7,3
Group 3,BB,-0.5,9,14,758,11,2016,9,2
Group 3,BB,-0.5,9,14,759,10,2016,8,2
Group 3,BB,-0.5,9,14,760,10,2016,6,4
Group 3,BB,-0.5,9,14,761,10,2016,9,1
Group 3,BB,-0.5,9,14,762,12,2016,8,4
Group 3,BB,-0.5,9,14,763,7,2016,7,0
Group 3,BB,-0.5,9,14,764,10,2016,10,0
Group 3,BB,-0.5,9,14,765,5,2016,10,-5
Group 3,BB,-0.5,9,14,766,12,2016,7,5
Group 3,BB,-0.5,9,14,767,11,2016,9,2
Group 3,BB,-0.5,9,14,768,9,2016,7,2
Group 3,BB,-0.5,9,14,769,10,2016,6,4
Group 3,BB,-0.5,9,14,770,7,2016,7,0
Group 3,BB,-0.5,9,14,771,6,2016,7,-1
Group 3,BB,-0.5,9,14,772,10,2016,10,0
Group 3,BB,-0.5,9,14,773,8,2016,7,1
Group 3,BB,-0.5,9,14,774,7,2016,10,-3
Group 3,BB,-0.5,9,14,775,9,2016,7,2
Group 3,BB,-0.5,9,14,776,11,2016,6,5
Group 3,BB,-0.5,9,14,777,12,2016,7,5
Group 3,BB,-0.5,9,14,778,11,2016,7,4
Group 3,BB,-0.5,9,14,779,6,2016,5,1
Group 3,BB,-0.5,9,14,780,9,2016,5,4
Group 3,BB,-0.5,9,14,781,9,2016,8,1
Group 3,BB,-0.5,9,14,782,8,2016,10,-2
Group 3,BB,-0.5,9,14,783,6,2016,5,1
Group 3,BB,-0.5,9,14,784,9,2016,9,0
Group 3,BB,-0.5,9,14,785,12,2016,9,3
Group 3,BB,-0.5,9,14,786,10,2016,10,0
Group 3,BB,-0.5,9,14,787,9,2016,7,2
Group 3,BB,-0.5,9,14,788,12,2016,9,3
Group 3,BB,-0.5,9,14,789,9,2016,8,1
Group 3,BB,-0.5,9,14,790,9,2016,7,2
Group 3,BB,-0.5,9,14,791,9,2016,9,0
Group 3,BB,-0.5,9,14,792,6,2016,8,-2
Group 3,BB,-0.5,9,14,793,9,2016,6,3
Group 3,BB,-0.5,9,14,794,12,2016,8,4
Group 3,BB,-0.5,9,14,795,11,2016,8,3
Group 3,BB,-0.5,9,14,796,11,2016,8,3
Group 3,BB,-0.5,9,14,797,12,2016,12,0
Group 3,BB,-0.5,9,14,798,10,2016,8,2
Group 3,BB,-0.5,9,14,799,6,2016,10,-4
Group 3,BB,-0.5,9,14,800,10,2016,8,2
Group 3,BB,-0.5,9,14,801,8,2016,7,1
Group 3,BB,-0.5,9,14,802,8,2016,7,1
Group 3,BB,-0.5,9,14,803,10,2016,6,4
Group 3,BB,-0.5,9,14,804,8,2016,5,3
Group 3,BB,-0.5,9,14,805,13,2016,5,8
Group 3,BB,-0.5,9,14,806,8,2016,6,2
Group 3,BB,-0.5,9,14,807,10,2016,4,6
Group 3,BB,-0.5,9,14,808,8,2016,7,1
Group 3,BB,-0.5,9,14,809,7,2016,10,-3
Group 3,BB,-0.5,9,14,810,12,2016,11,1
Group 3,BB,-0.5,9,14,811,7,2016,7,0
Group 3,BB,-0.5,9,14,812,10,2016,6,4
Group 3,BB,-0.5,9,14,813,6,2016,6,0
Group 3,BB,-0.5,9,14,814,11,2016,5,6
Group 3,BB,-0.5,9,14,815,9,2016,7,2
Group 3,BB,-0.5,9,14,816,12,2016,8,4
Group 3,BB,-0.5,9,14,817,8,2016,8,0
Group 3,BB,-0.5,9,14,818,6,2016,5,1
Group 3,BB,-0.5,9,14,819,8,2016,9,-1
Group 3,BB,-0.5,9,14,820,12,2016,3,9
Group 3,BB,-0.5,9,14,821,10,2016,5,5
Group 3,BB,-0.5,9,14,822,13,2016,3,10
Group 3,BB,-0.5,9,14,823,12,2016,9,3
Group 3,BB,-0.5,9,14,824,11,2016,8,3
Group 3,BB,-0.5,9,14,825,10,2016,8,2
Group 3,BB,-0.5,9,14,826,9,2016,6,3
Group 3,BB,-0.5,9,14,827,11,2016,6,5
Group 3,BB,-0.5,9,14,828,10,2016,5,5
Group 3,BB,-0.5,9,14,829,10,2016,5,5
Group 3,BB,-0.5,9,14,830,12,2016,8,4
Group 3,BB,-0.5,9,14,831,11,2016,7,4
Group 3,BB,-0.5,9,14,832,9,2016,8,1
Group 3,BB,-0.5,9,14,833,12,2016,4,8
Group 3,BB,-0.5,9,14,834,11,2016,9,2
Group 3,BB,-0.5,9,14,835,6,2016,10,-4
Group 3,BB,-0.5,9,14,836,13,2016,10,3
Group 3,BB,-0.5,9,14,837,13,2016,8,5
Group 3,BB,-0.5,9,14,838,8,2016,6,2
Group 3,BB,-0.5,9,14,839,13,2016,8,5
Group 3,BB,-0.5,9,14,840,9,2016,7,2
Group 3,BB,-0.5,9,14,841,9,2016,5,4
Group 3,BB,-0.5,9,14,842,11,2016,8,3
Group 3,BB,-0.5,9,14,843,8,2016,3,5
Group 3,BB,-0.5,9,14,844,10,2016,8,2
Group 3,BB,-0.5,9,14,845,10,2016,9,1
Group 3,BB,-0.5,9,14,846,7,2016,5,2
Group 3,BB,-0.5,9,14,847,6,2016,7,-1
Group 3,BB,-0.5,9,14,848,13,2016,5,8
Group 3,BB,-0.5,9,14,849,9,2016,7,2
Group 3,BB,-0.5,9,14,850,8,2016,11,-3
Group 3,BB,-0.5,9,14,851,11,2016,5,6
Group 3,BB,-0.5,9,14,852,11,2016,7,4
Group 3,BB,-0.5,9,14,853,6,2016,9,-3
Group 3,BB,-0.5,9,14,854,7,2016,6,1
Group 3,BB,-0.5,9,14,855,8,2016,7,1
Group 3,BB,-0.5,9,14,856,10,2016,8,2
Group 3,BB,-0.5,9,14,857,6,2016,6,0
Group 3,BB,-0.5,9,14,858,11,2016,12,-1
Group 3,BB,-0.5,9,14,859,10,2016,10,0
Group 3,BB,-0.5,9,14,860,9,2016,8,1
Group 3,BB,-0.5,9,14,861,11,2016,10,1
Group 3,BB,-0.5,9,14,862,10,2016,9,1
Group 3,BB,-0.5,9,14,863,7,2016,6,1
Group 3,BB,-0.5,9,14,864,10,2016,7,3
Group 3,BB,-0.5,9,14,865,6,2016,7,-1
Group 3,BB,-0.5,9,14,866,11,2016,9,2
Group 3,BB,-0.5,9,14,867,8,2016,5,3
Group 3,BB,-0.5,9,14,868,10,2016,7,3
Group 3,BB,-0.5,9,14,869,9,2016,9,0
Group 3,BB,-0.5,9,14,870,8,2016,7,1
Group 3,BB,-0.5,9,14,871,6,2016,7,-1
Group 3,BB,-0.5,9,14,872,10,2016,5,5
Group 3,BB,-0.5,9,14,873,10,2016,10,0
Group 3,BB,-0.5,9,14,874,8,2016,7,1
Group 3,BB,-0.5,9,14,875,10,2016,8,2
Group 3,BB,-0.5,9,14,876,10,2016,11,-1
Group 3,BB,-0.5,9,14,877,11,2016,9,2
Group 3,BB,-0.5,9,14,878,11,2016,5,6
Group 3,BB,-0.5,9,14,879,12,2016,6,6
Group 3,BB,-0.5,9,14,880,9,2016,7,2
Group 3,BB,-0.5,9,14,881,4,2016,2,2
Group 3,BB,-0.5,9,14,882,12,2016,7,5
Group 3,BB,-0.5,9,14,883,11,2016,9,2
Group 3,BB,-0.5,9,14,884,8,2016,7,1
Group 3,BB,-0.5,9,14,885,9,2016,8,1
Group 3,BB,-0.5,9,14,886,11,2016,8,3
Group 3,BB,-0.5,9,14,887,9,2016,8,1
Group 3,BB,-0.5,9,14,888,9,2016,10,-1
Group 3,BB,-0.5,9,14,889,12,2016,10,2
Group 3,BB,-0.5,9,14,890,9,2016,7,2
Group 3,BB,-0.5,9,14,891,10,2016,7,3
Group 3,BB,-0.5,9,14,892,9,2016,7,2
Group 3,BB,-0.5,9,14,893,12,2016,7,5
Group 3,BB,-0.5,9,14,894,12,2016,7,5
Group 3,BB,-0.5,9,14,895,11,2016,11,0
Group 3,BB,-0.5,9,14,896,6,2016,13,-7
Group 3,BB,-0.5,9,14,897,10,2016,6,4
Group 3,BB,-0.5,9,14,898,6,2016,5,1
Group 3,BB,-0.5,9,14,899,10,2016,6,4
Group 3,BB,-0.5,9,14,900,12,2016,13,-1
Group 3,BB,-0.5,9,14,901,8,2016,5,3
Group 3,BB,-0.5,9,14,902,11,2016,10,1
Group 3,BB,-0.5,9,14,903,12,2016,7,5
Group 3,BB,-0.5,9,14,904,12,2016,8,4
Group 3,BB,-0.5,9,14,905,9,2016,9,0
Group 3,BB,-0.5,9,14,906,8,2016,3,5
Group 3,BB,-0.5,9,14,907,7,2016,8,-1
Group 3,BB,-0.5,9,14,908,7,2016,7,0
Group 3,BB,-0.5,9,14,909,4,2016,10,-6
Group 3,BB,-0.5,9,14,910,12,2016,10,2
Group 3,BB,-0.5,9,14,911,11,2016,8,3
Group 3,BB,-0.5,9,14,912,8,2016,10,-2
Group 3,BB,-0.5,9,14,913,8,2016,5,3
Group 3,BB,-0.5,9,14,914,10,2016,8,2
Group 3,BB,-0.5,9,14,915,9,2016,5,4
Group 3,BB,-0.5,9,14,916,8,2016,5,3
Group 3,BB,-0.5,9,14,917,11,2016,5,6
Group 3,BB,-0.5,9,14,918,10,2016,7,3
Group 3,BB,-0.5,9,14,919,8,2016,10,-2
Group 3,BB,-0.5,9,14,920,7,2016,7,0
Group 3,BB,-0.5,9,14,921,10,2016,5,5
Group 3,BB,-0.5,9,14,922,8,2016,5,3
Group 3,BB,-0.5,9,14,923,10,2016,11,-1
Group 3,BB,-0.5,9,14,924,9,2016,9,0
Group 3,BB,-0.5,9,14,925,11,2016,6,5
Group 3,BB,-0.5,9,14,926,11,2016,8,3
Group 3,BB,-0.5,9,14,927,10,2016,5,5
Group 3,BB,-0.5,9,14,928,11,2016,4,7
Group 3,BB,-0.5,9,14,929,11,2016,4,7
Group 3,BB,-0.5,9,14,930,9,2016,9,0
Group 3,BB,-0.5,9,14,931,8,2016,8,0
Group 3,BB,-0.5,9,14,932,12,2016,10,2
Group 3,BB,-0.5,9,14,933,7,2016,9,-2
Group 3,BB,-0.5,9,14,934,7,2016,9,-2
Group 3,BB,-0.5,9,14,935,11,2016,9,2
Group 3,BB,-0.5,9,14,936,9,2016,7,2
Group 3,BB,-0.5,9,14,937,5,2016,8,-3
Group 3,BB,-0.5,9,14,938,9,2016,12,-3
Group 3,BB,-0.5,9,14,939,7,2016,8,-1
Group 3,BB,-0.5,9,14,940,8,2016,7,1
Group 3,BB,-0.5,9,14,941,11,2016,7,4
Group 3,BB,-0.5,9,14,942,11,2016,9,2
Group 3,BB,-0.5,9,14,943,7,2016,10,-3
Group 3,BB,-0.5,9,14,944,5,2016,11,-6
Group 3,BB,-0.5,9,14,945,9,2016,12,-3
Group 3,BB,-0.5,9,14,946,9,2016,8,1
Group 3,BB,-0.5,9,14,947,10,2016,12,-2
Group 3,BB,-0.5,9,14,948,10,2016,8,2
Group 3,BB,-0.5,9,14,949,10,2016,9,1
Group 3,BB,-0.5,9,14,950,10,2016,7,3
Group 3,BB,-0.5,9,14,951,7,2016,10,-3
Group 3,BB,-0.5,9,14,952,8,2016,7,1
Group 3,BB,-0.5,9,14,953,7,2016,5,2
Group 3,BB,-0.5,9,14,954,12,2016,6,6
Group 3,BB,-0.5,9,14,955,10,2016,4,6
Group 3,BB,-0.5,9,14,956,8,2016,8,0
Group 3,BB,-0.5,9,14,957,8,2016,6,2
Group 3,BB,-0.5,9,14,958,8,2016,8,0
Group 3,BB,-0.5,9,14,959,9,2016,9,0
Group 3,BB,-0.5,9,14,960,8,2016,12,-4
Group 3,BB,-0.5,9,14,961,11,2016,6,5
Group 3,BB,-0.5,9,14,962,8,2016,10,-2
Group 3,BB,-0.5,9,14,963,11,2016,9,2
Group 3,BB,-0.5,9,14,964,12,2016,6,6
Group 3,BB,-0.5,9,14,965,9,2016,6,3
Group 3,BB,-0.5,9,14,966,9,2016,11,-2
Group 3,BB,-0.5,9,14,967,10,2016,6,4
Group 3,BB,-0.5,9,14,968,7,2016,9,-2
Group 3,BB,-0.5,9,14,969,8,2016,9,-1
Group 3,BB,-0.5,9,14,970,9,2016,5,4
Group 3,BB,-0.5,9,14,971,11,2016,10,1
Group 3,BB,-0.5,9,14,972,11,2016,10,1
Group 3,BB,-0.5,9,14,973,6,2016,8,-2
Group 3,BB,-0.5,9,14,974,7,2016,10,-3
Group 3,BB,-0.5,9,14,975,10,2016,11,-1
Group 3,BB,-0.5,9,14,976,10,2016,9,1
Group 3,BB,-0.5,9,14,977,6,2016,7,-1
Group 3,BB,-0.5,9,14,978,12,2016,5,7
Group 3,BB,-0.5,9,14,979,8,2016,7,1
Group 3,BB,-0.5,9,14,980,8,2016,9,-1
Group 3,BB,-0.5,9,14,981,7,2016,5,2
Group 3,BB,-0.5,9,14,982,7,2016,6,1
Group 3,BB,-0.5,9,14,983,7,2016,5,2
Group 3,BB,-0.5,9,14,984,7,2016,8,-1
Group 3,BB,-0.5,9,14,985,11,2016,11,0
Group 3,BB,-0.5,9,14,986,8,2016,8,0
Group 3,BB,-0.5,9,14,987,9,2016,9,0
Group 3,BB,-0.5,9,14,988,13,2016,11,2
Group 3,BB,-0.5,9,14,989,12,2016,8,4
Group 3,BB,-0.5,9,14,990,10,2016,7,3
Group 3,BB,-0.5,9,14,991,10,2016,11,-1
Group 3,BB,-0.5,9,14,992,10,2016,10,0
Group 3,BB,-0.5,9,14,993,8,2016,10,-2
Group 3,BB,-0.5,9,14,994,12,2016,8,4
Group 3,BB,-0.5,9,14,995,4,2016,6,-2
Group 3,BB,-0.5,9,14,996,10,2016,9,1
Group 3,BB,-0.5,9,14,997,13,2016,6,7
Group 3,BB,-0.5,9,14,998,8,2016,8,0
Group 3,BB,-0.5,9,14,999,11,2016,12,-1
Group 3,BB,-0.5,9,14,1000,11,2016,6,5
Group 3,BB,-0.5,9,14,1001,9,2016,9,0
Group 3,BB,-0.5,9,14,1002,11,2016,9,2
Group 3,BB,-0.5,9,14,1003,9,2016,8,1
Group 3,BB,-0.5,9,14,1004,14,2016,8,6
Group 3,BB,-0.5,9,14,1005,5,2016,6,-1
Group 3,BB,-0.5,9,14,1006,13,2016,3,10
Group 3,BB,-0.5,9,14,1007,8,2016,7,1
Group 3,BB,-0.5,9,14,1008,13,2016,5,8
Group 3,BB,-0.5,9,14,1009,11,2016,6,5
Group 3,BB,-0.5,9,14,1010,10,2016,8,2
Group 3,BB,-0.5,9,14,1011,9,2016,5,4
Group 3,BB,-0.5,9,14,1012,12,2016,5,7
Group 3,BB,-0.5,9,14,1013,9,2016,7,2
Group 3,BB,-0.5,9,14,1014,10,2016,9,1
Group 3,BB,-0.5,9,14,1015,13,2016,6,7
Group 3,BB,-0.5,9,14,1016,14,2016,8,6
Group 3,BB,-0.5,9,14,1017,11,2016,7,4
Group 3,BB,-0.5,9,14,1018,9,2016,8,1
Group 3,BB,-0.5,9,14,1019,7,2016,10,-3
Group 3,BB,-0.5,9,14,1020,9,2016,6,3
Group 3,BB,-0.5,9,14,1021,12,2016,7,5
Group 3,BB,-0.5,9,14,1022,9,2016,7,2
Group 3,BB,-0.5,9,14,1023,8,2016,6,2
Group 3,BB,-0.5,9,14,1024,11,2016,8,3
Group 3,BB,-0.5,9,14,1025,11,2016,9,2
Group 3,BB,-0.5,9,14,1026,9,2016,9,0
Group 3,BB,-0.5,9,14,1027,9,2016,8,1
Group 3,BB,-0.5,9,14,1028,12,2016,9,3
Group 3,BB,-0.5,9,14,1029,10,2016,7,3
Group 3,BB,-0.5,9,14,1030,10,2016,8,2
Group 3,BB,-0.5,9,14,1031,7,2016,7,0
Group 3,BB,-0.5,9,14,1032,12,2016,7,5
Group 3,BB,-0.5,9,14,1033,6,2016,6,0
Group 3,BB,-0.5,9,14,1034,11,2016,9,2
Group 3,BB,-0.5,9,14,1035,11,2016,3,8
Group 3,BB,-0.5,9,14,1036,7,2016,12,-5
Group 3,BB,-0.5,9,14,1037,9,2016,6,3
Group 3,BB,-0.5,9,14,1038,8,2016,12,-4
Group 3,BB,-0.5,9,14,1039,10,2016,12,-2
Group 3,BB,-0.5,9,14,1040,9,2016,5,4
Group 3,BB,-0.5,9,14,1041,10,2016,8,2
Group 3,BB,-0.5,9,14,1042,12,2016,9,3
Group 3,BB,-0.5,9,14,1043,8,2016,8,0
Group 3,BB,-0.5,9,14,1044,8,2016,7,1
Group 3,BB,-0.5,9,14,1045,10,2016,9,1
Group 3,BB,-0.5,9,14,1046,9,2016,7,2
Group 3,BB,-0.5,9,14,1047,12,2016,8,4
Group 3,BB,-0.5,9,14,1048,10,2016,11,-1
Group 3,BB,-0.5,9,14,1049,7,2016,7,0
Group 3,BB,-0.5,9,14,1050,12,2016,6,6
Group 3,BB,-0.5,9,14,1051,8,2016,9,-1
Group 3,BB,-0.5,9,14,1052,10,2016,10,0
Group 3,BB,-0.5,9,14,1053,10,2016,11,-1
Group 3,BB,-0.5,9,14,1054,11,2016,10,1
Group 3,BB,-0.5,9,14,1055,11,2016,7,4
Group 3,BB,-0.5,9,14,1056,10,2016,9,1
Group 3,BB,-0.5,9,14,1057,10,2016,9,1
Group 3,BB,-0.5,9,14,1058,7,2016,8,-1
Group 3,BB,-0.5,9,14,1059,12,2016,6,6
Group 3,BB,-0.5,9,14,1060,9,2016,12,-3
Group 3,BB,-0.5,9,14,1061,3,2016,12,-9
Group 3,BB,-0.5,9,14,1062,9,2016,9,0
Group 3,BB,-0.5,9,14,1063,9,2016,7,2
Group 3,BB,-0.5,9,14,1064,10,2016,10,0
Group 3,BB,-0.5,9,14,1065,9,2016,5,4
Group 3,BB,-0.5,9,14,1066,10,2016,7,3
Group 3,BB,-0.5,9,14,1067,10,2016,10,0
Group 3,BB,-0.5,9,14,1068,9,2016,8,1
Group 3,BB,-0.5,9,14,1069,6,2016,8,-2
Group 3,BB,-0.5,9,14,1070,9,2016,9,0
Group 3,BB,-0.5,9,14,1071,8,2016,8,0
Group 3,BB,-0.5,9,14,1072,7,2016,7,0
Group 3,BB,-0.5,9,14,1073,9,2016,9,0
Group 3,BB,-0.5,9,14,1074,10,2016,8,2
Group 3,BB,-0.5,9,14,1075,9,2016,5,4
Group 3,BB,-0.5,9,14,1076,11,2016,9,2
Group 3,BB,-0.5,9,14,1077,9,2016,7,2
Group 3,BB,-0.5,9,14,1078,11,2016,6,5
Group 3,BB,-0.5,9,14,1079,12,2016,8,4
Group 3,BB,-0.5,9,14,1080,10,2016,10,0
Group 3,BB,-0.5,9,14,1081,6,2016,7,-1
Group 3,BB,-0.5,9,14,1082,5,2016,6,-1
Group 3,BB,-0.5,9,14,1083,10,2016,10,0
Group 3,BB,-0.5,9,14,1084,9,2016,11,-2
Group 3,BB,-0.5,9,14,1085,6,2016,12,-6
Group 3,BB,-0.5,9,14,1086,8,2016,6,2
Group 3,BB,-0.5,9,14,1087,5,2016,6,-1
Group 3,BB,-0.5,9,14,1088,8,2016,8,0
Group 3,BB,-0.5,9,14,1089,10,2016,8,2
Group 3,BB,-0.5,9,14,1090,12,2016,9,3
Group 3,BB,-0.5,9,14,1091,8,2016,10,-2
Group 3,BB,-0.5,9,14,1092,9,2016,12,-3
Group 3,BB,-0.5,9,14,1093,11,2016,5,6
Group 3,BB,-0.5,9,14,1094,10,2016,7,3
Group 3,BB,-0.5,9,14,1095,8,2016,6,2
Group 3,BB,-0.5,9,14,1096,9,2016,5,4
Group 3,BB,-0.5,9,14,1097,10,2016,8,2
Group 3,BB,-0.5,9,14,1098,10,2016,7,3
Group 3,BB,-0.5,9,14,1099,1,2016,9,-8
Group 3,BB,-0.5,9,14,1100,3,2016,14,-11
Group 3,BB,-0.5,9,14,1101,7,2016,12,-5
Group 3,BB,-0.5,9,14,1102,13,2016,8,5
Group 3,BB,-0.5,9,14,1103,10,2016,8,2
Group 3,BB,-0.5,9,14,1104,10,2016,6,4
Group 3,BB,-0.5,9,14,1105,10,2016,9,1
Group 3,BB,-0.5,9,14,1106,9,2016,10,-1
Group 3,BB,-0.5,9,14,1107,11,2016,7,4
Group 3,BB,-0.5,9,14,1108,9,2016,6,3
Group 3,BB,-0.5,9,14,1109,10,2016,9,1
Group 3,BB,-0.5,9,14,1110,11,2016,11,0
Group 3,BB,-0.5,9,14,1111,7,2016,10,-3
Group 3,BB,-0.5,9,14,1112,7,2016,10,-3
Group 3,BB,-0.5,9,14,1113,12,2016,4,8
Group 3,BB,-0.5,9,14,1114,7,2016,8,-1
Group 3,BB,-0.5,9,14,1115,10,2016,5,5
Group 3,BB,-0.5,9,14,1116,7,2016,6,1
Group 3,BB,-0.5,9,14,1117,9,2016,5,4
Group 3,BB,-0.5,9,14,1118,10,2016,7,3
Group 3,BB,-0.5,9,14,1119,13,2016,9,4
Group 3,BB,-0.5,9,14,1120,6,2016,10,-4
Group 3,BB,-0.5,9,14,1121,9,2016,6,3
Group 3,BB,-0.5,9,14,1122,6,2016,6,0
Group 3,BB,-0.5,9,14,1123,9,2016,5,4
Group 3,BB,-0.5,9,14,1124,10,2016,10,0
Group 3,BB,-0.5,9,14,1125,9,2016,6,3
Group 3,BB,-0.5,9,14,1126,7,2016,7,0
Group 3,BB,-0.5,9,14,1127,9,2016,3,6
Group 3,BB,-0.5,9,14,1128,8,2016,8,0
Group 3,BB,-0.5,9,14,1129,8,2016,7,1
Group 3,BB,-0.5,9,14,1130,9,2016,11,-2
Group 3,BB,-0.5,9,14,1131,8,2016,9,-1
Group 3,BB,-0.5,9,14,1132,5,2016,7,-2
Group 3,BB,-0.5,9,14,1133,8,2016,8,0
Group 3,BB,-0.5,9,14,1134,10,2016,8,2
Group 3,BB,-0.5,9,14,1135,10,2016,10,0
Group 3,BB,-0.5,9,14,1136,11,2016,4,7
Group 3,BB,-0.5,9,14,1137,10,2016,8,2
Group 3,BB,-0.5,9,14,1138,9,2016,8,1
Group 3,BB,-0.5,9,14,1139,6,2016,5,1
Group 3,BB,-0.5,9,14,1140,9,2016,3,6
Group 3,BB,-0.5,9,14,1141,9,2016,11,-2
Group 3,BB,-0.5,9,14,1142,13,2016,7,6
Group 3,BB,-0.5,9,14,1143,12,2016,8,4
Group 3,BB,-0.5,9,14,1144,12,2016,9,3
Group 3,BB,-0.5,9,14,1145,10,2016,5,5
Group 3,BB,-0.5,9,14,1146,8,2016,11,-3
Group 3,BB,-0.5,9,14,1147,9,2016,5,4
Group 3,BB,-0.5,9,14,1148,13,2016,11,2
Group 3,BB,-0.5,9,14,1149,6,2016,9,-3
Group 3,BB,-0.5,9,14,1150,11,2016,9,2
Group 3,BB,-0.5,9,14,1151,7,2016,12,-5
Group 3,BB,-0.5,9,14,1152,6,2016,7,-1
Group 3,BB,-0.5,9,14,1153,14,2016,4,10
Group 3,BB,-0.5,9,14,1154,12,2016,7,5
Group 3,BB,-0.5,9,14,1155,9,2016,5,4
Group 3,BB,-0.5,9,14,1156,6,2016,7,-1
Group 3,BB,-0.5,9,14,1157,6,2016,10,-4
Group 3,BB,-0.5,9,14,1158,5,2016,8,-3
Group 3,BB,-0.5,9,14,1159,8,2016,12,-4
Group 3,BB,-0.5,9,14,1160,13,2016,9,4
Group 3,BB,-0.5,9,14,1161,6,2016,10,-4
Group 3,BB,-0.5,9,14,1162,10,2016,6,4
Group 3,BB,-0.5,9,14,1163,7,2016,10,-3
Group 3,BB,-0.5,9,14,1164,8,2016,8,0
Group 3,BB,-0.5,9,14,1165,12,2016,6,6
Group 3,BB,-0.5,9,14,1166,10,2016,10,0
Group 3,BB,-0.5,9,14,1167,9,2016,7,2
Group 3,BB,-0.5,9,14,1168,7,2016,9,-2
Group 3,BB,-0.5,9,14,1169,5,2016,8,-3
Group 3,BB,-0.5,9,14,1170,10,2016,9,1
Group 3,BB,-0.5,9,14,1171,6,2016,10,-4
Group 3,BB,-0.5,9,14,1172,8,2016,11,-3
Group 3,BB,-0.5,9,14,1173,10,2016,5,5
Group 3,BB,-0.5,9,14,1174,12,2016,9,3
Group 3,BB,-0.5,9,14,1175,9,2016,7,2
Group 3,BB,-0.5,9,14,1176,13,2016,11,2
Group 3,BB,-0.5,9,14,1177,8,2016,11,-3
Group 3,BB,-0.5,9,14,1178,12,2016,10,2
Group 3,BB,-0.5,9,14,1179,11,2016,9,2
Group 3,BB,-0.5,9,14,1180,8,2016,12,-4
Group 3,BB,-0.5,9,14,1181,12,2016,11,1
Group 3,BB,-0.5,9,14,1182,11,2016,7,4
Group 3,BB,-0.5,9,14,1183,8,2016,7,1
Group 3,BB,-0.5,9,14,1184,10,2016,9,1
Group 3,BB,-0.5,9,14,1185,8,2016,10,-2
Group 3,BB,-0.5,9,14,1186,7,2016,8,-1
Group 3,BB,-0.5,9,14,1187,8,2016,6,2
Group 3,BB,-0.5,9,14,1188,11,2016,3,8
Group 3,BB,-0.5,9,14,1189,10,2016,9,1
Group 3,BB,-0.5,9,14,1190,11,2016,7,4
Group 3,BB,-0.5,9,14,1191,10,2016,6,4
Group 3,BB,-0.5,9,14,1192,11,2016,8,3
Group 3,BB,-0.5,9,14,1193,8,2016,9,-1
Group 3,BB,-0.5,9,14,1194,7,2016,8,-1
Group 3,BB,-0.5,9,14,1195,11,2016,11,0
Group 3,BB,-0.5,9,14,1196,7,2016,7,0
Group 3,BB,-0.5,9,14,1197,7,2016,10,-3
Group 3,BB,-0.5,9,14,1198,8,2016,5,3
Group 3,BB,-0.5,9,14,1199,9,2016,6,3
Group 3,BB,-0.5,9,14,1200,7,2016,5,2
Group 3,BB,-0.5,9,14,1201,10,2016,9,1
Group 3,BB,-0.5,9,14,1202,7,2016,6,1
Group 3,BB,-0.5,9,14,1203,8,2016,4,4
Group 3,BB,-0.5,9,14,1204,7,2016,8,-1
Group 3,BB,-0.5,9,14,1205,10,2016,7,3
Group 3,BB,-0.5,9,14,1206,13,2016,7,6
Group 3,BB,-0.5,9,14,1207,12,2016,10,2
Group 3,BB,-0.5,9,14,1208,6,2016,8,-2
Group 3,BB,-0.5,9,14,1209,9,2016,9,0
Group 3,BB,-0.5,9,14,1210,10,2016,9,1
Group 3,BB,-0.5,9,14,1211,12,2016,6,6
Group 3,BB,-0.5,9,14,1212,9,2016,10,-1
Group 3,BB,-0.5,9,14,1213,10,2016,7,3
Group 3,BB,-0.5,9,14,1214,11,2016,11,0
Group 3,BB,-0.5,9,14,1215,11,2016,8,3
Group 3,BB,-0.5,9,14,1216,6,2016,6,0
Group 3,BB,-0.5,9,14,1217,4,2016,7,-3
Group 3,BB,-0.5,9,14,1218,10,2016,10,0
Group 3,BB,-0.5,9,14,1219,9,2016,13,-4
Group 3,BB,-0.5,9,14,1220,8,2016,11,-3
Group 3,BB,-0.5,9,14,1221,10,2016,7,3
Group 3,BB,-0.5,9,14,1222,4,2016,9,-5
Group 3,BB,-0.5,9,14,1223,9,2016,5,4
Group 3,BB,-0.5,9,14,1224,9,2016,13,-4
Group 3,BB,-0.5,9,14,1225,5,2016,8,-3
Group 3,BB,-0.5,9,14,1226,7,2016,9,-2
Group 3,BB,-0.5,9,14,1227,12,2016,10,2
Group 3,BB,-0.5,9,14,1228,10,2016,10,0
Group 3,BB,-0.5,9,14,1229,8,2016,7,1
Group 3,BB,-0.5,9,14,1230,9,2016,9,0
Group 3,BB,-0.5,9,14,1231,11,2016,8,3
Group 3,BB,-0.5,9,14,1232,7,2016,7,0
Group 3,BB,-0.5,9,14,1233,5,2016,9,-4
Group 3,BB,-0.5,9,14,1234,9,2016,11,-2
Group 3,BB,-0.5,9,14,1235,11,2016,8,3
Group 3,BB,-0.5,9,14,1236,11,2016,5,6
Group 3,BB,-0.5,9,14,1237,12,2016,10,2
Group 3,BB,-0.5,9,14,1238,10,2016,12,-2
Group 3,BB,-0.5,9,14,1239,12,2016,7,5
Group 3,BB,-0.5,9,14,1240,9,2016,6,3
Group 3,BB,-0.5,9,14,1241,9,2016,10,-1
Group 3,BB,-0.5,9,14,1242,5,2016,4,1
Group 3,BB,-0.5,9,14,1243,7,2016,4,3
Group 3,BB,-0.5,9,14,1244,13,2016,8,5
Group 3,BB,-0.5,9,14,1245,13,2016,10,3
Group 3,BB,-0.5,9,14,1246,13,2016,10,3
Group 3,BB,-0.5,9,14,1247,10,2016,12,-2
Group 3,BB,-0.5,9,14,1248,12,2016,9,3
Group 3,BB,-0.5,9,14,1249,10,2016,6,4
Group 3,BB,-0.5,9,14,1250,9,2016,9,0
Group 3,BB,-0.5,9,14,1251,9,2016,8,1
Group 3,BB,-0.5,9,14,1252,9,2016,12,-3
Group 3,BB,-0.5,9,14,1253,9,2016,4,5
Group 3,BB,-0.5,9,14,1254,7,2016,5,2
Group 3,BB,-0.5,9,14,1255,11,2016,7,4
Group 3,BB,-0.5,9,14,1256,8,2016,7,1
Group 3,BB,-0.5,9,14,1257,11,2016,10,1
Group 3,BB,-0.5,9,14,1258,7,2016,7,0
Group 3,BB,-0.5,9,14,1259,10,2016,6,4
Group 3,BB,-0.5,9,14,1260,11,2016,8,3
Group 3,BB,-0.5,9,14,1261,9,2016,8,1
Group 3,BB,-0.5,9,14,1262,7,2016,5,2
Group 3,BB,-0.5,9,14,1263,11,2016,6,5
Group 3,BB,-0.5,9,14,1264,8,2016,9,-1
Group 3,BB,-0.5,9,14,1265,8,2016,6,2
Group 3,BB,-0.5,9,14,1266,10,2016,10,0
Group 3,BB,-0.5,9,14,1267,9,2016,10,-1
Group 3,BB,-0.5,9,14,1268,14,2016,8,6
Group 3,BB,-0.5,9,14,1269,7,2016,11,-4
Group 3,BB,-0.5,9,14,1270,11,2016,7,4
Group 3,BB,-0.5,9,14,1271,9,2016,7,2
Group 3,BB,-0.5,9,14,1272,14,2016,9,5
Group 3,BB,-0.5,9,14,1273,4,2016,11,-7
Group 3,BB,-0.5,9,14,1274,7,2016,6,1
Group 3,BB,-0.5,9,14,1275,11,2016,8,3
Group 3,BB,-0.5,9,14,1276,9,2016,7,2
Group 3,BB,-0.5,9,14,1277,3,2016,9,-6
Group 3,BB,-0.5,9,14,1278,6,2016,10,-4
Group 3,BB,-0.5,9,14,1279,10,2016,10,0
Group 3,BB,-0.5,9,14,1280,5,2016,7,-2
Group 3,BB,-0.5,9,14,1281,8,2016,8,0
Group 3,BB,-0.5,9,14,1282,8,2016,8,0
Group 3,BB,-0.5,9,14,1283,10,2016,8,2
Group 3,BB,-0.5,9,14,1284,12,2016,9,3
Group 3,BB,-0.5,9,14,1285,4,2016,12,-8
Group 3,BB,-0.5,9,14,1286,9,2016,6,3
Group 3,BB,-0.5,9,14,1287,10,2016,9,1
Group 3,BB,-0.5,9,14,1288,10,2016,6,4
Group 3,BB,-0.5,9,14,1289,8,2016,9,-1
Group 3,BB,-0.5,9,14,1290,9,2016,8,1
Group 3,BB,-0.5,9,14,1291,10,2016,10,0
Group 3,BB,-0.5,9,14,1292,10,2016,6,4
Group 3,BB,-0.5,9,14,1293,10,2016,5,5
Group 3,BB,-0.5,9,14,1294,11,2016,5,6
Group 3,BB,-0.5,9,14,1295,12,2016,12,0
Group 3,BB,-0.5,9,14,1296,10,2016,11,-1
Group 3,BB,-0.5,9,14,1297,7,2016,11,-4
Group 3,BB,-0.5,9,14,1298,9,2016,12,-3
Group 3,BB,-0.5,9,14,1299,12,2016,10,2
Group 3,BB,-0.5,9,14,1300,11,2016,10,1
Group 3,BB,-0.5,9,14,1301,11,2016,13,-2
Group 3,BB,-0.5,9,14,1302,9,2016,7,2
Group 3,BB,-0.5,9,14,1303,7,2016,9,-2
Group 3,BB,-0.5,9,14,1304,6,2016,9,-3
Group 3,BB,-0.5,9,14,1305,8,2016,7,1
Group 3,BB,-0.5,9,14,1306,9,2016,4,5
Group 3,BB,-0.5,9,14,1307,10,2016,10,0
Group 3,BB,-0.5,9,14,1308,12,2016,3,9
Group 3,BB,-0.5,9,14,1309,12,2016,11,1
Group 3,BB,-0.5,9,14,1310,7,2016,10,-3
Group 3,BB,-0.5,9,14,1311,10,2016,7,3
Group 3,BB,-0.5,9,14,1312,13,2016,8,5
Group 3,BB,-0.5,9,14,1313,9,2016,7,2
Group 3,BB,-0.5,9,14,1314,9,2016,6,3
Group 3,BB,-0.5,9,14,1315,8,2016,8,0
Group 3,BB,-0.5,9,14,1316,10,2016,9,1
Group 3,BB,-0.5,9,14,1317,12,2016,6,6
Group 3,BB,-0.5,9,14,1318,10,2016,5,5
Group 3,BB,-0.5,9,14,1319,11,2016,9,2
Group 3,BB,-0.5,9,14,1320,9,2016,11,-2
Group 3,BB,-0.5,9,14,1321,11,2016,7,4
Group 3,BB,-0.5,9,14,1322,9,2016,8,1
Group 3,BB,-0.5,9,14,1323,8,2016,4,4
Group 3,BB,-0.5,9,14,1324,9,2016,5,4
Group 3,BB,-0.5,9,14,1325,12,2016,6,6
Group 3,BB,-0.5,9,14,1326,11,2016,2,9
Group 3,BB,-0.5,9,14,1327,13,2016,9,4
Group 3,BB,-0.5,9,14,1328,11,2016,6,5
Group 3,BB,-0.5,9,14,1329,11,2016,8,3
Group 3,BB,-0.5,9,14,1330,10,2016,11,-1
Group 3,BB,-0.5,9,14,1331,9,2016,5,4
Group 3,BB,-0.5,9,14,1332,9,2016,4,5
Group 3,BB,-0.5,9,14,1333,10,2016,7,3
Group 3,BB,-0.5,9,14,1334,12,2016,3,9
Group 3,BB,-0.5,9,14,1335,8,2016,8,0
Group 3,BB,-0.5,9,14,1336,7,2016,8,-1
Group 3,BB,-0.5,9,14,1337,10,2016,5,5
Group 3,BB,-0.5,9,14,1338,7,2016,10,-3
Group 3,BB,-0.5,9,14,1339,8,2016,9,-1
Group 3,BB,-0.5,9,14,1340,10,2016,9,1
Group 3,BB,-0.5,9,14,1341,9,2016,8,1
Group 3,BB,-0.5,9,14,1342,9,2016,8,1
Group 3,BB,-0.5,9,14,1343,8,2016,9,-1
Group 3,BB,-0.5,9,14,1344,8,2016,4,4
Group 3,BB,-0.5,9,14,1345,10,2016,8,2
Group 3,BB,-0.5,9,14,1346,9,2016,8,1
Group 3,BB,-0.5,9,14,1347,10,2016,10,0
Group 3,BB,-0.5,9,14,1348,11,2016,9,2
Group 3,BB,-0.5,9,14,1349,6,2016,8,-2
Group 3,BB,-0.5,9,14,1350,7,2016,8,-1
Group 3,BB,-0.5,9,14,1351,8,2016,5,3
Group 3,BB,-0.5,9,14,1352,10,2016,8,2
Group 3,BB,-0.5,9,14,1353,11,2016,5,6
Group 3,BB,-0.5,9,14,1354,11,2016,8,3
Group 3,BB,-0.5,9,14,1355,10,2016,7,3
Group 3,BB,-0.5,9,14,1356,9,2016,10,-1
Group 3,BB,-0.5,9,14,1357,9,2016,7,2
Group 3,BB,-0.5,9,14,1358,7,2016,9,-2
Group 3,BB,-0.5,9,14,1359,11,2016,5,6
Group 3,BB,-0.5,9,14,1360,10,2016,7,3
Group 3,BB,-0.5,9,14,1361,3,2016,7,-4
Group 3,BB,-0.5,9,14,1362,10,2016,11,-1
Group 3,BB,-0.5,9,14,1363,6,2016,10,-4
Group 3,BB,-0.5,9,14,1364,10,2016,8,2
Group 3,BB,-0.5,9,14,1365,7,2016,9,-2
Group 3,BB,-0.5,9,14,1366,6,2016,8,-2
Group 3,BB,-0.5,9,14,1367,6,2016,6,0
Group 3,BB,-0.5,9,14,1368,8,2016,10,-2
Group 3,BB,-0.5,9,14,1369,11,2016,9,2
Group 3,BB,-0.5,9,14,1370,9,2016,10,-1
Group 3,BB,-0.5,9,14,1371,11,2016,8,3
Group 3,BB,-0.5,9,14,1372,12,2016,12,0
Group 3,BB,-0.5,9,14,1373,7,2016,6,1
Group 3,BB,-0.5,9,14,1374,5,2016,8,-3
Group 3,BB,-0.5,9,14,1375,11,2016,7,4
Group 3,BB,-0.5,9,14,1376,11,2016,8,3
Group 3,BB,-0.5,9,14,1377,11,2016,8,3
Group 3,BB,-0.5,9,14,1378,10,2016,7,3
Group 3,BB,-0.5,9,14,1379,6,2016,5,1
Group 3,BB,-0.5,9,14,1380,11,2016,7,4
Group 3,BB,-0.5,9,14,1381,10,2016,7,3
Group 3,BB,-0.5,9,14,1382,9,2016,7,2
Group 3,BB,-0.5,9,14,1383,9,2016,7,2
Group 3,BB,-0.5,9,14,1384,6,2016,11,-5
Group 3,BB,-0.5,9,14,1385,6,2016,12,-6
Group 3,BB,-0.5,9,14,1386,7,2016,7,0
Group 3,BB,-0.5,9,14,1387,11,2016,9,2
Group 3,BB,-0.5,9,14,1388,8,2016,10,-2
Group 3,BB,-0.5,9,14,1389,10,2016,6,4
Group 3,BB,-0.5,9,14,1390,7,2016,6,1
Group 3,BB,-0.5,9,14,1391,8,2016,3,5
Group 3,BB,-0.5,9,14,1392,8,2016,9,-1
Group 3,BB,-0.5,9,14,1393,7,2016,10,-3
Group 3,BB,-0.5,9,14,1394,10,2016,7,3
Group 3,BB,-0.5,9,14,1395,10,2016,9,1
Group 3,BB,-0.5,9,14,1396,6,2016,8,-2
Group 3,BB,-0.5,9,14,1397,9,2016,6,3
Group 3,BB,-0.5,9,14,1398,11,2016,11,0
Group 3,BB,-0.5,9,14,1399,9,2016,10,-1
Group 3,BB,-0.5,9,14,1400,8,2016,9,-1
Group 3,BB,-0.5,9,14,1401,9,2016,4,5
Group 3,BB,-0.5,9,14,1402,9,2016,7,2
Group 3,BB,-0.5,9,14,1403,9,2016,9,0
Group 3,BB,-0.5,9,14,1404,10,2016,7,3
Group 3,BB,-0.5,9,14,1405,10,2016,6,4
Group 3,BB,-0.5,9,14,1406,6,2016,8,-2
Group 3,BB,-0.5,9,14,1407,10,2016,6,4
Group 3,BB,-0.5,9,14,1408,8,2016,5,3
Group 3,BB,-0.5,9,14,1409,11,2016,5,6
Group 3,BB,-0.5,9,14,1410,3,2016,9,-6
Group 3,BB,-0.5,9,14,1411,8,2016,2,6
Group 3,BB,-0.5,9,14,1412,13,2016,11,2
Group 3,BB,-0.5,9,14,1413,13,2016,8,5
Group 3,BB,-0.5,9,14,1414,9,2016,11,-2
Group 3,BB,-0.5,9,14,1415,11,2016,7,4
Group 3,BB,-0.5,9,14,1416,6,2016,4,2
Group 3,BB,-0.5,9,14,1417,9,2016,12,-3
Group 3,BB,-0.5,9,14,1418,11,2016,6,5
Group 3,BB,-0.5,9,14,1419,9,2016,10,-1
Group 3,BB,-0.5,9,14,1420,9,2016,10,-1
Group 3,BB,-0.5,9,14,1421,8,2016,7,1
Group 3,BB,-0.5,9,14,1422,9,2016,9,0
Group 3,BB,-0.5,9,14,1423,11,2016,5,6
Group 3,BB,-0.5,9,14,1424,12,2016,8,4
Group 3,BB,-0.5,9,14,1425,10,2016,9,1
Group 3,BB,-0.5,9,14,1426,8,2016,8,0
Group 3,BB,-0.5,9,14,1427,8,2016,12,-4
Group 3,BB,-0.5,9,14,1428,10,2016,11,-1
Group 3,BB,-0.5,9,14,1429,7,2016,13,-6
Group 3,BB,-0.5,9,14,1430,6,2016,7,-1
Group 3,BB,-0.5,9,14,1431,9,2016,4,5
Group 3,BB,-0.5,9,14,1432,9,2016,4,5
Group 3,BB,-0.5,9,14,1433,10,2016,9,1
Group 3,BB,-0.5,9,14,1434,6,2016,9,-3
Group 3,BB,-0.5,9,14,1435,8,2016,9,-1
Group 3,BB,-0.5,9,14,1436,10,2016,8,2
Group 3,BB,-0.5,9,14,1437,6,2016,10,-4
Group 3,BB,-0.5,9,14,1438,7,2016,9,-2
Group 3,BB,-0.5,9,14,1439,7,2016,9,-2
Group 3,BB,-0.5,9,14,1440,13,2016,10,3
Group 3,BB,-0.5,9,14,1441,13,2016,12,1
Group 3,BB,-0.5,9,14,1442,6,2016,6,0
Group 3,BB,-0.5,9,14,1443,7,2016,4,3
Group 3,BB,-0.5,9,14,1444,9,2016,6,3
Group 3,BB,-0.5,9,14,1445,7,2016,10,-3
Group 3,BB,-0.5,9,14,1446,9,2016,10,-1
Group 3,BB,-0.5,9,14,1447,10,2016,6,4
Group 3,BB,-0.5,9,14,1448,8,2016,4,4
Group 3,BB,-0.5,9,14,1449,8,2016,7,1
Group 3,BB,-0.5,9,14,1450,10,2016,9,1
Group 3,BB,-0.5,9,14,1451,5,2016,6,-1
Group 3,BB,-0.5,9,14,1452,9,2016,8,1
Group 3,BB,-0.5,9,14,1453,8,2016,8,0
Group 3,BB,-0.5,9,14,1454,8,2016,8,0
Group 3,BB,-0.5,9,14,1455,7,2016,10,-3
Group 3,BB,-0.5,9,14,1456,12,2016,6,6
Group 3,BB,-0.5,9,14,1457,9,2016,8,1
Group 3,BB,-0.5,9,14,1458,7,2016,8,-1
Group 3,BB,-0.5,9,14,1459,8,2016,10,-2
Group 3,BB,-0.5,9,14,1460,7,2016,3,4
Group 3,BB,-0.5,9,14,1461,13,2016,7,6
Group 3,BB,-0.5,9,14,1462,9,2016,8,1
Group 3,BB,-0.5,9,14,1463,10,2016,6,4
Group 3,BB,-0.5,9,14,1464,10,2016,7,3
Group 3,BB,-0.5,9,14,1465,10,2016,10,0
Group 3,BB,-0.5,9,14,1466,9,2016,8,1
Group 3,BB,-0.5,9,14,1467,10,2016,6,4
Group 3,BB,-0.5,9,14,1468,11,2016,7,4
Group 3,BB,-0.5,9,14,1469,11,2016,5,6
Group 3,BB,-0.5,9,14,1470,12,2016,6,6
Group 3,BB,-0.5,9,14,1471,9,2016,7,2
Group 3,BB,-0.5,9,14,1472,8,2016,6,2
Group 3,BB,-0.5,9,14,1473,10,2016,6,4
Group 3,BB,-0.5,9,14,1474,11,2016,7,4
Group 3,BB,-0.5,9,14,1475,10,2016,7,3
Group 3,BB,-0.5,9,14,1476,13,2016,10,3
Group 3,BB,-0.5,9,14,1477,12,2016,6,6
Group 3,BB,-0.5,9,14,1478,9,2016,4,5
Group 3,BB,-0.5,9,14,1479,10,2016,7,3
Group 3,BB,-0.5,9,14,1480,11,2016,13,-2
Group 3,BB,-0.5,9,14,1481,10,2016,8,2
Group 3,BB,-0.5,9,14,1482,11,2016,9,2
Group 3,BB,-0.5,9,14,1483,11,2016,9,2
Group 3,BB,-0.5,9,14,1484,9,2016,8,1
Group 3,BB,-0.5,9,14,1485,7,2016,9,-2
Group 3,BB,-0.5,9,14,1486,12,2016,9,3
Group 3,BB,-0.5,9,14,1487,11,2016,8,3
Group 3,BB,-0.5,9,14,1488,6,2016,4,2
Group 3,BB,-0.5,9,14,1489,12,2016,10,2
Group 3,BB,-0.5,9,14,1490,14,2016,9,5
Group 3,BB,-0.5,9,14,1491,11,2016,6,5
Group 3,BB,-0.5,9,14,1492,5,2016,4,1
Group 3,BB,-0.5,9,14,1493,11,2016,7,4
Group 3,BB,-0.5,9,14,1494,10,2016,9,1
Group 3,BB,-0.5,9,14,1495,12,2016,10,2
Group 3,BB,-0.5,9,14,1496,5,2016,5,0
Group 3,BB,-0.5,9,14,1497,11,2016,7,4
Group 3,BB,-0.5,9,14,1498,9,2016,10,-1
Group 3,BB,-0.5,9,14,1499,8,2016,6,2
Group 3,BB,-0.5,9,14,1500,11,2016,9,2
Group 3,BB,-0.5,9,14,1501,9,2016,11,-2
Group 3,BB,-0.5,9,14,1502,11,2016,8,3
Group 3,BB,-0.5,9,14,1503,12,2016,10,2
Group 3,BB,-0.5,9,14,1504,5,2016,10,-5
Group 3,BB,-0.5,9,14,1505,9,2016,10,-1
Group 3,BB,-0.5,9,14,1506,10,2016,4,6
Group 3,BB,-0.5,9,14,1507,9,2016,11,-2
Group 3,BB,-0.5,9,14,1508,9,2016,10,-1
Group 3,BB,-0.5,9,14,1509,12,2016,6,6
Group 3,BB,-0.5,9,14,1510,12,2016,8,4
Group 3,BB,-0.5,9,14,1511,10,2016,13,-3
Group 3,BB,-0.5,9,14,1512,9,2016,10,-1
Group 3,BB,-0.5,9,14,1513,10,2016,7,3
Group 3,BB,-0.5,9,14,1514,12,2016,13,-1
Group 3,BB,-0.5,9,14,1515,9,2016,10,-1
Group 3,BB,-0.5,9,14,1516,7,2016,8,-1
Group 3,BB,-0.5,9,14,1517,9,2016,4,5
Group 3,BB,-0.5,9,14,1518,11,2016,9,2
Group 3,BB,-0.5,9,14,1519,13,2016,7,6
Group 3,BB,-0.5,9,14,1520,11,2016,7,4
Group 3,BB,-0.5,9,14,1521,3,2016,8,-5
Group 3,BB,-0.5,9,14,1522,7,2016,8,-1
Group 3,BB,-0.5,9,14,1523,8,2016,8,0
Group 3,BB,-0.5,9,14,1524,10,2016,8,2
Group 3,BB,-0.5,9,14,1525,8,2016,12,-4
Group 3,BB,-0.5,9,14,1526,7,2016,7,0
Group 3,BB,-0.5,9,14,1527,9,2016,9,0
Group 3,BB,-0.5,9,14,1528,8,2016,6,2
Group 3,BB,-0.5,9,14,1529,7,2016,8,-1
Group 3,BB,-0.5,9,14,1530,9,2016,10,-1
Group 3,BB,-0.5,9,14,1531,10,2016,5,5
Group 3,BB,-0.5,9,14,1532,8,2016,10,-2
Group 3,BB,-0.5,9,14,1533,12,2016,7,5
Group 3,BB,-0.5,9,14,1534,10,2016,9,1
Group 3,BB,-0.5,9,14,1535,6,2016,4,2
Group 3,BB,-0.5,9,14,1536,11,2016,9,2
Group 3,BB,-0.5,9,14,1537,8,2016,9,-1
Group 3,BB,-0.5,9,14,1538,11,2016,9,2
Group 3,BB,-0.5,9,14,1539,11,2016,9,2
Group 3,BB,-0.5,9,14,1540,8,2016,6,2
Group 3,BB,-0.5,9,14,1541,10,2016,8,2
Group 3,BB,-0.5,9,14,1542,8,2016,7,1
Group 3,BB,-0.5,9,14,1543,10,2016,7,3
Group 3,BB,-0.5,9,14,1544,9,2016,4,5
Group 3,BB,-0.5,9,14,1545,6,2016,9,-3
Group 3,BB,-0.5,9,14,1546,8,2016,9,-1
Group 3,BB,-0.5,9,14,1547,12,2016,8,4
Group 3,BB,-0.5,9,14,1548,12,2016,9,3
Group 3,BB,-0.5,9,14,1549,8,2016,10,-2
Group 3,BB,-0.5,9,14,1550,8,2016,11,-3
Group 3,BB,-0.5,9,14,1551,5,2016,10,-5
Group 3,BB,-0.5,9,14,1552,13,2016,6,7
Group 3,BB,-0.5,9,14,1553,11,2016,8,3
Group 3,BB,-0.5,9,14,1554,10,2016,9,1
Group 3,BB,-0.5,9,14,1555,12,2016,7,5
Group 3,BB,-0.5,9,14,1556,10,2016,8,2
Group 3,BB,-0.5,9,14,1557,8,2016,6,2
Group 3,BB,-0.5,9,14,1558,10,2016,13,-3
Group 3,BB,-0.5,9,14,1559,9,2016,5,4
Group 3,BB,-0.5,9,14,1560,8,2016,8,0
Group 3,BB,-0.5,9,14,1561,8,2016,5,3
Group 3,BB,-0.5,9,14,1562,9,2016,10,-1
Group 3,BB,-0.5,9,14,1563,9,2016,4,5
Group 3,BB,-0.5,9,14,1564,7,2016,5,2
Group 3,BB,-0.5,9,14,1565,10,2016,7,3
Group 3,BB,-0.5,9,14,1566,12,2016,9,3
Group 3,BB,-0.5,9,14,1567,6,2016,8,-2
Group 3,BB,-0.5,9,14,1568,8,2016,5,3
Group 3,BB,-0.5,9,14,1569,13,2016,6,7
Group 3,BB,-0.5,9,14,1570,12,2016,7,5
Group 3,BB,-0.5,9,14,1571,7,2016,8,-1
Group 3,BB,-0.5,9,14,1572,7,2016,8,-1
Group 3,BB,-0.5,9,14,1573,8,2016,7,1
Group 3,BB,-0.5,9,14,1574,11,2016,10,1
Group 3,BB,-0.5,9,14,1575,11,2016,11,0
Group 3,BB,-0.5,9,14,1576,8,2016,11,-3
Group 3,BB,-0.5,9,14,1577,9,2016,11,-2
Group 3,BB,-0.5,9,14,1578,8,2016,8,0
Group 3,BB,-0.5,9,14,1579,9,2016,11,-2
Group 3,BB,-0.5,9,14,1580,8,2016,6,2
Group 3,BB,-0.5,9,14,1581,11,2016,8,3
Group 3,BB,-0.5,9,14,1582,11,2016,6,5
Group 3,BB,-0.5,9,14,1583,13,2016,9,4
Group 3,BB,-0.5,9,14,1584,11,2016,11,0
Group 3,BB,-0.5,9,14,1585,8,2016,12,-4
Group 3,BB,-0.5,9,14,1586,9,2016,7,2
Group 3,BB,-0.5,9,14,1587,12,2016,4,8
Group 3,BB,-0.5,9,14,1588,10,2016,9,1
Group 3,BB,-0.5,9,14,1589,6,2016,10,-4
Group 3,BB,-0.5,9,14,1590,12,2016,9,3
Group 3,BB,-0.5,9,14,1591,9,2016,9,0
Group 3,BB,-0.5,9,14,1592,7,2016,7,0
Group 3,BB,-0.5,9,14,1593,11,2016,7,4
Group 3,BB,-0.5,9,14,1594,8,2016,10,-2
Group 3,BB,-0.5,9,14,1595,9,2016,8,1
Group 3,BB,-0.5,9,14,1596,6,2016,7,-1
Group 3,BB,-0.5,9,14,1597,10,2016,6,4
Group 3,BB,-0.5,9,14,1598,6,2016,8,-2
Group 3,BB,-0.5,9,14,1599,7,2016,10,-3
Group 3,BB,-0.5,9,14,1600,8,2016,10,-2
Group 3,BB,-0.5,9,14,1601,11,2016,6,5
Group 3,BB,-0.5,9,14,1602,6,2016,6,0
Group 3,BB,-0.5,9,14,1603,11,2016,10,1
Group 3,BB,-0.5,9,14,1604,8,2016,9,-1
Group 3,BB,-0.5,9,14,1605,9,2016,11,-2
Group 3,BB,-0.5,9,14,1606,10,2016,9,1
Group 3,BB,-0.5,9,14,1607,9,2016,9,0
Group 3,BB,-0.5,9,14,1608,11,2016,7,4
Group 3,BB,-0.5,9,14,1609,5,2016,10,-5
Group 3,BB,-0.5,9,14,1610,9,2016,8,1
Group 3,BB,-0.5,9,14,1611,10,2016,6,4
Group 3,BB,-0.5,9,14,1612,9,2016,12,-3
Group 3,BB,-0.5,9,14,1613,8,2016,7,1
Group 3,BB,-0.5,9,14,1614,9,2016,7,2
Group 3,BB,-0.5,9,14,1615,8,2016,9,-1
Group 3,BB,-0.5,9,14,1616,11,2016,11,0
Group 3,BB,-0.5,9,14,1617,6,2016,10,-4
Group 3,BB,-0.5,9,14,1618,5,2016,10,-5
Group 3,BB,-0.5,9,14,1619,10,2016,7,3
Group 3,BB,-0.5,9,14,1620,10,2016,9,1
Group 3,BB,-0.5,9,14,1621,13,2016,10,3
Group 3,BB,-0.5,9,14,1622,9,2016,7,2
Group 3,BB,-0.5,9,14,1623,9,2016,6,3
Group 3,BB,-0.5,9,14,1624,7,2016,9,-2
Group 3,BB,-0.5,9,14,1625,9,2016,10,-1
Group 3,BB,-0.5,9,14,1626,10,2016,7,3
Group 3,BB,-0.5,9,14,1627,11,2016,9,2
Group 3,BB,-0.5,9,14,1628,8,2016,11,-3
Group 3,BB,-0.5,9,14,1629,6,2016,10,-4
Group 3,BB,-0.5,9,14,1630,8,2016,5,3
Group 3,BB,-0.5,9,14,1631,9,2016,4,5
Group 3,BB,-0.5,9,14,1632,5,2016,9,-4
Group 3,BB,-0.5,9,14,1633,8,2016,11,-3
Group 3,BB,-0.5,9,14,1634,9,2016,8,1
Group 3,BB,-0.5,9,14,1635,9,2016,7,2
Group 3,BB,-0.5,9,14,1636,9,2016,4,5
Group 3,BB,-0.5,9,14,1637,10,2016,11,-1
Group 3,BB,-0.5,9,14,1638,8,2016,12,-4
Group 3,BB,-0.5,9,14,1639,10,2016,8,2
Group 3,BB,-0.5,9,14,1640,10,2016,6,4
Group 3,BB,-0.5,9,14,1641,8,2016,5,3
Group 3,BB,-0.5,9,14,1642,8,2016,11,-3
Group 3,BB,-0.5,9,14,1643,11,2016,9,2
Group 3,BB,-0.5,9,14,1644,12,2016,10,2
Group 3,BB,-0.5,9,14,1645,10,2016,6,4
Group 3,BB,-0.5,9,14,1646,8,2016,7,1
Group 3,BB,-0.5,9,14,1647,9,2016,10,-1
Group 3,BB,-0.5,9,14,1648,11,2016,6,5
Group 3,BB,-0.5,9,14,1649,9,2016,8,1
Group 3,BB,-0.5,9,14,1650,8,2016,11,-3
Group 3,BB,-0.5,9,14,1651,6,2016,10,-4
Group 3,BB,-0.5,9,14,1652,12,2016,8,4
Group 3,BB,-0.5,9,14,1653,7,2016,6,1
Group 3,BB,-0.5,9,14,1654,8,2016,4,4
Group 3,BB,-0.5,9,14,1655,9,2016,9,0
Group 3,BB,-0.5,9,14,1656,7,2016,8,-1
Group 3,BB,-0.5,9,14,1657,13,2016,8,5
Group 3,BB,-0.5,9,14,1658,10,2016,11,-1
Group 3,BB,-0.5,9,14,1659,8,2016,10,-2
Group 3,BB,-0.5,9,14,1660,9,2016,11,-2
Group 3,BB,-0.5,9,14,1661,10,2016,8,2
Group 3,BB,-0.5,9,14,1662,11,2016,5,6
Group 3,BB,-0.5,9,14,1663,9,2016,6,3
Group 3,BB,-0.5,9,14,1664,10,2016,8,2
Group 3,BB,-0.5,9,14,1665,5,2016,7,-2
Group 3,BB,-0.5,9,14,1666,10,2016,10,0
Group 3,BB,-0.5,9,14,1667,10,2016,7,3
Group 3,BB,-0.5,9,14,1668,6,2016,11,-5
Group 3,BB,-0.5,9,14,1669,10,2016,11,-1
Group 3,BB,-0.5,9,14,1670,12,2016,11,1
Group 3,BB,-0.5,9,14,1671,8,2016,9,-1
Group 3,BB,-0.5,9,14,1672,10,2016,10,0
Group 3,BB,-0.5,9,14,1673,10,2016,7,3
Group 3,BB,-0.5,9,14,1674,8,2016,10,-2
Group 3,BB,-0.5,9,14,1675,11,2016,7,4
Group 3,BB,-0.5,9,14,1676,8,2016,8,0
Group 3,BB,-0.5,9,14,1677,9,2016,11,-2
Group 3,BB,-0.5,9,14,1678,13,2016,11,2
Group 3,BB,-0.5,9,14,1679,12,2016,9,3
Group 3,BB,-0.5,9,14,1680,7,2016,7,0
Group 3,BB,-0.5,9,14,1681,7,2016,13,-6
Group 3,BB,-0.5,9,14,1682,10,2016,9,1
Group 3,BB,-0.5,9,14,1683,8,2016,12,-4
Group 3,BB,-0.5,9,14,1684,11,2016,10,1
Group 3,BB,-0.5,9,14,1685,10,2016,8,2
Group 3,BB,-0.5,9,14,1686,8,2016,7,1
Group 3,BB,-0.5,9,14,1687,8,2016,9,-1
Group 3,BB,-0.5,9,14,1688,11,2016,5,6
Group 3,BB,-0.5,9,14,1689,12,2016,6,6
Group 3,BB,-0.5,9,14,1690,7,2016,8,-1
Group 3,BB,-0.5,9,14,1691,9,2016,11,-2
Group 3,BB,-0.5,9,14,1692,10,2016,11,-1
Group 3,BB,-0.5,9,14,1693,7,2016,8,-1
Group 3,BB,-0.5,9,14,1694,8,2016,9,-1
Group 3,BB,-0.5,9,14,1695,9,2016,6,3
Group 3,BB,-0.5,9,14,1696,11,2016,8,3
Group 3,BB,-0.5,9,14,1697,12,2016,9,3
Group 3,BB,-0.5,9,14,1698,11,2016,6,5
Group 3,BB,-0.5,9,14,1699,12,2016,9,3
Group 3,BB,-0.5,9,14,1700,10,2016,9,1
Group 3,BB,-0.5,9,14,1701,11,2016,10,1
Group 3,BB,-0.5,9,14,1702,8,2016,10,-2
Group 3,BB,-0.5,9,14,1703,9,2016,7,2
Group 3,BB,-0.5,9,14,1704,7,2016,7,0
Group 3,BB,-0.5,9,14,1705,7,2016,7,0
Group 3,BB,-0.5,9,14,1706,9,2016,10,-1
Group 3,BB,-0.5,9,14,1707,7,2016,9,-2
Group 3,BB,-0.5,9,14,1708,8,2016,9,-1
Group 3,BB,-0.5,9,14,1709,10,2016,9,1
Group 3,BB,-0.5,9,14,1710,8,2016,10,-2
Group 3,BB,-0.5,9,14,1711,9,2016,8,1
Group 3,BB,-0.5,9,14,1712,7,2016,8,-1
Group 3,BB,-0.5,9,14,1713,7,2016,11,-4
Group 3,BB,-0.5,9,14,1714,9,2016,7,2
Group 3,BB,-0.5,9,14,1715,12,2016,12,0
Group 3,BB,-0.5,9,14,1716,9,2016,8,1
Group 3,BB,-0.5,9,14,1717,9,2016,7,2
Group 3,BB,-0.5,9,14,1718,11,2016,11,0
Group 3,BB,-0.5,9,14,1719,8,2016,9,-1
Group 3,BB,-0.5,9,14,1720,10,2016,5,5
Group 3,BB,-0.5,9,14,1721,10,2016,8,2
Group 3,BB,-0.5,9,14,1722,10,2016,7,3
Group 3,BB,-0.5,9,14,1723,9,2016,8,1
Group 3,BB,-0.5,9,14,1724,11,2016,7,4
Group 3,BB,-0.5,9,14,1725,9,2016,8,1
Group 3,BB,-0.5,9,14,1726,8,2016,10,-2
Group 3,BB,-0.5,9,14,1727,7,2016,5,2
Group 3,BB,-0.5,9,14,1728,8,2016,8,0
Group 3,BB,-0.5,9,14,1729,9,2016,11,-2
Group 3,BB,-0.5,9,14,1730,12,2016,10,2
Group 3,BB,-0.5,9,14,1731,12,2016,6,6
Group 3,BB,-0.5,9,14,1732,10,2016,8,2
Group 3,BB,-0.5,9,14,1733,12,2016,9,3
Group 3,BB,-0.5,9,14,1734,10,2016,11,-1
Group 3,BB,-0.5,9,14,1735,10,2016,8,2
Group 3,BB,-0.5,9,14,1736,6,2016,4,2
Group 3,BB,-0.5,9,14,1737,13,2016,10,3
Group 3,BB,-0.5,9,14,1738,10,2016,9,1
Group 3,BB,-0.5,9,14,1739,10,2016,11,-1
Group 3,BB,-0.5,9,14,1740,9,2016,12,-3
Group 3,BB,-0.5,9,14,1741,11,2016,12,-1
Group 3,BB,-0.5,9,14,1742,7,2016,7,0
Group 3,BB,-0.5,9,14,1743,12,2016,8,4
Group 3,BB,-0.5,9,14,1744,13,2016,8,5
Group 3,BB,-0.5,9,14,1745,8,2016,11,-3
Group 3,BB,-0.5,9,14,1746,10,2016,9,1
Group 3,BB,-0.5,9,14,1747,7,2016,9,-2
Group 3,BB,-0.5,9,14,1748,11,2016,7,4
Group 3,BB,-0.5,9,14,1749,10,2016,7,3
Group 3,BB,-0.5,9,14,1750,9,2016,5,4
Group 3,BB,-0.5,9,14,1751,7,2016,8,-1
Group 3,BB,-0.5,9,14,1752,10,2016,12,-2
Group 3,BB,-0.5,9,14,1753,6,2016,9,-3
Group 3,BB,-0.5,9,14,1754,8,2016,6,2
Group 3,BB,-0.5,9,14,1755,8,2016,7,1
Group 3,BB,-0.5,9,14,1756,8,2016,7,1
Group 3,BB,-0.5,9,14,1757,8,2016,5,3
Group 3,BB,-0.5,9,14,1758,8,2016,5,3
Group 3,BB,-0.5,9,14,1759,11,2016,5,6
Group 3,BB,-0.5,9,14,1760,12,2016,7,5
Group 3,BB,-0.5,9,14,1761,9,2016,5,4
Group 3,BB,-0.5,9,14,1762,8,2016,7,1
Group 3,BB,-0.5,9,14,1763,10,2016,10,0
Group 3,BB,-0.5,9,14,1764,5,2016,4,1
Group 3,BB,-0.5,9,14,1765,8,2016,9,-1
Group 3,BB,-0.5,9,14,1766,8,2016,12,-4
Group 3,BB,-0.5,9,14,1767,10,2016,9,1
Group 3,BB,-0.5,9,14,1768,5,2016,9,-4
Group 3,BB,-0.5,9,14,1769,8,2016,9,-1
Group 3,BB,-0.5,9,14,1770,6,2016,5,1
Group 3,BB,-0.5,9,14,1771,5,2016,5,0
Group 3,BB,-0.5,9,14,1772,9,2016,7,2
Group 3,BB,-0.5,9,14,1773,7,2016,10,-3
Group 3,BB,-0.5,9,14,1774,12,2016,6,6
Group 3,BB,-0.5,9,14,1775,10,2016,7,3
Group 3,BB,-0.5,9,14,1776,7,2016,12,-5
Group 3,BB,-0.5,9,14,1777,6,2016,6,0
Group 3,BB,-0.5,9,14,1778,7,2016,9,-2
Group 3,BB,-0.5,9,14,1779,7,2016,10,-3
Group 3,BB,-0.5,9,14,1780,7,2016,7,0
Group 3,BB,-0.5,9,14,1781,10,2016,12,-2
Group 3,BB,-0.5,9,14,1782,7,2016,7,0
Group 3,BB,-0.5,9,14,1783,11,2016,8,3
Group 3,BB,-0.5,9,14,1784,12,2016,10,2
Group 3,BB,-0.5,9,14,1785,11,2016,9,2
Group 3,BB,-0.5,9,14,1786,9,2016,8,1
Group 3,BB,-0.5,9,14,1787,9,2016,8,1
Group 3,BB,-0.5,9,14,1788,7,2016,9,-2
Group 3,BB,-0.5,9,14,1789,9,2016,12,-3
Group 3,BB,-0.5,9,14,1790,11,2016,7,4
Group 3,BB,-0.5,9,14,1791,12,2016,6,6
Group 3,BB,-0.5,9,14,1792,7,2016,8,-1
Group 3,BB,-0.5,9,14,1793,9,2016,11,-2
Group 3,BB,-0.5,9,14,1794,10,2016,4,6
Group 3,BB,-0.5,9,14,1795,6,2016,6,0
Group 3,BB,-0.5,9,14,1796,7,2016,6,1
Group 3,BB,-0.5,9,14,1797,11,2016,7,4
Group 3,BB,-0.5,9,14,1798,10,2016,6,4
Group 3,BB,-0.5,9,14,1799,7,2016,9,-2
Group 3,BB,-0.5,9,14,1800,9,2016,10,-1
Group 3,BB,-0.5,9,14,1801,3,2016,7,-4
Group 3,BB,-0.5,9,14,1802,12,2016,5,7
Group 3,BB,-0.5,9,14,1803,9,2016,7,2
Group 3,BB,-0.5,9,14,1804,7,2016,7,0
Group 3,BB,-0.5,9,14,1805,7,2016,8,-1
Group 3,BB,-0.5,9,14,1806,9,2016,7,2
Group 3,BB,-0.5,9,14,1807,10,2016,4,6
Group 3,BB,-0.5,9,14,1808,11,2016,7,4
Group 3,BB,-0.5,9,14,1809,12,2016,5,7
Group 3,BB,-0.5,9,14,1810,10,2016,6,4
Group 3,BB,-0.5,9,14,1811,9,2016,5,4
Group 3,BB,-0.5,9,14,1812,10,2016,11,-1
Group 3,BB,-0.5,9,14,1813,9,2016,6,3
Group 3,BB,-0.5,9,14,1814,8,2016,6,2
Group 3,BB,-0.5,9,14,1815,7,2016,6,1
Group 3,BB,-0.5,9,14,1816,11,2016,9,2
Group 3,BB,-0.5,9,14,1817,11,2016,10,1
Group 3,BB,-0.5,9,14,1818,8,2016,8,0
Group 3,BB,-0.5,9,14,1819,10,2016,6,4
Group 3,BB,-0.5,9,14,1820,9,2016,6,3
Group 3,BB,-0.5,9,14,1821,7,2016,7,0
Group 3,BB,-0.5,9,14,1822,12,2016,7,5
Group 3,BB,-0.5,9,14,1823,10,2016,6,4
Group 3,BB,-0.5,9,14,1824,11,2016,10,1
Group 3,BB,-0.5,9,14,1825,6,2016,6,0
Group 3,BB,-0.5,9,14,1826,10,2016,6,4
Group 3,BB,-0.5,9,14,1827,9,2016,6,3
Group 3,BB,-0.5,9,14,1828,11,2016,8,3
Group 3,BB,-0.5,9,14,1829,9,2016,6,3
Group 3,BB,-0.5,9,14,1830,11,2016,7,4
Group 3,BB,-0.5,9,14,1831,6,2016,6,0
Group 3,BB,-0.5,9,14,1832,8,2016,9,-1
Group 3,BB,-0.5,9,14,1833,8,2016,6,2
Group 3,BB,-0.5,9,14,1834,10,2016,7,3
Group 3,BB,-0.5,9,14,1835,12,2016,8,4
Group 3,BB,-0.5,9,14,1836,4,2016,9,-5
Group 3,BB,-0.5,9,14,1837,9,2016,9,0
Group 3,BB,-0.5,9,14,1838,9,2016,11,-2
Group 3,BB,-0.5,9,14,1839,13,2016,9,4
Group 3,BB,-0.5,9,14,1840,9,2016,5,4
Group 3,BB,-0.5,9,14,1841,7,2016,8,-1
Group 3,BB,-0.5,9,14,1842,9,2016,9,0
Group 3,BB,-0.5,9,14,1843,7,2016,6,1
Group 3,BB,-0.5,9,14,1844,11,2016,9,2
Group 3,BB,-0.5,9,14,1845,7,2016,11,-4
Group 3,BB,-0.5,9,14,1846,8,2016,14,-6
Group 3,BB,-0.5,9,14,1847,10,2016,3,7
Group 3,BB,-0.5,9,14,1848,9,2016,3,6
Group 3,BB,-0.5,9,14,1849,11,2016,6,5
Group 3,BB,-0.5,9,14,1850,7,2016,7,0
Group 3,BB,-0.5,9,14,1851,9,2016,7,2
Group 3,BB,-0.5,9,14,1852,10,2016,11,-1
Group 3,BB,-0.5,9,14,1853,11,2016,9,2
Group 3,BB,-0.5,9,14,1854,10,2016,8,2
Group 3,BB,-0.5,9,14,1855,9,2016,9,0
Group 3,BB,-0.5,9,14,1856,9,2016,9,0
Group 3,BB,-0.5,9,14,1857,10,2016,6,4
Group 3,BB,-0.5,9,14,1858,12,2016,6,6
Group 3,BB,-0.5,9,14,1859,7,2016,6,1
Group 3,BB,-0.5,9,14,1860,6,2016,9,-3
Group 3,BB,-0.5,9,14,1861,8,2016,7,1
Group 3,BB,-0.5,9,14,1862,12,2016,7,5
Group 3,BB,-0.5,9,14,1863,11,2016,8,3
Group 3,BB,-0.5,9,14,1864,12,2016,6,6
Group 3,BB,-0.5,9,14,1865,12,2016,5,7
Group 3,BB,-0.5,9,14,1866,10,2016,7,3
Group 3,BB,-0.5,9,14,1867,11,2016,10,1
Group 3,BB,-0.5,9,14,1868,5,2016,8,-3
Group 3,BB,-0.5,9,14,1869,7,2016,8,-1
Group 3,BB,-0.5,9,14,1870,9,2016,12,-3
Group 3,BB,-0.5,9,14,1871,5,2016,6,-1
Group 3,BB,-0.5,9,14,1872,10,2016,10,0
Group 3,BB,-0.5,9,14,1873,7,2016,8,-1
Group 3,BB,-0.5,9,14,1874,9,2016,8,1
Group 3,BB,-0.5,9,14,1875,5,2016,8,-3
Group 3,BB,-0.5,9,14,1876,6,2016,8,-2
Group 3,BB,-0.5,9,14,1877,7,2016,6,1
Group 3,BB,-0.5,9,14,1878,8,2016,11,-3
Group 3,BB,-0.5,9,14,1879,10,2016,14,-4
Group 3,BB,-0.5,9,14,1880,10,2016,11,-1
Group 3,BB,-0.5,9,14,1881,5,2016,10,-5
Group 3,BB,-0.5,9,14,1882,10,2016,8,2
Group 3,BB,-0.5,9,14,1883,9,2016,11,-2
Group 3,BB,-0.5,9,14,1884,12,2016,7,5
Group 3,BB,-0.5,9,14,1885,11,2016,8,3
Group 3,BB,-0.5,9,14,1886,9,2016,7,2
Group 3,BB,-0.5,9,14,1887,9,2016,3,6
Group 3,BB,-0.5,9,14,1888,5,2016,7,-2
Group 3,BB,-0.5,9,14,1889,7,2016,9,-2
Group 3,BB,-0.5,9,14,1890,10,2016,10,0
Group 3,BB,-0.5,9,14,1891,11,2016,6,5
Group 3,BB,-0.5,9,14,1892,11,2016,8,3
Group 3,BB,-0.5,9,14,1893,9,2016,7,2
Group 3,BB,-0.5,9,14,1894,10,2016,7,3
Group 3,BB,-0.5,9,14,1895,7,2016,9,-2
Group 3,BB,-0.5,9,14,1896,7,2016,8,-1
Group 3,BB,-0.5,9,14,1897,12,2016,10,2
Group 3,BB,-0.5,9,14,1898,8,2016,7,1
Group 3,BB,-0.5,9,14,1899,8,2016,6,2
Group 3,BB,-0.5,9,14,1900,11,2016,8,3
Group 3,BB,-0.5,9,14,1901,11,2016,6,5
Group 3,BB,-0.5,9,14,1902,10,2016,6,4
Group 3,BB,-0.5,9,14,1903,12,2016,10,2
Group 3,BB,-0.5,9,14,1904,8,2016,10,-2
Group 3,BB,-0.5,9,14,1905,6,2016,9,-3
Group 3,BB,-0.5,9,14,1906,5,2016,9,-4
Group 3,BB,-0.5,9,14,1907,5,2016,9,-4
Group 3,BB,-0.5,9,14,1908,8,2016,8,0
Group 3,BB,-0.5,9,14,1909,10,2016,6,4
Group 3,BB,-0.5,9,14,1910,11,2016,10,1
Group 3,BB,-0.5,9,14,1911,12,2016,12,0
Group 3,BB,-0.5,9,14,1912,10,2016,7,3
Group 3,BB,-0.5,9,14,1913,12,2016,11,1
Group 3,BB,-0.5,9,14,1914,9,2016,4,5
Group 3,BB,-0.5,9,14,1915,8,2016,5,3
Group 3,BB,-0.5,9,14,1916,9,2016,11,-2
Group 3,BB,-0.5,9,14,1917,9,2016,11,-2
Group 3,BB,-0.5,9,14,1918,8,2016,8,0
Group 3,BB,-0.5,9,14,1919,10,2016,7,3
Group 3,BB,-0.5,9,14,1920,10,2016,7,3
Group 3,BB,-0.5,9,14,1921,11,2016,5,6
Group 3,BB,-0.5,9,14,1922,7,2016,6,1
Group 3,BB,-0.5,9,14,1923,9,2016,8,1
Group 3,BB,-0.5,9,14,1924,6,2016,10,-4
Group 3,BB,-0.5,9,14,1925,7,2016,6,1
Group 3,BB,-0.5,9,14,1926,7,2016,10,-3
Group 3,BB,-0.5,9,14,1927,8,2016,6,2
Group 3,BB,-0.5,9,14,1928,8,2016,7,1
Group 3,BB,-0.5,9,14,1929,12,2016,10,2
Group 3,BB,-0.5,9,14,1930,7,2016,7,0
Group 3,BB,-0.5,9,14,1931,13,2016,6,7
Group 3,BB,-0.5,9,14,1932,6,2016,9,-3
Group 3,BB,-0.5,9,14,1933,6,2016,9,-3
Group 3,BB,-0.5,9,14,1934,7,2016,8,-1
Group 3,BB,-0.5,9,14,1935,10,2016,9,1
Group 3,BB,-0.5,9,14,1936,12,2016,10,2
Group 3,BB,-0.5,9,14,1937,7,2016,9,-2
Group 3,BB,-0.5,9,14,1938,8,2016,13,-5
Group 3,BB,-0.5,9,14,1939,11,2016,5,6
Group 3,BB,-0.5,9,14,1940,8,2016,7,1
Group 3,BB,-0.5,9,14,1941,8,2016,9,-1
Group 3,BB,-0.5,9,14,1942,7,2016,9,-2
Group 3,BB,-0.5,9,14,1943,10,2016,8,2
Group 3,BB,-0.5,9,14,1944,10,2016,6,4
Group 3,BB,-0.5,9,14,1945,10,2016,11,-1
Group 3,BB,-0.5,9,14,1946,8,2016,8,0
Group 3,BB,-0.5,9,14,1947,10,2016,6,4
Group 3,BB,-0.5,9,14,1948,6,2016,10,-4
Group 3,BB,-0.5,9,14,1949,9,2016,9,0
Group 3,BB,-0.5,9,14,1950,10,2016,8,2
Group 3,BB,-0.5,9,14,1951,14,2016,9,5
Group 3,BB,-0.5,9,14,1952,9,2016,7,2
Group 3,BB,-0.5,9,14,1953,7,2016,5,2
Group 3,BB,-0.5,9,14,1954,11,2016,11,0
Group 3,BB,-0.5,9,14,1955,8,2016,9,-1
Group 3,BB,-0.5,9,14,1956,7,2016,7,0
Group 3,BB,-0.5,9,14,1957,7,2016,8,-1
Group 3,BB,-0.5,9,14,1958,8,2016,6,2
Group 3,BB,-0.5,9,14,1959,11,2016,6,5
Group 3,BB,-0.5,9,14,1960,11,2016,8,3
Group 3,BB,-0.5,9,14,1961,9,2016,8,1
Group 3,BB,-0.5,9,14,1962,12,2016,3,9
Group 3,BB,-0.5,9,14,1963,8,2016,6,2
Group 3,BB,-0.5,9,14,1964,11,2016,9,2
Group 3,BB,-0.5,9,14,1965,8,2016,5,3
Group 3,BB,-0.5,9,14,1966,7,2016,9,-2
Group 3,BB,-0.5,9,14,1967,8,2016,8,0
Group 3,BB,-0.5,9,14,1968,10,2016,10,0
Group 3,BB,-0.5,9,14,1969,10,2016,10,0
Group 3,BB,-0.5,9,14,1970,13,2016,9,4
Group 3,BB,-0.5,9,14,1971,5,2016,5,0
Group 3,BB,-0.5,9,14,1972,11,2016,8,3
Group 3,BB,-0.5,9,14,1973,11,2016,8,3
Group 3,BB,-0.5,9,14,1974,11,2016,9,2
Group 3,BB,-0.5,9,14,1975,13,2016,5,8
Group 3,BB,-0.5,9,14,1976,10,2016,4,6
Group 3,BB,-0.5,9,14,1977,12,2016,5,7
Group 3,BB,-0.5,9,14,1978,10,2016,8,2
Group 3,BB,-0.5,9,14,1979,8,2016,10,-2
Group 3,BB,-0.5,9,14,1980,7,2016,8,-1
Group 3,BB,-0.5,9,14,1981,9,2016,8,1
Group 3,BB,-0.5,9,14,1982,9,2016,8,1
Group 3,BB,-0.5,9,14,1983,7,2016,10,-3
Group 3,BB,-0.5,9,14,1984,7,2016,12,-5
Group 3,BB,-0.5,9,14,1985,10,2016,12,-2
Group 3,BB,-0.5,9,14,1986,7,2016,5,2
Group 3,BB,-0.5,9,14,1987,7,2016,13,-6
Group 3,BB,-0.5,9,14,1988,9,2016,10,-1
Group 3,BB,-0.5,9,14,1989,13,2016,3,10
Group 3,BB,-0.5,9,14,1990,12,2016,8,4
Group 3,BB,-0.5,9,14,1991,12,2016,8,4
Group 3,BB,-0.5,9,14,1992,9,2016,9,0
Group 3,BB,-0.5,9,14,1993,12,2016,7,5
Group 3,BB,-0.5,9,14,1994,13,2016,6,7
Group 3,BB,-0.5,9,14,1995,9,2016,9,0
Group 3,BB,-0.5,9,14,1996,9,2016,9,0
Group 3,BB,-0.5,9,14,1997,11,2016,5,6
Group 3,BB,-0.5,9,14,1998,3,2016,8,-5
Group 3,BB,-0.5,9,14,1999,5,2016,9,-4
Group 3,BB,-0.5,9,14,2000,11,2016,10,1
Group 3,BB,-0.5,9,14,2001,14,2016,11,3
Group 3,BB,-0.5,9,14,2002,9,2016,10,-1
Group 3,BB,-0.5,9,14,2003,10,2016,12,-2
Group 3,BB,-0.5,9,14,2004,13,2016,8,5
Group 3,BB,-0.5,9,14,2005,7,2016,8,-1
Group 3,BB,-0.5,9,14,2006,5,2016,7,-2
Group 3,BB,-0.5,9,14,2007,7,2016,11,-4
Group 3,BB,-0.5,9,14,2008,11,2016,7,4
Group 3,BB,-0.5,9,14,2009,6,2016,6,0
Group 3,BB,-0.5,9,14,2010,12,2016,10,2
Group 3,BB,-0.5,9,14,2011,11,2016,9,2
Group 3,BB,-0.5,9,14,2012,9,2016,5,4
Group 3,BB,-0.5,9,14,2013,7,2016,10,-3
Group 3,BB,-0.5,9,14,2014,8,2016,10,-2
Group 3,BB,-0.5,9,14,2015,11,2016,8,3
Group 3,BB,-0.5,9,14,2016,10,2016,8,2
Group 3,BB,-0.5,9,14,2017,8,2016,7,1
Group 3,BB,-0.5,9,14,2018,9,2016,4,5
Group 3,BB,-0.5,9,14,2019,9,2016,9,0
Group 3,BB,-0.5,9,14,2020,6,2016,8,-2
Group 3,BB,-0.5,9,14,2021,9,2016,4,5
Group 3,BB,-0.5,9,14,2022,4,2016,8,-4
Group 3,BB,-0.5,9,14,2023,10,2016,11,-1
Group 3,BB,-0.5,9,14,2024,12,2016,10,2
Group 3,BB,-0.5,9,14,2025,9,2016,11,-2
Group 3,BB,-0.5,9,14,2026,12,2016,10,2
Group 3,BB,-0.5,9,14,2027,10,2016,11,-1
Group 3,BB,-0.5,9,14,2028,7,2016,10,-3
Group 3,BB,-0.5,9,14,2029,8,2016,6,2
Group 3,BB,-0.5,9,14,2030,8,2016,12,-4
Group 3,BB,-0.5,9,14,2031,9,2016,5,4
Group 3,BB,-0.5,9,14,2032,9,2016,9,0
Group 3,BB,-0.5,9,14,2033,12,2016,9,3
Group 3,BB,-0.5,9,14,2034,8,2016,9,-1
Group 3,BB,-0.5,9,14,2035,7,2016,7,0
Group 3,BB,-0.5,9,14,2036,11,2016,7,4
Group 3,BB,-0.5,9,14,2037,10,2016,9,1
Group 3,BB,-0.5,9,14,2038,7,2016,9,-2
Group 3,BB,-0.5,9,14,2039,11,2016,9,2
Group 3,BB,-0.5,9,14,2040,10,2016,6,4
Group 3,BB,-0.5,9,14,2041,11,2016,8,3
Group 3,BB,-0.5,9,14,2042,10,2016,7,3
Group 3,BB,-0.5,9,14,2043,11,2016,6,5
Group 3,BB,-0.5,9,14,2044,7,2016,6,1
Group 3,BB,-0.5,9,14,2045,10,2016,7,3
Group 3,BB,-0.5,9,14,2046,10,2016,8,2
Group 3,BB,-0.5,9,14,2047,8,2016,3,5
Group 3,BB,-0.5,9,14,2048,13,2016,8,5
Group 3,BB,-0.5,9,14,2049,9,2016,7,2
Group 3,BB,-0.5,9,14,2050,11,2016,9,2
Group 3,BB,-0.5,9,14,2051,10,2016,10,0
Group 3,BB,-0.5,9,14,2052,9,2016,9,0
Group 3,BB,-0.5,9,14,2053,8,2016,7,1
Group 3,BB,-0.5,9,14,2054,10,2016,10,0
Group 3,BB,-0.5,9,14,2055,4,2016,8,-4
Group 3,BB,-0.5,9,14,2056,8,2016,8,0
Group 3,BB,-0.5,9,14,2057,11,2016,9,2
Group 3,BB,-0.5,9,14,2058,10,2016,10,0
Group 3,BB,-0.5,9,14,2059,11,2016,8,3
Group 3,BB,-0.5,9,14,2060,10,2016,10,0
Group 3,BB,-0.5,9,14,2061,10,2016,11,-1
Group 3,BB,-0.5,9,14,2062,9,2016,7,2
Group 3,BB,-0.5,9,14,2063,6,2016,8,-2
Group 3,BB,-0.5,9,14,2064,9,2016,4,5
Group 3,BB,-0.5,9,14,2065,9,2016,5,4
Group 3,BB,-0.5,9,14,2066,11,2016,10,1
Group 3,BB,-0.5,9,14,2067,10,2016,9,1
Group 3,BB,-0.5,9,14,2068,10,2016,11,-1
Group 3,BB,-0.5,9,14,2069,5,2016,8,-3
Group 3,BB,-0.5,9,14,2070,8,2016,7,1
Group 3,BB,-0.5,9,14,2071,12,2016,9,3
Group 3,BB,-0.5,9,14,2072,7,2016,7,0
Group 3,BB,-0.5,9,14,2073,12,2016,8,4
Group 3,BB,-0.5,9,14,2074,6,2016,6,0
Group 3,BB,-0.5,9,14,2075,8,2016,7,1
Group 3,BB,-0.5,9,14,2076,6,2016,9,-3
Group 3,BB,-0.5,9,14,2077,8,2016,8,0
Group 3,BB,-0.5,9,14,2078,10,2016,9,1
Group 3,BB,-0.5,9,14,2079,10,2016,8,2
Group 3,BB,-0.5,9,14,2080,8,2016,4,4
Group 3,BB,-0.5,9,14,2081,8,2016,7,1
Group 3,BB,-0.5,9,14,2082,8,2016,8,0
Group 3,BB,-0.5,9,14,2083,11,2016,5,6
Group 3,BB,-0.5,9,14,2084,10,2016,5,5
Group 3,BB,-0.5,9,14,2085,7,2016,7,0
Group 3,BB,-0.5,9,14,2086,8,2016,8,0
Group 3,BB,-0.5,9,14,2087,7,2016,9,-2
Group 3,BB,-0.5,9,14,2088,9,2016,6,3
Group 3,BB,-0.5,9,14,2089,10,2016,8,2
Group 3,BB,-0.5,9,14,2090,7,2016,9,-2
Group 3,BB,-0.5,9,14,2091,10,2016,6,4
Group 3,BB,-0.5,9,14,2092,9,2016,11,-2
Group 3,BB,-0.5,9,14,2093,13,2016,8,5
Group 3,BB,-0.5,9,14,2094,12,2016,11,1
Group 3,BB,-0.5,9,14,2095,4,2016,8,-4
Group 3,BB,-0.5,9,14,2096,7,2016,9,-2
Group 3,BB,-0.5,9,14,2097,7,2016,7,0
Group 3,BB,-0.5,9,14,2098,9,2016,9,0
Group 3,BB,-0.5,9,14,2099,8,2016,8,0
Group 3,BB,-0.5,9,14,2100,11,2016,7,4
Group 3,BB,-0.5,9,14,2101,10,2016,9,1
Group 3,BB,-0.5,9,14,2102,9,2016,8,1
Group 3,BB,-0.5,9,14,2103,9,2016,11,-2
Group 3,BB,-0.5,9,14,2104,11,2016,11,0
Group 3,BB,-0.5,9,14,2105,9,2016,10,-1
Group 3,BB,-0.5,9,14,2106,10,2016,8,2
Group 3,BB,-0.5,9,14,2107,6,2016,9,-3
Group 3,BB,-0.5,9,14,2108,10,2016,7,3
Group 3,BB,-0.5,9,14,2109,10,2016,8,2
Group 3,BB,-0.5,9,14,2110,10,2016,10,0
Group 3,BB,-0.5,9,14,2111,10,2016,11,-1
Group 3,BB,-0.5,9,14,2112,8,2016,7,1
Group 3,BB,-0.5,9,14,2113,11,2016,9,2
Group 3,BB,-0.5,9,14,2114,5,2016,6,-1
Group 3,BB,-0.5,9,14,2115,8,2016,4,4
Group 3,BB,-0.5,9,14,2116,8,2016,7,1
Group 3,BB,-0.5,9,14,2117,9,2016,7,2
Group 3,BB,-0.5,9,14,2118,10,2016,8,2
Group 3,BB,-0.5,9,14,2119,10,2016,7,3
Group 3,BB,-0.5,9,14,2120,12,2016,9,3
Group 3,BB,-0.5,9,14,2121,11,2016,9,2
Group 3,BB,-0.5,9,14,2122,8,2016,12,-4
Group 3,BB,-0.5,9,14,2123,9,2016,9,0
Group 3,BB,-0.5,9,14,2124,11,2016,10,1
Group 3,BB,-0.5,9,14,2125,9,2016,9,0
Group 3,BB,-0.5,9,14,2126,11,2016,10,1
Group 3,BB,-0.5,9,14,2127,8,2016,11,-3
Group 3,BB,-0.5,9,14,2128,7,2016,10,-3
Group 3,BB,-0.5,9,14,2129,8,2016,9,-1
Group 3,BB,-0.5,9,14,2130,10,2016,8,2
Group 3,BB,-0.5,9,14,2131,10,2016,6,4
Group 3,BB,-0.5,9,14,2132,14,2016,3,11
Group 3,BB,-0.5,9,14,2133,12,2016,3,9
Group 3,BB,-0.5,9,14,2134,8,2016,4,4
Group 3,BB,-0.5,9,14,2135,10,2016,6,4
Group 3,BB,-0.5,9,14,2136,10,2016,7,3
Group 3,BB,-0.5,9,14,2137,11,2016,7,4
Group 3,BB,-0.5,9,14,2138,6,2016,5,1
Group 3,BB,-0.5,9,14,2139,8,2016,10,-2
Group 3,BB,-0.5,9,14,2140,10,2016,5,5
Group 3,BB,-0.5,9,14,2141,11,2016,10,1
Group 3,BB,-0.5,9,14,2142,12,2016,5,7
Group 3,BB,-0.5,9,14,2143,5,2016,8,-3
Group 3,BB,-0.5,9,14,2144,8,2016,8,0
Group 3,BB,-0.5,9,14,2145,8,2016,6,2
Group 3,BB,-0.5,9,14,2146,10,2016,10,0
Group 3,BB,-0.5,9,14,2147,9,2016,9,0
Group 3,BB,-0.5,9,14,2148,6,2016,9,-3
Group 3,BB,-0.5,9,14,2149,4,2016,4,0
Group 3,BB,-0.5,9,14,2150,10,2016,7,3
Group 3,BB,-0.5,9,14,2151,11,2016,6,5
Group 3,BB,-0.5,9,14,2152,9,2016,11,-2
Group 3,BB,-0.5,9,14,2153,14,2016,11,3
Group 3,BB,-0.5,9,14,2154,8,2016,10,-2
Group 3,BB,-0.5,9,14,2155,4,2016,6,-2
Group 3,BB,-0.5,9,14,2156,11,2016,8,3
Group 3,BB,-0.5,9,14,2157,12,2016,6,6
Group 3,BB,-0.5,9,14,2158,12,2016,10,2
Group 3,BB,-0.5,9,14,2159,10,2016,7,3
Group 3,BB,-0.5,9,14,2160,8,2016,7,1
Group 3,BB,-0.5,9,14,2161,10,2016,10,0
Group 3,BB,-0.5,9,14,2162,11,2016,9,2
Group 3,BB,-0.5,9,14,2163,8,2016,11,-3
Group 3,BB,-0.5,9,14,2164,10,2016,13,-3
Group 3,BB,-0.5,9,14,2165,8,2016,7,1
Group 3,BB,-0.5,9,14,2166,11,2016,11,0
Group 3,BB,-0.5,9,14,2167,6,2016,8,-2
Group 3,BB,-0.5,9,14,2168,12,2016,9,3
Group 3,BB,-0.5,9,14,2169,11,2016,4,7
Group 3,BB,-0.5,9,14,2170,11,2016,4,7
Group 3,BB,-0.5,9,14,2171,12,2016,1,11
Group 3,BB,-0.5,9,14,2172,9,2016,6,3
Group 3,BB,-0.5,9,14,2173,11,2016,9,2
Group 3,BB,-0.5,9,14,2174,7,2016,8,-1
Group 3,BB,-0.5,9,14,2175,8,2016,12,-4
Group 3,BB,-0.5,9,14,2176,5,2016,8,-3
Group 3,BB,-0.5,9,14,2177,11,2016,10,1
Group 3,BB,-0.5,9,14,2178,11,2016,10,1
Group 3,BB,-0.5,9,14,2179,8,2016,7,1
Group 3,BB,-0.5,9,14,2180,10,2016,7,3
Group 3,BB,-0.5,9,14,2181,4,2016,7,-3
Group 3,BB,-0.5,9,14,2182,7,2016,9,-2
Group 3,BB,-0.5,9,14,2183,9,2016,7,2
Group 3,BB,-0.5,9,14,2184,8,2016,10,-2
Group 3,BB,-0.5,9,14,2185,12,2016,8,4
Group 3,BB,-0.5,9,14,2186,7,2016,5,2
Group 3,BB,-0.5,9,14,2187,5,2016,8,-3
Group 3,BB,-0.5,9,14,2188,11,2016,6,5
Group 3,BB,-0.5,9,14,2189,7,2016,6,1
Group 3,BB,-0.5,9,14,2190,8,2016,10,-2
Group 3,BB,-0.5,9,14,2191,10,2016,11,-1
Group 3,BB,-0.5,9,14,2192,9,2016,8,1
Group 3,BB,-0.5,9,14,2193,10,2016,7,3
Group 3,BB,-0.5,9,14,2194,11,2016,8,3
Group 3,BB,-0.5,9,14,2195,9,2016,9,0
Group 3,BB,-0.5,9,14,2196,10,2016,8,2
Group 3,BB,-0.5,9,14,2197,11,2016,8,3
Group 3,BB,-0.5,9,14,2198,9,2016,9,0
Group 3,BB,-0.5,9,14,2199,11,2016,9,2
Group 3,BB,-0.5,9,14,2200,10,2016,9,1
Group 3,BB,-0.5,9,14,2201,8,2016,4,4
Group 3,BB,-0.5,9,14,2202,8,2016,13,-5
Group 3,BB,-0.5,9,14,2203,10,2016,9,1
Group 3,BB,-0.5,9,14,2204,7,2016,10,-3
Group 3,BB,-0.5,9,14,2205,9,2016,9,0
Group 3,BB,-0.5,9,14,2206,10,2016,9,1
Group 3,BB,-0.5,9,14,2207,9,2016,9,0
Group 3,BB,-0.5,9,14,2208,7,2016,5,2
Group 3,BB,-0.5,9,14,2209,6,2016,6,0
Group 3,BB,-0.5,9,14,2210,11,2016,9,2
Group 3,BB,-0.5,9,14,2211,8,2016,11,-3
Group 3,BB,-0.5,9,14,2212,8,2016,10,-2
Group 3,BB,-0.5,9,14,2213,10,2016,8,2
Group 3,BB,-0.5,9,14,2214,11,2016,7,4
Group 3,BB,-0.5,9,14,2215,11,2016,8,3
Group 3,BB,-0.5,9,14,2216,12,2016,7,5
Group 3,BB,-0.5,9,14,2217,11,2016,9,2
Group 3,BB,-0.5,9,14,2218,7,2016,9,-2
Group 3,BB,-0.5,9,14,2219,10,2016,8,2
Group 3,BB,-0.5,9,14,2220,7,2016,9,-2
Group 3,BB,-0.5,9,14,2221,9,2016,8,1
Group 3,BB,-0.5,9,14,2222,9,2016,11,-2
Group 3,BB,-0.5,9,14,2223,11,2016,5,6
Group 3,BB,-0.5,9,14,2224,7,2016,10,-3
Group 3,BB,-0.5,9,14,2225,6,2016,11,-5
Group 3,BB,-0.5,9,14,2226,10,2016,3,7
Group 3,BB,-0.5,9,14,2227,8,2016,8,0
Group 3,BB,-0.5,9,14,2228,10,2016,10,0
Group 3,BB,-0.5,9,14,2229,9,2016,11,-2
Group 3,BB,-0.5,9,14,2230,9,2016,10,-1
Group 3,BB,-0.5,9,14,2231,8,2016,6,2
Group 3,BB,-0.5,9,14,2232,9,2016,7,2
Group 3,BB,-0.5,9,14,2233,9,2016,5,4
Group 3,BB,-0.5,9,14,2234,7,2016,8,-1
Group 3,BB,-0.5,9,14,2235,12,2016,11,1
Group 3,BB,-0.5,9,14,2236,7,2016,9,-2
Group 3,BB,-0.5,9,14,2237,12,2016,10,2
Group 3,BB,-0.5,9,14,2238,10,2016,9,1
Group 3,BB,-0.5,9,14,2239,8,2016,9,-1
Group 3,BB,-0.5,9,14,2240,13,2016,10,3
Group 3,BB,-0.5,9,14,2241,8,2016,7,1
Group 3,BB,-0.5,9,14,2242,7,2016,7,0
Group 3,BB,-0.5,9,14,2243,11,2016,5,6
Group 3,BB,-0.5,9,14,2244,9,2016,9,0
Group 3,BB,-0.5,9,14,2245,9,2016,9,0
Group 3,BB,-0.5,9,14,2246,7,2016,8,-1
Group 3,BB,-0.5,9,14,2247,10,2016,9,1
Group 3,BB,-0.5,9,14,2248,10,2016,11,-1
Group 3,BB,-0.5,9,14,2249,11,2016,9,2
Group 3,BB,-0.5,9,14,2250,12,2016,11,1
Group 3,BB,-0.5,9,14,2251,7,2016,6,1
Group 3,BB,-0.5,9,14,2252,12,2016,8,4
Group 3,BB,-0.5,9,14,2253,8,2016,6,2
Group 3,BB,-0.5,9,14,2254,13,2016,10,3
Group 3,BB,-0.5,9,14,2255,11,2016,8,3
Group 3,BB,-0.5,9,14,2256,6,2016,10,-4
Group 3,BB,-0.5,9,14,2257,8,2016,9,-1
Group 3,BB,-0.5,9,14,2258,10,2016,8,2
Group 3,BB,-0.5,9,14,2259,7,2016,4,3
Group 3,BB,-0.5,9,14,2260,7,2016,6,1
Group 3,BB,-0.5,9,14,2261,11,2016,6,5
Group 3,BB,-0.5,9,14,2262,7,2016,7,0
Group 3,BB,-0.5,9,14,2263,11,2016,10,1
Group 3,BB,-0.5,9,14,2264,10,2016,8,2
Group 3,BB,-0.5,9,14,2265,6,2016,6,0
Group 3,BB,-0.5,9,14,2266,11,2016,6,5
Group 3,BB,-0.5,9,14,2267,7,2016,10,-3
Group 3,BB,-0.5,9,14,2268,11,2016,8,3
Group 3,BB,-0.5,9,14,2269,10,2016,9,1
Group 3,BB,-0.5,9,14,2270,10,2016,10,0
Group 3,BB,-0.5,9,14,2271,12,2016,7,5
Group 3,BB,-0.5,9,14,2272,10,2016,8,2
Group 3,BB,-0.5,9,14,2273,10,2016,2,8
Group 3,BB,-0.5,9,14,2274,11,2016,6,5
Group 3,BB,-0.5,9,14,2275,8,2016,7,1
Group 3,BB,-0.5,9,14,2276,6,2016,10,-4
Group 3,BB,-0.5,9,14,2277,9,2016,9,0
Group 3,BB,-0.5,9,14,2278,9,2016,4,5
Group 3,BB,-0.5,9,14,2279,6,2016,7,-1
Group 3,BB,-0.5,9,14,2280,10,2016,5,5
Group 3,BB,-0.5,9,14,2281,9,2016,6,3
Group 3,BB,-0.5,9,14,2282,9,2016,6,3
Group 3,BB,-0.5,9,14,2283,10,2016,7,3
Group 3,BB,-0.5,9,14,2284,8,2016,9,-1
Group 3,BB,-0.5,9,14,2285,7,2016,11,-4
Group 3,BB,-0.5,9,14,2286,7,2016,9,-2
Group 3,BB,-0.5,9,14,2287,5,2016,7,-2
Group 3,BB,-0.5,9,14,2288,7,2016,8,-1
Group 3,BB,-0.5,9,14,2289,8,2016,7,1
Group 3,BB,-0.5,9,14,2290,8,2016,8,0
Group 3,BB,-0.5,9,14,2291,10,2016,4,6
Group 3,BB,-0.5,9,14,2292,11,2016,8,3
Group 3,BB,-0.5,9,14,2293,9,2016,8,1
Group 3,BB,-0.5,9,14,2294,11,2016,9,2
Group 3,BB,-0.5,9,14,2295,9,2016,7,2
Group 3,BB,-0.5,9,14,2296,7,2016,6,1
Group 3,BB,-0.5,9,14,2297,9,2016,10,-1
Group 3,BB,-0.5,9,14,2298,6,2016,8,-2
Group 3,BB,-0.5,9,14,2299,8,2016,7,1
Group 3,BB,-0.5,9,14,2300,6,2016,3,3
Group 3,BB,-0.5,9,14,2301,9,2016,9,0
Group 3,BB,-0.5,9,14,2302,9,2016,8,1
Group 3,BB,-0.5,9,14,2303,10,2016,7,3
Group 3,BB,-0.5,9,14,2304,9,2016,7,2
Group 3,BB,-0.5,9,14,2305,11,2016,11,0
Group 3,BB,-0.5,9,14,2306,11,2016,4,7
Group 3,BB,-0.5,9,14,2307,9,2016,9,0
Group 3,BB,-0.5,9,14,2308,9,2016,10,-1
Group 3,BB,-0.5,9,14,2309,8,2016,8,0
Group 3,BB,-0.5,9,14,2310,9,2016,12,-3
Group 3,BB,-0.5,9,14,2311,7,2016,8,-1
Group 3,BB,-0.5,9,14,2312,4,2016,10,-6
Group 3,BB,-0.5,9,14,2313,11,2016,8,3
Group 3,BB,-0.5,9,14,2314,11,2016,7,4
Group 3,BB,-0.5,9,14,2315,9,2016,7,2
Group 3,BB,-0.5,9,14,2316,7,2016,9,-2
Group 3,BB,-0.5,9,14,2317,11,2016,9,2
Group 3,BB,-0.5,9,14,2318,8,2016,9,-1
Group 3,BB,-0.5,9,14,2319,12,2016,9,3
Group 3,BB,-0.5,9,14,2320,8,2016,8,0
Group 3,BB,-0.5,9,14,2321,9,2016,11,-2
Group 3,BB,-0.5,9,14,2322,11,2016,8,3
Group 3,BB,-0.5,9,14,2323,11,2016,12,-1
Group 3,BB,-0.5,9,14,2324,8,2016,9,-1
Group 3,BB,-0.5,9,14,2325,12,2016,8,4
Group 3,BB,-0.5,9,14,2326,13,2016,8,5
Group 3,BB,-0.5,9,14,2327,9,2016,5,4
Group 3,BB,-0.5,9,14,2328,10,2016,10,0
Group 3,BB,-0.5,9,14,2329,8,2016,4,4
Group 3,BB,-0.5,9,14,2330,9,2016,7,2
Group 3,BB,-0.5,9,14,2331,12,2016,7,5
Group 3,BB,-0.5,9,14,2332,7,2016,13,-6
Group 3,BB,-0.5,9,14,2333,9,2016,11,-2
Group 3,BB,-0.5,9,14,2334,9,2016,9,0
Group 3,BB,-0.5,9,14,2335,10,2016,8,2
Group 3,BB,-0.5,9,14,2336,9,2016,8,1
Group 3,BB,-0.5,9,14,2337,11,2016,9,2
Group 3,BB,-0.5,9,14,2338,8,2016,11,-3
Group 3,BB,-0.5,9,14,2339,8,2016,9,-1
Group 3,BB,-0.5,9,14,2340,8,2016,2,6
Group 3,BB,-0.5,9,14,2341,12,2016,9,3
Group 3,BB,-0.5,9,14,2342,10,2016,8,2
Group 3,BB,-0.5,9,14,2343,11,2016,9,2
Group 3,BB,-0.5,9,14,2344,10,2016,7,3
Group 3,BB,-0.5,9,14,2345,8,2016,8,0
Group 3,BB,-0.5,9,14,2346,12,2016,11,1
Group 3,BB,-0.5,9,14,2347,10,2016,10,0
Group 3,BB,-0.5,9,14,2348,8,2016,7,1
Group 3,BB,-0.5,9,14,2349,10,2016,5,5
Group 3,BB,-0.5,9,14,2350,10,2016,11,-1
Group 3,BB,-0.5,9,14,2351,8,2016,7,1
Group 3,BB,-0.5,9,14,2352,5,2016,6,-1
Group 3,BB,-0.5,9,14,2353,9,2016,7,2
Group 3,BB,-0.5,9,14,2354,5,2016,9,-4
Group 3,BB,-0.5,9,14,2355,8,2016,11,-3
Group 3,BB,-0.5,9,14,2356,11,2016,11,0
Group 3,BB,-0.5,9,14,2357,12,2016,6,6
Group 3,BB,-0.5,9,14,2358,8,2016,8,0
Group 3,BB,-0.5,9,14,2359,9,2016,12,-3
Group 3,BB,-0.5,9,14,2360,9,2016,8,1
Group 3,BB,-0.5,9,14,2361,9,2016,9,0
Group 3,BB,-0.5,9,14,2362,9,2016,9,0
Group 3,BB,-0.5,9,14,2363,7,2016,4,3
Group 3,BB,-0.5,9,14,2364,14,2016,9,5
Group 3,BB,-0.5,9,14,2365,10,2016,6,4
Group 3,BB,-0.5,9,14,2366,10,2016,3,7
Group 3,BB,-0.5,9,14,2367,8,2016,9,-1
Group 3,BB,-0.5,9,14,2368,11,2016,13,-2
Group 3,BB,-0.5,9,14,2369,7,2016,12,-5
Group 3,BB,-0.5,9,14,2370,10,2016,9,1
Group 3,BB,-0.5,9,14,2371,11,2016,9,2
Group 3,BB,-0.5,9,14,2372,12,2016,11,1
Group 3,BB,-0.5,9,14,2373,7,2016,5,2
Group 3,BB,-0.5,9,14,2374,11,2016,7,4
Group 3,BB,-0.5,9,14,2375,10,2016,9,1
Group 3,BB,-0.5,9,14,2376,11,2016,9,2
Group 3,BB,-0.5,9,14,2377,12,2016,11,1
Group 3,BB,-0.5,9,14,2378,12,2016,7,5
Group 3,BB,-0.5,9,14,2379,6,2016,8,-2
Group 3,BB,-0.5,9,14,2380,8,2016,12,-4
Group 3,BB,-0.5,9,14,2381,8,2016,7,1
Group 3,BB,-0.5,9,14,2382,9,2016,5,4
Group 3,BB,-0.5,9,14,2383,10,2016,6,4
Group 3,BB,-0.5,9,14,2384,9,2016,8,1
Group 3,BB,-0.5,9,14,2385,7,2016,8,-1
Group 3,BB,-0.5,9,14,2386,8,2016,9,-1
Group 3,BB,-0.5,9,14,2387,9,2016,6,3
Group 3,BB,-0.5,9,14,2388,13,2016,8,5
Group 3,BB,-0.5,9,14,2389,7,2016,7,0
Group 3,BB,-0.5,9,14,2390,14,2016,11,3
Group 3,BB,-0.5,9,14,2391,12,2016,9,3
Group 3,BB,-0.5,9,14,2392,9,2016,8,1
Group 3,BB,-0.5,9,14,2393,11,2016,7,4
Group 3,BB,-0.5,9,14,2394,9,2016,5,4
Group 3,BB,-0.5,9,14,2395,12,2016,4,8
Group 3,BB,-0.5,9,14,2396,9,2016,7,2
Group 3,BB,-0.5,9,14,2397,8,2016,5,3
Group 3,BB,-0.5,9,14,2398,7,2016,10,-3
Group 3,BB,-0.5,9,14,2399,11,2016,5,6
Group 3,BB,-0.5,9,14,2400,11,2016,13,-2
Group 3,BB,-0.5,9,14,2401,11,2016,7,4
Group 3,BB,-0.5,9,14,2402,9,2016,2,7
Group 3,BB,-0.5,9,14,2403,9,2016,9,0
Group 3,BB,-0.5,9,14,2404,10,2016,8,2
Group 3,BB,-0.5,9,14,2405,11,2016,4,7
Group 3,BB,-0.5,9,14,2406,8,2016,12,-4
Group 3,BB,-0.5,9,14,2407,9,2016,10,-1
Group 3,BB,-0.5,9,14,2408,3,2016,8,-5
Group 3,BB,-0.5,9,14,2409,12,2016,8,4
Group 3,BB,-0.5,9,14,2410,13,2016,9,4
Group 3,BB,-0.5,9,14,2411,12,2016,9,3
Group 3,BB,-0.5,9,14,2412,8,2016,13,-5
Group 3,BB,-0.5,9,14,2413,9,2016,5,4
Group 3,BB,-0.5,9,14,2414,9,2016,9,0
Group 3,BB,-0.5,9,14,2415,10,2016,8,2
Group 3,BB,-0.5,9,14,2416,9,2016,7,2
Group 3,BB,-0.5,9,14,2417,9,2016,9,0
Group 3,BB,-0.5,9,14,2418,11,2016,9,2
Group 3,BB,-0.5,9,14,2419,9,2016,6,3
Group 3,BB,-0.5,9,14,2420,12,2016,6,6
Group 3,BB,-0.5,9,14,2421,11,2016,6,5
Group 3,BB,-0.5,9,14,2422,10,2016,8,2
Group 3,BB,-0.5,9,14,2423,9,2016,8,1
Group 3,BB,-0.5,9,14,2424,7,2016,10,-3
Group 3,BB,-0.5,9,14,2425,7,2016,7,0
Group 3,BB,-0.5,9,14,2426,7,2016,7,0
Group 3,BB,-0.5,9,14,2427,8,2016,10,-2
Group 3,BB,-0.5,9,14,2428,6,2016,8,-2
Group 3,BB,-0.5,9,14,2429,10,2016,8,2
Group 3,BB,-0.5,9,14,2430,9,2016,11,-2
Group 3,BB,-0.5,9,14,2431,8,2016,7,1
Group 3,BB,-0.5,9,14,2432,11,2016,6,5
Group 3,BB,-0.5,9,14,2433,12,2016,9,3
Group 3,BB,-0.5,9,14,2434,4,2016,5,-1
Group 3,BB,-0.5,9,14,2435,10,2016,9,1
Group 3,BB,-0.5,9,14,2436,9,2016,6,3
Group 3,BB,-0.5,9,14,2437,5,2016,10,-5
Group 3,BB,-0.5,9,14,2438,8,2016,10,-2
Group 3,BB,-0.5,9,14,2439,7,2016,7,0
Group 3,BB,-0.5,9,14,2440,5,2016,10,-5
Group 3,BB,-0.5,9,14,2441,11,2016,4,7
Group 3,BB,-0.5,9,14,2442,9,2016,9,0
Group 3,BB,-0.5,9,14,2443,6,2016,9,-3
Group 3,BB,-0.5,9,14,2444,8,2016,8,0
Group 3,BB,-0.5,9,14,2445,8,2016,9,-1
Group 3,BB,-0.5,9,14,2446,10,2016,11,-1
Group 3,BB,-0.5,9,14,2447,8,2016,10,-2
Group 3,BB,-0.5,9,14,2448,11,2016,9,2
Group 3,BB,-0.5,9,14,2449,11,2016,7,4
Group 3,BB,-0.5,9,14,2450,12,2016,5,7
Group 3,BB,-0.5,9,14,2451,12,2016,11,1
Group 3,BB,-0.5,9,14,2452,8,2016,11,-3
Group 3,BB,-0.5,9,14,2453,8,2016,9,-1
Group 3,BB,-0.5,9,14,2454,7,2016,11,-4
Group 3,BB,-0.5,9,14,2455,7,2016,9,-2
Group 3,BB,-0.5,9,14,2456,7,2016,8,-1
Group 3,BB,-0.5,9,14,2457,12,2016,12,0
Group 3,BB,-0.5,9,14,2458,9,2016,12,-3
Group 3,BB,-0.5,9,14,2459,7,2016,8,-1
Group 3,BB,-0.5,9,14,2460,11,2016,10,1
Group 3,BB,-0.5,9,14,2461,7,2016,10,-3
Group 3,BB,-0.5,9,14,2462,7,2016,6,1
Group 3,BB,-0.5,9,14,2463,9,2016,9,0
Group 3,BB,-0.5,9,14,2464,9,2016,9,0
Group 3,BB,-0.5,9,14,2465,10,2016,7,3
Group 3,BB,-0.5,9,14,2466,8,2016,7,1
Group 3,BB,-0.5,9,14,2467,8,2016,9,-1
Group 3,BB,-0.5,9,14,2468,10,2016,8,2
Group 3,BB,-0.5,9,14,2469,13,2016,9,4
Group 3,BB,-0.5,9,14,2470,5,2016,10,-5
Group 3,BB,-0.5,9,14,2471,10,2016,10,0
Group 3,BB,-0.5,9,14,2472,8,2016,9,-1
Group 3,BB,-0.5,9,14,2473,9,2016,5,4
Group 3,BB,-0.5,9,14,2474,12,2016,9,3
Group 3,BB,-0.5,9,14,2475,9,2016,11,-2
Group 3,BB,-0.5,9,14,2476,10,2016,5,5
Group 3,BB,-0.5,9,14,2477,8,2016,10,-2
Group 3,BB,-0.5,9,14,2478,8,2016,7,1
Group 3,BB,-0.5,9,14,2479,10,2016,5,5
Group 3,BB,-0.5,9,14,2480,12,2016,9,3
Group 3,BB,-0.5,9,14,2481,7,2016,5,2
Group 3,BB,-0.5,9,14,2482,7,2016,9,-2
Group 3,BB,-0.5,9,14,2483,6,2016,7,-1
Group 3,BB,-0.5,9,14,2484,12,2016,8,4
Group 3,BB,-0.5,9,14,2485,12,2016,6,6
Group 3,BB,-0.5,9,14,2486,6,2016,8,-2
Group 3,BB,-0.5,9,14,2487,7,2016,7,0
Group 3,BB,-0.5,9,14,2488,8,2016,8,0
Group 3,BB,-0.5,9,14,2489,10,2016,9,1
Group 3,BB,-0.5,9,14,2490,9,2016,10,-1
Group 3,BB,-0.5,9,14,2491,7,2016,5,2
Group 3,BB,-0.5,9,14,2492,9,2016,10,-1
Group 3,BB,-0.5,9,14,2493,8,2016,9,-1
Group 3,BB,-0.5,9,14,2494,9,2016,7,2
Group 3,BB,-0.5,9,14,2495,9,2016,7,2
Group 3,BB,-0.5,9,14,2496,10,2016,11,-1
Group 3,BB,-0.5,9,14,2497,11,2016,8,3
Group 3,BB,-0.5,9,14,2498,11,2016,6,5
Group 3,BB,-0.5,9,14,2499,7,2016,10,-3
Group 3,BB,-0.5,9,14,2500,9,2016,10,-1
Group 3,BB,-0.5,9,14,2501,12,2016,6,6
Group 3,BB,-0.5,9,14,2502,9,2016,7,2
Group 3,BB,-0.5,9,14,2503,10,2016,10,0
Group 3,BB,-0.5,9,14,2504,10,2016,12,-2
Group 3,BB,-0.5,9,14,2505,6,2016,6,0
Group 3,BB,-0.5,9,14,2506,9,2016,6,3
Group 3,BB,-0.5,9,14,2507,8,2016,5,3
Group 3,BB,-0.5,9,14,2508,6,2016,12,-6
Group 3,BB,-0.5,9,14,2509,7,2016,11,-4
Group 3,BB,-0.5,9,14,2510,7,2016,11,-4
Group 3,BB,-0.5,9,14,2511,4,2016,10,-6
Group 3,BB,-0.5,9,14,2512,11,2016,9,2
Group 3,BB,-0.5,9,14,2513,9,2016,8,1
Group 3,BB,-0.5,9,14,2514,9,2016,12,-3
Group 3,BB,-0.5,9,14,2515,10,2016,10,0
Group 3,BB,-0.5,9,14,2516,11,2016,7,4
Group 3,BB,-0.5,9,14,2517,6,2016,7,-1
Group 3,BB,-0.5,9,14,2518,9,2016,11,-2
Group 3,BB,-0.5,9,14,2519,9,2016,8,1
Group 3,BB,-0.5,9,14,2520,7,2016,12,-5
Group 3,BB,-0.5,9,14,2521,6,2016,9,-3
Group 3,BB,-0.5,9,14,2522,7,2016,7,0
Group 3,BB,-0.5,9,14,2523,9,2016,9,0
Group 3,BB,-0.5,9,14,2524,8,2016,8,0
Group 3,BB,-0.5,9,14,2525,12,2016,9,3
Group 3,BB,-0.5,9,14,2526,6,2016,10,-4
Group 3,BB,-0.5,9,14,2527,8,2016,11,-3
Group 3,BB,-0.5,9,14,2528,7,2016,11,-4
Group 3,BB,-0.5,9,14,2529,6,2016,10,-4
Group 3,BB,-0.5,9,14,2530,8,2016,11,-3
Group 3,BB,-0.5,9,14,2531,8,2016,8,0
Group 3,BB,-0.5,9,14,2532,10,2016,10,0
Group 3,BB,-0.5,9,14,2533,10,2016,8,2
Group 3,BB,-0.5,9,14,2534,12,2016,13,-1
Group 3,BB,-0.5,9,14,2535,6,2016,9,-3
Group 3,BB,-0.5,9,14,2536,10,2016,8,2
Group 3,BB,-0.5,9,14,2537,9,2016,10,-1
Group 3,BB,-0.5,9,14,2538,9,2016,9,0
Group 3,BB,-0.5,9,14,2539,9,2016,12,-3
Group 3,BB,-0.5,9,14,2540,11,2016,9,2
Group 3,BB,-0.5,9,14,2541,14,2016,7,7
Group 3,BB,-0.5,9,14,2542,11,2016,9,2
Group 3,BB,-0.5,9,14,2543,13,2016,7,6
Group 3,BB,-0.5,9,14,2544,6,2016,9,-3
Group 3,BB,-0.5,9,14,2545,2,2016,9,-7
Group 3,BB,-0.5,9,14,2546,7,2016,4,3
Group 3,BB,-0.5,9,14,2547,4,2016,9,-5
Group 3,BB,-0.5,9,14,2548,7,2016,11,-4
Group 3,BB,-0.5,9,14,2549,8,2016,10,-2
Group 3,BB,-0.5,9,14,2550,14,2016,10,4
Group 3,BB,-0.5,9,14,2551,8,2016,9,-1
Group 3,BB,-0.5,9,14,2552,14,2016,12,2
Group 3,BB,-0.5,9,14,2553,8,2016,11,-3
Group 3,BB,-0.5,9,14,2554,9,2016,10,-1
Group 3,BB,-0.5,9,14,2555,6,2016,8,-2
Group 3,BB,-0.5,9,14,2556,11,2016,8,3
Group 3,BB,-0.5,9,14,2557,8,2016,6,2
Group 3,BB,-0.5,9,14,2558,13,2016,5,8
Group 3,BB,-0.5,9,14,2559,5,2016,10,-5
Group 3,BB,-0.5,9,14,2560,5,2016,8,-3
Group 3,BB,-0.5,9,14,2561,10,2016,8,2
Group 3,BB,-0.5,9,14,2562,11,2016,9,2
Group 3,BB,-0.5,9,14,2563,13,2016,10,3
Group 3,BB,-0.5,9,14,2564,9,2016,8,1
Group 3,BB,-0.5,9,14,2565,6,2016,8,-2
Group 3,BB,-0.5,9,14,2566,9,2016,8,1
Group 3,BB,-0.5,9,14,2567,9,2016,10,-1
Group 3,BB,-0.5,9,14,2568,12,2016,7,5
Group 3,BB,-0.5,9,14,2569,11,2016,8,3
Group 3,BB,-0.5,9,14,2570,9,2016,9,0
Group 3,BB,-0.5,9,14,2571,9,2016,6,3
Group 3,BB,-0.5,9,14,2572,9,2016,6,3
Group 3,BB,-0.5,9,14,2573,9,2016,10,-1
Group 3,BB,-0.5,9,14,2574,12,2016,9,3
Group 3,BB,-0.5,9,14,2575,9,2016,5,4
Group 3,BB,-0.5,9,14,2576,8,2016,12,-4
Group 3,BB,-0.5,9,14,2577,9,2016,10,-1
Group 3,BB,-0.5,9,14,2578,4,2016,5,-1
Group 3,BB,-0.5,9,14,2579,7,2016,4,3
Group 3,BB,-0.5,9,14,2580,6,2016,5,1
Group 3,BB,-0.5,9,14,2581,11,2016,8,3
Group 3,BB,-0.5,9,14,2582,8,2016,9,-1
Group 3,BB,-0.5,9,14,2583,9,2016,7,2
Group 3,BB,-0.5,9,14,2584,8,2016,9,-1
Group 3,BB,-0.5,9,14,2585,10,2016,9,1
Group 3,BB,-0.5,9,14,2586,11,2016,8,3
Group 3,BB,-0.5,9,14,2587,11,2016,8,3
Group 3,BB,-0.5,9,14,2588,11,2016,8,3
Group 3,BB,-0.5,9,14,2589,11,2016,11,0
Group 3,BB,-0.5,9,14,2590,11,2016,9,2
Group 3,BB,-0.5,9,14,2591,11,2016,11,0
Group 3,BB,-0.5,9,14,2592,10,2016,9,1
Group 3,BB,-0.5,9,14,2593,12,2016,4,8
Group 3,BB,-0.5,9,14,2594,8,2016,8,0
Group 3,BB,-0.5,9,14,2595,9,2016,7,2
Group 3,BB,-0.5,9,14,2596,12,2016,9,3
Group 3,BB,-0.5,9,14,2597,12,2016,9,3
Group 3,BB,-0.5,9,14,2598,7,2016,9,-2
Group 3,BB,-0.5,9,14,2599,11,2016,6,5
Group 3,BB,-0.5,9,14,2600,9,2016,9,0
Group 3,BB,-0.5,9,14,2601,10,2016,4,6
Group 3,BB,-0.5,9,14,2602,10,2016,6,4
Group 3,BB,-0.5,9,14,2603,5,2016,5,0
Group 3,BB,-0.5,9,14,2604,7,2016,8,-1
Group 3,BB,-0.5,9,14,2605,12,2016,9,3
Group 3,BB,-0.5,9,14,2606,6,2016,10,-4
Group 3,BB,-0.5,9,14,2607,5,2016,9,-4
Group 3,BB,-0.5,9,14,2608,11,2016,9,2
Group 3,BB,-0.5,9,14,2609,8,2016,9,-1
Group 3,BB,-0.5,9,14,2610,5,2016,8,-3
Group 3,BB,-0.5,9,14,2611,10,2016,6,4
Group 3,BB,-0.5,9,14,2612,11,2016,8,3
Group 3,BB,-0.5,9,14,2613,10,2016,10,0
Group 3,BB,-0.5,9,14,2614,14,2016,7,7
Group 3,BB,-0.5,9,14,2615,10,2016,8,2
Group 3,BB,-0.5,9,14,2616,12,2016,6,6
Group 3,BB,-0.5,9,14,2617,8,2016,9,-1
Group 3,BB,-0.5,9,14,2618,9,2016,7,2
Group 3,BB,-0.5,9,14,2619,7,2016,7,0
Group 3,BB,-0.5,9,14,2620,10,2016,8,2
Group 3,BB,-0.5,9,14,2621,7,2016,8,-1
Group 3,BB,-0.5,9,14,2622,11,2016,12,-1
Group 3,BB,-0.5,9,14,2623,11,2016,7,4
Group 3,BB,-0.5,9,14,2624,9,2016,8,1
Group 3,BB,-0.5,9,14,2625,7,2016,8,-1
Group 3,BB,-0.5,9,14,2626,11,2016,8,3
Group 3,BB,-0.5,9,14,2627,6,2016,12,-6
Group 3,BB,-0.5,9,14,2628,7,2016,10,-3
Group 3,BB,-0.5,9,14,2629,10,2016,5,5
Group 3,BB,-0.5,9,14,2630,10,2016,7,3
Group 3,BB,-0.5,9,14,2631,12,2016,9,3
Group 3,BB,-0.5,9,14,2632,9,2016,9,0
Group 3,BB,-0.5,9,14,2633,11,2016,5,6
Group 3,BB,-0.5,9,14,2634,10,2016,9,1
Group 3,BB,-0.5,9,14,2635,10,2016,8,2
Group 3,BB,-0.5,9,14,2636,8,2016,5,3
Group 3,BB,-0.5,9,14,2637,9,2016,7,2
Group 3,BB,-0.5,9,14,2638,10,2016,9,1
Group 3,BB,-0.5,9,14,2639,9,2016,10,-1
Group 3,BB,-0.5,9,14,2640,10,2016,8,2
Group 3,BB,-0.5,9,14,2641,8,2016,8,0
Group 3,BB,-0.5,9,14,2642,13,2016,8,5
Group 3,BB,-0.5,9,14,2643,9,2016,9,0
Group 3,BB,-0.5,9,14,2644,9,2016,4,5
Group 3,BB,-0.5,9,14,2645,10,2016,7,3
Group 3,BB,-0.5,9,14,2646,6,2016,9,-3
Group 3,BB,-0.5,9,14,2647,12,2016,12,0
Group 3,BB,-0.5,9,14,2648,10,2016,9,1
Group 3,BB,-0.5,9,14,2649,10,2016,7,3
Group 3,BB,-0.5,9,14,2650,7,2016,11,-4
Group 3,BB,-0.5,9,14,2651,8,2016,9,-1
Group 3,BB,-0.5,9,14,2652,10,2016,8,2
Group 3,BB,-0.5,9,14,2653,6,2016,9,-3
Group 3,BB,-0.5,9,14,2654,14,2016,9,5
Group 3,BB,-0.5,9,14,2655,6,2016,9,-3
Group 3,BB,-0.5,9,14,2656,8,2016,7,1
Group 3,BB,-0.5,9,14,2657,8,2016,9,-1
Group 3,BB,-0.5,9,14,2658,8,2016,4,4
Group 3,BB,-0.5,9,14,2659,10,2016,9,1
Group 3,BB,-0.5,9,14,2660,9,2016,11,-2
Group 3,BB,-0.5,9,14,2661,13,2016,9,4
Group 3,BB,-0.5,9,14,2662,8,2016,7,1
Group 3,BB,-0.5,9,14,2663,11,2016,7,4
Group 3,BB,-0.5,9,14,2664,11,2016,8,3
Group 3,BB,-0.5,9,14,2665,5,2016,8,-3
Group 3,BB,-0.5,9,14,2666,9,2016,8,1
Group 3,BB,-0.5,9,14,2667,8,2016,6,2
Group 3,BB,-0.5,9,14,2668,12,2016,11,1
Group 3,BB,-0.5,9,14,2669,12,2016,10,2
Group 3,BB,-0.5,9,14,2670,9,2016,10,-1
Group 3,BB,-0.5,9,14,2671,8,2016,10,-2
Group 3,BB,-0.5,9,14,2672,13,2016,6,7
Group 3,BB,-0.5,9,14,2673,12,2016,7,5
Group 3,BB,-0.5,9,14,2674,8,2016,3,5
Group 3,BB,-0.5,9,14,2675,10,2016,9,1
Group 3,BB,-0.5,9,14,2676,4,2016,3,1
Group 3,BB,-0.5,9,14,2677,10,2016,9,1
Group 3,BB,-0.5,9,14,2678,10,2016,7,3
Group 3,BB,-0.5,9,14,2679,10,2016,6,4
Group 3,BB,-0.5,9,14,2680,11,2016,12,-1
Group 3,BB,-0.5,9,14,2681,10,2016,7,3
Group 3,BB,-0.5,9,14,2682,9,2016,11,-2
Group 3,BB,-0.5,9,14,2683,7,2016,7,0
Group 3,BB,-0.5,9,14,2684,7,2016,8,-1
Group 3,BB,-0.5,9,14,2685,10,2016,6,4
Group 3,BB,-0.5,9,14,2686,11,2016,3,8
Group 3,BB,-0.5,9,14,2687,7,2016,9,-2
Group 3,BB,-0.5,9,14,2688,4,2016,3,1
Group 3,BB,-0.5,9,14,2689,7,2016,11,-4
Group 3,BB,-0.5,9,14,2690,14,2016,10,4
Group 3,BB,-0.5,9,14,2691,8,2016,10,-2
Group 3,BB,-0.5,9,14,2692,11,2016,10,1
Group 3,BB,-0.5,9,14,2693,6,2016,5,1
Group 3,BB,-0.5,9,14,2694,8,2016,7,1
Group 3,BB,-0.5,9,14,2695,8,2016,4,4
Group 3,BB,-0.5,9,14,2696,8,2016,8,0
Group 3,BB,-0.5,9,14,2697,10,2016,8,2
Group 3,BB,-0.5,9,14,2698,8,2016,8,0
Group 3,BB,-0.5,9,14,2699,11,2016,9,2
Group 3,BB,-0.5,9,14,2700,7,2016,6,1
Group 3,BB,-0.5,9,14,2701,6,2016,6,0
Group 3,BB,-0.5,9,14,2702,10,2016,6,4
Group 3,BB,-0.5,9,14,2703,11,2016,9,2
Group 3,BB,-0.5,9,14,2704,11,2016,8,3
Group 3,BB,-0.5,9,14,2705,11,2016,7,4
Group 3,BB,-0.5,9,14,2706,6,2016,6,0
Group 3,BB,-0.5,9,14,2707,10,2016,7,3
Group 3,BB,-0.5,9,14,2708,7,2016,12,-5
Group 3,BB,-0.5,9,14,2709,9,2016,8,1
Group 3,BB,-0.5,9,14,2710,9,2016,7,2
Group 3,BB,-0.5,9,14,2711,12,2016,9,3
Group 3,BB,-0.5,9,14,2712,7,2016,11,-4
Group 3,BB,-0.5,9,14,2713,8,2016,11,-3
Group 3,BB,-0.5,9,14,2714,4,2016,7,-3
Group 3,BB,-0.5,9,14,2715,6,2016,6,0
Group 3,BB,-0.5,9,14,2716,8,2016,7,1
Group 3,BB,-0.5,9,14,2717,10,2016,10,0
Group 3,BB,-0.5,9,14,2718,12,2016,9,3
Group 3,BB,-0.5,9,14,2719,9,2016,9,0
Group 3,BB,-0.5,9,14,2720,12,2016,9,3
Group 3,BB,-0.5,9,14,2721,11,2016,11,0
Group 3,BB,-0.5,9,14,2722,9,2016,7,2
Group 3,BB,-0.5,9,14,2723,8,2016,6,2
Group 3,BB,-0.5,9,14,2724,8,2016,9,-1
Group 3,BB,-0.5,9,14,2725,9,2016,12,-3
Group 3,BB,-0.5,9,14,2726,14,2016,7,7
Group 3,BB,-0.5,9,14,2727,9,2016,10,-1
Group 3,BB,-0.5,9,14,2728,8,2016,11,-3
Group 3,BB,-0.5,9,14,2729,3,2016,9,-6
Group 3,BB,-0.5,9,14,2730,8,2016,8,0
Group 3,BB,-0.5,9,14,2731,11,2016,11,0
Group 3,BB,-0.5,9,14,2732,8,2016,10,-2
Group 3,BB,-0.5,9,14,2733,10,2016,8,2
Group 3,BB,-0.5,9,14,2734,9,2016,10,-1
Group 3,BB,-0.5,9,14,2735,7,2016,11,-4
Group 3,BB,-0.5,9,14,2736,8,2016,6,2
Group 3,BB,-0.5,9,14,2737,12,2016,9,3
Group 3,BB,-0.5,9,14,2738,12,2016,9,3
Group 3,BB,-0.5,9,14,2739,11,2016,9,2
Group 3,BB,-0.5,9,14,2740,10,2016,5,5
Group 3,BB,-0.5,9,14,2741,10,2016,7,3
Group 3,BB,-0.5,9,14,2742,6,2016,7,-1
Group 3,BB,-0.5,9,14,2743,11,2016,9,2
Group 3,BB,-0.5,9,14,2744,10,2016,8,2
Group 3,BB,-0.5,9,14,2745,12,2016,6,6
Group 3,BB,-0.5,9,14,2746,11,2016,7,4
Group 3,BB,-0.5,9,14,2747,11,2016,5,6
Group 3,BB,-0.5,9,14,2748,11,2016,7,4
Group 3,BB,-0.5,9,14,2749,12,2016,8,4
Group 3,BB,-0.5,9,14,2750,9,2016,7,2
Group 3,BB,-0.5,9,14,2751,7,2016,8,-1
Group 3,BB,-0.5,9,14,2752,9,2016,9,0
Group 3,BB,-0.5,9,14,2753,9,2016,8,1
Group 3,BB,-0.5,9,14,2754,9,2016,7,2
Group 3,BB,-0.5,9,14,2755,8,2016,8,0
Group 3,BB,-0.5,9,14,2756,11,2016,6,5
Group 3,BB,-0.5,9,14,2757,9,2016,11,-2
Group 3,BB,-0.5,9,14,2758,8,2016,8,0
Group 3,BB,-0.5,9,14,2759,12,2016,5,7
Group 3,BB,-0.5,9,14,2760,13,2016,6,7
Group 3,BB,-0.5,9,14,2761,10,2016,5,5
Group 3,BB,-0.5,9,14,2762,7,2016,8,-1
Group 3,BB,-0.5,9,14,2763,12,2016,9,3
Group 3,BB,-0.5,9,14,2764,11,2016,7,4
Group 3,BB,-0.5,9,14,2765,9,2016,6,3
Group 3,BB,-0.5,9,14,2766,9,2016,8,1
Group 3,BB,-0.5,9,14,2767,12,2016,9,3
Group 3,BB,-0.5,9,14,2768,7,2016,7,0
Group 3,BB,-0.5,9,14,2769,4,2016,8,-4
Group 3,BB,-0.5,9,14,2770,10,2016,7,3
Group 3,BB,-0.5,9,14,2771,10,2016,6,4
Group 3,BB,-0.5,9,14,2772,10,2016,11,-1
Group 3,BB,-0.5,9,14,2773,12,2016,8,4
Group 3,BB,-0.5,9,14,2774,10,2016,10,0
Group 3,BB,-0.5,9,14,2775,6,2016,8,-2
Group 3,BB,-0.5,9,14,2776,10,2016,11,-1
Group 3,BB,-0.5,9,14,2777,11,2016,9,2
Group 3,BB,-0.5,9,14,2778,9,2016,10,-1
Group 3,BB,-0.5,9,14,2779,9,2016,8,1
Group 3,BB,-0.5,9,14,2780,10,2016,11,-1
Group 3,BB,-0.5,9,14,2781,12,2016,9,3
Group 3,BB,-0.5,9,14,2782,9,2016,7,2
Group 3,BB,-0.5,9,14,2783,10,2016,6,4
Group 3,BB,-0.5,9,14,2784,8,2016,6,2
Group 3,BB,-0.5,9,14,2785,10,2016,12,-2
Group 3,BB,-0.5,9,14,2786,9,2016,7,2
Group 3,BB,-0.5,9,14,2787,7,2016,8,-1
Group 3,BB,-0.5,9,14,2788,11,2016,8,3
Group 3,BB,-0.5,9,14,2789,9,2016,9,0
Group 3,BB,-0.5,9,14,2790,8,2016,12,-4
Group 3,BB,-0.5,9,14,2791,5,2016,8,-3
Group 3,BB,-0.5,9,14,2792,8,2016,9,-1
Group 3,BB,-0.5,9,14,2793,8,2016,8,0
Group 3,BB,-0.5,9,14,2794,7,2016,9,-2
Group 3,BB,-0.5,9,14,2795,8,2016,6,2
Group 3,BB,-0.5,9,14,2796,8,2016,5,3
Group 3,BB,-0.5,9,14,2797,9,2016,7,2
Group 3,BB,-0.5,9,14,2798,14,2016,13,1
Group 3,BB,-0.5,9,14,2799,7,2016,6,1
Group 3,BB,-0.5,9,14,2800,11,2016,8,3
Group 3,BB,-0.5,9,14,2801,9,2016,7,2
Group 3,BB,-0.5,9,14,2802,7,2016,6,1
Group 3,BB,-0.5,9,14,2803,8,2016,9,-1
Group 3,BB,-0.5,9,14,2804,10,2016,11,-1
Group 3,BB,-0.5,9,14,2805,11,2016,7,4
Group 3,BB,-0.5,9,14,2806,11,2016,6,5
Group 3,BB,-0.5,9,14,2807,8,2016,5,3
Group 3,BB,-0.5,9,14,2808,9,2016,8,1
Group 3,BB,-0.5,9,14,2809,11,2016,5,6
Group 3,BB,-0.5,9,14,2810,11,2016,8,3
Group 3,BB,-0.5,9,14,2811,7,2016,9,-2
Group 3,BB,-0.5,9,14,2812,10,2016,12,-2
Group 3,BB,-0.5,9,14,2813,12,2016,8,4
Group 3,BB,-0.5,9,14,2814,13,2016,6,7
Group 3,BB,-0.5,9,14,2815,8,2016,8,0
Group 3,BB,-0.5,9,14,2816,12,2016,7,5
Group 3,BB,-0.5,9,14,2817,10,2016,8,2
Group 3,BB,-0.5,9,14,2818,6,2016,9,-3
Group 3,BB,-0.5,9,14,2819,11,2016,8,3
Group 3,BB,-0.5,9,14,2820,9,2016,11,-2
Group 3,BB,-0.5,9,14,2821,8,2016,8,0
Group 3,BB,-0.5,9,14,2822,7,2016,9,-2
Group 3,BB,-0.5,9,14,2823,10,2016,7,3
Group 3,BB,-0.5,9,14,2824,7,2016,7,0
Group 3,BB,-0.5,9,14,2825,11,2016,8,3
Group 3,BB,-0.5,9,14,2826,9,2016,8,1
Group 3,BB,-0.5,9,14,2827,8,2016,7,1
Group 3,BB,-0.5,9,14,2828,10,2016,11,-1
Group 3,BB,-0.5,9,14,2829,11,2016,6,5
Group 3,BB,-0.5,9,14,2830,10,2016,9,1
Group 3,BB,-0.5,9,14,2831,10,2016,4,6
Group 3,BB,-0.5,9,14,2832,10,2016,7,3
Group 3,BB,-0.5,9,14,2833,10,2016,6,4
Group 3,BB,-0.5,9,14,2834,7,2016,8,-1
Group 3,BB,-0.5,9,14,2835,13,2016,7,6
Group 3,BB,-0.5,9,14,2836,13,2016,7,6
Group 3,BB,-0.5,9,14,2837,12,2016,8,4
Group 3,BB,-0.5,9,14,2838,9,2016,10,-1
Group 3,BB,-0.5,9,14,2839,8,2016,9,-1
Group 3,BB,-0.5,9,14,2840,6,2016,10,-4
Group 3,BB,-0.5,9,14,2841,10,2016,12,-2
Group 3,BB,-0.5,9,14,2842,9,2016,5,4
Group 3,BB,-0.5,9,14,2843,8,2016,9,-1
Group 3,BB,-0.5,9,14,2844,10,2016,7,3
Group 3,BB,-0.5,9,14,2845,9,2016,8,1
Group 3,BB,-0.5,9,14,2846,6,2016,5,1
Group 3,BB,-0.5,9,14,2847,10,2016,13,-3
Group 3,BB,-0.5,9,14,2848,10,2016,8,2
Group 3,BB,-0.5,9,14,2849,8,2016,9,-1
Group 3,BB,-0.5,9,14,2850,9,2016,8,1
Group 3,BB,-0.5,9,14,2851,5,2016,7,-2
Group 3,BB,-0.5,9,14,2852,8,2016,12,-4
Group 3,BB,-0.5,9,14,2853,8,2016,8,0
Group 3,BB,-0.5,9,14,2854,8,2016,4,4
Group 3,BB,-0.5,9,14,2855,13,2016,11,2
Group 3,BB,-0.5,9,14,2856,12,2016,10,2
Group 3,BB,-0.5,9,14,2857,9,2016,4,5
Group 3,BB,-0.5,9,14,2858,9,2016,12,-3
Group 3,BB,-0.5,9,14,2859,11,2016,5,6
Group 3,BB,-0.5,9,14,2860,12,2016,5,7
Group 3,BB,-0.5,9,14,2861,5,2016,10,-5
Group 3,BB,-0.5,9,14,2862,8,2016,9,-1
Group 3,BB,-0.5,9,14,2863,6,2016,5,1
Group 3,BB,-0.5,9,14,2864,8,2016,7,1
Group 3,BB,-0.5,9,14,2865,11,2016,10,1
Group 3,BB,-0.5,9,14,2866,8,2016,8,0
Group 3,BB,-0.5,9,14,2867,11,2016,9,2
Group 3,BB,-0.5,9,14,2868,9,2016,10,-1
Group 3,BB,-0.5,9,14,2869,6,2016,6,0
Group 3,BB,-0.5,9,14,2870,8,2016,11,-3
Group 3,BB,-0.5,9,14,2871,5,2016,9,-4
Group 3,BB,-0.5,9,14,2872,4,2016,11,-7
Group 3,BB,-0.5,9,14,2873,5,2016,11,-6
Group 3,BB,-0.5,9,14,2874,6,2016,11,-5
Group 3,BB,-0.5,9,14,2875,4,2016,7,-3
Group 3,BB,-0.5,9,14,2876,11,2016,5,6
Group 3,BB,-0.5,9,14,2877,9,2016,11,-2
Group 3,BB,-0.5,9,14,2878,10,2016,5,5
Group 3,BB,-0.5,9,14,2879,11,2016,6,5
Group 3,BB,-0.5,9,14,2880,9,2016,3,6
Group 3,BB,-0.5,9,14,2881,7,2016,4,3
Group 3,BB,-0.5,9,14,2882,10,2016,11,-1
Group 3,BB,-0.5,9,14,2883,7,2016,9,-2
Group 3,BB,-0.5,9,14,2884,11,2016,3,8
Group 3,BB,-0.5,9,14,2885,12,2016,10,2
Group 3,BB,-0.5,9,14,2886,8,2016,4,4
Group 3,BB,-0.5,9,14,2887,8,2016,7,1
Group 3,BB,-0.5,9,14,2888,11,2016,6,5
Group 3,BB,-0.5,9,14,2889,11,2016,7,4
Group 3,BB,-0.5,9,14,2890,9,2016,10,-1
Group 3,BB,-0.5,9,14,2891,11,2016,8,3
Group 3,BB,-0.5,9,14,2892,10,2016,6,4
Group 3,BB,-0.5,9,14,2893,10,2016,9,1
Group 3,BB,-0.5,9,14,2894,8,2016,8,0
Group 3,BB,-0.5,9,14,2895,11,2016,5,6
Group 3,BB,-0.5,9,14,2896,8,2016,6,2
Group 3,BB,-0.5,9,14,2897,8,2016,9,-1
Group 3,BB,-0.5,9,14,2898,9,2016,6,3
Group 3,BB,-0.5,9,14,2899,8,2016,8,0
Group 3,BB,-0.5,9,14,2900,9,2016,11,-2
Group 3,BB,-0.5,9,14,2901,6,2016,8,-2
Group 3,BB,-0.5,9,14,2902,10,2016,7,3
Group 3,BB,-0.5,9,14,2903,12,2016,8,4
Group 3,BB,-0.5,9,14,2904,11,2016,6,5
Group 3,BB,-0.5,9,14,2905,11,2016,9,2
Group 3,BB,-0.5,9,14,2906,10,2016,8,2
Group 3,BB,-0.5,9,14,2907,8,2016,9,-1
Group 3,BB,-0.5,9,14,2908,5,2016,5,0
Group 3,BB,-0.5,9,14,2909,8,2016,6,2
Group 3,BB,-0.5,9,14,2910,7,2016,10,-3
Group 3,BB,-0.5,9,14,2911,8,2016,8,0
Group 3,BB,-0.5,9,14,2912,8,2016,4,4
Group 3,BB,-0.5,9,14,2913,13,2016,6,7
Group 3,BB,-0.5,9,14,2914,9,2016,5,4
Group 3,BB,-0.5,9,14,2915,11,2016,5,6
Group 3,BB,-0.5,9,14,2916,8,2016,9,-1
Group 3,BB,-0.5,9,14,2917,7,2016,9,-2
Group 3,BB,-0.5,9,14,2918,11,2016,13,-2
Group 3,BB,-0.5,9,14,2919,8,2016,10,-2
Group 3,BB,-0.5,9,14,2920,8,2016,9,-1
Group 3,BB,-0.5,9,14,2921,11,2016,9,2
Group 3,BB,-0.5,9,14,2922,7,2016,5,2
Group 3,BB,-0.5,9,14,2923,9,2016,8,1
Group 3,BB,-0.5,9,14,2924,8,2016,5,3
Group 3,BB,-0.5,9,14,2925,12,2016,9,3
Group 3,BB,-0.5,9,14,2926,6,2016,4,2
Group 3,BB,-0.5,9,14,2927,10,2016,7,3
Group 3,BB,-0.5,9,14,2928,10,2016,8,2
Group 3,BB,-0.5,9,14,2929,12,2016,8,4
Group 3,BB,-0.5,9,14,2930,13,2016,7,6
Group 3,BB,-0.5,9,14,2931,10,2016,9,1
Group 3,BB,-0.5,9,14,2932,9,2016,8,1
Group 3,BB,-0.5,9,14,2933,9,2016,5,4
Group 3,BB,-0.5,9,14,2934,8,2016,7,1
Group 3,BB,-0.5,9,14,2935,10,2016,11,-1
Group 3,BB,-0.5,9,14,2936,5,2016,8,-3
Group 3,BB,-0.5,9,14,2937,11,2016,8,3
Group 3,BB,-0.5,9,14,2938,10,2016,8,2
Group 3,BB,-0.5,9,14,2939,11,2016,5,6
Group 3,BB,-0.5,9,14,2940,7,2016,8,-1
Group 3,BB,-0.5,9,14,2941,7,2016,8,-1
Group 3,BB,-0.5,9,14,2942,10,2016,12,-2
Group 3,BB,-0.5,9,14,2943,11,2016,6,5
Group 3,BB,-0.5,9,14,2944,9,2016,9,0
Group 3,BB,-0.5,9,14,2945,9,2016,6,3
Group 3,BB,-0.5,9,14,2946,8,2016,10,-2
Group 3,BB,-0.5,9,14,2947,8,2016,11,-3
Group 3,BB,-0.5,9,14,2948,11,2016,7,4
Group 3,BB,-0.5,9,14,2949,9,2016,8,1
Group 3,BB,-0.5,9,14,2950,12,2016,10,2
Group 3,BB,-0.5,9,14,2951,7,2016,8,-1
Group 3,BB,-0.5,9,14,2952,8,2016,8,0
Group 3,BB,-0.5,9,14,2953,10,2016,5,5
Group 3,BB,-0.5,9,14,2954,8,2016,8,0
Group 3,BB,-0.5,9,14,2955,11,2016,8,3
Group 3,BB,-0.5,9,14,2956,10,2016,10,0
Group 3,BB,-0.5,9,14,2957,12,2016,10,2
Group 3,BB,-0.5,9,14,2958,7,2016,7,0
Group 3,BB,-0.5,9,14,2959,9,2016,7,2
Group 3,BB,-0.5,9,14,2960,7,2016,10,-3
Group 3,BB,-0.5,9,14,2961,9,2016,10,-1
Group 3,BB,-0.5,9,14,2962,9,2016,6,3
Group 3,BB,-0.5,9,14,2963,11,2016,7,4
Group 3,BB,-0.5,9,14,2964,9,2016,7,2
Group 3,BB,-0.5,9,14,2965,10,2016,5,5
Group 3,BB,-0.5,9,14,2966,10,2016,7,3
Group 3,BB,-0.5,9,14,2967,11,2016,9,2
Group 3,BB,-0.5,9,14,2968,10,2016,9,1
Group 3,BB,-0.5,9,14,2969,9,2016,4,5
Group 3,BB,-0.5,9,14,2970,9,2016,5,4
Group 3,BB,-0.5,9,14,2971,7,2016,6,1
Group 3,BB,-0.5,9,14,2972,7,2016,6,1
Group 3,BB,-0.5,9,14,2973,6,2016,9,-3
Group 3,BB,-0.5,9,14,2974,6,2016,7,-1
Group 3,BB,-0.5,9,14,2975,8,2016,8,0
Group 3,BB,-0.5,9,14,2976,12,2016,6,6
Group 3,BB,-0.5,9,14,2977,9,2016,7,2
Group 3,BB,-0.5,9,14,2978,11,2016,9,2
Group 3,BB,-0.5,9,14,2979,8,2016,9,-1
Group 3,BB,-0.5,9,14,2980,12,2016,11,1
Group 3,BB,-0.5,9,14,2981,11,2016,10,1
Group 3,BB,-0.5,9,14,2982,8,2016,11,-3
Group 3,BB,-0.5,9,14,2983,7,2016,5,2
Group 3,BB,-0.5,9,14,2984,6,2016,6,0
Group 3,BB,-0.5,9,14,2985,10,2016,10,0
Group 3,BB,-0.5,9,14,2986,11,2016,10,1
Group 3,BB,-0.5,9,14,2987,7,2016,9,-2
Group 3,BB,-0.5,9,14,2988,8,2016,6,2
Group 3,BB,-0.5,9,14,2989,4,2016,9,-5
Group 3,BB,-0.5,9,14,2990,11,2016,5,6
Group 3,BB,-0.5,9,14,2991,9,2016,10,-1
Group 3,BB,-0.5,9,14,2992,10,2016,9,1
Group 3,BB,-0.5,9,14,2993,10,2016,10,0
Group 3,BB,-0.5,9,14,2994,7,2016,6,1
Group 3,BB,-0.5,9,14,2995,8,2016,12,-4
Group 3,BB,-0.5,9,14,2996,7,2016,10,-3
Group 3,BB,-0.5,9,14,2997,11,2016,11,0
Group 3,BB,-0.5,9,14,2998,7,2016,13,-6
Group 3,BB,-0.5,9,14,2999,12,2016,10,2
Group 3,BB,-0.5,9,14,3000,10,2016,11,-1
Group 3,BB,-0.5,9,14,3001,9,2016,9,0
Group 3,BB,-0.5,9,14,3002,6,2016,9,-3
Group 3,BB,-0.5,9,14,3003,11,2016,12,-1
Group 3,BB,-0.5,9,14,3004,11,2016,7,4
Group 3,BB,-0.5,9,14,3005,10,2016,7,3
Group 3,BB,-0.5,9,14,3006,7,2016,5,2
Group 3,BB,-0.5,9,14,3007,6,2016,8,-2
Group 3,BB,-0.5,9,14,3008,11,2016,12,-1
Group 3,BB,-0.5,9,14,3009,9,2016,10,-1
Group 3,BB,-0.5,9,14,3010,9,2016,9,0
Group 3,BB,-0.5,9,14,3011,9,2016,8,1
Group 3,BB,-0.5,9,14,3012,6,2016,10,-4
Group 3,BB,-0.5,9,14,3013,12,2016,11,1
Group 3,BB,-0.5,9,14,3014,8,2016,7,1
Group 3,BB,-0.5,9,14,3015,7,2016,9,-2
Group 3,BB,-0.5,9,14,3016,6,2016,8,-2
Group 3,BB,-0.5,9,14,3017,7,2016,8,-1
Group 3,BB,-0.5,9,14,3018,10,2016,8,2
Group 3,BB,-0.5,9,14,3019,9,2016,8,1
Group 3,BB,-0.5,9,14,3020,9,2016,7,2
Group 3,BB,-0.5,9,14,3021,4,2016,8,-4
Group 3,BB,-0.5,9,14,3022,7,2016,5,2
Group 3,BB,-0.5,9,14,3023,10,2016,7,3
Group 3,BB,-0.5,9,14,3024,6,2016,10,-4
Group 3,BB,-0.5,9,14,3025,9,2016,9,0
Group 3,BB,-0.5,9,14,3026,9,2016,7,2
Group 3,BB,-0.5,9,14,3027,9,2016,11,-2
Group 3,BB,-0.5,9,14,3028,13,2016,13,0
Group 3,BB,-0.5,9,14,3029,8,2016,11,-3
Group 3,BB,-0.5,9,14,3030,9,2016,8,1
Group 3,BB,-0.5,9,14,3031,11,2016,10,1
Group 3,BB,-0.5,9,14,3032,8,2016,9,-1
Group 3,BB,-0.5,9,14,3033,6,2016,8,-2
Group 3,BB,-0.5,9,14,3034,10,2016,10,0
Group 3,BB,-0.5,9,14,3035,6,2016,9,-3
Group 3,BB,-0.5,9,14,3036,12,2016,10,2
Group 3,BB,-0.5,9,14,3037,10,2016,5,5
Group 3,BB,-0.5,9,14,3038,11,2016,11,0
Group 3,BB,-0.5,9,14,3039,10,2016,7,3
Group 3,BB,-0.5,9,14,3040,8,2016,7,1
Group 3,BB,-0.5,9,14,3041,8,2016,8,0
Group 3,BB,-0.5,9,14,3042,9,2016,9,0
Group 3,BB,-0.5,9,14,3043,8,2016,10,-2
Group 3,BB,-0.5,9,14,3044,10,2016,3,7
Group 3,BB,-0.5,9,14,3045,7,2016,9,-2
Group 3,BB,-0.5,9,14,3046,9,2016,4,5
Group 3,BB,-0.5,9,14,3047,9,2016,6,3
Group 3,BB,-0.5,9,14,3048,6,2016,7,-1
Group 3,BB,-0.5,9,14,3049,12,2016,9,3
Group 3,BB,-0.5,9,14,3050,8,2016,10,-2
Group 3,BB,-0.5,9,14,3051,10,2016,9,1
Group 3,BB,-0.5,9,14,3052,10,2016,10,0
Group 3,BB,-0.5,9,14,3053,11,2016,7,4
Group 3,BB,-0.5,9,14,3054,9,2016,10,-1
Group 3,BB,-0.5,9,14,3055,12,2016,9,3
Group 3,BB,-0.5,9,14,3056,7,2016,6,1
Group 3,BB,-0.5,9,14,3057,10,2016,8,2
Group 3,BB,-0.5,9,14,3058,10,2016,7,3
Group 3,BB,-0.5,9,14,3059,6,2016,8,-2
Group 3,BB,-0.5,9,14,3060,7,2016,3,4
Group 3,BB,-0.5,9,14,3061,12,2016,5,7
Group 3,BB,-0.5,9,14,3062,5,2016,7,-2
Group 3,BB,-0.5,9,14,3063,8,2016,8,0
Group 3,BB,-0.5,9,14,3064,10,2016,9,1
Group 3,BB,-0.5,9,14,3065,10,2016,11,-1
Group 3,BB,-0.5,9,14,3066,13,2016,9,4
Group 3,BB,-0.5,9,14,3067,11,2016,9,2
Group 3,BB,-0.5,9,14,3068,9,2016,6,3
Group 3,BB,-0.5,9,14,3069,8,2016,3,5
Group 3,BB,-0.5,9,14,3070,9,2016,7,2
Group 3,BB,-0.5,9,14,3071,9,2016,13,-4
Group 3,BB,-0.5,9,14,3072,7,2016,11,-4
Group 3,BB,-0.5,9,14,3073,8,2016,10,-2
Group 3,BB,-0.5,9,14,3074,6,2016,3,3
Group 3,BB,-0.5,9,14,3075,8,2016,8,0
Group 3,BB,-0.5,9,14,3076,5,2016,5,0
Group 3,BB,-0.5,9,14,3077,6,2016,6,0
Group 3,BB,-0.5,9,14,3078,9,2016,9,0
Group 3,BB,-0.5,9,14,3079,5,2016,9,-4
Group 3,BB,-0.5,9,14,3080,8,2016,9,-1
Group 3,BB,-0.5,9,14,3081,9,2016,11,-2
Group 3,BB,-0.5,9,14,3082,10,2016,5,5
Group 3,BB,-0.5,9,14,3083,11,2016,9,2
Group 3,BB,-0.5,9,14,3084,5,2016,9,-4
Group 3,BB,-0.5,9,14,3085,11,2016,6,5
Group 3,BB,-0.5,9,14,3086,13,2016,10,3
Group 3,BB,-0.5,9,14,3087,12,2016,8,4
Group 3,BB,-0.5,9,14,3088,7,2016,6,1
Group 3,BB,-0.5,9,14,3089,9,2016,8,1
Group 3,BB,-0.5,9,14,3090,11,2016,11,0
Group 3,BB,-0.5,9,14,3091,12,2016,10,2
Group 3,BB,-0.5,9,14,3092,6,2016,10,-4
Group 3,BB,-0.5,9,14,3093,6,2016,3,3
Group 3,BB,-0.5,9,14,3094,7,2016,9,-2
Group 3,BB,-0.5,9,14,3095,6,2016,10,-4
Group 3,BB,-0.5,9,14,3096,10,2016,11,-1
Group 3,BB,-0.5,9,14,3097,5,2016,9,-4
Group 3,BB,-0.5,9,14,3098,11,2016,8,3
Group 3,BB,-0.5,9,14,3099,7,2016,6,1
Group 3,BB,-0.5,9,14,3100,8,2016,7,1
Group 3,BB,-0.5,9,14,3101,12,2016,11,1
Group 3,BB,-0.5,9,14,3102,6,2016,5,1
Group 3,BB,-0.5,9,14,3103,13,2016,4,9
Group 3,BB,-0.5,9,14,3104,12,2016,7,5
Group 3,BB,-0.5,9,14,3105,7,2016,6,1
Group 3,BB,-0.5,9,14,3106,8,2016,8,0
Group 3,BB,-0.5,9,14,3107,5,2016,11,-6
Group 3,BB,-0.5,9,14,3108,8,2016,8,0
Group 3,BB,-0.5,9,14,3109,8,2016,10,-2
Group 3,BB,-0.5,9,14,3110,7,2016,9,-2
Group 3,BB,-0.5,9,14,3111,7,2016,6,1
Group 3,BB,-0.5,9,14,3112,7,2016,9,-2
Group 3,BB,-0.5,9,14,3113,9,2016,10,-1
Group 3,BB,-0.5,9,14,3114,13,2016,8,5
Group 3,BB,-0.5,9,14,3115,5,2016,10,-5
Group 3,BB,-0.5,9,14,3116,11,2016,7,4
Group 3,BB,-0.5,9,14,3117,12,2016,10,2
Group 3,BB,-0.5,9,14,3118,9,2016,5,4
Group 3,BB,-0.5,9,14,3119,10,2016,9,1
Group 3,BB,-0.5,9,14,3120,8,2016,8,0
Group 3,BB,-0.5,9,14,3121,11,2016,8,3
Group 3,BB,-0.5,9,14,3122,8,2016,7,1
Group 3,BB,-0.5,9,14,3123,8,2016,9,-1
Group 3,BB,-0.5,9,14,3124,11,2016,11,0
Group 3,BB,-0.5,9,14,3125,9,2016,10,-1
Group 3,BB,-0.5,9,14,3126,9,2016,9,0
Group 3,BB,-0.5,9,14,3127,8,2016,9,-1
Group 3,BB,-0.5,9,14,3128,10,2016,11,-1
Group 3,BB,-0.5,9,14,3129,11,2016,12,-1
Group 3,BB,-0.5,9,14,3130,11,2016,11,0
Group 3,BB,-0.5,9,14,3131,7,2016,8,-1
Group 3,BB,-0.5,9,14,3132,9,2016,4,5
Group 3,BB,-0.5,9,14,3133,8,2016,8,0
Group 3,BB,-0.5,9,14,3134,8,2016,7,1
Group 3,BB,-0.5,9,14,3135,9,2016,8,1
Group 3,BB,-0.5,9,14,3136,9,2016,5,4
Group 3,BB,-0.5,9,14,3137,8,2016,10,-2
Group 3,BB,-0.5,9,14,3138,10,2016,6,4
Group 3,BB,-0.5,9,14,3139,8,2016,6,2
Group 3,BB,-0.5,9,14,3140,8,2016,7,1
Group 3,BB,-0.5,9,14,3141,10,2016,11,-1
Group 3,BB,-0.5,9,14,3142,6,2016,8,-2
Group 3,BB,-0.5,9,14,3143,14,2016,14,0
Group 3,BB,-0.5,9,14,3144,9,2016,3,6
Group 3,BB,-0.5,9,14,3145,9,2016,1,8
Group 3,BB,-0.5,9,14,3146,9,2016,0,9
Group 3,BB,-0.5,9,14,3147,10,2016,11,-1
Group 3,BB,-0.5,9,14,3148,8,2016,8,0
Group 3,BB,-0.5,9,14,3149,12,2016,8,4
Group 3,BB,-0.5,9,14,3150,4,2016,6,-2
Group 3,BB,-0.5,9,14,3151,6,2016,4,2
Group 3,BB,-0.5,9,14,3152,8,2016,3,5
Group 3,BB,-0.5,9,14,3153,10,2016,9,1
Group 3,BB,-0.5,9,14,3154,4,2016,8,-4
Group 3,BB,-0.5,9,14,3155,6,2016,7,-1
Group 3,BB,-0.5,9,14,3156,11,2016,10,1
Group 3,BB,-0.5,9,14,3157,10,2016,10,0
Group 3,BB,-0.5,9,14,3158,6,2016,10,-4
Group 3,BB,-0.5,9,14,3159,6,2016,9,-3
Group 3,BB,-0.5,9,14,3160,9,2016,10,-1
Group 3,BB,-0.5,9,14,3161,9,2016,10,-1
Group 3,BB,-0.5,9,14,3162,9,2016,5,4
Group 3,BB,-0.5,9,14,3163,8,2016,5,3
Group 3,BB,-0.5,9,14,3164,8,2016,8,0
Group 3,BB,-0.5,9,14,3165,10,2016,11,-1
Group 3,BB,-0.5,9,14,3166,10,2016,7,3
Group 3,BB,-0.5,9,14,3167,9,2016,9,0
Group 3,BB,-0.5,9,14,3168,10,2016,8,2
Group 3,BB,-0.5,9,14,3169,9,2016,8,1
Group 3,BB,-0.5,9,14,3170,8,2016,8,0
Group 3,BB,-0.5,9,14,3171,9,2016,8,1
Group 3,BB,-0.5,9,14,3172,9,2016,8,1
Group 3,BB,-0.5,9,14,3173,9,2016,8,1
Group 3,BB,-0.5,9,14,3174,7,2016,11,-4
Group 3,BB,-0.5,9,14,3175,10,2016,8,2
Group 3,BB,-0.5,9,14,3176,12,2016,6,6
Group 3,BB,-0.5,9,14,3177,11,2016,5,6
Group 3,BB,-0.5,9,14,3178,8,2016,7,1
Group 3,BB,-0.5,9,14,3179,9,2016,7,2
Group 3,BB,-0.5,9,14,3180,10,2016,10,0
Group 3,BB,-0.5,9,14,3181,10,2016,4,6
Group 3,BB,-0.5,9,14,3182,6,2016,6,0
Group 3,BB,-0.5,9,14,3183,9,2016,5,4
Group 3,BB,-0.5,9,14,3184,13,2016,7,6
Group 3,BB,-0.5,9,14,3185,11,2016,4,7
Group 3,BB,-0.5,9,14,3186,7,2016,8,-1
Group 3,BB,-0.5,9,14,3187,6,2016,9,-3
Group 3,BB,-0.5,9,14,3188,11,2016,7,4
Group 3,BB,-0.5,9,14,3189,9,2016,3,6
Group 3,BB,-0.5,9,14,3190,12,2016,5,7
Group 3,BB,-0.5,9,14,3191,11,2016,5,6
Group 3,BB,-0.5,9,14,3192,10,2016,3,7
Group 3,BB,-0.5,9,14,3193,10,2016,7,3
Group 3,BB,-0.5,9,14,3194,10,2016,2,8
Group 3,BB,-0.5,9,14,3195,10,2016,6,4
Group 3,BB,-0.5,9,14,3196,5,2016,8,-3
Group 3,BB,-0.5,9,14,3197,7,2016,5,2
Group 3,BB,-0.5,9,14,3198,5,2016,6,-1
Group 3,BB,-0.5,9,14,3199,8,2016,8,0
Group 3,BB,-0.5,9,14,3200,9,2016,7,2
Group 3,BB,-0.5,9,14,3201,8,2016,9,-1
Group 3,BB,-0.5,9,14,3202,9,2016,10,-1
Group 3,BB,-0.5,9,14,3203,14,2016,8,6
Group 3,BB,-0.5,9,14,3204,12,2016,10,2
Group 3,BB,-0.5,9,14,3205,8,2016,7,1
Group 3,BB,-0.5,9,14,3206,8,2016,7,1
Group 3,BB,-0.5,9,14,3207,6,2016,8,-2
Group 3,BB,-0.5,9,14,3208,7,2016,9,-2
Group 3,BB,-0.5,9,14,3209,10,2016,8,2
Group 3,BB,-0.5,9,14,3210,11,2016,9,2
Group 3,BB,-0.5,9,14,3211,13,2016,5,8
Group 3,BB,-0.5,9,14,3212,9,2016,11,-2
Group 3,BB,-0.5,9,14,3213,11,2016,7,4
Group 3,BB,-0.5,9,14,3214,9,2016,7,2
Group 3,BB,-0.5,9,14,3215,7,2016,10,-3
Group 3,BB,-0.5,9,14,3216,7,2016,4,3
Group 3,BB,-0.5,9,14,3217,7,2016,9,-2
Group 3,BB,-0.5,9,14,3218,8,2016,6,2
Group 3,BB,-0.5,9,14,3219,8,2016,8,0
Group 3,BB,-0.5,9,14,3220,8,2016,7,1
Group 3,BB,-0.5,9,14,3221,10,2016,10,0
Group 3,BB,-0.5,9,14,3222,8,2016,7,1
Group 3,BB,-0.5,9,14,3223,9,2016,10,-1
Group 3,BB,-0.5,9,14,3224,7,2016,9,-2
Group 3,BB,-0.5,9,14,3225,12,2016,6,6
Group 3,BB,-0.5,9,14,3226,6,2016,10,-4
Group 3,BB,-0.5,9,14,3227,10,2016,8,2
Group 3,BB,-0.5,9,14,3228,6,2016,7,-1
Group 3,BB,-0.5,9,14,3229,10,2016,10,0
Group 3,BB,-0.5,9,14,3230,12,2016,8,4
Group 3,BB,-0.5,9,14,3231,10,2016,4,6
Group 3,BB,-0.5,9,14,3232,10,2016,8,2
Group 3,BB,-0.5,9,14,3233,8,2016,9,-1
Group 3,BB,-0.5,9,14,3234,8,2016,10,-2
Group 3,BB,-0.5,9,14,3235,9,2016,9,0
Group 3,BB,-0.5,9,14,3236,7,2016,5,2
Group 3,BB,-0.5,9,14,3237,11,2016,7,4
Group 3,BB,-0.5,9,14,3238,12,2016,5,7
Group 3,BB,-0.5,9,14,3239,7,2016,7,0
Group 3,BB,-0.5,9,14,3240,9,2016,9,0
Group 3,BB,-0.5,9,14,3241,7,2016,9,-2
Group 3,BB,-0.5,9,14,3242,9,2016,7,2
Group 3,BB,-0.5,9,14,3243,11,2016,6,5
Group 3,BB,-0.5,9,14,3244,10,2016,8,2
Group 3,BB,-0.5,9,14,3245,12,2016,9,3
Group 3,BB,-0.5,9,14,3246,9,2016,5,4
Group 3,BB,-0.5,9,14,3247,7,2016,9,-2
Group 3,BB,-0.5,9,14,3248,11,2016,6,5
Group 3,BB,-0.5,9,14,3249,10,2016,9,1
Group 3,BB,-0.5,9,14,3250,11,2016,9,2
Group 3,BB,-0.5,9,14,3251,7,2016,8,-1
Group 3,BB,-0.5,9,14,3252,5,2016,10,-5
Group 3,BB,-0.5,9,14,3253,11,2016,6,5
Group 3,BB,-0.5,9,14,3254,9,2016,8,1
Group 3,BB,-0.5,9,14,3255,8,2016,5,3
Group 3,BB,-0.5,9,14,3256,11,2016,7,4
Group 3,BB,-0.5,9,14,3257,7,2016,7,0
Group 3,BB,-0.5,9,14,3258,12,2016,9,3
Group 3,BB,-0.5,9,14,3259,8,2016,10,-2
Group 3,BB,-0.5,9,14,3260,7,2016,11,-4
Group 3,BB,-0.5,9,14,3261,6,2016,12,-6
Group 3,BB,-0.5,9,14,3262,10,2016,7,3
Group 3,BB,-0.5,9,14,3263,10,2016,8,2
Group 3,BB,-0.5,9,14,3264,11,2016,4,7
Group 3,BB,-0.5,9,14,3265,9,2016,7,2
Group 3,BB,-0.5,9,14,3266,9,2016,10,-1
Group 3,BB,-0.5,9,14,3267,8,2016,10,-2
Group 3,BB,-0.5,9,14,3268,11,2016,6,5
Group 3,BB,-0.5,9,14,3269,8,2016,6,2
Group 3,BB,-0.5,9,14,3270,10,2016,4,6
Group 3,BB,-0.5,9,14,3271,9,2016,11,-2
Group 3,BB,-0.5,9,14,3272,11,2016,7,4
Group 3,BB,-0.5,9,14,3273,11,2016,7,4
Group 3,BB,-0.5,9,14,3274,11,2016,7,4
Group 3,BB,-0.5,9,14,3275,9,2016,7,2
Group 3,BB,-0.5,9,14,3276,7,2016,8,-1
Group 3,BB,-0.5,9,14,3277,10,2016,6,4
Group 3,BB,-0.5,9,14,3278,13,2016,8,5
Group 3,BB,-0.5,9,14,3279,10,2016,7,3
Group 3,BB,-0.5,9,14,3280,7,2016,8,-1
Group 3,BB,-0.5,9,14,3281,6,2016,12,-6
Group 3,BB,-0.5,9,14,3282,10,2016,10,0
Group 3,BB,-0.5,9,14,3283,9,2016,6,3
Group 3,BB,-0.5,9,14,3284,11,2016,10,1
Group 3,BB,-0.5,9,14,3285,9,2016,5,4
Group 3,BB,-0.5,9,14,3286,11,2016,9,2
Group 3,BB,-0.5,9,14,3287,11,2016,5,6
Group 3,BB,-0.5,9,14,3288,8,2016,5,3
Group 3,BB,-0.5,9,14,3289,8,2016,10,-2
Group 3,BB,-0.5,9,14,3290,11,2016,11,0
Group 3,BB,-0.5,9,14,3291,5,2016,11,-6
Group 3,BB,-0.5,9,14,3292,12,2016,6,6
Group 3,BB,-0.5,9,14,3293,10,2016,9,1
Group 3,BB,-0.5,9,14,3294,10,2016,11,-1
Group 3,BB,-0.5,9,14,3295,7,2016,10,-3
Group 3,BB,-0.5,9,14,3296,9,2016,8,1
Group 3,BB,-0.5,9,14,3297,9,2016,11,-2
Group 3,BB,-0.5,9,14,3298,12,2016,11,1
Group 3,BB,-0.5,9,14,3299,6,2016,10,-4
Group 3,BB,-0.5,9,14,3300,6,2016,13,-7
Group 3,BB,-0.5,9,14,3301,9,2016,10,-1
Group 3,BB,-0.5,9,14,3302,9,2016,8,1
Group 3,BB,-0.5,9,14,3303,10,2016,7,3
Group 3,BB,-0.5,9,14,3304,8,2016,13,-5
Group 3,BB,-0.5,9,14,3305,13,2016,12,1
Group 3,BB,-0.5,9,14,3306,10,2016,9,1
Group 3,BB,-0.5,9,14,3307,8,2016,5,3
Group 3,BB,-0.5,9,14,3308,6,2016,8,-2
Group 3,BB,-0.5,9,14,3309,11,2016,7,4
Group 3,BB,-0.5,9,14,3310,8,2016,11,-3
Group 3,BB,-0.5,9,14,3311,12,2016,10,2
Group 3,BB,-0.5,9,14,3312,10,2016,6,4
Group 3,BB,-0.5,9,14,3313,7,2016,6,1
Group 3,BB,-0.5,9,14,3314,7,2016,7,0
Group 3,BB,-0.5,9,14,3315,10,2016,10,0
Group 3,BB,-0.5,9,14,3316,8,2016,6,2
Group 3,BB,-0.5,9,14,3317,8,2016,7,1
Group 3,BB,-0.5,9,14,3318,9,2016,10,-1
Group 3,BB,-0.5,9,14,3319,9,2016,6,3
Group 3,BB,-0.5,9,14,3320,8,2016,10,-2
Group 3,BB,-0.5,9,14,3321,8,2016,8,0
Group 3,BB,-0.5,9,14,3322,8,2016,10,-2
Group 3,BB,-0.5,9,14,3323,10,2016,8,2
Group 3,BB,-0.5,9,14,3324,11,2016,11,0
Group 3,BB,-0.5,9,14,3325,9,2016,6,3
Group 3,BB,-0.5,9,14,3326,8,2016,7,1
Group 3,BB,-0.5,9,14,3327,10,2016,9,1
Group 3,BB,-0.5,9,14,3328,7,2016,5,2
Group 3,BB,-0.5,9,14,3329,9,2016,9,0
Group 3,BB,-0.5,9,14,3330,9,2016,6,3
Group 3,BB,-0.5,9,14,3331,10,2016,7,3
Group 3,BB,-0.5,9,14,3332,10,2016,7,3
Group 3,BB,-0.5,9,14,3333,10,2016,8,2
Group 3,BB,-0.5,9,14,3334,5,2016,5,0
Group 3,BB,-0.5,9,14,3335,5,2016,7,-2
Group 3,BB,-0.5,9,14,3336,10,2016,6,4
Group 3,BB,-0.5,9,14,3337,10,2016,7,3
Group 3,BB,-0.5,9,14,3338,8,2016,8,0
Group 3,BB,-0.5,9,14,3339,9,2016,9,0
Group 3,BB,-0.5,9,14,3340,9,2016,6,3
Group 3,BB,-0.5,9,14,3341,12,2016,6,6
Group 3,BB,-0.5,9,14,3342,9,2016,6,3
Group 3,BB,-0.5,9,14,3343,10,2016,9,1
Group 3,BB,-0.5,9,14,3344,12,2016,11,1
Group 3,BB,-0.5,9,14,3345,7,2016,10,-3
Group 3,BB,-0.5,9,14,3346,11,2016,9,2
Group 3,BB,-0.5,9,14,3347,11,2016,8,3
Group 3,BB,-0.5,9,14,3348,11,2016,10,1
Group 3,BB,-0.5,9,14,3349,7,2016,7,0
Group 3,BB,-0.5,9,14,3350,6,2016,7,-1
Group 3,BB,-0.5,9,14,3351,5,2016,7,-2
Group 3,BB,-0.5,9,14,3352,10,2016,10,0
Group 3,BB,-0.5,9,14,3353,8,2016,9,-1
Group 3,BB,-0.5,9,14,3354,7,2016,9,-2
Group 3,BB,-0.5,9,14,3355,10,2016,7,3
Group 3,BB,-0.5,9,14,3356,10,2016,9,1
Group 3,BB,-0.5,9,14,3357,6,2016,6,0
Group 3,BB,-0.5,9,14,3358,10,2016,6,4
Group 3,BB,-0.5,9,14,3359,9,2016,8,1
Group 3,BB,-0.5,9,14,3360,10,2016,3,7
Group 3,BB,-0.5,9,14,3361,11,2016,6,5
Group 3,BB,-0.5,9,14,3362,10,2016,7,3
Group 3,BB,-0.5,9,14,3363,12,2016,5,7
Group 3,BB,-0.5,9,14,3364,7,2016,8,-1
Group 3,BB,-0.5,9,14,3365,11,2016,9,2
Group 3,BB,-0.5,9,14,3366,5,2016,5,0
Group 3,BB,-0.5,9,14,3367,11,2016,10,1
Group 3,BB,-0.5,9,14,3368,9,2016,7,2
Group 3,BB,-0.5,9,14,3369,6,2016,9,-3
Group 3,BB,-0.5,9,14,3370,12,2016,13,-1
Group 3,BB,-0.5,9,14,3371,11,2016,11,0
Group 3,BB,-0.5,9,14,3372,13,2016,8,5
Group 3,BB,-0.5,9,14,3373,9,2016,11,-2
Group 3,BB,-0.5,9,14,3374,12,2016,8,4
Group 3,BB,-0.5,9,14,3375,11,2016,10,1
Group 3,BB,-0.5,9,14,3376,8,2016,9,-1
Group 3,BB,-0.5,9,14,3377,10,2016,8,2
Group 3,BB,-0.5,9,14,3378,11,2016,7,4
Group 3,BB,-0.5,9,14,3379,5,2016,8,-3
Group 3,BB,-0.5,9,14,3380,10,2016,5,5
Group 3,BB,-0.5,9,14,3381,8,2016,7,1
Group 3,BB,-0.5,9,14,3382,9,2016,3,6
Group 3,BB,-0.5,9,14,3383,10,2016,9,1
Group 3,BB,-0.5,9,14,3384,10,2016,9,1
Group 3,BB,-0.5,9,14,3385,10,2016,3,7
Group 3,BB,-0.5,9,14,3386,9,2016,4,5
Group 3,BB,-0.5,9,14,3387,11,2016,8,3
Group 3,BB,-0.5,9,14,3388,9,2016,5,4
Group 3,BB,-0.5,9,14,3389,10,2016,6,4
Group 3,BB,-0.5,9,14,3390,12,2016,8,4
Group 3,BB,-0.5,9,14,3391,10,2016,11,-1
Group 3,BB,-0.5,9,14,3392,6,2016,10,-4
Group 3,BB,-0.5,9,14,3393,12,2016,11,1
Group 3,BB,-0.5,9,14,3394,7,2016,6,1
Group 3,BB,-0.5,9,14,3395,9,2016,6,3
Group 3,BB,-0.5,9,14,3396,8,2016,8,0
Group 3,BB,-0.5,9,14,3397,9,2016,8,1
Group 3,BB,-0.5,9,14,3398,10,2016,7,3
Group 3,BB,-0.5,9,14,3399,11,2016,10,1
Group 3,BB,-0.5,9,14,3400,8,2016,5,3
Group 3,BB,-0.5,9,14,3401,7,2016,10,-3
Group 3,BB,-0.5,9,14,3402,8,2016,8,0
Group 3,BB,-0.5,9,14,3403,9,2016,8,1
Group 3,BB,-0.5,9,14,3404,12,2016,7,5
Group 3,BB,-0.5,9,14,3405,11,2016,8,3
Group 3,BB,-0.5,9,14,3406,11,2016,6,5
Group 3,BB,-0.5,9,14,3407,11,2016,6,5
Group 3,BB,-0.5,9,14,3408,9,2016,10,-1
Group 3,BB,-0.5,9,14,3409,7,2016,6,1
Group 3,BB,-0.5,9,14,3410,12,2016,12,0
Group 3,BB,-0.5,9,14,3411,7,2016,8,-1
Group 3,BB,-0.5,9,14,3412,10,2016,6,4
Group 3,BB,-0.5,9,14,3413,10,2016,11,-1
Group 3,BB,-0.5,9,14,3414,8,2016,7,1
Group 3,BB,-0.5,9,14,3415,10,2016,7,3
Group 3,BB,-0.5,9,14,3416,11,2016,11,0
Group 3,BB,-0.5,9,14,3417,8,2016,7,1
Group 3,BB,-0.5,9,14,3418,10,2016,7,3
Group 3,BB,-0.5,9,14,3419,9,2016,7,2
Group 3,BB,-0.5,9,14,3420,9,2016,7,2
Group 3,BB,-0.5,9,14,3421,12,2016,10,2
Group 3,BB,-0.5,9,14,3422,7,2016,7,0
Group 3,BB,-0.5,9,14,3423,8,2016,6,2
Group 3,BB,-0.5,9,14,3424,11,2016,6,5
Group 3,BB,-0.5,9,14,3425,14,2016,8,6
Group 3,BB,-0.5,9,14,3426,8,2016,6,2
Group 3,BB,-0.5,9,14,3427,8,2016,7,1
Group 3,BB,-0.5,9,14,3428,8,2016,8,0
Group 3,BB,-0.5,9,14,3429,7,2016,5,2
Group 3,BB,-0.5,9,14,3430,7,2016,5,2
Group 3,BB,-0.5,9,14,3431,10,2016,7,3
Group 3,BB,-0.5,9,14,3432,12,2016,4,8
Group 3,BB,-0.5,9,14,3433,9,2016,6,3
Group 3,BB,-0.5,9,14,3434,8,2016,10,-2
Group 3,BB,-0.5,9,14,3435,7,2016,6,1
Group 3,BB,-0.5,9,14,3436,7,2016,7,0
Group 3,BB,-0.5,9,14,3437,11,2016,8,3
Group 3,BB,-0.5,9,14,3438,6,2016,5,1
Group 3,BB,-0.5,9,14,3439,10,2016,5,5
Group 3,BB,-0.5,9,14,3440,11,2016,9,2
Group 3,BB,-0.5,9,14,3441,8,2016,7,1
Group 3,BB,-0.5,9,14,3442,11,2016,6,5
Group 3,BB,-0.5,9,14,3443,7,2016,10,-3
Group 3,BB,-0.5,9,14,3444,7,2016,9,-2
Group 3,BB,-0.5,9,14,3445,7,2016,11,-4
Group 3,BB,-0.5,9,14,3446,7,2016,10,-3
Group 3,BB,-0.5,9,14,3447,11,2016,11,0
Group 3,BB,-0.5,9,14,3448,7,2016,8,-1
Group 3,BB,-0.5,9,14,3449,8,2016,9,-1
Group 3,BB,-0.5,9,14,3450,9,2016,10,-1
Group 3,BB,-0.5,9,14,3451,6,2016,10,-4
Group 3,BB,-0.5,9,14,3452,11,2016,8,3
Group 3,BB,-0.5,9,14,3453,8,2016,11,-3
Group 3,BB,-0.5,9,14,3454,9,2016,10,-1
Group 3,BB,-0.5,9,14,3455,10,2016,10,0
Group 3,BB,-0.5,9,14,3456,8,2016,7,1
Group 3,BB,-0.5,9,14,3457,7,2016,8,-1
Group 3,BB,-0.5,9,14,3458,11,2016,9,2
Group 3,BB,-0.5,9,14,3459,7,2016,10,-3
Group 3,BB,-0.5,9,14,3460,11,2016,8,3
Group 3,BB,-0.5,9,14,3461,8,2016,10,-2
Group 3,BB,-0.5,9,14,3462,7,2016,8,-1
Group 3,BB,-0.5,9,14,3463,8,2016,9,-1
Group 3,BB,-0.5,9,14,3464,6,2016,9,-3
Group 3,BB,-0.5,9,14,3465,11,2016,7,4
Group 3,BB,-0.5,9,14,3466,10,2016,9,1
Group 3,BB,-0.5,9,14,3467,10,2016,9,1
Group 3,BB,-0.5,9,14,3468,7,2016,7,0
Group 3,BB,-0.5,9,14,3469,9,2016,7,2
Group 3,BB,-0.5,9,14,3470,10,2016,10,0
Group 3,BB,-0.5,9,14,3471,9,2016,9,0
Group 3,BB,-0.5,9,14,3472,11,2016,6,5
Group 3,BB,-0.5,9,14,3473,8,2016,5,3
Group 3,BB,-0.5,9,14,3474,10,2016,8,2
Group 3,BB,-0.5,9,14,3475,7,2016,7,0
Group 3,BB,-0.5,9,14,3476,7,2016,11,-4
Group 3,BB,-0.5,9,14,3477,6,2016,7,-1
Group 3,BB,-0.5,9,14,3478,9,2016,9,0
Group 3,BB,-0.5,9,14,3479,12,2016,9,3
Group 3,BB,-0.5,9,14,3480,13,2016,11,2
Group 3,BB,-0.5,9,14,3481,6,2016,4,2
Group 3,BB,-0.5,9,14,3482,13,2016,7,6
Group 3,BB,-0.5,9,14,3483,10,2016,10,0
Group 3,BB,-0.5,9,14,3484,9,2016,4,5
Group 3,BB,-0.5,9,14,3485,12,2016,6,6
Group 3,BB,-0.5,9,14,3486,4,2016,7,-3
Group 3,BB,-0.5,9,14,3487,12,2016,6,6
Group 3,BB,-0.5,9,14,3488,4,2016,9,-5
Group 3,BB,-0.5,9,14,3489,6,2016,7,-1
Group 3,BB,-0.5,9,14,3490,8,2016,7,1
Group 3,BB,-0.5,9,14,3491,9,2016,12,-3
Group 3,BB,-0.5,9,14,3492,7,2016,8,-1
Group 3,BB,-0.5,9,14,3493,6,2016,8,-2
Group 3,BB,-0.5,9,14,3494,8,2016,6,2
Group 3,BB,-0.5,9,14,3495,7,2016,10,-3
Group 3,BB,-0.5,9,14,3496,11,2016,13,-2
Group 3,BB,-0.5,9,14,3497,10,2016,10,0
Group 3,BB,-0.5,9,14,3498,6,2016,9,-3
Group 3,BB,-0.5,9,14,3499,8,2016,6,2
Group 3,BB,-0.5,9,14,3500,10,2016,11,-1
Group 3,BB,-0.5,9,14,3501,10,2016,7,3
Group 3,BB,-0.5,9,14,3502,11,2016,8,3
Group 3,BB,-0.5,9,14,3503,10,2016,9,1
Group 3,BB,-0.5,9,14,3504,7,2016,7,0
Group 3,BB,-0.5,9,14,3505,8,2016,9,-1
Group 3,BB,-0.5,9,14,3506,9,2016,13,-4
Group 3,BB,-0.5,9,14,3507,8,2016,6,2
Group 3,BB,-0.5,9,14,3508,14,2016,7,7
Group 3,BB,-0.5,9,14,3509,8,2016,13,-5
Group 3,BB,-0.5,9,14,3510,11,2016,10,1
Group 3,BB,-0.5,9,14,3511,13,2016,9,4
Group 3,BB,-0.5,9,14,3512,8,2016,7,1
Group 3,BB,-0.5,9,14,3513,11,2016,9,2
Group 3,BB,-0.5,9,14,3514,10,2016,6,4
Group 3,BB,-0.5,9,14,3515,12,2016,11,1
Group 3,BB,-0.5,9,14,3516,11,2016,7,4
Group 3,BB,-0.5,9,14,3517,8,2016,9,-1
Group 3,BB,-0.5,9,14,3518,9,2016,5,4
Group 3,BB,-0.5,9,14,3519,9,2016,6,3
Group 3,BB,-0.5,9,14,3520,8,2016,7,1
Group 3,BB,-0.5,9,14,3521,14,2016,7,7
Group 3,BB,-0.5,9,14,3522,10,2016,11,-1
Group 3,BB,-0.5,9,14,3523,11,2016,9,2
Group 3,BB,-0.5,9,14,3524,8,2016,10,-2
Group 3,BB,-0.5,9,14,3525,7,2016,9,-2
Group 3,BB,-0.5,9,14,3526,13,2016,9,4
Group 3,BB,-0.5,9,14,3527,13,2016,8,5
Group 3,BB,-0.5,9,14,3528,13,2016,11,2
Group 3,BB,-0.5,9,14,3529,12,2016,3,9
Group 3,BB,-0.5,9,14,3530,9,2016,5,4
Group 3,BB,-0.5,9,14,3531,12,2016,8,4
Group 3,BB,-0.5,9,14,3532,8,2016,4,4
Group 3,BB,-0.5,9,14,3533,6,2016,6,0
Group 3,BB,-0.5,9,14,3534,8,2016,9,-1
Group 3,BB,-0.5,9,14,3535,6,2016,4,2
Group 3,BB,-0.5,9,14,3536,9,2016,9,0
Group 3,BB,-0.5,9,14,3537,10,2016,11,-1
Group 3,BB,-0.5,9,14,3538,8,2016,10,-2
Group 3,BB,-0.5,9,14,3539,8,2016,13,-5
Group 3,BB,-0.5,9,14,3540,8,2016,12,-4
Group 3,BB,-0.5,9,14,3541,10,2016,5,5
Group 3,BB,-0.5,9,14,3542,7,2016,7,0
Group 3,BB,-0.5,9,14,3543,12,2016,11,1
Group 3,BB,-0.5,9,14,3544,5,2016,5,0
Group 3,BB,-0.5,9,14,3545,7,2016,10,-3
Group 3,BB,-0.5,9,14,3546,13,2016,11,2
Group 3,BB,-0.5,9,14,3547,8,2016,5,3
Group 3,BB,-0.5,9,14,3548,8,2016,6,2
Group 3,BB,-0.5,9,14,3549,8,2016,7,1
Group 3,BB,-0.5,9,14,3550,9,2016,6,3
Group 3,BB,-0.5,9,14,3551,12,2016,7,5
Group 3,BB,-0.5,9,14,3552,6,2016,10,-4
Group 3,BB,-0.5,9,14,3553,5,2016,5,0
Group 3,BB,-0.5,9,14,3554,12,2016,7,5
Group 3,BB,-0.5,9,14,3555,7,2016,5,2
Group 3,BB,-0.5,9,14,3556,10,2016,9,1
Group 3,BB,-0.5,9,14,3557,9,2016,10,-1
Group 3,BB,-0.5,9,14,3558,9,2016,7,2
Group 3,BB,-0.5,9,14,3559,12,2016,10,2
Group 3,BB,-0.5,9,14,3560,12,2016,8,4
Group 3,BB,-0.5,9,14,3561,9,2016,11,-2
Group 3,BB,-0.5,9,14,3562,14,2016,11,3
Group 3,BB,-0.5,9,14,3563,10,2016,4,6
Group 3,BB,-0.5,9,14,3564,3,2016,11,-8
Group 3,BB,-0.5,9,14,3565,11,2016,9,2
Group 3,BB,-0.5,9,14,3566,7,2016,9,-2
Group 3,BB,-0.5,9,14,3567,12,2016,7,5
Group 3,BB,-0.5,9,14,3568,10,2016,7,3
Group 3,BB,-0.5,9,14,3569,8,2016,8,0
Group 3,BB,-0.5,9,14,3570,11,2016,10,1
Group 3,BB,-0.5,9,14,3571,5,2016,6,-1
Group 3,BB,-0.5,9,14,3572,8,2016,8,0
Group 3,BB,-0.5,9,14,3573,6,2016,9,-3
Group 3,BB,-0.5,9,14,3574,10,2016,7,3
Group 3,BB,-0.5,9,14,3575,10,2016,11,-1
Group 3,BB,-0.5,9,14,3576,12,2016,6,6
Group 3,BB,-0.5,9,14,3577,8,2016,8,0
Group 3,BB,-0.5,9,14,3578,6,2016,8,-2
Group 3,BB,-0.5,9,14,3579,6,2016,4,2
Group 3,BB,-0.5,9,14,3580,14,2016,12,2
Group 3,BB,-0.5,9,14,3581,6,2016,10,-4
Group 3,BB,-0.5,9,14,3582,8,2016,9,-1
Group 3,BB,-0.5,9,14,3583,9,2016,7,2
Group 3,BB,-0.5,9,14,3584,7,2016,7,0
Group 3,BB,-0.5,9,14,3585,8,2016,4,4
Group 3,BB,-0.5,9,14,3586,10,2016,8,2
Group 3,BB,-0.5,9,14,3587,10,2016,4,6
Group 3,BB,-0.5,9,14,3588,13,2016,3,10
Group 3,BB,-0.5,9,14,3589,11,2016,5,6
Group 3,BB,-0.5,9,14,3590,8,2016,8,0
Group 3,BB,-0.5,9,14,3591,9,2016,10,-1
Group 3,BB,-0.5,9,14,3592,13,2016,8,5
Group 3,BB,-0.5,9,14,3593,7,2016,9,-2
Group 3,BB,-0.5,9,14,3594,8,2016,6,2
Group 3,BB,-0.5,9,14,3595,11,2016,6,5
Group 3,BB,-0.5,9,14,3596,9,2016,8,1
Group 3,BB,-0.5,9,14,3597,13,2016,7,6
Group 3,BB,-0.5,9,14,3598,3,2016,8,-5
Group 3,BB,-0.5,9,14,3599,9,2016,6,3
Group 3,BB,-0.5,9,14,3600,10,2016,8,2
Group 3,BB,-0.5,9,14,3601,9,2016,10,-1
Group 3,BB,-0.5,9,14,3602,11,2016,6,5
Group 3,BB,-0.5,9,14,3603,12,2016,7,5
Group 3,BB,-0.5,9,14,3604,6,2016,12,-6
Group 3,BB,-0.5,9,14,3605,7,2016,9,-2
Group 3,BB,-0.5,9,14,3606,7,2016,4,3
Group 3,BB,-0.5,9,14,3607,12,2016,6,6
Group 3,BB,-0.5,9,14,3608,10,2016,5,5
Group 3,BB,-0.5,9,14,3609,8,2016,11,-3
Group 3,BB,-0.5,9,14,3610,10,2016,6,4
Group 3,BB,-0.5,9,14,3611,9,2016,6,3
Group 3,BB,-0.5,9,14,3612,10,2016,4,6
Group 3,BB,-0.5,9,14,3613,11,2016,6,5
Group 3,BB,-0.5,9,14,3614,11,2016,10,1
Group 3,BB,-0.5,9,14,3615,7,2016,9,-2
Group 3,BB,-0.5,9,14,3616,9,2016,9,0
Group 3,BB,-0.5,9,14,3617,10,2016,7,3
Group 3,BB,-0.5,9,14,3618,5,2016,8,-3
Group 3,BB,-0.5,9,14,3619,8,2016,10,-2
Group 3,BB,-0.5,9,14,3620,7,2016,8,-1
Group 3,BB,-0.5,9,14,3621,10,2016,9,1
Group 3,BB,-0.5,9,14,3622,10,2016,10,0
Group 3,BB,-0.5,9,14,3623,13,2016,9,4
Group 3,BB,-0.5,9,14,3624,12,2016,10,2
Group 3,BB,-0.5,9,14,3625,11,2016,6,5
Group 3,BB,-0.5,9,14,3626,10,2016,8,2
Group 3,BB,-0.5,9,14,3627,11,2016,13,-2
Group 3,BB,-0.5,9,14,3628,12,2016,9,3
Group 3,BB,-0.5,9,14,3629,6,2016,11,-5
Group 3,BB,-0.5,9,14,3630,9,2016,8,1
Group 3,BB,-0.5,9,14,3631,6,2016,10,-4
Group 3,BB,-0.5,9,14,3632,8,2016,12,-4
Group 3,BB,-0.5,9,14,3633,4,2016,3,1
Group 3,BB,-0.5,9,14,3634,8,2016,10,-2
Group 3,BB,-0.5,9,14,3635,8,2016,9,-1
Group 3,BB,-0.5,9,14,3636,9,2016,5,4
Group 3,BB,-0.5,9,14,3637,9,2016,9,0
Group 3,BB,-0.5,9,14,3638,9,2016,6,3
Group 3,BB,-0.5,9,14,3639,12,2016,6,6
Group 3,BB,-0.5,9,14,3640,8,2016,6,2
Group 3,BB,-0.5,9,14,3641,5,2016,7,-2
Group 3,BB,-0.5,9,14,3642,7,2016,7,0
Group 3,BB,-0.5,9,14,3643,10,2016,10,0
Group 3,BB,-0.5,9,14,3644,11,2016,10,1
Group 3,BB,-0.5,9,14,3645,6,2016,7,-1
Group 3,BB,-0.5,9,14,3646,10,2016,6,4
Group 3,BB,-0.5,9,14,3647,12,2016,12,0
Group 3,BB,-0.5,9,14,3648,8,2016,7,1
Group 3,BB,-0.5,9,14,3649,11,2016,9,2
Group 3,BB,-0.5,9,14,3650,13,2016,12,1
Group 3,BB,-0.5,9,14,3651,8,2016,9,-1
Group 3,BB,-0.5,9,14,3652,7,2016,10,-3
Group 3,BB,-0.5,9,14,3653,6,2016,8,-2
Group 3,BB,-0.5,9,14,3654,11,2016,7,4
Group 3,BB,-0.5,9,14,3655,9,2016,9,0
Group 3,BB,-0.5,9,14,3656,12,2016,8,4
Group 3,BB,-0.5,9,14,3657,7,2016,9,-2
Group 3,BB,-0.5,9,14,3658,7,2016,7,0
Group 3,BB,-0.5,9,14,3659,7,2016,10,-3
Group 3,BB,-0.5,9,14,3660,8,2016,7,1
Group 3,BB,-0.5,9,14,3661,8,2016,5,3
Group 3,BB,-0.5,9,14,3662,8,2016,8,0
Group 3,BB,-0.5,9,14,3663,9,2016,6,3
Group 3,BB,-0.5,9,14,3664,4,2016,4,0
Group 3,BB,-0.5,9,14,3665,10,2016,8,2
Group 3,BB,-0.5,9,14,3666,11,2016,10,1
Group 3,BB,-0.5,9,14,3667,8,2016,9,-1
Group 3,BB,-0.5,9,14,3668,7,2016,9,-2
Group 3,BB,-0.5,9,14,3669,14,2016,9,5
Group 3,BB,-0.5,9,14,3670,7,2016,11,-4
Group 3,BB,-0.5,9,14,3671,7,2016,7,0
Group 3,BB,-0.5,9,14,3672,7,2016,11,-4
Group 3,BB,-0.5,9,14,3673,8,2016,9,-1
Group 3,BB,-0.5,9,14,3674,9,2016,14,-5
Group 3,BB,-0.5,9,14,3675,4,2016,11,-7
Group 3,BB,-0.5,9,14,3676,12,2016,8,4
Group 3,BB,-0.5,9,14,3677,11,2016,7,4
Group 3,BB,-0.5,9,14,3678,6,2016,8,-2
Group 3,BB,-0.5,9,14,3679,9,2016,8,1
Group 3,BB,-0.5,9,14,3680,6,2016,5,1
Group 3,BB,-0.5,9,14,3681,11,2016,5,6
Group 3,BB,-0.5,9,14,3682,6,2016,9,-3
Group 3,BB,-0.5,9,14,3683,10,2016,8,2
Group 3,BB,-0.5,9,14,3684,7,2016,8,-1
Group 3,BB,-0.5,9,14,3685,10,2016,5,5
Group 3,BB,-0.5,9,14,3686,9,2016,8,1
Group 3,BB,-0.5,9,14,3687,9,2016,7,2
Group 3,BB,-0.5,9,14,3688,8,2016,8,0
Group 3,BB,-0.5,9,14,3689,9,2016,7,2
Group 3,BB,-0.5,9,14,3690,8,2016,7,1
Group 3,BB,-0.5,9,14,3691,7,2016,4,3
Group 3,BB,-0.5,9,14,3692,7,2016,7,0
Group 3,BB,-0.5,9,14,3693,11,2016,7,4
Group 3,BB,-0.5,9,14,3694,11,2016,7,4
Group 3,BB,-0.5,9,14,3695,7,2016,9,-2
Group 3,BB,-0.5,9,14,3696,9,2016,8,1
Group 3,BB,-0.5,9,14,3697,11,2016,8,3
Group 3,BB,-0.5,9,14,3698,9,2016,8,1
Group 3,BB,-0.5,9,14,3699,12,2016,6,6
Group 3,BB,-0.5,9,14,3700,12,2016,11,1
Group 3,BB,-0.5,9,14,3701,9,2016,12,-3
Group 3,BB,-0.5,9,14,3702,7,2016,5,2
Group 3,BB,-0.5,9,14,3703,8,2016,9,-1
Group 3,BB,-0.5,9,14,3704,5,2016,8,-3
Group 3,BB,-0.5,9,14,3705,12,2016,10,2
Group 3,BB,-0.5,9,14,3706,11,2016,10,1
Group 3,BB,-0.5,9,14,3707,10,2016,9,1
Group 3,BB,-0.5,9,14,3708,9,2016,8,1
Group 3,BB,-0.5,9,14,3709,8,2016,6,2
Group 3,BB,-0.5,9,14,3710,8,2016,7,1
Group 3,BB,-0.5,9,14,3711,9,2016,10,-1
Group 3,BB,-0.5,9,14,3712,4,2016,10,-6
Group 3,BB,-0.5,9,14,3713,11,2016,6,5
Group 3,BB,-0.5,9,14,3714,7,2016,8,-1
Group 3,BB,-0.5,9,14,3715,10,2016,9,1
Group 3,BB,-0.5,9,14,3716,9,2016,7,2
Group 3,BB,-0.5,9,14,3717,7,2016,11,-4
Group 3,BB,-0.5,9,14,3718,9,2016,9,0
Group 3,BB,-0.5,9,14,3719,12,2016,5,7
Group 3,BB,-0.5,9,14,3720,10,2016,8,2
Group 3,BB,-0.5,9,14,3721,9,2016,7,2
Group 3,BB,-0.5,9,14,3722,6,2016,8,-2
Group 3,BB,-0.5,9,14,3723,7,2016,7,0
Group 3,BB,-0.5,9,14,3724,5,2016,9,-4
Group 3,BB,-0.5,9,14,3725,7,2016,6,1
Group 3,BB,-0.5,9,14,3726,9,2016,7,2
Group 3,BB,-0.5,9,14,3727,6,2016,3,3
Group 3,BB,-0.5,9,14,3728,7,2016,7,0
Group 3,BB,-0.5,9,14,3729,9,2016,6,3
Group 3,BB,-0.5,9,14,3730,10,2016,5,5
Group 3,BB,-0.5,9,14,3731,11,2016,10,1
Group 3,BB,-0.5,9,14,3732,6,2016,4,2
Group 3,BB,-0.5,9,14,3733,9,2016,7,2
Group 3,BB,-0.5,9,14,3734,9,2016,10,-1
Group 3,BB,-0.5,9,14,3735,9,2016,12,-3
Group 3,BB,-0.5,9,14,3736,6,2016,8,-2
Group 3,BB,-0.5,9,14,3737,11,2016,10,1
Group 3,BB,-0.5,9,14,3738,4,2016,7,-3
Group 3,BB,-0.5,9,14,3739,10,2016,7,3
Group 3,BB,-0.5,9,14,3740,11,2016,7,4
Group 3,BB,-0.5,9,14,3741,11,2016,9,2
Group 3,BB,-0.5,9,14,3742,8,2016,9,-1
Group 3,BB,-0.5,9,14,3743,12,2016,7,5
Group 3,BB,-0.5,9,14,3744,6,2016,6,0
Group 3,BB,-0.5,9,14,3745,8,2016,6,2
Group 3,BB,-0.5,9,14,3746,8,2016,10,-2
Group 3,BB,-0.5,9,14,3747,12,2016,4,8
Group 3,BB,-0.5,9,14,3748,9,2016,10,-1
Group 3,BB,-0.5,9,14,3749,11,2016,10,1
Group 3,BB,-0.5,9,14,3750,9,2016,7,2
Group 3,BB,-0.5,9,14,3751,9,2016,8,1
Group 3,BB,-0.5,9,14,3752,9,2016,7,2
Group 3,BB,-0.5,9,14,3753,12,2016,7,5
Group 3,BB,-0.5,9,14,3754,8,2016,8,0
Group 3,BB,-0.5,9,14,3755,8,2016,8,0
Group 3,BB,-0.5,9,14,3756,7,2016,8,-1
Group 3,BB,-0.5,9,14,3757,13,2016,10,3
Group 3,BB,-0.5,9,14,3758,13,2016,10,3
Group 3,BB,-0.5,9,14,3759,6,2016,7,-1
Group 3,BB,-0.5,9,14,3760,8,2016,7,1
Group 3,BB,-0.5,9,14,3761,12,2016,9,3
Group 3,BB,-0.5,9,14,3762,13,2016,7,6
Group 3,BB,-0.5,9,14,3763,9,2016,11,-2
Group 3,BB,-0.5,9,14,3764,11,2016,9,2
Group 3,BB,-0.5,9,14,3765,8,2016,8,0
Group 3,BB,-0.5,9,14,3766,10,2016,5,5
Group 3,BB,-0.5,9,14,3767,10,2016,7,3
Group 3,BB,-0.5,9,14,3768,9,2016,8,1
Group 3,BB,-0.5,9,14,3769,9,2016,9,0
Group 3,BB,-0.5,9,14,3770,13,2016,13,0
Group 3,BB,-0.5,9,14,3771,10,2016,12,-2
Group 3,BB,-0.5,9,14,3772,12,2016,12,0
Group 3,BB,-0.5,9,14,3773,8,2016,8,0
Group 3,BB,-0.5,9,14,3774,5,2016,10,-5
Group 3,BB,-0.5,9,14,3775,10,2016,11,-1
Group 3,BB,-0.5,9,14,3776,12,2016,5,7
Group 3,BB,-0.5,9,14,3777,13,2016,4,9
Group 3,BB,-0.5,9,14,3778,5,2016,1,4
Group 3,BB,-0.5,9,14,3779,11,2016,8,3
Group 3,BB,-0.5,9,14,3780,10,2016,5,5
Group 3,BB,-0.5,9,14,3781,7,2016,10,-3
Group 3,BB,-0.5,9,14,3782,10,2016,11,-1
Group 3,BB,-0.5,9,14,3783,7,2016,7,0
Group 3,BB,-0.5,9,14,3784,11,2016,10,1
Group 3,BB,-0.5,9,14,3785,9,2016,10,-1
Group 3,BB,-0.5,9,14,3786,12,2016,7,5
Group 3,BB,-0.5,9,14,3787,10,2016,8,2
Group 3,BB,-0.5,9,14,3788,6,2016,9,-3
Group 3,BB,-0.5,9,14,3789,13,2016,11,2
Group 3,BB,-0.5,9,14,3790,11,2016,8,3
Group 3,BB,-0.5,9,14,3791,8,2016,8,0
Group 3,BB,-0.5,9,14,3792,8,2016,6,2
Group 3,BB,-0.5,9,14,3793,11,2016,9,2
Group 3,BB,-0.5,9,14,3794,6,2016,5,1
Group 3,BB,-0.5,9,14,3795,5,2016,12,-7
Group 3,BB,-0.5,9,14,3796,9,2016,9,0
Group 3,BB,-0.5,9,14,3797,5,2016,8,-3
Group 3,BB,-0.5,9,14,3798,3,2016,5,-2
Group 3,BB,-0.5,9,14,3799,12,2016,10,2
Group 3,BB,-0.5,9,14,3800,10,2016,9,1
Group 3,BB,-0.5,9,14,3801,13,2016,9,4
Group 3,BB,-0.5,9,14,3802,11,2016,7,4
Group 3,BB,-0.5,9,14,3803,5,2016,11,-6
Group 3,BB,-0.5,9,14,3804,6,2016,6,0
Group 3,BB,-0.5,9,14,3805,7,2016,5,2
Group 3,BB,-0.5,9,14,3806,9,2016,7,2
Group 3,BB,-0.5,9,14,3807,11,2016,8,3
Group 3,BB,-0.5,9,14,3808,12,2016,9,3
Group 3,BB,-0.5,9,14,3809,10,2016,8,2
Group 3,BB,-0.5,9,14,3810,13,2016,6,7
Group 3,BB,-0.5,9,14,3811,3,2016,9,-6
Group 3,BB,-0.5,9,14,3812,11,2016,10,1
Group 3,BB,-0.5,9,14,3813,11,2016,11,0
Group 3,BB,-0.5,9,14,3814,7,2016,9,-2
Group 3,BB,-0.5,9,14,3815,4,2016,9,-5
Group 3,BB,-0.5,9,14,3816,7,2016,8,-1
Group 3,BB,-0.5,9,14,3817,8,2016,7,1
Group 3,BB,-0.5,9,14,3818,10,2016,9,1
Group 3,BB,-0.5,9,14,3819,10,2016,7,3
Group 3,BB,-0.5,9,14,3820,10,2016,6,4
Group 3,BB,-0.5,9,14,3821,8,2016,11,-3
Group 3,BB,-0.5,9,14,3822,11,2016,9,2
Group 3,BB,-0.5,9,14,3823,8,2016,11,-3
Group 3,BB,-0.5,9,14,3824,10,2016,4,6
Group 3,BB,-0.5,9,14,3825,9,2016,9,0
Group 3,BB,-0.5,9,14,3826,7,2016,12,-5
Group 3,BB,-0.5,9,14,3827,12,2016,8,4
Group 3,BB,-0.5,9,14,3828,7,2016,5,2
Group 3,BB,-0.5,9,14,3829,10,2016,4,6
Group 3,BB,-0.5,9,14,3830,9,2016,9,0
Group 3,BB,-0.5,9,14,3831,7,2016,9,-2
Group 3,BB,-0.5,9,14,3832,9,2016,9,0
Group 3,BB,-0.5,9,14,3833,9,2016,7,2
Group 3,BB,-0.5,9,14,3834,8,2016,7,1
Group 3,BB,-0.5,9,14,3835,11,2016,10,1
Group 3,BB,-0.5,9,14,3836,11,2016,8,3
Group 3,BB,-0.5,9,14,3837,8,2016,8,0
Group 3,BB,-0.5,9,14,3838,9,2016,6,3
Group 3,BB,-0.5,9,14,3839,9,2016,8,1
Group 3,BB,-0.5,9,14,3840,9,2016,7,2
Group 3,BB,-0.5,9,14,3841,10,2016,7,3
Group 3,BB,-0.5,9,14,3842,5,2016,7,-2
Group 3,BB,-0.5,9,14,3843,11,2016,9,2
Group 3,BB,-0.5,9,14,3844,9,2016,12,-3
Group 3,BB,-0.5,9,14,3845,8,2016,9,-1
Group 3,BB,-0.5,9,14,3846,9,2016,9,0
Group 3,BB,-0.5,9,14,3847,10,2016,8,2
Group 3,BB,-0.5,9,14,3848,11,2016,6,5
Group 3,BB,-0.5,9,14,3849,6,2016,11,-5
Group 3,BB,-0.5,9,14,3850,7,2016,7,0
Group 3,BB,-0.5,9,14,3851,8,2016,12,-4
Group 3,BB,-0.5,9,14,3852,9,2016,10,-1
Group 3,BB,-0.5,9,14,3853,9,2016,7,2
Group 3,BB,-0.5,9,14,3854,8,2016,10,-2
Group 3,BB,-0.5,9,14,3855,7,2016,6,1
Group 3,BB,-0.5,9,14,3856,9,2016,9,0
Group 3,BB,-0.5,9,14,3857,10,2016,9,1
Group 3,BB,-0.5,9,14,3858,10,2016,8,2
Group 3,BB,-0.5,9,14,3859,9,2016,8,1
Group 3,BB,-0.5,9,14,3860,10,2016,8,2
Group 3,BB,-0.5,9,14,3861,13,2016,11,2
Group 3,BB,-0.5,9,14,3862,12,2016,9,3
Group 3,BB,-0.5,9,14,3863,12,2016,10,2
Group 3,BB,-0.5,9,14,3864,10,2016,6,4
Group 3,BB,-0.5,9,14,3865,9,2016,7,2
Group 3,BB,-0.5,9,14,3866,10,2016,10,0
Group 3,BB,-0.5,9,14,3867,10,2016,9,1
Group 3,BB,-0.5,9,14,3868,9,2016,11,-2
Group 3,BB,-0.5,9,14,3869,8,2016,9,-1
Group 3,BB,-0.5,9,14,3870,9,2016,7,2
Group 3,BB,-0.5,9,14,3871,9,2016,8,1
Group 3,BB,-0.5,9,14,3872,9,2016,10,-1
Group 3,BB,-0.5,9,14,3873,9,2016,10,-1
Group 3,BB,-0.5,9,14,3874,7,2016,8,-1
Group 3,BB,-0.5,9,14,3875,8,2016,7,1
Group 3,BB,-0.5,9,14,3876,12,2016,7,5
Group 3,BB,-0.5,9,14,3877,7,2016,9,-2
Group 3,BB,-0.5,9,14,3878,10,2016,6,4
Group 3,BB,-0.5,9,14,3879,9,2016,8,1
Group 3,BB,-0.5,9,14,3880,7,2016,8,-1
Group 3,BB,-0.5,9,14,3881,8,2016,7,1
Group 3,BB,-0.5,9,14,3882,11,2016,6,5
Group 3,BB,-0.5,9,14,3883,7,2016,10,-3
Group 3,BB,-0.5,9,14,3884,7,2016,8,-1
Group 3,BB,-0.5,9,14,3885,8,2016,7,1
Group 3,BB,-0.5,9,14,3886,9,2016,9,0
Group 3,BB,-0.5,9,14,3887,8,2016,10,-2
Group 3,BB,-0.5,9,14,3888,9,2016,12,-3
Group 3,BB,-0.5,9,14,3889,9,2016,8,1
Group 3,BB,-0.5,9,14,3890,8,2016,5,3
Group 3,BB,-0.5,9,14,3891,7,2016,9,-2
Group 3,BB,-0.5,9,14,3892,11,2016,10,1
Group 3,BB,-0.5,9,14,3893,7,2016,9,-2
Group 3,BB,-0.5,9,14,3894,8,2016,6,2
Group 3,BB,-0.5,9,14,3895,9,2016,5,4
Group 3,BB,-0.5,9,14,3896,9,2016,9,0
Group 3,BB,-0.5,9,14,3897,10,2016,7,3
Group 3,BB,-0.5,9,14,3898,7,2016,7,0
Group 3,BB,-0.5,9,14,3899,10,2016,3,7
Group 3,BB,-0.5,9,14,3900,8,2016,9,-1
Group 3,BB,-0.5,9,14,3901,9,2016,5,4
Group 3,BB,-0.5,9,14,3902,9,2016,8,1
Group 3,BB,-0.5,9,14,3903,8,2016,10,-2
Group 3,BB,-0.5,9,14,3904,8,2016,6,2
Group 3,BB,-0.5,9,14,3905,9,2016,8,1
Group 3,BB,-0.5,9,14,3906,12,2016,6,6
Group 3,BB,-0.5,9,14,3907,11,2016,10,1
Group 3,BB,-0.5,9,14,3908,7,2016,9,-2
Group 3,BB,-0.5,9,14,3909,11,2016,11,0
Group 3,BB,-0.5,9,14,3910,10,2016,9,1
Group 3,BB,-0.5,9,14,3911,9,2016,6,3
Group 3,BB,-0.5,9,14,3912,8,2016,9,-1
Group 3,BB,-0.5,9,14,3913,7,2016,5,2
Group 3,BB,-0.5,9,14,3914,10,2016,9,1
Group 3,BB,-0.5,9,14,3915,11,2016,3,8
Group 3,BB,-0.5,9,14,3916,10,2016,8,2
Group 3,BB,-0.5,9,14,3917,10,2016,6,4
Group 3,BB,-0.5,9,14,3918,9,2016,7,2
Group 3,BB,-0.5,9,14,3919,12,2016,7,5
Group 3,BB,-0.5,9,14,3920,12,2016,4,8
Group 3,BB,-0.5,9,14,3921,9,2016,9,0
Group 3,BB,-0.5,9,14,3922,12,2016,10,2
Group 3,BB,-0.5,9,14,3923,13,2016,7,6
Group 3,BB,-0.5,9,14,3924,11,2016,8,3
Group 3,BB,-0.5,9,14,3925,9,2016,13,-4
Group 3,BB,-0.5,9,14,3926,7,2016,9,-2
Group 3,BB,-0.5,9,14,3927,10,2016,10,0
Group 3,BB,-0.5,9,14,3928,8,2016,7,1
Group 3,BB,-0.5,9,14,3929,7,2016,6,1
Group 3,BB,-0.5,9,14,3930,11,2016,11,0
Group 3,BB,-0.5,9,14,3931,7,2016,6,1
Group 3,BB,-0.5,9,14,3932,10,2016,7,3
Group 3,BB,-0.5,9,14,3933,9,2016,6,3
Group 3,BB,-0.5,9,14,3934,12,2016,8,4
Group 3,BB,-0.5,9,14,3935,11,2016,5,6
Group 3,BB,-0.5,9,14,3936,7,2016,5,2
Group 3,BB,-0.5,9,14,3937,6,2016,6,0
Group 3,BB,-0.5,9,14,3938,8,2016,9,-1
Group 3,BB,-0.5,9,14,3939,9,2016,9,0
Group 3,BB,-0.5,9,14,3940,12,2016,7,5
Group 3,BB,-0.5,9,14,3941,8,2016,12,-4
Group 3,BB,-0.5,9,14,3942,10,2016,9,1
Group 3,BB,-0.5,9,14,3943,7,2016,6,1
Group 3,BB,-0.5,9,14,3944,8,2016,9,-1
Group 3,BB,-0.5,9,14,3945,9,2016,7,2
Group 3,BB,-0.5,9,14,3946,5,2016,5,0
Group 3,BB,-0.5,9,14,3947,8,2016,4,4
Group 3,BB,-0.5,9,14,3948,11,2016,7,4
Group 3,BB,-0.5,9,14,3949,7,2016,7,0
Group 3,BB,-0.5,9,14,3950,8,2016,9,-1
Group 3,BB,-0.5,9,14,3951,9,2016,7,2
Group 3,BB,-0.5,9,14,3952,9,2016,6,3
Group 3,BB,-0.5,9,14,3953,9,2016,3,6
Group 3,BB,-0.5,9,14,3954,12,2016,8,4
Group 3,BB,-0.5,9,14,3955,6,2016,5,1
Group 3,BB,-0.5,9,14,3956,8,2016,3,5
Group 3,BB,-0.5,9,14,3957,11,2016,8,3
Group 3,BB,-0.5,9,14,3958,9,2016,7,2
Group 3,BB,-0.5,9,14,3959,8,2016,2,6
Group 3,BB,-0.5,9,14,3960,13,2016,5,8
Group 3,BB,-0.5,9,14,3961,9,2016,5,4
Group 3,BB,-0.5,9,14,3962,8,2016,11,-3
Group 3,BB,-0.5,9,14,3963,10,2016,8,2
Group 3,BB,-0.5,9,14,3964,3,2016,9,-6
Group 3,BB,-0.5,9,14,3965,8,2016,6,2
Group 3,BB,-0.5,9,14,3966,6,2016,7,-1
Group 3,BB,-0.5,9,14,3967,11,2016,11,0
Group 3,BB,-0.5,9,14,3968,12,2016,9,3
Group 3,BB,-0.5,9,14,3969,11,2016,5,6
Group 3,BB,-0.5,9,14,3970,8,2016,6,2
Group 3,BB,-0.5,9,14,3971,8,2016,8,0
Group 3,BB,-0.5,9,14,3972,12,2016,9,3
Group 3,BB,-0.5,9,14,3973,11,2016,11,0
Group 3,BB,-0.5,9,14,3974,9,2016,9,0
Group 3,BB,-0.5,9,14,3975,8,2016,9,-1
Group 3,BB,-0.5,9,14,3976,11,2016,8,3
Group 3,BB,-0.5,9,14,3977,9,2016,6,3
Group 3,BB,-0.5,9,14,3978,10,2016,8,2
Group 3,BB,-0.5,9,14,3979,11,2016,7,4
Group 3,BB,-0.5,9,14,3980,8,2016,11,-3
Group 3,BB,-0.5,9,14,3981,9,2016,6,3
Group 3,BB,-0.5,9,14,3982,10,2016,4,6
Group 3,BB,-0.5,9,14,3983,10,2016,9,1
Group 3,BB,-0.5,9,14,3984,6,2016,7,-1
Group 3,BB,-0.5,9,14,3985,9,2016,4,5
Group 3,BB,-0.5,9,14,3986,13,2016,7,6
Group 3,BB,-0.5,9,14,3987,11,2016,7,4
Group 3,BB,-0.5,9,14,3988,7,2016,6,1
Group 3,BB,-0.5,9,14,3989,6,2016,7,-1
Group 3,BB,-0.5,9,14,3990,11,2016,9,2
Group 3,BB,-0.5,9,14,3991,7,2016,7,0
Group 3,BB,-0.5,9,14,3992,10,2016,8,2
Group 3,BB,-0.5,9,14,3993,12,2016,10,2
Group 3,BB,-0.5,9,14,3994,5,2016,9,-4
Group 3,BB,-0.5,9,14,3995,10,2016,11,-1
Group 3,BB,-0.5,9,14,3996,8,2016,9,-1
Group 3,BB,-0.5,9,14,3997,7,2016,6,1
Group 3,BB,-0.5,9,14,3998,11,2016,8,3
Group 3,BB,-0.5,9,14,3999,7,2016,5,2
Group 3,BB,-0.5,9,14,4000,6,2016,4,2
Group 3,RRG,-0.5,11,14,1,6,2016,5,1
Group 3,RRG,-0.5,11,14,2,11,2016,9,2
Group 3,RRG,-0.5,11,14,3,10,2016,7,3
Group 3,RRG,-0.5,11,14,4,10,2016,9,1
Group 3,RRG,-0.5,11,14,5,8,2016,8,0
Group 3,RRG,-0.5,11,14,6,8,2016,11,-3
Group 3,RRG,-0.5,11,14,7,10,2016,10,0
Group 3,RRG,-0.5,11,14,8,8,2016,10,-2
Group 3,RRG,-0.5,11,14,9,11,2016,9,2
Group 3,RRG,-0.5,11,14,10,7,2016,9,-2
Group 3,RRG,-0.5,11,14,11,11,2016,7,4
Group 3,RRG,-0.5,11,14,12,11,2016,10,1
Group 3,RRG,-0.5,11,14,13,5,2016,6,-1
Group 3,RRG,-0.5,11,14,14,8,2016,5,3
Group 3,RRG,-0.5,11,14,15,7,2016,7,0
Group 3,RRG,-0.5,11,14,16,7,2016,7,0
Group 3,RRG,-0.5,11,14,17,7,2016,6,1
Group 3,RRG,-0.5,11,14,18,7,2016,11,-4
Group 3,RRG,-0.5,11,14,19,8,2016,6,2
Group 3,RRG,-0.5,11,14,20,5,2016,7,-2
Group 3,RRG,-0.5,11,14,21,6,2016,6,0
Group 3,RRG,-0.5,11,14,22,12,2016,8,4
Group 3,RRG,-0.5,11,14,23,10,2016,7,3
Group 3,RRG,-0.5,11,14,24,9,2016,11,-2
Group 3,RRG,-0.5,11,14,25,5,2016,10,-5
Group 3,RRG,-0.5,11,14,26,6,2016,8,-2
Group 3,RRG,-0.5,11,14,27,9,2016,8,1
Group 3,RRG,-0.5,11,14,28,12,2016,14,-2
Group 3,RRG,-0.5,11,14,29,3,2016,5,-2
Group 3,RRG,-0.5,11,14,30,6,2016,6,0
Group 3,RRG,-0.5,11,14,31,3,2016,6,-3
Group 3,RRG,-0.5,11,14,32,6,2016,8,-2
Group 3,RRG,-0.5,11,14,33,12,2016,9,3
Group 3,RRG,-0.5,11,14,34,6,2016,8,-2
Group 3,RRG,-0.5,11,14,35,6,2016,3,3
Group 3,RRG,-0.5,11,14,36,7,2016,10,-3
Group 3,RRG,-0.5,11,14,37,10,2016,10,0
Group 3,RRG,-0.5,11,14,38,9,2016,12,-3
Group 3,RRG,-0.5,11,14,39,10,2016,9,1
Group 3,RRG,-0.5,11,14,40,7,2016,10,-3
Group 3,RRG,-0.5,11,14,41,9,2016,11,-2
Group 3,RRG,-0.5,11,14,42,10,2016,10,0
Group 3,RRG,-0.5,11,14,43,6,2016,7,-1
Group 3,RRG,-0.5,11,14,44,11,2016,7,4
Group 3,RRG,-0.5,11,14,45,12,2016,8,4
Group 3,RRG,-0.5,11,14,46,9,2016,6,3
Group 3,RRG,-0.5,11,14,47,13,2016,7,6
Group 3,RRG,-0.5,11,14,48,4,2016,8,-4
Group 3,RRG,-0.5,11,14,49,3,2016,7,-4
Group 3,RRG,-0.5,11,14,50,10,2016,8,2
Group 3,RRG,-0.5,11,14,51,7,2016,10,-3
Group 3,RRG,-0.5,11,14,52,5,2016,8,-3
Group 3,RRG,-0.5,11,14,53,10,2016,5,5
Group 3,RRG,-0.5,11,14,54,7,2016,12,-5
Group 3,RRG,-0.5,11,14,55,8,2016,10,-2
Group 3,RRG,-0.5,11,14,56,8,2016,10,-2
Group 3,RRG,-0.5,11,14,57,13,2016,9,4
Group 3,RRG,-0.5,11,14,58,6,2016,10,-4
Group 3,RRG,-0.5,11,14,59,11,2016,12,-1
Group 3,RRG,-0.5,11,14,60,6,2016,7,-1
Group 3,RRG,-0.5,11,14,61,13,2016,12,1
Group 3,RRG,-0.5,11,14,62,14,2016,13,1
Group 3,RRG,-0.5,11,14,63,8,2016,6,2
Group 3,RRG,-0.5,11,14,64,6,2016,9,-3
Group 3,RRG,-0.5,11,14,65,9,2016,12,-3
Group 3,RRG,-0.5,11,14,66,7,2016,6,1
Group 3,RRG,-0.5,11,14,67,5,2016,6,-1
Group 3,RRG,-0.5,11,14,68,5,2016,5,0
Group 3,RRG,-0.5,11,14,69,4,2016,1,3
Group 3,RRG,-0.5,11,14,70,8,2016,6,2
Group 3,RRG,-0.5,11,14,71,9,2016,4,5
Group 3,RRG,-0.5,11,14,72,9,2016,11,-2
Group 3,RRG,-0.5,11,14,73,9,2016,9,0
Group 3,RRG,-0.5,11,14,74,8,2016,10,-2
Group 3,RRG,-0.5,11,14,75,8,2016,9,-1
Group 3,RRG,-0.5,11,14,76,5,2016,4,1
Group 3,RRG,-0.5,11,14,77,8,2016,11,-3
Group 3,RRG,-0.5,11,14,78,5,2016,9,-4
Group 3,RRG,-0.5,11,14,79,8,2016,6,2
Group 3,RRG,-0.5,11,14,80,4,2016,11,-7
Group 3,RRG,-0.5,11,14,81,10,2016,9,1
Group 3,RRG,-0.5,11,14,82,10,2016,9,1
Group 3,RRG,-0.5,11,14,83,11,2016,8,3
Group 3,RRG,-0.5,11,14,84,6,2016,8,-2
Group 3,RRG,-0.5,11,14,85,9,2016,12,-3
Group 3,RRG,-0.5,11,14,86,7,2016,7,0
Group 3,RRG,-0.5,11,14,87,12,2016,9,3
Group 3,RRG,-0.5,11,14,88,11,2016,11,0
Group 3,RRG,-0.5,11,14,89,12,2016,10,2
Group 3,RRG,-0.5,11,14,90,14,2016,9,5
Group 3,RRG,-0.5,11,14,91,9,2016,9,0
Group 3,RRG,-0.5,11,14,92,9,2016,8,1
Group 3,RRG,-0.5,11,14,93,6,2016,9,-3
Group 3,RRG,-0.5,11,14,94,8,2016,8,0
Group 3,RRG,-0.5,11,14,95,8,2016,6,2
Group 3,RRG,-0.5,11,14,96,7,2016,8,-1
Group 3,RRG,-0.5,11,14,97,6,2016,11,-5
Group 3,RRG,-0.5,11,14,98,5,2016,7,-2
Group 3,RRG,-0.5,11,14,99,8,2016,12,-4
Group 3,RRG,-0.5,11,14,100,11,2016,7,4
Group 3,RRG,-0.5,11,14,101,9,2016,9,0
Group 3,RRG,-0.5,11,14,102,9,2016,10,-1
Group 3,RRG,-0.5,11,14,103,11,2016,7,4
Group 3,RRG,-0.5,11,14,104,11,2016,8,3
Group 3,RRG,-0.5,11,14,105,7,2016,7,0
Group 3,RRG,-0.5,11,14,106,7,2016,9,-2
Group 3,RRG,-0.5,11,14,107,12,2016,6,6
Group 3,RRG,-0.5,11,14,108,9,2016,8,1
Group 3,RRG,-0.5,11,14,109,9,2016,7,2
Group 3,RRG,-0.5,11,14,110,7,2016,9,-2
Group 3,RRG,-0.5,11,14,111,4,2016,6,-2
Group 3,RRG,-0.5,11,14,112,4,2016,10,-6
Group 3,RRG,-0.5,11,14,113,6,2016,12,-6
Group 3,RRG,-0.5,11,14,114,8,2016,9,-1
Group 3,RRG,-0.5,11,14,115,8,2016,4,4
Group 3,RRG,-0.5,11,14,116,6,2016,9,-3
Group 3,RRG,-0.5,11,14,117,11,2016,8,3
Group 3,RRG,-0.5,11,14,118,10,2016,5,5
Group 3,RRG,-0.5,11,14,119,12,2016,9,3
Group 3,RRG,-0.5,11,14,120,9,2016,9,0
Group 3,RRG,-0.5,11,14,121,9,2016,11,-2
Group 3,RRG,-0.5,11,14,122,10,2016,6,4
Group 3,RRG,-0.5,11,14,123,9,2016,11,-2
Group 3,RRG,-0.5,11,14,124,10,2016,12,-2
Group 3,RRG,-0.5,11,14,125,4,2016,8,-4
Group 3,RRG,-0.5,11,14,126,11,2016,13,-2
Group 3,RRG,-0.5,11,14,127,9,2016,9,0
Group 3,RRG,-0.5,11,14,128,11,2016,11,0
Group 3,RRG,-0.5,11,14,129,6,2016,10,-4
Group 3,RRG,-0.5,11,14,130,9,2016,10,-1
Group 3,RRG,-0.5,11,14,131,12,2016,10,2
Group 3,RRG,-0.5,11,14,132,8,2016,8,0
Group 3,RRG,-0.5,11,14,133,11,2016,11,0
Group 3,RRG,-0.5,11,14,134,8,2016,9,-1
Group 3,RRG,-0.5,11,14,135,10,2016,8,2
Group 3,RRG,-0.5,11,14,136,11,2016,12,-1
Group 3,RRG,-0.5,11,14,137,13,2016,9,4
Group 3,RRG,-0.5,11,14,138,7,2016,7,0
Group 3,RRG,-0.5,11,14,139,8,2016,9,-1
Group 3,RRG,-0.5,11,14,140,10,2016,8,2
Group 3,RRG,-0.5,11,14,141,5,2016,9,-4
Group 3,RRG,-0.5,11,14,142,8,2016,14,-6
Group 3,RRG,-0.5,11,14,143,13,2016,9,4
Group 3,RRG,-0.5,11,14,144,14,2016,11,3
Group 3,RRG,-0.5,11,14,145,4,2016,6,-2
Group 3,RRG,-0.5,11,14,146,4,2016,9,-5
Group 3,RRG,-0.5,11,14,147,6,2016,7,-1
Group 3,RRG,-0.5,11,14,148,8,2016,7,1
Group 3,RRG,-0.5,11,14,149,10,2016,13,-3
Group 3,RRG,-0.5,11,14,150,6,2016,6,0
Group 3,RRG,-0.5,11,14,151,8,2016,12,-4
Group 3,RRG,-0.5,11,14,152,7,2016,10,-3
Group 3,RRG,-0.5,11,14,153,7,2016,5,2
Group 3,RRG,-0.5,11,14,154,6,2016,12,-6
Group 3,RRG,-0.5,11,14,155,6,2016,8,-2
Group 3,RRG,-0.5,11,14,156,3,2016,8,-5
Group 3,RRG,-0.5,11,14,157,9,2016,10,-1
Group 3,RRG,-0.5,11,14,158,8,2016,4,4
Group 3,RRG,-0.5,11,14,159,9,2016,7,2
Group 3,RRG,-0.5,11,14,160,7,2016,4,3
Group 3,RRG,-0.5,11,14,161,7,2016,9,-2
Group 3,RRG,-0.5,11,14,162,12,2016,9,3
Group 3,RRG,-0.5,11,14,163,10,2016,7,3
Group 3,RRG,-0.5,11,14,164,7,2016,11,-4
Group 3,RRG,-0.5,11,14,165,6,2016,5,1
Group 3,RRG,-0.5,11,14,166,7,2016,9,-2
Group 3,RRG,-0.5,11,14,167,10,2016,9,1
Group 3,RRG,-0.5,11,14,168,9,2016,8,1
Group 3,RRG,-0.5,11,14,169,8,2016,7,1
Group 3,RRG,-0.5,11,14,170,13,2016,12,1
Group 3,RRG,-0.5,11,14,171,11,2016,12,-1
Group 3,RRG,-0.5,11,14,172,3,2016,7,-4
Group 3,RRG,-0.5,11,14,173,3,2016,5,-2
Group 3,RRG,-0.5,11,14,174,7,2016,10,-3
Group 3,RRG,-0.5,11,14,175,7,2016,5,2
Group 3,RRG,-0.5,11,14,176,4,2016,13,-9
Group 3,RRG,-0.5,11,14,177,8,2016,7,1
Group 3,RRG,-0.5,11,14,178,7,2016,9,-2
Group 3,RRG,-0.5,11,14,179,10,2016,9,1
Group 3,RRG,-0.5,11,14,180,9,2016,10,-1
Group 3,RRG,-0.5,11,14,181,8,2016,12,-4
Group 3,RRG,-0.5,11,14,182,7,2016,7,0
Group 3,RRG,-0.5,11,14,183,6,2016,8,-2
Group 3,RRG,-0.5,11,14,184,10,2016,8,2
Group 3,RRG,-0.5,11,14,185,8,2016,11,-3
Group 3,RRG,-0.5,11,14,186,9,2016,9,0
Group 3,RRG,-0.5,11,14,187,11,2016,7,4
Group 3,RRG,-0.5,11,14,188,11,2016,7,4
Group 3,RRG,-0.5,11,14,189,8,2016,10,-2
Group 3,RRG,-0.5,11,14,190,5,2016,5,0
Group 3,RRG,-0.5,11,14,191,12,2016,10,2
Group 3,RRG,-0.5,11,14,192,13,2016,7,6
Group 3,RRG,-0.5,11,14,193,7,2016,10,-3
Group 3,RRG,-0.5,11,14,194,13,2016,11,2
Group 3,RRG,-0.5,11,14,195,4,2016,7,-3
Group 3,RRG,-0.5,11,14,196,7,2016,10,-3
Group 3,RRG,-0.5,11,14,197,14,2016,10,4
Group 3,RRG,-0.5,11,14,198,12,2016,6,6
Group 3,RRG,-0.5,11,14,199,9,2016,10,-1
Group 3,RRG,-0.5,11,14,200,6,2016,9,-3
Group 3,RRG,-0.5,11,14,201,7,2016,10,-3
Group 3,RRG,-0.5,11,14,202,8,2016,9,-1
Group 3,RRG,-0.5,11,14,203,12,2016,4,8
Group 3,RRG,-0.5,11,14,204,9,2016,11,-2
Group 3,RRG,-0.5,11,14,205,6,2016,3,3
Group 3,RRG,-0.5,11,14,206,11,2016,7,4
Group 3,RRG,-0.5,11,14,207,9,2016,5,4
Group 3,RRG,-0.5,11,14,208,7,2016,4,3
Group 3,RRG,-0.5,11,14,209,7,2016,10,-3
Group 3,RRG,-0.5,11,14,210,11,2016,11,0
Group 3,RRG,-0.5,11,14,211,7,2016,9,-2
Group 3,RRG,-0.5,11,14,212,8,2016,8,0
Group 3,RRG,-0.5,11,14,213,10,2016,5,5
Group 3,RRG,-0.5,11,14,214,4,2016,7,-3
Group 3,RRG,-0.5,11,14,215,3,2016,8,-5
Group 3,RRG,-0.5,11,14,216,9,2016,7,2
Group 3,RRG,-0.5,11,14,217,10,2016,5,5
Group 3,RRG,-0.5,11,14,218,8,2016,9,-1
Group 3,RRG,-0.5,11,14,219,11,2016,5,6
Group 3,RRG,-0.5,11,14,220,5,2016,9,-4
Group 3,RRG,-0.5,11,14,221,8,2016,8,0
Group 3,RRG,-0.5,11,14,222,7,2016,7,0
Group 3,RRG,-0.5,11,14,223,7,2016,4,3
Group 3,RRG,-0.5,11,14,224,4,2016,7,-3
Group 3,RRG,-0.5,11,14,225,9,2016,6,3
Group 3,RRG,-0.5,11,14,226,8,2016,12,-4
Group 3,RRG,-0.5,11,14,227,10,2016,7,3
Group 3,RRG,-0.5,11,14,228,8,2016,12,-4
Group 3,RRG,-0.5,11,14,229,6,2016,7,-1
Group 3,RRG,-0.5,11,14,230,11,2016,8,3
Group 3,RRG,-0.5,11,14,231,6,2016,10,-4
Group 3,RRG,-0.5,11,14,232,10,2016,9,1
Group 3,RRG,-0.5,11,14,233,9,2016,4,5
Group 3,RRG,-0.5,11,14,234,6,2016,8,-2
Group 3,RRG,-0.5,11,14,235,9,2016,10,-1
Group 3,RRG,-0.5,11,14,236,9,2016,7,2
Group 3,RRG,-0.5,11,14,237,6,2016,13,-7
Group 3,RRG,-0.5,11,14,238,10,2016,10,0
Group 3,RRG,-0.5,11,14,239,8,2016,5,3
Group 3,RRG,-0.5,11,14,240,7,2016,11,-4
Group 3,RRG,-0.5,11,14,241,9,2016,5,4
Group 3,RRG,-0.5,11,14,242,8,2016,9,-1
Group 3,RRG,-0.5,11,14,243,9,2016,5,4
Group 3,RRG,-0.5,11,14,244,9,2016,12,-3
Group 3,RRG,-0.5,11,14,245,9,2016,10,-1
Group 3,RRG,-0.5,11,14,246,9,2016,7,2
Group 3,RRG,-0.5,11,14,247,12,2016,11,1
Group 3,RRG,-0.5,11,14,248,5,2016,6,-1
Group 3,RRG,-0.5,11,14,249,9,2016,8,1
Group 3,RRG,-0.5,11,14,250,9,2016,9,0
Group 3,RRG,-0.5,11,14,251,5,2016,6,-1
Group 3,RRG,-0.5,11,14,252,5,2016,9,-4
Group 3,RRG,-0.5,11,14,253,10,2016,10,0
Group 3,RRG,-0.5,11,14,254,10,2016,8,2
Group 3,RRG,-0.5,11,14,255,7,2016,10,-3
Group 3,RRG,-0.5,11,14,256,5,2016,11,-6
Group 3,RRG,-0.5,11,14,257,13,2016,9,4
Group 3,RRG,-0.5,11,14,258,8,2016,10,-2
Group 3,RRG,-0.5,11,14,259,3,2016,11,-8
Group 3,RRG,-0.5,11,14,260,10,2016,8,2
Group 3,RRG,-0.5,11,14,261,10,2016,8,2
Group 3,RRG,-0.5,11,14,262,10,2016,9,1
Group 3,RRG,-0.5,11,14,263,2,2016,2,0
Group 3,RRG,-0.5,11,14,264,11,2016,11,0
Group 3,RRG,-0.5,11,14,265,5,2016,7,-2
Group 3,RRG,-0.5,11,14,266,4,2016,5,-1
Group 3,RRG,-0.5,11,14,267,5,2016,8,-3
Group 3,RRG,-0.5,11,14,268,10,2016,7,3
Group 3,RRG,-0.5,11,14,269,3,2016,10,-7
Group 3,RRG,-0.5,11,14,270,12,2016,11,1
Group 3,RRG,-0.5,11,14,271,13,2016,11,2
Group 3,RRG,-0.5,11,14,272,10,2016,7,3
Group 3,RRG,-0.5,11,14,273,7,2016,8,-1
Group 3,RRG,-0.5,11,14,274,7,2016,7,0
Group 3,RRG,-0.5,11,14,275,10,2016,10,0
Group 3,RRG,-0.5,11,14,276,2,2016,9,-7
Group 3,RRG,-0.5,11,14,277,9,2016,6,3
Group 3,RRG,-0.5,11,14,278,7,2016,9,-2
Group 3,RRG,-0.5,11,14,279,8,2016,9,-1
Group 3,RRG,-0.5,11,14,280,11,2016,10,1
Group 3,RRG,-0.5,11,14,281,10,2016,11,-1
Group 3,RRG,-0.5,11,14,282,11,2016,8,3
Group 3,RRG,-0.5,11,14,283,5,2016,5,0
Group 3,RRG,-0.5,11,14,284,11,2016,8,3
Group 3,RRG,-0.5,11,14,285,4,2016,7,-3
Group 3,RRG,-0.5,11,14,286,14,2016,10,4
Group 3,RRG,-0.5,11,14,287,4,2016,9,-5
Group 3,RRG,-0.5,11,14,288,8,2016,11,-3
Group 3,RRG,-0.5,11,14,289,9,2016,12,-3
Group 3,RRG,-0.5,11,14,290,10,2016,6,4
Group 3,RRG,-0.5,11,14,291,10,2016,8,2
Group 3,RRG,-0.5,11,14,292,10,2016,9,1
Group 3,RRG,-0.5,11,14,293,12,2016,11,1
Group 3,RRG,-0.5,11,14,294,7,2016,11,-4
Group 3,RRG,-0.5,11,14,295,11,2016,6,5
Group 3,RRG,-0.5,11,14,296,12,2016,9,3
Group 3,RRG,-0.5,11,14,297,13,2016,11,2
Group 3,RRG,-0.5,11,14,298,5,2016,6,-1
Group 3,RRG,-0.5,11,14,299,10,2016,8,2
Group 3,RRG,-0.5,11,14,300,11,2016,7,4
Group 3,RRG,-0.5,11,14,301,10,2016,10,0
Group 3,RRG,-0.5,11,14,302,9,2016,10,-1
Group 3,RRG,-0.5,11,14,303,6,2016,13,-7
Group 3,RRG,-0.5,11,14,304,4,2016,6,-2
Group 3,RRG,-0.5,11,14,305,7,2016,9,-2
Group 3,RRG,-0.5,11,14,306,9,2016,8,1
Group 3,RRG,-0.5,11,14,307,10,2016,7,3
Group 3,RRG,-0.5,11,14,308,5,2016,9,-4
Group 3,RRG,-0.5,11,14,309,8,2016,7,1
Group 3,RRG,-0.5,11,14,310,13,2016,10,3
Group 3,RRG,-0.5,11,14,311,13,2016,7,6
Group 3,RRG,-0.5,11,14,312,6,2016,9,-3
Group 3,RRG,-0.5,11,14,313,10,2016,12,-2
Group 3,RRG,-0.5,11,14,314,9,2016,6,3
Group 3,RRG,-0.5,11,14,315,12,2016,10,2
Group 3,RRG,-0.5,11,14,316,7,2016,8,-1
Group 3,RRG,-0.5,11,14,317,10,2016,6,4
Group 3,RRG,-0.5,11,14,318,7,2016,11,-4
Group 3,RRG,-0.5,11,14,319,12,2016,9,3
Group 3,RRG,-0.5,11,14,320,11,2016,11,0
Group 3,RRG,-0.5,11,14,321,7,2016,9,-2
Group 3,RRG,-0.5,11,14,322,9,2016,8,1
Group 3,RRG,-0.5,11,14,323,11,2016,11,0
Group 3,RRG,-0.5,11,14,324,9,2016,9,0
Group 3,RRG,-0.5,11,14,325,7,2016,6,1
Group 3,RRG,-0.5,11,14,326,6,2016,5,1
Group 3,RRG,-0.5,11,14,327,7,2016,7,0
Group 3,RRG,-0.5,11,14,328,9,2016,10,-1
Group 3,RRG,-0.5,11,14,329,8,2016,2,6
Group 3,RRG,-0.5,11,14,330,11,2016,12,-1
Group 3,RRG,-0.5,11,14,331,6,2016,6,0
Group 3,RRG,-0.5,11,14,332,4,2016,5,-1
Group 3,RRG,-0.5,11,14,333,8,2016,8,0
Group 3,RRG,-0.5,11,14,334,9,2016,6,3
Group 3,RRG,-0.5,11,14,335,11,2016,12,-1
Group 3,RRG,-0.5,11,14,336,5,2016,10,-5
Group 3,RRG,-0.5,11,14,337,12,2016,5,7
Group 3,RRG,-0.5,11,14,338,6,2016,9,-3
Group 3,RRG,-0.5,11,14,339,8,2016,10,-2
Group 3,RRG,-0.5,11,14,340,7,2016,10,-3
Group 3,RRG,-0.5,11,14,341,2,2016,4,-2
Group 3,RRG,-0.5,11,14,342,11,2016,10,1
Group 3,RRG,-0.5,11,14,343,10,2016,7,3
Group 3,RRG,-0.5,11,14,344,13,2016,11,2
Group 3,RRG,-0.5,11,14,345,8,2016,10,-2
Group 3,RRG,-0.5,11,14,346,7,2016,9,-2
Group 3,RRG,-0.5,11,14,347,10,2016,9,1
Group 3,RRG,-0.5,11,14,348,5,2016,7,-2
Group 3,RRG,-0.5,11,14,349,5,2016,10,-5
Group 3,RRG,-0.5,11,14,350,7,2016,7,0
Group 3,RRG,-0.5,11,14,351,11,2016,12,-1
Group 3,RRG,-0.5,11,14,352,8,2016,8,0
Group 3,RRG,-0.5,11,14,353,9,2016,8,1
Group 3,RRG,-0.5,11,14,354,11,2016,10,1
Group 3,RRG,-0.5,11,14,355,6,2016,10,-4
Group 3,RRG,-0.5,11,14,356,10,2016,10,0
Group 3,RRG,-0.5,11,14,357,6,2016,6,0
Group 3,RRG,-0.5,11,14,358,8,2016,8,0
Group 3,RRG,-0.5,11,14,359,9,2016,6,3
Group 3,RRG,-0.5,11,14,360,11,2016,12,-1
Group 3,RRG,-0.5,11,14,361,10,2016,7,3
Group 3,RRG,-0.5,11,14,362,7,2016,6,1
Group 3,RRG,-0.5,11,14,363,10,2016,10,0
Group 3,RRG,-0.5,11,14,364,4,2016,6,-2
Group 3,RRG,-0.5,11,14,365,8,2016,5,3
Group 3,RRG,-0.5,11,14,366,11,2016,9,2
Group 3,RRG,-0.5,11,14,367,11,2016,7,4
Group 3,RRG,-0.5,11,14,368,7,2016,8,-1
Group 3,RRG,-0.5,11,14,369,7,2016,6,1
Group 3,RRG,-0.5,11,14,370,11,2016,10,1
Group 3,RRG,-0.5,11,14,371,6,2016,6,0
Group 3,RRG,-0.5,11,14,372,10,2016,10,0
Group 3,RRG,-0.5,11,14,373,8,2016,8,0
Group 3,RRG,-0.5,11,14,374,6,2016,7,-1
Group 3,RRG,-0.5,11,14,375,5,2016,10,-5
Group 3,RRG,-0.5,11,14,376,8,2016,9,-1
Group 3,RRG,-0.5,11,14,377,7,2016,5,2
Group 3,RRG,-0.5,11,14,378,9,2016,5,4
Group 3,RRG,-0.5,11,14,379,6,2016,5,1
Group 3,RRG,-0.5,11,14,380,6,2016,6,0
Group 3,RRG,-0.5,11,14,381,8,2016,5,3
Group 3,RRG,-0.5,11,14,382,12,2016,8,4
Group 3,RRG,-0.5,11,14,383,10,2016,6,4
Group 3,RRG,-0.5,11,14,384,11,2016,5,6
Group 3,RRG,-0.5,11,14,385,11,2016,10,1
Group 3,RRG,-0.5,11,14,386,4,2016,4,0
Group 3,RRG,-0.5,11,14,387,7,2016,8,-1
Group 3,RRG,-0.5,11,14,388,7,2016,8,-1
Group 3,RRG,-0.5,11,14,389,12,2016,12,0
Group 3,RRG,-0.5,11,14,390,7,2016,4,3
Group 3,RRG,-0.5,11,14,391,7,2016,7,0
Group 3,RRG,-0.5,11,14,392,3,2016,4,-1
Group 3,RRG,-0.5,11,14,393,8,2016,12,-4
Group 3,RRG,-0.5,11,14,394,4,2016,5,-1
Group 3,RRG,-0.5,11,14,395,9,2016,6,3
Group 3,RRG,-0.5,11,14,396,11,2016,11,0
Group 3,RRG,-0.5,11,14,397,10,2016,7,3
Group 3,RRG,-0.5,11,14,398,8,2016,6,2
Group 3,RRG,-0.5,11,14,399,6,2016,10,-4
Group 3,RRG,-0.5,11,14,400,11,2016,8,3
Group 3,RRG,-0.5,11,14,401,9,2016,12,-3
Group 3,RRG,-0.5,11,14,402,12,2016,8,4
Group 3,RRG,-0.5,11,14,403,7,2016,7,0
Group 3,RRG,-0.5,11,14,404,10,2016,9,1
Group 3,RRG,-0.5,11,14,405,11,2016,12,-1
Group 3,RRG,-0.5,11,14,406,10,2016,7,3
Group 3,RRG,-0.5,11,14,407,9,2016,7,2
Group 3,RRG,-0.5,11,14,408,6,2016,6,0
Group 3,RRG,-0.5,11,14,409,10,2016,9,1
Group 3,RRG,-0.5,11,14,410,9,2016,13,-4
Group 3,RRG,-0.5,11,14,411,2,2016,1,1
Group 3,RRG,-0.5,11,14,412,5,2016,7,-2
Group 3,RRG,-0.5,11,14,413,4,2016,8,-4
Group 3,RRG,-0.5,11,14,414,12,2016,8,4
Group 3,RRG,-0.5,11,14,415,11,2016,12,-1
Group 3,RRG,-0.5,11,14,416,9,2016,8,1
Group 3,RRG,-0.5,11,14,417,8,2016,4,4
Group 3,RRG,-0.5,11,14,418,12,2016,11,1
Group 3,RRG,-0.5,11,14,419,9,2016,8,1
Group 3,RRG,-0.5,11,14,420,10,2016,11,-1
Group 3,RRG,-0.5,11,14,421,7,2016,11,-4
Group 3,RRG,-0.5,11,14,422,8,2016,10,-2
Group 3,RRG,-0.5,11,14,423,13,2016,13,0
Group 3,RRG,-0.5,11,14,424,11,2016,10,1
Group 3,RRG,-0.5,11,14,425,11,2016,10,1
Group 3,RRG,-0.5,11,14,426,5,2016,7,-2
Group 3,RRG,-0.5,11,14,427,4,2016,5,-1
Group 3,RRG,-0.5,11,14,428,7,2016,12,-5
Group 3,RRG,-0.5,11,14,429,9,2016,8,1
Group 3,RRG,-0.5,11,14,430,10,2016,9,1
Group 3,RRG,-0.5,11,14,431,10,2016,10,0
Group 3,RRG,-0.5,11,14,432,7,2016,9,-2
Group 3,RRG,-0.5,11,14,433,11,2016,8,3
Group 3,RRG,-0.5,11,14,434,7,2016,5,2
Group 3,RRG,-0.5,11,14,435,7,2016,11,-4
Group 3,RRG,-0.5,11,14,436,13,2016,11,2
Group 3,RRG,-0.5,11,14,437,12,2016,10,2
Group 3,RRG,-0.5,11,14,438,6,2016,8,-2
Group 3,RRG,-0.5,11,14,439,9,2016,6,3
Group 3,RRG,-0.5,11,14,440,9,2016,8,1
Group 3,RRG,-0.5,11,14,441,8,2016,8,0
Group 3,RRG,-0.5,11,14,442,10,2016,11,-1
Group 3,RRG,-0.5,11,14,443,7,2016,11,-4
Group 3,RRG,-0.5,11,14,444,6,2016,12,-6
Group 3,RRG,-0.5,11,14,445,8,2016,7,1
Group 3,RRG,-0.5,11,14,446,6,2016,6,0
Group 3,RRG,-0.5,11,14,447,12,2016,11,1
Group 3,RRG,-0.5,11,14,448,11,2016,10,1
Group 3,RRG,-0.5,11,14,449,10,2016,9,1
Group 3,RRG,-0.5,11,14,450,8,2016,8,0
Group 3,RRG,-0.5,11,14,451,14,2016,12,2
Group 3,RRG,-0.5,11,14,452,12,2016,11,1
Group 3,RRG,-0.5,11,14,453,9,2016,8,1
Group 3,RRG,-0.5,11,14,454,14,2016,14,0
Group 3,RRG,-0.5,11,14,455,12,2016,10,2
Group 3,RRG,-0.5,11,14,456,11,2016,8,3
Group 3,RRG,-0.5,11,14,457,5,2016,12,-7
Group 3,RRG,-0.5,11,14,458,9,2016,7,2
Group 3,RRG,-0.5,11,14,459,8,2016,7,1
Group 3,RRG,-0.5,11,14,460,6,2016,7,-1
Group 3,RRG,-0.5,11,14,461,5,2016,6,-1
Group 3,RRG,-0.5,11,14,462,2,2016,9,-7
Group 3,RRG,-0.5,11,14,463,5,2016,6,-1
Group 3,RRG,-0.5,11,14,464,5,2016,10,-5
Group 3,RRG,-0.5,11,14,465,8,2016,6,2
Group 3,RRG,-0.5,11,14,466,10,2016,1,9
Group 3,RRG,-0.5,11,14,467,11,2016,10,1
Group 3,RRG,-0.5,11,14,468,5,2016,9,-4
Group 3,RRG,-0.5,11,14,469,9,2016,10,-1
Group 3,RRG,-0.5,11,14,470,7,2016,10,-3
Group 3,RRG,-0.5,11,14,471,11,2016,8,3
Group 3,RRG,-0.5,11,14,472,11,2016,7,4
Group 3,RRG,-0.5,11,14,473,8,2016,9,-1
Group 3,RRG,-0.5,11,14,474,6,2016,4,2
Group 3,RRG,-0.5,11,14,475,5,2016,5,0
Group 3,RRG,-0.5,11,14,476,7,2016,8,-1
Group 3,RRG,-0.5,11,14,477,8,2016,7,1
Group 3,RRG,-0.5,11,14,478,5,2016,6,-1
Group 3,RRG,-0.5,11,14,479,12,2016,10,2
Group 3,RRG,-0.5,11,14,480,8,2016,8,0
Group 3,RRG,-0.5,11,14,481,10,2016,10,0
Group 3,RRG,-0.5,11,14,482,8,2016,7,1
Group 3,RRG,-0.5,11,14,483,12,2016,10,2
Group 3,RRG,-0.5,11,14,484,12,2016,10,2
Group 3,RRG,-0.5,11,14,485,9,2016,9,0
Group 3,RRG,-0.5,11,14,486,10,2016,9,1
Group 3,RRG,-0.5,11,14,487,12,2016,12,0
Group 3,RRG,-0.5,11,14,488,8,2016,7,1
Group 3,RRG,-0.5,11,14,489,12,2016,10,2
Group 3,RRG,-0.5,11,14,490,11,2016,10,1
Group 3,RRG,-0.5,11,14,491,12,2016,12,0
Group 3,RRG,-0.5,11,14,492,3,2016,7,-4
Group 3,RRG,-0.5,11,14,493,6,2016,10,-4
Group 3,RRG,-0.5,11,14,494,10,2016,11,-1
Group 3,RRG,-0.5,11,14,495,9,2016,9,0
Group 3,RRG,-0.5,11,14,496,8,2016,5,3
Group 3,RRG,-0.5,11,14,497,7,2016,8,-1
Group 3,RRG,-0.5,11,14,498,10,2016,13,-3
Group 3,RRG,-0.5,11,14,499,9,2016,11,-2
Group 3,RRG,-0.5,11,14,500,14,2016,8,6
Group 3,RRG,-0.5,11,14,501,12,2016,9,3
Group 3,RRG,-0.5,11,14,502,12,2016,11,1
Group 3,RRG,-0.5,11,14,503,8,2016,9,-1
Group 3,RRG,-0.5,11,14,504,11,2016,12,-1
Group 3,RRG,-0.5,11,14,505,10,2016,11,-1
Group 3,RRG,-0.5,11,14,506,12,2016,10,2
Group 3,RRG,-0.5,11,14,507,12,2016,9,3
Group 3,RRG,-0.5,11,14,508,9,2016,12,-3
Group 3,RRG,-0.5,11,14,509,8,2016,8,0
Group 3,RRG,-0.5,11,14,510,12,2016,11,1
Group 3,RRG,-0.5,11,14,511,12,2016,8,4
Group 3,RRG,-0.5,11,14,512,8,2016,8,0
Group 3,RRG,-0.5,11,14,513,3,2016,7,-4
Group 3,RRG,-0.5,11,14,514,14,2016,11,3
Group 3,RRG,-0.5,11,14,515,13,2016,12,1
Group 3,RRG,-0.5,11,14,516,7,2016,5,2
Group 3,RRG,-0.5,11,14,517,9,2016,9,0
Group 3,RRG,-0.5,11,14,518,10,2016,8,2
Group 3,RRG,-0.5,11,14,519,11,2016,5,6
Group 3,RRG,-0.5,11,14,520,12,2016,9,3
Group 3,RRG,-0.5,11,14,521,12,2016,10,2
Group 3,RRG,-0.5,11,14,522,4,2016,5,-1
Group 3,RRG,-0.5,11,14,523,11,2016,10,1
Group 3,RRG,-0.5,11,14,524,5,2016,4,1
Group 3,RRG,-0.5,11,14,525,9,2016,12,-3
Group 3,RRG,-0.5,11,14,526,9,2016,7,2
Group 3,RRG,-0.5,11,14,527,6,2016,7,-1
Group 3,RRG,-0.5,11,14,528,12,2016,6,6
Group 3,RRG,-0.5,11,14,529,8,2016,10,-2
Group 3,RRG,-0.5,11,14,530,11,2016,10,1
Group 3,RRG,-0.5,11,14,531,9,2016,6,3
Group 3,RRG,-0.5,11,14,532,4,2016,9,-5
Group 3,RRG,-0.5,11,14,533,8,2016,7,1
Group 3,RRG,-0.5,11,14,534,8,2016,10,-2
Group 3,RRG,-0.5,11,14,535,6,2016,7,-1
Group 3,RRG,-0.5,11,14,536,7,2016,11,-4
Group 3,RRG,-0.5,11,14,537,11,2016,9,2
Group 3,RRG,-0.5,11,14,538,11,2016,9,2
Group 3,RRG,-0.5,11,14,539,11,2016,11,0
Group 3,RRG,-0.5,11,14,540,8,2016,9,-1
Group 3,RRG,-0.5,11,14,541,9,2016,6,3
Group 3,RRG,-0.5,11,14,542,11,2016,9,2
Group 3,RRG,-0.5,11,14,543,5,2016,5,0
Group 3,RRG,-0.5,11,14,544,1,2016,3,-2
Group 3,RRG,-0.5,11,14,545,12,2016,10,2
Group 3,RRG,-0.5,11,14,546,11,2016,6,5
Group 3,RRG,-0.5,11,14,547,9,2016,6,3
Group 3,RRG,-0.5,11,14,548,7,2016,7,0
Group 3,RRG,-0.5,11,14,549,12,2016,9,3
Group 3,RRG,-0.5,11,14,550,6,2016,7,-1
Group 3,RRG,-0.5,11,14,551,12,2016,3,9
Group 3,RRG,-0.5,11,14,552,9,2016,6,3
Group 3,RRG,-0.5,11,14,553,8,2016,11,-3
Group 3,RRG,-0.5,11,14,554,7,2016,7,0
Group 3,RRG,-0.5,11,14,555,7,2016,9,-2
Group 3,RRG,-0.5,11,14,556,11,2016,7,4
Group 3,RRG,-0.5,11,14,557,14,2016,11,3
Group 3,RRG,-0.5,11,14,558,0,2016,3,-3
Group 3,RRG,-0.5,11,14,559,11,2016,13,-2
Group 3,RRG,-0.5,11,14,560,1,2016,5,-4
Group 3,RRG,-0.5,11,14,561,10,2016,11,-1
Group 3,RRG,-0.5,11,14,562,8,2016,5,3
Group 3,RRG,-0.5,11,14,563,7,2016,12,-5
Group 3,RRG,-0.5,11,14,564,3,2016,9,-6
Group 3,RRG,-0.5,11,14,565,8,2016,6,2
Group 3,RRG,-0.5,11,14,566,10,2016,7,3
Group 3,RRG,-0.5,11,14,567,6,2016,9,-3
Group 3,RRG,-0.5,11,14,568,5,2016,8,-3
Group 3,RRG,-0.5,11,14,569,12,2016,12,0
Group 3,RRG,-0.5,11,14,570,8,2016,5,3
Group 3,RRG,-0.5,11,14,571,7,2016,6,1
Group 3,RRG,-0.5,11,14,572,11,2016,10,1
Group 3,RRG,-0.5,11,14,573,9,2016,8,1
Group 3,RRG,-0.5,11,14,574,9,2016,8,1
Group 3,RRG,-0.5,11,14,575,6,2016,5,1
Group 3,RRG,-0.5,11,14,576,4,2016,10,-6
Group 3,RRG,-0.5,11,14,577,7,2016,8,-1
Group 3,RRG,-0.5,11,14,578,9,2016,9,0
Group 3,RRG,-0.5,11,14,579,9,2016,8,1
Group 3,RRG,-0.5,11,14,580,6,2016,5,1
Group 3,RRG,-0.5,11,14,581,11,2016,9,2
Group 3,RRG,-0.5,11,14,582,14,2016,10,4
Group 3,RRG,-0.5,11,14,583,9,2016,6,3
Group 3,RRG,-0.5,11,14,584,9,2016,8,1
Group 3,RRG,-0.5,11,14,585,9,2016,7,2
Group 3,RRG,-0.5,11,14,586,6,2016,7,-1
Group 3,RRG,-0.5,11,14,587,1,2016,9,-8
Group 3,RRG,-0.5,11,14,588,10,2016,4,6
Group 3,RRG,-0.5,11,14,589,6,2016,6,0
Group 3,RRG,-0.5,11,14,590,9,2016,11,-2
Group 3,RRG,-0.5,11,14,591,11,2016,7,4
Group 3,RRG,-0.5,11,14,592,8,2016,8,0
Group 3,RRG,-0.5,11,14,593,10,2016,8,2
Group 3,RRG,-0.5,11,14,594,7,2016,7,0
Group 3,RRG,-0.5,11,14,595,10,2016,7,3
Group 3,RRG,-0.5,11,14,596,8,2016,9,-1
Group 3,RRG,-0.5,11,14,597,10,2016,6,4
Group 3,RRG,-0.5,11,14,598,5,2016,5,0
Group 3,RRG,-0.5,11,14,599,7,2016,7,0
Group 3,RRG,-0.5,11,14,600,9,2016,8,1
Group 3,RRG,-0.5,11,14,601,7,2016,6,1
Group 3,RRG,-0.5,11,14,602,3,2016,5,-2
Group 3,RRG,-0.5,11,14,603,5,2016,7,-2
Group 3,RRG,-0.5,11,14,604,5,2016,10,-5
Group 3,RRG,-0.5,11,14,605,8,2016,7,1
Group 3,RRG,-0.5,11,14,606,10,2016,13,-3
Group 3,RRG,-0.5,11,14,607,10,2016,9,1
Group 3,RRG,-0.5,11,14,608,11,2016,5,6
Group 3,RRG,-0.5,11,14,609,11,2016,6,5
Group 3,RRG,-0.5,11,14,610,10,2016,10,0
Group 3,RRG,-0.5,11,14,611,12,2016,9,3
Group 3,RRG,-0.5,11,14,612,10,2016,7,3
Group 3,RRG,-0.5,11,14,613,6,2016,6,0
Group 3,RRG,-0.5,11,14,614,5,2016,6,-1
Group 3,RRG,-0.5,11,14,615,11,2016,6,5
Group 3,RRG,-0.5,11,14,616,9,2016,10,-1
Group 3,RRG,-0.5,11,14,617,12,2016,7,5
Group 3,RRG,-0.5,11,14,618,9,2016,3,6
Group 3,RRG,-0.5,11,14,619,8,2016,8,0
Group 3,RRG,-0.5,11,14,620,4,2016,8,-4
Group 3,RRG,-0.5,11,14,621,4,2016,6,-2
Group 3,RRG,-0.5,11,14,622,7,2016,10,-3
Group 3,RRG,-0.5,11,14,623,13,2016,9,4
Group 3,RRG,-0.5,11,14,624,11,2016,6,5
Group 3,RRG,-0.5,11,14,625,14,2016,8,6
Group 3,RRG,-0.5,11,14,626,13,2016,12,1
Group 3,RRG,-0.5,11,14,627,6,2016,10,-4
Group 3,RRG,-0.5,11,14,628,12,2016,6,6
Group 3,RRG,-0.5,11,14,629,11,2016,10,1
Group 3,RRG,-0.5,11,14,630,11,2016,9,2
Group 3,RRG,-0.5,11,14,631,12,2016,8,4
Group 3,RRG,-0.5,11,14,632,11,2016,9,2
Group 3,RRG,-0.5,11,14,633,9,2016,8,1
Group 3,RRG,-0.5,11,14,634,11,2016,8,3
Group 3,RRG,-0.5,11,14,635,9,2016,8,1
Group 3,RRG,-0.5,11,14,636,11,2016,9,2
Group 3,RRG,-0.5,11,14,637,11,2016,11,0
Group 3,RRG,-0.5,11,14,638,11,2016,7,4
Group 3,RRG,-0.5,11,14,639,7,2016,7,0
Group 3,RRG,-0.5,11,14,640,7,2016,9,-2
Group 3,RRG,-0.5,11,14,641,4,2016,6,-2
Group 3,RRG,-0.5,11,14,642,4,2016,6,-2
Group 3,RRG,-0.5,11,14,643,5,2016,5,0
Group 3,RRG,-0.5,11,14,644,10,2016,5,5
Group 3,RRG,-0.5,11,14,645,7,2016,9,-2
Group 3,RRG,-0.5,11,14,646,9,2016,10,-1
Group 3,RRG,-0.5,11,14,647,9,2016,9,0
Group 3,RRG,-0.5,11,14,648,12,2016,9,3
Group 3,RRG,-0.5,11,14,649,5,2016,7,-2
Group 3,RRG,-0.5,11,14,650,7,2016,7,0
Group 3,RRG,-0.5,11,14,651,8,2016,9,-1
Group 3,RRG,-0.5,11,14,652,10,2016,7,3
Group 3,RRG,-0.5,11,14,653,8,2016,8,0
Group 3,RRG,-0.5,11,14,654,6,2016,10,-4
Group 3,RRG,-0.5,11,14,655,11,2016,9,2
Group 3,RRG,-0.5,11,14,656,7,2016,7,0
Group 3,RRG,-0.5,11,14,657,12,2016,11,1
Group 3,RRG,-0.5,11,14,658,5,2016,9,-4
Group 3,RRG,-0.5,11,14,659,8,2016,11,-3
Group 3,RRG,-0.5,11,14,660,7,2016,8,-1
Group 3,RRG,-0.5,11,14,661,8,2016,6,2
Group 3,RRG,-0.5,11,14,662,11,2016,7,4
Group 3,RRG,-0.5,11,14,663,12,2016,9,3
Group 3,RRG,-0.5,11,14,664,10,2016,6,4
Group 3,RRG,-0.5,11,14,665,10,2016,11,-1
Group 3,RRG,-0.5,11,14,666,10,2016,8,2
Group 3,RRG,-0.5,11,14,667,12,2016,11,1
Group 3,RRG,-0.5,11,14,668,11,2016,6,5
Group 3,RRG,-0.5,11,14,669,11,2016,10,1
Group 3,RRG,-0.5,11,14,670,7,2016,9,-2
Group 3,RRG,-0.5,11,14,671,9,2016,9,0
Group 3,RRG,-0.5,11,14,672,3,2016,6,-3
Group 3,RRG,-0.5,11,14,673,13,2016,10,3
Group 3,RRG,-0.5,11,14,674,3,2016,2,1
Group 3,RRG,-0.5,11,14,675,13,2016,9,4
Group 3,RRG,-0.5,11,14,676,8,2016,8,0
Group 3,RRG,-0.5,11,14,677,11,2016,6,5
Group 3,RRG,-0.5,11,14,678,11,2016,12,-1
Group 3,RRG,-0.5,11,14,679,7,2016,7,0
Group 3,RRG,-0.5,11,14,680,4,2016,12,-8
Group 3,RRG,-0.5,11,14,681,11,2016,11,0
Group 3,RRG,-0.5,11,14,682,6,2016,7,-1
Group 3,RRG,-0.5,11,14,683,5,2016,7,-2
Group 3,RRG,-0.5,11,14,684,13,2016,9,4
Group 3,RRG,-0.5,11,14,685,11,2016,11,0
Group 3,RRG,-0.5,11,14,686,4,2016,6,-2
Group 3,RRG,-0.5,11,14,687,7,2016,10,-3
Group 3,RRG,-0.5,11,14,688,7,2016,11,-4
Group 3,RRG,-0.5,11,14,689,10,2016,4,6
Group 3,RRG,-0.5,11,14,690,12,2016,9,3
Group 3,RRG,-0.5,11,14,691,9,2016,10,-1
Group 3,RRG,-0.5,11,14,692,10,2016,8,2
Group 3,RRG,-0.5,11,14,693,6,2016,4,2
Group 3,RRG,-0.5,11,14,694,11,2016,8,3
Group 3,RRG,-0.5,11,14,695,10,2016,10,0
Group 3,RRG,-0.5,11,14,696,3,2016,6,-3
Group 3,RRG,-0.5,11,14,697,11,2016,10,1
Group 3,RRG,-0.5,11,14,698,7,2016,1,6
Group 3,RRG,-0.5,11,14,699,7,2016,8,-1
Group 3,RRG,-0.5,11,14,700,12,2016,9,3
Group 3,RRG,-0.5,11,14,701,6,2016,7,-1
Group 3,RRG,-0.5,11,14,702,3,2016,7,-4
Group 3,RRG,-0.5,11,14,703,13,2016,11,2
Group 3,RRG,-0.5,11,14,704,9,2016,7,2
Group 3,RRG,-0.5,11,14,705,7,2016,7,0
Group 3,RRG,-0.5,11,14,706,10,2016,8,2
Group 3,RRG,-0.5,11,14,707,6,2016,3,3
Group 3,RRG,-0.5,11,14,708,10,2016,8,2
Group 3,RRG,-0.5,11,14,709,10,2016,5,5
Group 3,RRG,-0.5,11,14,710,8,2016,9,-1
Group 3,RRG,-0.5,11,14,711,5,2016,7,-2
Group 3,RRG,-0.5,11,14,712,3,2016,7,-4
Group 3,RRG,-0.5,11,14,713,6,2016,8,-2
Group 3,RRG,-0.5,11,14,714,7,2016,4,3
Group 3,RRG,-0.5,11,14,715,9,2016,6,3
Group 3,RRG,-0.5,11,14,716,8,2016,1,7
Group 3,RRG,-0.5,11,14,717,11,2016,13,-2
Group 3,RRG,-0.5,11,14,718,3,2016,3,0
Group 3,RRG,-0.5,11,14,719,8,2016,12,-4
Group 3,RRG,-0.5,11,14,720,9,2016,9,0
Group 3,RRG,-0.5,11,14,721,9,2016,9,0
Group 3,RRG,-0.5,11,14,722,10,2016,10,0
Group 3,RRG,-0.5,11,14,723,13,2016,11,2
Group 3,RRG,-0.5,11,14,724,11,2016,11,0
Group 3,RRG,-0.5,11,14,725,12,2016,11,1
Group 3,RRG,-0.5,11,14,726,10,2016,4,6
Group 3,RRG,-0.5,11,14,727,10,2016,10,0
Group 3,RRG,-0.5,11,14,728,12,2016,14,-2
Group 3,RRG,-0.5,11,14,729,8,2016,3,5
Group 3,RRG,-0.5,11,14,730,11,2016,14,-3
Group 3,RRG,-0.5,11,14,731,14,2016,14,0
Group 3,RRG,-0.5,11,14,732,13,2016,9,4
Group 3,RRG,-0.5,11,14,733,6,2016,5,1
Group 3,RRG,-0.5,11,14,734,8,2016,11,-3
Group 3,RRG,-0.5,11,14,735,10,2016,9,1
Group 3,RRG,-0.5,11,14,736,11,2016,12,-1
Group 3,RRG,-0.5,11,14,737,6,2016,6,0
Group 3,RRG,-0.5,11,14,738,6,2016,7,-1
Group 3,RRG,-0.5,11,14,739,11,2016,8,3
Group 3,RRG,-0.5,11,14,740,4,2016,8,-4
Group 3,RRG,-0.5,11,14,741,9,2016,6,3
Group 3,RRG,-0.5,11,14,742,6,2016,7,-1
Group 3,RRG,-0.5,11,14,743,10,2016,7,3
Group 3,RRG,-0.5,11,14,744,6,2016,11,-5
Group 3,RRG,-0.5,11,14,745,10,2016,6,4
Group 3,RRG,-0.5,11,14,746,11,2016,6,5
Group 3,RRG,-0.5,11,14,747,10,2016,6,4
Group 3,RRG,-0.5,11,14,748,10,2016,10,0
Group 3,RRG,-0.5,11,14,749,6,2016,5,1
Group 3,RRG,-0.5,11,14,750,10,2016,7,3
Group 3,RRG,-0.5,11,14,751,11,2016,7,4
Group 3,RRG,-0.5,11,14,752,10,2016,7,3
Group 3,RRG,-0.5,11,14,753,9,2016,9,0
Group 3,RRG,-0.5,11,14,754,10,2016,7,3
Group 3,RRG,-0.5,11,14,755,9,2016,13,-4
Group 3,RRG,-0.5,11,14,756,14,2016,9,5
Group 3,RRG,-0.5,11,14,757,10,2016,13,-3
Group 3,RRG,-0.5,11,14,758,4,2016,6,-2
Group 3,RRG,-0.5,11,14,759,9,2016,11,-2
Group 3,RRG,-0.5,11,14,760,5,2016,5,0
Group 3,RRG,-0.5,11,14,761,12,2016,12,0
Group 3,RRG,-0.5,11,14,762,11,2016,7,4
Group 3,RRG,-0.5,11,14,763,6,2016,7,-1
Group 3,RRG,-0.5,11,14,764,1,2016,7,-6
Group 3,RRG,-0.5,11,14,765,6,2016,7,-1
Group 3,RRG,-0.5,11,14,766,6,2016,6,0
Group 3,RRG,-0.5,11,14,767,8,2016,10,-2
Group 3,RRG,-0.5,11,14,768,6,2016,11,-5
Group 3,RRG,-0.5,11,14,769,12,2016,10,2
Group 3,RRG,-0.5,11,14,770,4,2016,5,-1
Group 3,RRG,-0.5,11,14,771,5,2016,6,-1
Group 3,RRG,-0.5,11,14,772,8,2016,12,-4
Group 3,RRG,-0.5,11,14,773,10,2016,8,2
Group 3,RRG,-0.5,11,14,774,10,2016,9,1
Group 3,RRG,-0.5,11,14,775,4,2016,3,1
Group 3,RRG,-0.5,11,14,776,10,2016,7,3
Group 3,RRG,-0.5,11,14,777,7,2016,9,-2
Group 3,RRG,-0.5,11,14,778,11,2016,7,4
Group 3,RRG,-0.5,11,14,779,13,2016,13,0
Group 3,RRG,-0.5,11,14,780,12,2016,10,2
Group 3,RRG,-0.5,11,14,781,6,2016,6,0
Group 3,RRG,-0.5,11,14,782,3,2016,7,-4
Group 3,RRG,-0.5,11,14,783,6,2016,10,-4
Group 3,RRG,-0.5,11,14,784,8,2016,9,-1
Group 3,RRG,-0.5,11,14,785,8,2016,8,0
Group 3,RRG,-0.5,11,14,786,12,2016,6,6
Group 3,RRG,-0.5,11,14,787,4,2016,3,1
Group 3,RRG,-0.5,11,14,788,4,2016,4,0
Group 3,RRG,-0.5,11,14,789,4,2016,10,-6
Group 3,RRG,-0.5,11,14,790,12,2016,11,1
Group 3,RRG,-0.5,11,14,791,8,2016,7,1
Group 3,RRG,-0.5,11,14,792,4,2016,8,-4
Group 3,RRG,-0.5,11,14,793,13,2016,8,5
Group 3,RRG,-0.5,11,14,794,9,2016,10,-1
Group 3,RRG,-0.5,11,14,795,10,2016,7,3
Group 3,RRG,-0.5,11,14,796,6,2016,9,-3
Group 3,RRG,-0.5,11,14,797,10,2016,10,0
Group 3,RRG,-0.5,11,14,798,8,2016,8,0
Group 3,RRG,-0.5,11,14,799,6,2016,11,-5
Group 3,RRG,-0.5,11,14,800,10,2016,6,4
Group 3,RRG,-0.5,11,14,801,10,2016,7,3
Group 3,RRG,-0.5,11,14,802,8,2016,4,4
Group 3,RRG,-0.5,11,14,803,10,2016,5,5
Group 3,RRG,-0.5,11,14,804,10,2016,6,4
Group 3,RRG,-0.5,11,14,805,11,2016,6,5
Group 3,RRG,-0.5,11,14,806,11,2016,9,2
Group 3,RRG,-0.5,11,14,807,10,2016,8,2
Group 3,RRG,-0.5,11,14,808,2,2016,9,-7
Group 3,RRG,-0.5,11,14,809,9,2016,11,-2
Group 3,RRG,-0.5,11,14,810,9,2016,12,-3
Group 3,RRG,-0.5,11,14,811,5,2016,6,-1
Group 3,RRG,-0.5,11,14,812,10,2016,10,0
Group 3,RRG,-0.5,11,14,813,12,2016,13,-1
Group 3,RRG,-0.5,11,14,814,5,2016,9,-4
Group 3,RRG,-0.5,11,14,815,9,2016,11,-2
Group 3,RRG,-0.5,11,14,816,11,2016,8,3
Group 3,RRG,-0.5,11,14,817,9,2016,8,1
Group 3,RRG,-0.5,11,14,818,8,2016,11,-3
Group 3,RRG,-0.5,11,14,819,10,2016,12,-2
Group 3,RRG,-0.5,11,14,820,11,2016,10,1
Group 3,RRG,-0.5,11,14,821,4,2016,11,-7
Group 3,RRG,-0.5,11,14,822,12,2016,9,3
Group 3,RRG,-0.5,11,14,823,12,2016,10,2
Group 3,RRG,-0.5,11,14,824,8,2016,9,-1
Group 3,RRG,-0.5,11,14,825,9,2016,7,2
Group 3,RRG,-0.5,11,14,826,9,2016,7,2
Group 3,RRG,-0.5,11,14,827,8,2016,7,1
Group 3,RRG,-0.5,11,14,828,11,2016,10,1
Group 3,RRG,-0.5,11,14,829,7,2016,8,-1
Group 3,RRG,-0.5,11,14,830,11,2016,12,-1
Group 3,RRG,-0.5,11,14,831,13,2016,11,2
Group 3,RRG,-0.5,11,14,832,4,2016,8,-4
Group 3,RRG,-0.5,11,14,833,14,2016,12,2
Group 3,RRG,-0.5,11,14,834,8,2016,9,-1
Group 3,RRG,-0.5,11,14,835,7,2016,8,-1
Group 3,RRG,-0.5,11,14,836,11,2016,10,1
Group 3,RRG,-0.5,11,14,837,12,2016,8,4
Group 3,RRG,-0.5,11,14,838,9,2016,5,4
Group 3,RRG,-0.5,11,14,839,9,2016,8,1
Group 3,RRG,-0.5,11,14,840,9,2016,6,3
Group 3,RRG,-0.5,11,14,841,14,2016,9,5
Group 3,RRG,-0.5,11,14,842,9,2016,11,-2
Group 3,RRG,-0.5,11,14,843,8,2016,8,0
Group 3,RRG,-0.5,11,14,844,6,2016,8,-2
Group 3,RRG,-0.5,11,14,845,8,2016,7,1
Group 3,RRG,-0.5,11,14,846,12,2016,11,1
Group 3,RRG,-0.5,11,14,847,5,2016,5,0
Group 3,RRG,-0.5,11,14,848,8,2016,8,0
Group 3,RRG,-0.5,11,14,849,6,2016,5,1
Group 3,RRG,-0.5,11,14,850,6,2016,9,-3
Group 3,RRG,-0.5,11,14,851,11,2016,8,3
Group 3,RRG,-0.5,11,14,852,10,2016,10,0
Group 3,RRG,-0.5,11,14,853,5,2016,5,0
Group 3,RRG,-0.5,11,14,854,6,2016,10,-4
Group 3,RRG,-0.5,11,14,855,8,2016,10,-2
Group 3,RRG,-0.5,11,14,856,10,2016,11,-1
Group 3,RRG,-0.5,11,14,857,12,2016,8,4
Group 3,RRG,-0.5,11,14,858,6,2016,4,2
Group 3,RRG,-0.5,11,14,859,9,2016,9,0
Group 3,RRG,-0.5,11,14,860,13,2016,8,5
Group 3,RRG,-0.5,11,14,861,5,2016,7,-2
Group 3,RRG,-0.5,11,14,862,8,2016,11,-3
Group 3,RRG,-0.5,11,14,863,8,2016,10,-2
Group 3,RRG,-0.5,11,14,864,7,2016,6,1
Group 3,RRG,-0.5,11,14,865,10,2016,9,1
Group 3,RRG,-0.5,11,14,866,8,2016,10,-2
Group 3,RRG,-0.5,11,14,867,9,2016,12,-3
Group 3,RRG,-0.5,11,14,868,5,2016,7,-2
Group 3,RRG,-0.5,11,14,869,6,2016,10,-4
Group 3,RRG,-0.5,11,14,870,9,2016,8,1
Group 3,RRG,-0.5,11,14,871,7,2016,11,-4
Group 3,RRG,-0.5,11,14,872,10,2016,13,-3
Group 3,RRG,-0.5,11,14,873,12,2016,10,2
Group 3,RRG,-0.5,11,14,874,6,2016,10,-4
Group 3,RRG,-0.5,11,14,875,5,2016,12,-7
Group 3,RRG,-0.5,11,14,876,12,2016,6,6
Group 3,RRG,-0.5,11,14,877,7,2016,13,-6
Group 3,RRG,-0.5,11,14,878,5,2016,7,-2
Group 3,RRG,-0.5,11,14,879,6,2016,5,1
Group 3,RRG,-0.5,11,14,880,9,2016,4,5
Group 3,RRG,-0.5,11,14,881,10,2016,10,0
Group 3,RRG,-0.5,11,14,882,13,2016,11,2
Group 3,RRG,-0.5,11,14,883,13,2016,13,0
Group 3,RRG,-0.5,11,14,884,9,2016,8,1
Group 3,RRG,-0.5,11,14,885,10,2016,7,3
Group 3,RRG,-0.5,11,14,886,13,2016,12,1
Group 3,RRG,-0.5,11,14,887,9,2016,9,0
Group 3,RRG,-0.5,11,14,888,8,2016,9,-1
Group 3,RRG,-0.5,11,14,889,7,2016,7,0
Group 3,RRG,-0.5,11,14,890,8,2016,10,-2
Group 3,RRG,-0.5,11,14,891,7,2016,10,-3
Group 3,RRG,-0.5,11,14,892,10,2016,7,3
Group 3,RRG,-0.5,11,14,893,10,2016,8,2
Group 3,RRG,-0.5,11,14,894,9,2016,12,-3
Group 3,RRG,-0.5,11,14,895,11,2016,8,3
Group 3,RRG,-0.5,11,14,896,8,2016,11,-3
Group 3,RRG,-0.5,11,14,897,4,2016,9,-5
Group 3,RRG,-0.5,11,14,898,5,2016,4,1
Group 3,RRG,-0.5,11,14,899,10,2016,4,6
Group 3,RRG,-0.5,11,14,900,7,2016,9,-2
Group 3,RRG,-0.5,11,14,901,5,2016,9,-4
Group 3,RRG,-0.5,11,14,902,6,2016,7,-1
Group 3,RRG,-0.5,11,14,903,8,2016,8,0
Group 3,RRG,-0.5,11,14,904,9,2016,8,1
Group 3,RRG,-0.5,11,14,905,7,2016,8,-1
Group 3,RRG,-0.5,11,14,906,11,2016,7,4
Group 3,RRG,-0.5,11,14,907,3,2016,10,-7
Group 3,RRG,-0.5,11,14,908,3,2016,9,-6
Group 3,RRG,-0.5,11,14,909,10,2016,7,3
Group 3,RRG,-0.5,11,14,910,5,2016,3,2
Group 3,RRG,-0.5,11,14,911,10,2016,14,-4
Group 3,RRG,-0.5,11,14,912,5,2016,11,-6
Group 3,RRG,-0.5,11,14,913,1,2016,1,0
Group 3,RRG,-0.5,11,14,914,9,2016,8,1
Group 3,RRG,-0.5,11,14,915,7,2016,2,5
Group 3,RRG,-0.5,11,14,916,6,2016,2,4
Group 3,RRG,-0.5,11,14,917,10,2016,13,-3
Group 3,RRG,-0.5,11,14,918,12,2016,13,-1
Group 3,RRG,-0.5,11,14,919,12,2016,10,2
Group 3,RRG,-0.5,11,14,920,8,2016,11,-3
Group 3,RRG,-0.5,11,14,921,9,2016,8,1
Group 3,RRG,-0.5,11,14,922,8,2016,9,-1
Group 3,RRG,-0.5,11,14,923,5,2016,9,-4
Group 3,RRG,-0.5,11,14,924,5,2016,10,-5
Group 3,RRG,-0.5,11,14,925,4,2016,7,-3
Group 3,RRG,-0.5,11,14,926,11,2016,9,2
Group 3,RRG,-0.5,11,14,927,9,2016,7,2
Group 3,RRG,-0.5,11,14,928,11,2016,10,1
Group 3,RRG,-0.5,11,14,929,10,2016,10,0
Group 3,RRG,-0.5,11,14,930,12,2016,11,1
Group 3,RRG,-0.5,11,14,931,9,2016,10,-1
Group 3,RRG,-0.5,11,14,932,14,2016,9,5
Group 3,RRG,-0.5,11,14,933,6,2016,7,-1
Group 3,RRG,-0.5,11,14,934,4,2016,8,-4
Group 3,RRG,-0.5,11,14,935,12,2016,9,3
Group 3,RRG,-0.5,11,14,936,7,2016,8,-1
Group 3,RRG,-0.5,11,14,937,4,2016,6,-2
Group 3,RRG,-0.5,11,14,938,9,2016,7,2
Group 3,RRG,-0.5,11,14,939,10,2016,8,2
Group 3,RRG,-0.5,11,14,940,6,2016,9,-3
Group 3,RRG,-0.5,11,14,941,7,2016,12,-5
Group 3,RRG,-0.5,11,14,942,13,2016,12,1
Group 3,RRG,-0.5,11,14,943,6,2016,5,1
Group 3,RRG,-0.5,11,14,944,7,2016,10,-3
Group 3,RRG,-0.5,11,14,945,6,2016,9,-3
Group 3,RRG,-0.5,11,14,946,8,2016,12,-4
Group 3,RRG,-0.5,11,14,947,10,2016,10,0
Group 3,RRG,-0.5,11,14,948,7,2016,8,-1
Group 3,RRG,-0.5,11,14,949,11,2016,10,1
Group 3,RRG,-0.5,11,14,950,9,2016,9,0
Group 3,RRG,-0.5,11,14,951,8,2016,7,1
Group 3,RRG,-0.5,11,14,952,7,2016,7,0
Group 3,RRG,-0.5,11,14,953,5,2016,10,-5
Group 3,RRG,-0.5,11,14,954,11,2016,10,1
Group 3,RRG,-0.5,11,14,955,12,2016,10,2
Group 3,RRG,-0.5,11,14,956,5,2016,9,-4
Group 3,RRG,-0.5,11,14,957,9,2016,13,-4
Group 3,RRG,-0.5,11,14,958,6,2016,7,-1
Group 3,RRG,-0.5,11,14,959,4,2016,7,-3
Group 3,RRG,-0.5,11,14,960,7,2016,6,1
Group 3,RRG,-0.5,11,14,961,8,2016,12,-4
Group 3,RRG,-0.5,11,14,962,6,2016,7,-1
Group 3,RRG,-0.5,11,14,963,7,2016,7,0
Group 3,RRG,-0.5,11,14,964,4,2016,8,-4
Group 3,RRG,-0.5,11,14,965,7,2016,5,2
Group 3,RRG,-0.5,11,14,966,8,2016,5,3
Group 3,RRG,-0.5,11,14,967,12,2016,12,0
Group 3,RRG,-0.5,11,14,968,4,2016,9,-5
Group 3,RRG,-0.5,11,14,969,10,2016,8,2
Group 3,RRG,-0.5,11,14,970,12,2016,7,5
Group 3,RRG,-0.5,11,14,971,11,2016,8,3
Group 3,RRG,-0.5,11,14,972,8,2016,5,3
Group 3,RRG,-0.5,11,14,973,11,2016,13,-2
Group 3,RRG,-0.5,11,14,974,8,2016,5,3
Group 3,RRG,-0.5,11,14,975,9,2016,6,3
Group 3,RRG,-0.5,11,14,976,8,2016,7,1
Group 3,RRG,-0.5,11,14,977,9,2016,9,0
Group 3,RRG,-0.5,11,14,978,11,2016,6,5
Group 3,RRG,-0.5,11,14,979,10,2016,6,4
Group 3,RRG,-0.5,11,14,980,7,2016,8,-1
Group 3,RRG,-0.5,11,14,981,11,2016,12,-1
Group 3,RRG,-0.5,11,14,982,6,2016,7,-1
Group 3,RRG,-0.5,11,14,983,11,2016,12,-1
Group 3,RRG,-0.5,11,14,984,11,2016,6,5
Group 3,RRG,-0.5,11,14,985,10,2016,11,-1
Group 3,RRG,-0.5,11,14,986,7,2016,7,0
Group 3,RRG,-0.5,11,14,987,8,2016,11,-3
Group 3,RRG,-0.5,11,14,988,7,2016,9,-2
Group 3,RRG,-0.5,11,14,989,5,2016,5,0
Group 3,RRG,-0.5,11,14,990,14,2016,8,6
Group 3,RRG,-0.5,11,14,991,9,2016,8,1
Group 3,RRG,-0.5,11,14,992,7,2016,5,2
Group 3,RRG,-0.5,11,14,993,4,2016,10,-6
Group 3,RRG,-0.5,11,14,994,9,2016,10,-1
Group 3,RRG,-0.5,11,14,995,3,2016,4,-1
Group 3,RRG,-0.5,11,14,996,7,2016,11,-4
Group 3,RRG,-0.5,11,14,997,9,2016,10,-1
Group 3,RRG,-0.5,11,14,998,6,2016,10,-4
Group 3,RRG,-0.5,11,14,999,10,2016,9,1
Group 3,RRG,-0.5,11,14,1000,14,2016,12,2
Group 3,RRG,-0.5,11,14,1001,14,2016,13,1
Group 3,RRG,-0.5,11,14,1002,11,2016,13,-2
Group 3,RRG,-0.5,11,14,1003,9,2016,9,0
Group 3,RRG,-0.5,11,14,1004,14,2016,11,3
Group 3,RRG,-0.5,11,14,1005,8,2016,8,0
Group 3,RRG,-0.5,11,14,1006,13,2016,9,4
Group 3,RRG,-0.5,11,14,1007,11,2016,12,-1
Group 3,RRG,-0.5,11,14,1008,11,2016,8,3
Group 3,RRG,-0.5,11,14,1009,8,2016,6,2
Group 3,RRG,-0.5,11,14,1010,8,2016,9,-1
Group 3,RRG,-0.5,11,14,1011,4,2016,5,-1
Group 3,RRG,-0.5,11,14,1012,8,2016,8,0
Group 3,RRG,-0.5,11,14,1013,11,2016,8,3
Group 3,RRG,-0.5,11,14,1014,8,2016,10,-2
Group 3,RRG,-0.5,11,14,1015,9,2016,6,3
Group 3,RRG,-0.5,11,14,1016,9,2016,7,2
Group 3,RRG,-0.5,11,14,1017,7,2016,5,2
Group 3,RRG,-0.5,11,14,1018,8,2016,5,3
Group 3,RRG,-0.5,11,14,1019,6,2016,7,-1
Group 3,RRG,-0.5,11,14,1020,7,2016,8,-1
Group 3,RRG,-0.5,11,14,1021,6,2016,9,-3
Group 3,RRG,-0.5,11,14,1022,7,2016,11,-4
Group 3,RRG,-0.5,11,14,1023,11,2016,7,4
Group 3,RRG,-0.5,11,14,1024,7,2016,8,-1
Group 3,RRG,-0.5,11,14,1025,11,2016,10,1
Group 3,RRG,-0.5,11,14,1026,9,2016,6,3
Group 3,RRG,-0.5,11,14,1027,14,2016,10,4
Group 3,RRG,-0.5,11,14,1028,11,2016,10,1
Group 3,RRG,-0.5,11,14,1029,6,2016,8,-2
Group 3,RRG,-0.5,11,14,1030,9,2016,10,-1
Group 3,RRG,-0.5,11,14,1031,8,2016,10,-2
Group 3,RRG,-0.5,11,14,1032,9,2016,8,1
Group 3,RRG,-0.5,11,14,1033,7,2016,5,2
Group 3,RRG,-0.5,11,14,1034,8,2016,3,5
Group 3,RRG,-0.5,11,14,1035,6,2016,7,-1
Group 3,RRG,-0.5,11,14,1036,5,2016,10,-5
Group 3,RRG,-0.5,11,14,1037,7,2016,10,-3
Group 3,RRG,-0.5,11,14,1038,3,2016,9,-6
Group 3,RRG,-0.5,11,14,1039,8,2016,8,0
Group 3,RRG,-0.5,11,14,1040,10,2016,7,3
Group 3,RRG,-0.5,11,14,1041,9,2016,9,0
Group 3,RRG,-0.5,11,14,1042,9,2016,8,1
Group 3,RRG,-0.5,11,14,1043,10,2016,10,0
Group 3,RRG,-0.5,11,14,1044,6,2016,10,-4
Group 3,RRG,-0.5,11,14,1045,8,2016,9,-1
Group 3,RRG,-0.5,11,14,1046,11,2016,8,3
Group 3,RRG,-0.5,11,14,1047,7,2016,7,0
Group 3,RRG,-0.5,11,14,1048,7,2016,9,-2
Group 3,RRG,-0.5,11,14,1049,6,2016,10,-4
Group 3,RRG,-0.5,11,14,1050,6,2016,7,-1
Group 3,RRG,-0.5,11,14,1051,6,2016,6,0
Group 3,RRG,-0.5,11,14,1052,5,2016,2,3
Group 3,RRG,-0.5,11,14,1053,3,2016,7,-4
Group 3,RRG,-0.5,11,14,1054,6,2016,6,0
Group 3,RRG,-0.5,11,14,1055,11,2016,9,2
Group 3,RRG,-0.5,11,14,1056,9,2016,10,-1
Group 3,RRG,-0.5,11,14,1057,5,2016,11,-6
Group 3,RRG,-0.5,11,14,1058,12,2016,8,4
Group 3,RRG,-0.5,11,14,1059,13,2016,8,5
Group 3,RRG,-0.5,11,14,1060,9,2016,10,-1
Group 3,RRG,-0.5,11,14,1061,7,2016,7,0
Group 3,RRG,-0.5,11,14,1062,6,2016,8,-2
Group 3,RRG,-0.5,11,14,1063,8,2016,6,2
Group 3,RRG,-0.5,11,14,1064,3,2016,11,-8
Group 3,RRG,-0.5,11,14,1065,9,2016,11,-2
Group 3,RRG,-0.5,11,14,1066,9,2016,3,6
Group 3,RRG,-0.5,11,14,1067,7,2016,12,-5
Group 3,RRG,-0.5,11,14,1068,9,2016,12,-3
Group 3,RRG,-0.5,11,14,1069,5,2016,2,3
Group 3,RRG,-0.5,11,14,1070,12,2016,11,1
Group 3,RRG,-0.5,11,14,1071,5,2016,6,-1
Group 3,RRG,-0.5,11,14,1072,10,2016,9,1
Group 3,RRG,-0.5,11,14,1073,12,2016,11,1
Group 3,RRG,-0.5,11,14,1074,5,2016,4,1
Group 3,RRG,-0.5,11,14,1075,12,2016,10,2
Group 3,RRG,-0.5,11,14,1076,12,2016,13,-1
Group 3,RRG,-0.5,11,14,1077,14,2016,13,1
Group 3,RRG,-0.5,11,14,1078,12,2016,14,-2
Group 3,RRG,-0.5,11,14,1079,13,2016,10,3
Group 3,RRG,-0.5,11,14,1080,11,2016,10,1
Group 3,RRG,-0.5,11,14,1081,8,2016,10,-2
Group 3,RRG,-0.5,11,14,1082,5,2016,11,-6
Group 3,RRG,-0.5,11,14,1083,8,2016,7,1
Group 3,RRG,-0.5,11,14,1084,6,2016,5,1
Group 3,RRG,-0.5,11,14,1085,7,2016,8,-1
Group 3,RRG,-0.5,11,14,1086,7,2016,8,-1
Group 3,RRG,-0.5,11,14,1087,8,2016,3,5
Group 3,RRG,-0.5,11,14,1088,9,2016,7,2
Group 3,RRG,-0.5,11,14,1089,13,2016,11,2
Group 3,RRG,-0.5,11,14,1090,6,2016,9,-3
Group 3,RRG,-0.5,11,14,1091,10,2016,6,4
Group 3,RRG,-0.5,11,14,1092,4,2016,6,-2
Group 3,RRG,-0.5,11,14,1093,13,2016,10,3
Group 3,RRG,-0.5,11,14,1094,8,2016,9,-1
Group 3,RRG,-0.5,11,14,1095,8,2016,9,-1
Group 3,RRG,-0.5,11,14,1096,6,2016,4,2
Group 3,RRG,-0.5,11,14,1097,6,2016,4,2
Group 3,RRG,-0.5,11,14,1098,7,2016,9,-2
Group 3,RRG,-0.5,11,14,1099,1,2016,4,-3
Group 3,RRG,-0.5,11,14,1100,1,2016,4,-3
Group 3,RRG,-0.5,11,14,1101,2,2016,9,-7
Group 3,RRG,-0.5,11,14,1102,12,2016,6,6
Group 3,RRG,-0.5,11,14,1103,12,2016,9,3
Group 3,RRG,-0.5,11,14,1104,13,2016,12,1
Group 3,RRG,-0.5,11,14,1105,11,2016,3,8
Group 3,RRG,-0.5,11,14,1106,8,2016,6,2
Group 3,RRG,-0.5,11,14,1107,7,2016,4,3
Group 3,RRG,-0.5,11,14,1108,8,2016,7,1
Group 3,RRG,-0.5,11,14,1109,7,2016,11,-4
Group 3,RRG,-0.5,11,14,1110,7,2016,6,1
Group 3,RRG,-0.5,11,14,1111,7,2016,7,0
Group 3,RRG,-0.5,11,14,1112,6,2016,5,1
Group 3,RRG,-0.5,11,14,1113,10,2016,6,4
Group 3,RRG,-0.5,11,14,1114,8,2016,6,2
Group 3,RRG,-0.5,11,14,1115,10,2016,9,1
Group 3,RRG,-0.5,11,14,1116,11,2016,10,1
Group 3,RRG,-0.5,11,14,1117,10,2016,8,2
Group 3,RRG,-0.5,11,14,1118,10,2016,11,-1
Group 3,RRG,-0.5,11,14,1119,10,2016,11,-1
Group 3,RRG,-0.5,11,14,1120,8,2016,8,0
Group 3,RRG,-0.5,11,14,1121,2,2016,4,-2
Group 3,RRG,-0.5,11,14,1122,6,2016,5,1
Group 3,RRG,-0.5,11,14,1123,10,2016,12,-2
Group 3,RRG,-0.5,11,14,1124,10,2016,9,1
Group 3,RRG,-0.5,11,14,1125,11,2016,8,3
Group 3,RRG,-0.5,11,14,1126,6,2016,9,-3
Group 3,RRG,-0.5,11,14,1127,8,2016,7,1
Group 3,RRG,-0.5,11,14,1128,8,2016,7,1
Group 3,RRG,-0.5,11,14,1129,10,2016,9,1
Group 3,RRG,-0.5,11,14,1130,7,2016,7,0
Group 3,RRG,-0.5,11,14,1131,14,2016,12,2
Group 3,RRG,-0.5,11,14,1132,12,2016,8,4
Group 3,RRG,-0.5,11,14,1133,10,2016,11,-1
Group 3,RRG,-0.5,11,14,1134,13,2016,12,1
Group 3,RRG,-0.5,11,14,1135,11,2016,13,-2
Group 3,RRG,-0.5,11,14,1136,7,2016,10,-3
Group 3,RRG,-0.5,11,14,1137,4,2016,4,0
Group 3,RRG,-0.5,11,14,1138,6,2016,6,0
Group 3,RRG,-0.5,11,14,1139,9,2016,10,-1
Group 3,RRG,-0.5,11,14,1140,6,2016,10,-4
Group 3,RRG,-0.5,11,14,1141,8,2016,4,4
Group 3,RRG,-0.5,11,14,1142,11,2016,8,3
Group 3,RRG,-0.5,11,14,1143,10,2016,9,1
Group 3,RRG,-0.5,11,14,1144,12,2016,7,5
Group 3,RRG,-0.5,11,14,1145,11,2016,8,3
Group 3,RRG,-0.5,11,14,1146,6,2016,6,0
Group 3,RRG,-0.5,11,14,1147,12,2016,9,3
Group 3,RRG,-0.5,11,14,1148,3,2016,12,-9
Group 3,RRG,-0.5,11,14,1149,8,2016,8,0
Group 3,RRG,-0.5,11,14,1150,8,2016,7,1
Group 3,RRG,-0.5,11,14,1151,8,2016,9,-1
Group 3,RRG,-0.5,11,14,1152,6,2016,7,-1
Group 3,RRG,-0.5,11,14,1153,12,2016,11,1
Group 3,RRG,-0.5,11,14,1154,10,2016,10,0
Group 3,RRG,-0.5,11,14,1155,10,2016,10,0
Group 3,RRG,-0.5,11,14,1156,11,2016,12,-1
Group 3,RRG,-0.5,11,14,1157,3,2016,6,-3
Group 3,RRG,-0.5,11,14,1158,7,2016,11,-4
Group 3,RRG,-0.5,11,14,1159,12,2016,8,4
Group 3,RRG,-0.5,11,14,1160,11,2016,7,4
Group 3,RRG,-0.5,11,14,1161,11,2016,11,0
Group 3,RRG,-0.5,11,14,1162,7,2016,9,-2
Group 3,RRG,-0.5,11,14,1163,9,2016,7,2
Group 3,RRG,-0.5,11,14,1164,4,2016,8,-4
Group 3,RRG,-0.5,11,14,1165,9,2016,9,0
Group 3,RRG,-0.5,11,14,1166,10,2016,9,1
Group 3,RRG,-0.5,11,14,1167,8,2016,7,1
Group 3,RRG,-0.5,11,14,1168,8,2016,10,-2
Group 3,RRG,-0.5,11,14,1169,8,2016,10,-2
Group 3,RRG,-0.5,11,14,1170,6,2016,6,0
Group 3,RRG,-0.5,11,14,1171,9,2016,8,1
Group 3,RRG,-0.5,11,14,1172,10,2016,11,-1
Group 3,RRG,-0.5,11,14,1173,12,2016,10,2
Group 3,RRG,-0.5,11,14,1174,9,2016,7,2
Group 3,RRG,-0.5,11,14,1175,11,2016,12,-1
Group 3,RRG,-0.5,11,14,1176,13,2016,10,3
Group 3,RRG,-0.5,11,14,1177,8,2016,9,-1
Group 3,RRG,-0.5,11,14,1178,10,2016,5,5
Group 3,RRG,-0.5,11,14,1179,10,2016,11,-1
Group 3,RRG,-0.5,11,14,1180,9,2016,7,2
Group 3,RRG,-0.5,11,14,1181,10,2016,7,3
Group 3,RRG,-0.5,11,14,1182,7,2016,7,0
Group 3,RRG,-0.5,11,14,1183,7,2016,9,-2
Group 3,RRG,-0.5,11,14,1184,9,2016,9,0
Group 3,RRG,-0.5,11,14,1185,7,2016,5,2
Group 3,RRG,-0.5,11,14,1186,10,2016,10,0
Group 3,RRG,-0.5,11,14,1187,12,2016,8,4
Group 3,RRG,-0.5,11,14,1188,11,2016,11,0
Group 3,RRG,-0.5,11,14,1189,10,2016,8,2
Group 3,RRG,-0.5,11,14,1190,11,2016,11,0
Group 3,RRG,-0.5,11,14,1191,12,2016,9,3
Group 3,RRG,-0.5,11,14,1192,3,2016,10,-7
Group 3,RRG,-0.5,11,14,1193,5,2016,8,-3
Group 3,RRG,-0.5,11,14,1194,7,2016,8,-1
Group 3,RRG,-0.5,11,14,1195,3,2016,7,-4
Group 3,RRG,-0.5,11,14,1196,7,2016,7,0
Group 3,RRG,-0.5,11,14,1197,4,2016,10,-6
Group 3,RRG,-0.5,11,14,1198,10,2016,4,6
Group 3,RRG,-0.5,11,14,1199,5,2016,6,-1
Group 3,RRG,-0.5,11,14,1200,8,2016,6,2
Group 3,RRG,-0.5,11,14,1201,8,2016,11,-3
Group 3,RRG,-0.5,11,14,1202,8,2016,5,3
Group 3,RRG,-0.5,11,14,1203,6,2016,2,4
Group 3,RRG,-0.5,11,14,1204,8,2016,10,-2
Group 3,RRG,-0.5,11,14,1205,7,2016,10,-3
Group 3,RRG,-0.5,11,14,1206,12,2016,8,4
Group 3,RRG,-0.5,11,14,1207,12,2016,7,5
Group 3,RRG,-0.5,11,14,1208,6,2016,9,-3
Group 3,RRG,-0.5,11,14,1209,6,2016,6,0
Group 3,RRG,-0.5,11,14,1210,7,2016,8,-1
Group 3,RRG,-0.5,11,14,1211,10,2016,10,0
Group 3,RRG,-0.5,11,14,1212,5,2016,8,-3
Group 3,RRG,-0.5,11,14,1213,8,2016,8,0
Group 3,RRG,-0.5,11,14,1214,11,2016,9,2
Group 3,RRG,-0.5,11,14,1215,3,2016,7,-4
Group 3,RRG,-0.5,11,14,1216,11,2016,6,5
Group 3,RRG,-0.5,11,14,1217,10,2016,4,6
Group 3,RRG,-0.5,11,14,1218,3,2016,4,-1
Group 3,RRG,-0.5,11,14,1219,11,2016,12,-1
Group 3,RRG,-0.5,11,14,1220,6,2016,9,-3
Group 3,RRG,-0.5,11,14,1221,8,2016,8,0
Group 3,RRG,-0.5,11,14,1222,9,2016,9,0
Group 3,RRG,-0.5,11,14,1223,8,2016,12,-4
Group 3,RRG,-0.5,11,14,1224,6,2016,10,-4
Group 3,RRG,-0.5,11,14,1225,5,2016,8,-3
Group 3,RRG,-0.5,11,14,1226,8,2016,9,-1
Group 3,RRG,-0.5,11,14,1227,7,2016,9,-2
Group 3,RRG,-0.5,11,14,1228,5,2016,9,-4
Group 3,RRG,-0.5,11,14,1229,11,2016,9,2
Group 3,RRG,-0.5,11,14,1230,10,2016,10,0
Group 3,RRG,-0.5,11,14,1231,9,2016,6,3
Group 3,RRG,-0.5,11,14,1232,10,2016,11,-1
Group 3,RRG,-0.5,11,14,1233,9,2016,9,0
Group 3,RRG,-0.5,11,14,1234,8,2016,7,1
Group 3,RRG,-0.5,11,14,1235,8,2016,7,1
Group 3,RRG,-0.5,11,14,1236,9,2016,6,3
Group 3,RRG,-0.5,11,14,1237,8,2016,7,1
Group 3,RRG,-0.5,11,14,1238,6,2016,4,2
Group 3,RRG,-0.5,11,14,1239,5,2016,4,1
Group 3,RRG,-0.5,11,14,1240,6,2016,9,-3
Group 3,RRG,-0.5,11,14,1241,9,2016,8,1
Group 3,RRG,-0.5,11,14,1242,7,2016,8,-1
Group 3,RRG,-0.5,11,14,1243,9,2016,8,1
Group 3,RRG,-0.5,11,14,1244,9,2016,6,3
Group 3,RRG,-0.5,11,14,1245,11,2016,11,0
Group 3,RRG,-0.5,11,14,1246,11,2016,9,2
Group 3,RRG,-0.5,11,14,1247,10,2016,10,0
Group 3,RRG,-0.5,11,14,1248,14,2016,12,2
Group 3,RRG,-0.5,11,14,1249,9,2016,12,-3
Group 3,RRG,-0.5,11,14,1250,9,2016,13,-4
Group 3,RRG,-0.5,11,14,1251,9,2016,10,-1
Group 3,RRG,-0.5,11,14,1252,6,2016,8,-2
Group 3,RRG,-0.5,11,14,1253,11,2016,6,5
Group 3,RRG,-0.5,11,14,1254,11,2016,12,-1
Group 3,RRG,-0.5,11,14,1255,11,2016,8,3
Group 3,RRG,-0.5,11,14,1256,11,2016,8,3
Group 3,RRG,-0.5,11,14,1257,6,2016,12,-6
Group 3,RRG,-0.5,11,14,1258,11,2016,10,1
Group 3,RRG,-0.5,11,14,1259,9,2016,4,5
Group 3,RRG,-0.5,11,14,1260,9,2016,6,3
Group 3,RRG,-0.5,11,14,1261,11,2016,9,2
Group 3,RRG,-0.5,11,14,1262,7,2016,11,-4
Group 3,RRG,-0.5,11,14,1263,6,2016,8,-2
Group 3,RRG,-0.5,11,14,1264,6,2016,9,-3
Group 3,RRG,-0.5,11,14,1265,8,2016,7,1
Group 3,RRG,-0.5,11,14,1266,4,2016,5,-1
Group 3,RRG,-0.5,11,14,1267,7,2016,8,-1
Group 3,RRG,-0.5,11,14,1268,13,2016,10,3
Group 3,RRG,-0.5,11,14,1269,11,2016,6,5
Group 3,RRG,-0.5,11,14,1270,6,2016,10,-4
Group 3,RRG,-0.5,11,14,1271,4,2016,10,-6
Group 3,RRG,-0.5,11,14,1272,11,2016,8,3
Group 3,RRG,-0.5,11,14,1273,9,2016,10,-1
Group 3,RRG,-0.5,11,14,1274,9,2016,6,3
Group 3,RRG,-0.5,11,14,1275,8,2016,7,1
Group 3,RRG,-0.5,11,14,1276,11,2016,6,5
Group 3,RRG,-0.5,11,14,1277,6,2016,6,0
Group 3,RRG,-0.5,11,14,1278,8,2016,7,1
Group 3,RRG,-0.5,11,14,1279,8,2016,3,5
Group 3,RRG,-0.5,11,14,1280,9,2016,12,-3
Group 3,RRG,-0.5,11,14,1281,8,2016,9,-1
Group 3,RRG,-0.5,11,14,1282,7,2016,6,1
Group 3,RRG,-0.5,11,14,1283,8,2016,9,-1
Group 3,RRG,-0.5,11,14,1284,9,2016,12,-3
Group 3,RRG,-0.5,11,14,1285,9,2016,9,0
Group 3,RRG,-0.5,11,14,1286,7,2016,10,-3
Group 3,RRG,-0.5,11,14,1287,13,2016,6,7
Group 3,RRG,-0.5,11,14,1288,7,2016,6,1
Group 3,RRG,-0.5,11,14,1289,10,2016,5,5
Group 3,RRG,-0.5,11,14,1290,6,2016,10,-4
Group 3,RRG,-0.5,11,14,1291,3,2016,6,-3
Group 3,RRG,-0.5,11,14,1292,14,2016,13,1
Group 3,RRG,-0.5,11,14,1293,11,2016,10,1
Group 3,RRG,-0.5,11,14,1294,11,2016,10,1
Group 3,RRG,-0.5,11,14,1295,11,2016,12,-1
Group 3,RRG,-0.5,11,14,1296,4,2016,4,0
Group 3,RRG,-0.5,11,14,1297,5,2016,7,-2
Group 3,RRG,-0.5,11,14,1298,4,2016,9,-5
Group 3,RRG,-0.5,11,14,1299,9,2016,10,-1
Group 3,RRG,-0.5,11,14,1300,7,2016,8,-1
Group 3,RRG,-0.5,11,14,1301,6,2016,7,-1
Group 3,RRG,-0.5,11,14,1302,5,2016,3,2
Group 3,RRG,-0.5,11,14,1303,5,2016,4,1
Group 3,RRG,-0.5,11,14,1304,5,2016,5,0
Group 3,RRG,-0.5,11,14,1305,9,2016,12,-3
Group 3,RRG,-0.5,11,14,1306,8,2016,4,4
Group 3,RRG,-0.5,11,14,1307,8,2016,7,1
Group 3,RRG,-0.5,11,14,1308,12,2016,11,1
Group 3,RRG,-0.5,11,14,1309,7,2016,6,1
Group 3,RRG,-0.5,11,14,1310,8,2016,10,-2
Group 3,RRG,-0.5,11,14,1311,11,2016,8,3
Group 3,RRG,-0.5,11,14,1312,9,2016,8,1
Group 3,RRG,-0.5,11,14,1313,8,2016,9,-1
Group 3,RRG,-0.5,11,14,1314,6,2016,6,0
Group 3,RRG,-0.5,11,14,1315,9,2016,8,1
Group 3,RRG,-0.5,11,14,1316,6,2016,10,-4
Group 3,RRG,-0.5,11,14,1317,13,2016,12,1
Group 3,RRG,-0.5,11,14,1318,9,2016,9,0
Group 3,RRG,-0.5,11,14,1319,4,2016,6,-2
Group 3,RRG,-0.5,11,14,1320,2,2016,7,-5
Group 3,RRG,-0.5,11,14,1321,12,2016,12,0
Group 3,RRG,-0.5,11,14,1322,10,2016,11,-1
Group 3,RRG,-0.5,11,14,1323,13,2016,12,1
Group 3,RRG,-0.5,11,14,1324,14,2016,9,5
Group 3,RRG,-0.5,11,14,1325,13,2016,13,0
Group 3,RRG,-0.5,11,14,1326,12,2016,7,5
Group 3,RRG,-0.5,11,14,1327,12,2016,7,5
Group 3,RRG,-0.5,11,14,1328,8,2016,8,0
Group 3,RRG,-0.5,11,14,1329,9,2016,11,-2
Group 3,RRG,-0.5,11,14,1330,7,2016,6,1
Group 3,RRG,-0.5,11,14,1331,10,2016,6,4
Group 3,RRG,-0.5,11,14,1332,10,2016,9,1
Group 3,RRG,-0.5,11,14,1333,13,2016,10,3
Group 3,RRG,-0.5,11,14,1334,11,2016,7,4
Group 3,RRG,-0.5,11,14,1335,10,2016,12,-2
Group 3,RRG,-0.5,11,14,1336,9,2016,9,0
Group 3,RRG,-0.5,11,14,1337,6,2016,9,-3
Group 3,RRG,-0.5,11,14,1338,6,2016,10,-4
Group 3,RRG,-0.5,11,14,1339,11,2016,9,2
Group 3,RRG,-0.5,11,14,1340,8,2016,11,-3
Group 3,RRG,-0.5,11,14,1341,4,2016,5,-1
Group 3,RRG,-0.5,11,14,1342,6,2016,5,1
Group 3,RRG,-0.5,11,14,1343,8,2016,9,-1
Group 3,RRG,-0.5,11,14,1344,5,2016,3,2
Group 3,RRG,-0.5,11,14,1345,7,2016,8,-1
Group 3,RRG,-0.5,11,14,1346,9,2016,12,-3
Group 3,RRG,-0.5,11,14,1347,8,2016,10,-2
Group 3,RRG,-0.5,11,14,1348,11,2016,10,1
Group 3,RRG,-0.5,11,14,1349,8,2016,7,1
Group 3,RRG,-0.5,11,14,1350,7,2016,10,-3
Group 3,RRG,-0.5,11,14,1351,10,2016,8,2
Group 3,RRG,-0.5,11,14,1352,9,2016,5,4
Group 3,RRG,-0.5,11,14,1353,7,2016,8,-1
Group 3,RRG,-0.5,11,14,1354,10,2016,5,5
Group 3,RRG,-0.5,11,14,1355,9,2016,8,1
Group 3,RRG,-0.5,11,14,1356,10,2016,12,-2
Group 3,RRG,-0.5,11,14,1357,11,2016,9,2
Group 3,RRG,-0.5,11,14,1358,12,2016,11,1
Group 3,RRG,-0.5,11,14,1359,12,2016,11,1
Group 3,RRG,-0.5,11,14,1360,12,2016,5,7
Group 3,RRG,-0.5,11,14,1361,11,2016,11,0
Group 3,RRG,-0.5,11,14,1362,9,2016,7,2
Group 3,RRG,-0.5,11,14,1363,5,2016,9,-4
Group 3,RRG,-0.5,11,14,1364,10,2016,11,-1
Group 3,RRG,-0.5,11,14,1365,10,2016,9,1
Group 3,RRG,-0.5,11,14,1366,8,2016,9,-1
Group 3,RRG,-0.5,11,14,1367,10,2016,7,3
Group 3,RRG,-0.5,11,14,1368,8,2016,9,-1
Group 3,RRG,-0.5,11,14,1369,5,2016,8,-3
Group 3,RRG,-0.5,11,14,1370,6,2016,8,-2
Group 3,RRG,-0.5,11,14,1371,8,2016,8,0
Group 3,RRG,-0.5,11,14,1372,5,2016,11,-6
Group 3,RRG,-0.5,11,14,1373,6,2016,9,-3
Group 3,RRG,-0.5,11,14,1374,6,2016,9,-3
Group 3,RRG,-0.5,11,14,1375,12,2016,8,4
Group 3,RRG,-0.5,11,14,1376,12,2016,9,3
Group 3,RRG,-0.5,11,14,1377,6,2016,9,-3
Group 3,RRG,-0.5,11,14,1378,9,2016,7,2
Group 3,RRG,-0.5,11,14,1379,11,2016,9,2
Group 3,RRG,-0.5,11,14,1380,10,2016,7,3
Group 3,RRG,-0.5,11,14,1381,10,2016,10,0
Group 3,RRG,-0.5,11,14,1382,9,2016,9,0
Group 3,RRG,-0.5,11,14,1383,7,2016,4,3
Group 3,RRG,-0.5,11,14,1384,5,2016,10,-5
Group 3,RRG,-0.5,11,14,1385,9,2016,11,-2
Group 3,RRG,-0.5,11,14,1386,6,2016,10,-4
Group 3,RRG,-0.5,11,14,1387,7,2016,10,-3
Group 3,RRG,-0.5,11,14,1388,9,2016,7,2
Group 3,RRG,-0.5,11,14,1389,8,2016,8,0
Group 3,RRG,-0.5,11,14,1390,9,2016,7,2
Group 3,RRG,-0.5,11,14,1391,7,2016,9,-2
Group 3,RRG,-0.5,11,14,1392,10,2016,9,1
Group 3,RRG,-0.5,11,14,1393,10,2016,12,-2
Group 3,RRG,-0.5,11,14,1394,10,2016,9,1
Group 3,RRG,-0.5,11,14,1395,9,2016,10,-1
Group 3,RRG,-0.5,11,14,1396,9,2016,7,2
Group 3,RRG,-0.5,11,14,1397,11,2016,5,6
Group 3,RRG,-0.5,11,14,1398,5,2016,7,-2
Group 3,RRG,-0.5,11,14,1399,8,2016,4,4
Group 3,RRG,-0.5,11,14,1400,9,2016,10,-1
Group 3,RRG,-0.5,11,14,1401,7,2016,7,0
Group 3,RRG,-0.5,11,14,1402,5,2016,6,-1
Group 3,RRG,-0.5,11,14,1403,8,2016,11,-3
Group 3,RRG,-0.5,11,14,1404,11,2016,6,5
Group 3,RRG,-0.5,11,14,1405,13,2016,11,2
Group 3,RRG,-0.5,11,14,1406,9,2016,10,-1
Group 3,RRG,-0.5,11,14,1407,9,2016,8,1
Group 3,RRG,-0.5,11,14,1408,10,2016,7,3
Group 3,RRG,-0.5,11,14,1409,9,2016,3,6
Group 3,RRG,-0.5,11,14,1410,11,2016,9,2
Group 3,RRG,-0.5,11,14,1411,9,2016,10,-1
Group 3,RRG,-0.5,11,14,1412,8,2016,10,-2
Group 3,RRG,-0.5,11,14,1413,8,2016,12,-4
Group 3,RRG,-0.5,11,14,1414,12,2016,8,4
Group 3,RRG,-0.5,11,14,1415,6,2016,6,0
Group 3,RRG,-0.5,11,14,1416,11,2016,10,1
Group 3,RRG,-0.5,11,14,1417,9,2016,8,1
Group 3,RRG,-0.5,11,14,1418,4,2016,10,-6
Group 3,RRG,-0.5,11,14,1419,6,2016,2,4
Group 3,RRG,-0.5,11,14,1420,10,2016,10,0
Group 3,RRG,-0.5,11,14,1421,2,2016,7,-5
Group 3,RRG,-0.5,11,14,1422,10,2016,8,2
Group 3,RRG,-0.5,11,14,1423,6,2016,3,3
Group 3,RRG,-0.5,11,14,1424,12,2016,9,3
Group 3,RRG,-0.5,11,14,1425,9,2016,7,2
Group 3,RRG,-0.5,11,14,1426,10,2016,12,-2
Group 3,RRG,-0.5,11,14,1427,6,2016,8,-2
Group 3,RRG,-0.5,11,14,1428,10,2016,9,1
Group 3,RRG,-0.5,11,14,1429,11,2016,10,1
Group 3,RRG,-0.5,11,14,1430,7,2016,10,-3
Group 3,RRG,-0.5,11,14,1431,9,2016,9,0
Group 3,RRG,-0.5,11,14,1432,9,2016,8,1
Group 3,RRG,-0.5,11,14,1433,10,2016,12,-2
Group 3,RRG,-0.5,11,14,1434,9,2016,8,1
Group 3,RRG,-0.5,11,14,1435,8,2016,6,2
Group 3,RRG,-0.5,11,14,1436,9,2016,6,3
Group 3,RRG,-0.5,11,14,1437,7,2016,7,0
Group 3,RRG,-0.5,11,14,1438,7,2016,5,2
Group 3,RRG,-0.5,11,14,1439,1,2016,5,-4
Group 3,RRG,-0.5,11,14,1440,10,2016,13,-3
Group 3,RRG,-0.5,11,14,1441,13,2016,12,1
Group 3,RRG,-0.5,11,14,1442,11,2016,9,2
Group 3,RRG,-0.5,11,14,1443,11,2016,8,3
Group 3,RRG,-0.5,11,14,1444,7,2016,6,1
Group 3,RRG,-0.5,11,14,1445,5,2016,6,-1
Group 3,RRG,-0.5,11,14,1446,10,2016,9,1
Group 3,RRG,-0.5,11,14,1447,9,2016,8,1
Group 3,RRG,-0.5,11,14,1448,10,2016,11,-1
Group 3,RRG,-0.5,11,14,1449,10,2016,7,3
Group 3,RRG,-0.5,11,14,1450,6,2016,11,-5
Group 3,RRG,-0.5,11,14,1451,5,2016,9,-4
Group 3,RRG,-0.5,11,14,1452,6,2016,7,-1
Group 3,RRG,-0.5,11,14,1453,3,2016,9,-6
Group 3,RRG,-0.5,11,14,1454,8,2016,3,5
Group 3,RRG,-0.5,11,14,1455,6,2016,9,-3
Group 3,RRG,-0.5,11,14,1456,11,2016,4,7
Group 3,RRG,-0.5,11,14,1457,11,2016,13,-2
Group 3,RRG,-0.5,11,14,1458,12,2016,12,0
Group 3,RRG,-0.5,11,14,1459,4,2016,10,-6
Group 3,RRG,-0.5,11,14,1460,7,2016,2,5
Group 3,RRG,-0.5,11,14,1461,10,2016,11,-1
Group 3,RRG,-0.5,11,14,1462,13,2016,10,3
Group 3,RRG,-0.5,11,14,1463,12,2016,7,5
Group 3,RRG,-0.5,11,14,1464,8,2016,7,1
Group 3,RRG,-0.5,11,14,1465,3,2016,9,-6
Group 3,RRG,-0.5,11,14,1466,4,2016,11,-7
Group 3,RRG,-0.5,11,14,1467,9,2016,6,3
Group 3,RRG,-0.5,11,14,1468,11,2016,8,3
Group 3,RRG,-0.5,11,14,1469,9,2016,8,1
Group 3,RRG,-0.5,11,14,1470,10,2016,8,2
Group 3,RRG,-0.5,11,14,1471,13,2016,9,4
Group 3,RRG,-0.5,11,14,1472,11,2016,10,1
Group 3,RRG,-0.5,11,14,1473,10,2016,6,4
Group 3,RRG,-0.5,11,14,1474,11,2016,8,3
Group 3,RRG,-0.5,11,14,1475,9,2016,7,2
Group 3,RRG,-0.5,11,14,1476,9,2016,9,0
Group 3,RRG,-0.5,11,14,1477,9,2016,10,-1
Group 3,RRG,-0.5,11,14,1478,9,2016,9,0
Group 3,RRG,-0.5,11,14,1479,7,2016,10,-3
Group 3,RRG,-0.5,11,14,1480,6,2016,7,-1
Group 3,RRG,-0.5,11,14,1481,9,2016,9,0
Group 3,RRG,-0.5,11,14,1482,9,2016,8,1
Group 3,RRG,-0.5,11,14,1483,12,2016,6,6
Group 3,RRG,-0.5,11,14,1484,13,2016,7,6
Group 3,RRG,-0.5,11,14,1485,12,2016,10,2
Group 3,RRG,-0.5,11,14,1486,14,2016,11,3
Group 3,RRG,-0.5,11,14,1487,12,2016,11,1
Group 3,RRG,-0.5,11,14,1488,4,2016,7,-3
Group 3,RRG,-0.5,11,14,1489,12,2016,12,0
Group 3,RRG,-0.5,11,14,1490,14,2016,10,4
Group 3,RRG,-0.5,11,14,1491,9,2016,4,5
Group 3,RRG,-0.5,11,14,1492,9,2016,12,-3
Group 3,RRG,-0.5,11,14,1493,6,2016,5,1
Group 3,RRG,-0.5,11,14,1494,8,2016,7,1
Group 3,RRG,-0.5,11,14,1495,7,2016,3,4
Group 3,RRG,-0.5,11,14,1496,10,2016,12,-2
Group 3,RRG,-0.5,11,14,1497,12,2016,10,2
Group 3,RRG,-0.5,11,14,1498,8,2016,9,-1
Group 3,RRG,-0.5,11,14,1499,6,2016,8,-2
Group 3,RRG,-0.5,11,14,1500,7,2016,9,-2
Group 3,RRG,-0.5,11,14,1501,6,2016,9,-3
Group 3,RRG,-0.5,11,14,1502,7,2016,3,4
Group 3,RRG,-0.5,11,14,1503,5,2016,9,-4
Group 3,RRG,-0.5,11,14,1504,8,2016,5,3
Group 3,RRG,-0.5,11,14,1505,9,2016,8,1
Group 3,RRG,-0.5,11,14,1506,13,2016,9,4
Group 3,RRG,-0.5,11,14,1507,4,2016,8,-4
Group 3,RRG,-0.5,11,14,1508,10,2016,8,2
Group 3,RRG,-0.5,11,14,1509,11,2016,7,4
Group 3,RRG,-0.5,11,14,1510,5,2016,12,-7
Group 3,RRG,-0.5,11,14,1511,7,2016,11,-4
Group 3,RRG,-0.5,11,14,1512,6,2016,8,-2
Group 3,RRG,-0.5,11,14,1513,6,2016,9,-3
Group 3,RRG,-0.5,11,14,1514,7,2016,5,2
Group 3,RRG,-0.5,11,14,1515,9,2016,9,0
Group 3,RRG,-0.5,11,14,1516,4,2016,7,-3
Group 3,RRG,-0.5,11,14,1517,9,2016,8,1
Group 3,RRG,-0.5,11,14,1518,7,2016,4,3
Group 3,RRG,-0.5,11,14,1519,8,2016,9,-1
Group 3,RRG,-0.5,11,14,1520,8,2016,3,5
Group 3,RRG,-0.5,11,14,1521,9,2016,7,2
Group 3,RRG,-0.5,11,14,1522,9,2016,6,3
Group 3,RRG,-0.5,11,14,1523,10,2016,6,4
Group 3,RRG,-0.5,11,14,1524,5,2016,10,-5
Group 3,RRG,-0.5,11,14,1525,9,2016,13,-4
Group 3,RRG,-0.5,11,14,1526,7,2016,9,-2
Group 3,RRG,-0.5,11,14,1527,9,2016,12,-3
Group 3,RRG,-0.5,11,14,1528,9,2016,8,1
Group 3,RRG,-0.5,11,14,1529,8,2016,8,0
Group 3,RRG,-0.5,11,14,1530,11,2016,10,1
Group 3,RRG,-0.5,11,14,1531,11,2016,7,4
Group 3,RRG,-0.5,11,14,1532,8,2016,8,0
Group 3,RRG,-0.5,11,14,1533,12,2016,11,1
Group 3,RRG,-0.5,11,14,1534,6,2016,7,-1
Group 3,RRG,-0.5,11,14,1535,7,2016,5,2
Group 3,RRG,-0.5,11,14,1536,11,2016,8,3
Group 3,RRG,-0.5,11,14,1537,6,2016,7,-1
Group 3,RRG,-0.5,11,14,1538,13,2016,9,4
Group 3,RRG,-0.5,11,14,1539,13,2016,11,2
Group 3,RRG,-0.5,11,14,1540,10,2016,6,4
Group 3,RRG,-0.5,11,14,1541,8,2016,9,-1
Group 3,RRG,-0.5,11,14,1542,10,2016,8,2
Group 3,RRG,-0.5,11,14,1543,11,2016,7,4
Group 3,RRG,-0.5,11,14,1544,9,2016,10,-1
Group 3,RRG,-0.5,11,14,1545,5,2016,5,0
Group 3,RRG,-0.5,11,14,1546,8,2016,4,4
Group 3,RRG,-0.5,11,14,1547,10,2016,10,0
Group 3,RRG,-0.5,11,14,1548,7,2016,12,-5
Group 3,RRG,-0.5,11,14,1549,11,2016,10,1
Group 3,RRG,-0.5,11,14,1550,7,2016,6,1
Group 3,RRG,-0.5,11,14,1551,3,2016,9,-6
Group 3,RRG,-0.5,11,14,1552,13,2016,10,3
Group 3,RRG,-0.5,11,14,1553,10,2016,6,4
Group 3,RRG,-0.5,11,14,1554,4,2016,4,0
Group 3,RRG,-0.5,11,14,1555,6,2016,6,0
Group 3,RRG,-0.5,11,14,1556,10,2016,5,5
Group 3,RRG,-0.5,11,14,1557,8,2016,12,-4
Group 3,RRG,-0.5,11,14,1558,9,2016,14,-5
Group 3,RRG,-0.5,11,14,1559,10,2016,7,3
Group 3,RRG,-0.5,11,14,1560,10,2016,11,-1
Group 3,RRG,-0.5,11,14,1561,12,2016,8,4
Group 3,RRG,-0.5,11,14,1562,5,2016,7,-2
Group 3,RRG,-0.5,11,14,1563,13,2016,8,5
Group 3,RRG,-0.5,11,14,1564,11,2016,11,0
Group 3,RRG,-0.5,11,14,1565,9,2016,7,2
Group 3,RRG,-0.5,11,14,1566,7,2016,7,0
Group 3,RRG,-0.5,11,14,1567,8,2016,8,0
Group 3,RRG,-0.5,11,14,1568,8,2016,6,2
Group 3,RRG,-0.5,11,14,1569,13,2016,10,3
Group 3,RRG,-0.5,11,14,1570,9,2016,4,5
Group 3,RRG,-0.5,11,14,1571,10,2016,10,0
Group 3,RRG,-0.5,11,14,1572,5,2016,9,-4
Group 3,RRG,-0.5,11,14,1573,9,2016,14,-5
Group 3,RRG,-0.5,11,14,1574,7,2016,5,2
Group 3,RRG,-0.5,11,14,1575,11,2016,10,1
Group 3,RRG,-0.5,11,14,1576,1,2016,9,-8
Group 3,RRG,-0.5,11,14,1577,5,2016,3,2
Group 3,RRG,-0.5,11,14,1578,13,2016,10,3
Group 3,RRG,-0.5,11,14,1579,5,2016,8,-3
Group 3,RRG,-0.5,11,14,1580,13,2016,11,2
Group 3,RRG,-0.5,11,14,1581,12,2016,12,0
Group 3,RRG,-0.5,11,14,1582,8,2016,6,2
Group 3,RRG,-0.5,11,14,1583,9,2016,9,0
Group 3,RRG,-0.5,11,14,1584,7,2016,5,2
Group 3,RRG,-0.5,11,14,1585,7,2016,13,-6
Group 3,RRG,-0.5,11,14,1586,14,2016,8,6
Group 3,RRG,-0.5,11,14,1587,13,2016,13,0
Group 3,RRG,-0.5,11,14,1588,8,2016,10,-2
Group 3,RRG,-0.5,11,14,1589,7,2016,2,5
Group 3,RRG,-0.5,11,14,1590,10,2016,7,3
Group 3,RRG,-0.5,11,14,1591,8,2016,9,-1
Group 3,RRG,-0.5,11,14,1592,9,2016,10,-1
Group 3,RRG,-0.5,11,14,1593,12,2016,6,6
Group 3,RRG,-0.5,11,14,1594,7,2016,8,-1
Group 3,RRG,-0.5,11,14,1595,7,2016,7,0
Group 3,RRG,-0.5,11,14,1596,9,2016,7,2
Group 3,RRG,-0.5,11,14,1597,9,2016,10,-1
Group 3,RRG,-0.5,11,14,1598,10,2016,5,5
Group 3,RRG,-0.5,11,14,1599,8,2016,11,-3
Group 3,RRG,-0.5,11,14,1600,12,2016,9,3
Group 3,RRG,-0.5,11,14,1601,10,2016,8,2
Group 3,RRG,-0.5,11,14,1602,12,2016,8,4
Group 3,RRG,-0.5,11,14,1603,9,2016,6,3
Group 3,RRG,-0.5,11,14,1604,9,2016,5,4
Group 3,RRG,-0.5,11,14,1605,4,2016,8,-4
Group 3,RRG,-0.5,11,14,1606,4,2016,9,-5
Group 3,RRG,-0.5,11,14,1607,10,2016,8,2
Group 3,RRG,-0.5,11,14,1608,13,2016,9,4
Group 3,RRG,-0.5,11,14,1609,8,2016,11,-3
Group 3,RRG,-0.5,11,14,1610,8,2016,9,-1
Group 3,RRG,-0.5,11,14,1611,4,2016,9,-5
Group 3,RRG,-0.5,11,14,1612,5,2016,4,1
Group 3,RRG,-0.5,11,14,1613,8,2016,9,-1
Group 3,RRG,-0.5,11,14,1614,9,2016,10,-1
Group 3,RRG,-0.5,11,14,1615,7,2016,10,-3
Group 3,RRG,-0.5,11,14,1616,11,2016,10,1
Group 3,RRG,-0.5,11,14,1617,3,2016,10,-7
Group 3,RRG,-0.5,11,14,1618,5,2016,8,-3
Group 3,RRG,-0.5,11,14,1619,6,2016,3,3
Group 3,RRG,-0.5,11,14,1620,12,2016,9,3
Group 3,RRG,-0.5,11,14,1621,13,2016,9,4
Group 3,RRG,-0.5,11,14,1622,12,2016,10,2
Group 3,RRG,-0.5,11,14,1623,11,2016,5,6
Group 3,RRG,-0.5,11,14,1624,7,2016,9,-2
Group 3,RRG,-0.5,11,14,1625,2,2016,7,-5
Group 3,RRG,-0.5,11,14,1626,12,2016,11,1
Group 3,RRG,-0.5,11,14,1627,11,2016,12,-1
Group 3,RRG,-0.5,11,14,1628,5,2016,9,-4
Group 3,RRG,-0.5,11,14,1629,10,2016,5,5
Group 3,RRG,-0.5,11,14,1630,10,2016,8,2
Group 3,RRG,-0.5,11,14,1631,8,2016,6,2
Group 3,RRG,-0.5,11,14,1632,6,2016,6,0
Group 3,RRG,-0.5,11,14,1633,7,2016,9,-2
Group 3,RRG,-0.5,11,14,1634,2,2016,7,-5
Group 3,RRG,-0.5,11,14,1635,3,2016,6,-3
Group 3,RRG,-0.5,11,14,1636,10,2016,11,-1
Group 3,RRG,-0.5,11,14,1637,7,2016,7,0
Group 3,RRG,-0.5,11,14,1638,9,2016,9,0
Group 3,RRG,-0.5,11,14,1639,6,2016,1,5
Group 3,RRG,-0.5,11,14,1640,9,2016,8,1
Group 3,RRG,-0.5,11,14,1641,11,2016,9,2
Group 3,RRG,-0.5,11,14,1642,9,2016,10,-1
Group 3,RRG,-0.5,11,14,1643,13,2016,8,5
Group 3,RRG,-0.5,11,14,1644,6,2016,6,0
Group 3,RRG,-0.5,11,14,1645,7,2016,10,-3
Group 3,RRG,-0.5,11,14,1646,6,2016,5,1
Group 3,RRG,-0.5,11,14,1647,8,2016,4,4
Group 3,RRG,-0.5,11,14,1648,11,2016,6,5
Group 3,RRG,-0.5,11,14,1649,13,2016,13,0
Group 3,RRG,-0.5,11,14,1650,3,2016,7,-4
Group 3,RRG,-0.5,11,14,1651,7,2016,9,-2
Group 3,RRG,-0.5,11,14,1652,9,2016,6,3
Group 3,RRG,-0.5,11,14,1653,6,2016,5,1
Group 3,RRG,-0.5,11,14,1654,10,2016,7,3
Group 3,RRG,-0.5,11,14,1655,10,2016,8,2
Group 3,RRG,-0.5,11,14,1656,9,2016,10,-1
Group 3,RRG,-0.5,11,14,1657,8,2016,5,3
Group 3,RRG,-0.5,11,14,1658,6,2016,6,0
Group 3,RRG,-0.5,11,14,1659,5,2016,5,0
Group 3,RRG,-0.5,11,14,1660,2,2016,4,-2
Group 3,RRG,-0.5,11,14,1661,5,2016,6,-1
Group 3,RRG,-0.5,11,14,1662,7,2016,6,1
Group 3,RRG,-0.5,11,14,1663,9,2016,10,-1
Group 3,RRG,-0.5,11,14,1664,8,2016,8,0
Group 3,RRG,-0.5,11,14,1665,10,2016,7,3
Group 3,RRG,-0.5,11,14,1666,9,2016,10,-1
Group 3,RRG,-0.5,11,14,1667,11,2016,11,0
Group 3,RRG,-0.5,11,14,1668,4,2016,8,-4
Group 3,RRG,-0.5,11,14,1669,8,2016,9,-1
Group 3,RRG,-0.5,11,14,1670,9,2016,7,2
Group 3,RRG,-0.5,11,14,1671,11,2016,9,2
Group 3,RRG,-0.5,11,14,1672,11,2016,13,-2
Group 3,RRG,-0.5,11,14,1673,11,2016,10,1
Group 3,RRG,-0.5,11,14,1674,8,2016,10,-2
Group 3,RRG,-0.5,11,14,1675,9,2016,10,-1
Group 3,RRG,-0.5,11,14,1676,8,2016,7,1
Group 3,RRG,-0.5,11,14,1677,10,2016,9,1
Group 3,RRG,-0.5,11,14,1678,12,2016,8,4
Group 3,RRG,-0.5,11,14,1679,10,2016,12,-2
Group 3,RRG,-0.5,11,14,1680,9,2016,8,1
Group 3,RRG,-0.5,11,14,1681,7,2016,8,-1
Group 3,RRG,-0.5,11,14,1682,8,2016,8,0
Group 3,RRG,-0.5,11,14,1683,10,2016,9,1
Group 3,RRG,-0.5,11,14,1684,10,2016,8,2
Group 3,RRG,-0.5,11,14,1685,9,2016,10,-1
Group 3,RRG,-0.5,11,14,1686,9,2016,4,5
Group 3,RRG,-0.5,11,14,1687,7,2016,7,0
Group 3,RRG,-0.5,11,14,1688,8,2016,8,0
Group 3,RRG,-0.5,11,14,1689,9,2016,7,2
Group 3,RRG,-0.5,11,14,1690,7,2016,8,-1
Group 3,RRG,-0.5,11,14,1691,9,2016,6,3
Group 3,RRG,-0.5,11,14,1692,10,2016,7,3
Group 3,RRG,-0.5,11,14,1693,7,2016,7,0
Group 3,RRG,-0.5,11,14,1694,8,2016,6,2
Group 3,RRG,-0.5,11,14,1695,7,2016,8,-1
Group 3,RRG,-0.5,11,14,1696,10,2016,9,1
Group 3,RRG,-0.5,11,14,1697,3,2016,9,-6
Group 3,RRG,-0.5,11,14,1698,7,2016,2,5
Group 3,RRG,-0.5,11,14,1699,11,2016,4,7
Group 3,RRG,-0.5,11,14,1700,10,2016,7,3
Group 3,RRG,-0.5,11,14,1701,11,2016,6,5
Group 3,RRG,-0.5,11,14,1702,9,2016,8,1
Group 3,RRG,-0.5,11,14,1703,9,2016,6,3
Group 3,RRG,-0.5,11,14,1704,10,2016,8,2
Group 3,RRG,-0.5,11,14,1705,6,2016,12,-6
Group 3,RRG,-0.5,11,14,1706,12,2016,10,2
Group 3,RRG,-0.5,11,14,1707,8,2016,4,4
Group 3,RRG,-0.5,11,14,1708,5,2016,5,0
Group 3,RRG,-0.5,11,14,1709,5,2016,2,3
Group 3,RRG,-0.5,11,14,1710,4,2016,3,1
Group 3,RRG,-0.5,11,14,1711,5,2016,3,2
Group 3,RRG,-0.5,11,14,1712,11,2016,12,-1
Group 3,RRG,-0.5,11,14,1713,10,2016,13,-3
Group 3,RRG,-0.5,11,14,1714,6,2016,8,-2
Group 3,RRG,-0.5,11,14,1715,7,2016,9,-2
Group 3,RRG,-0.5,11,14,1716,9,2016,10,-1
Group 3,RRG,-0.5,11,14,1717,10,2016,8,2
Group 3,RRG,-0.5,11,14,1718,13,2016,6,7
Group 3,RRG,-0.5,11,14,1719,10,2016,11,-1
Group 3,RRG,-0.5,11,14,1720,9,2016,6,3
Group 3,RRG,-0.5,11,14,1721,10,2016,7,3
Group 3,RRG,-0.5,11,14,1722,7,2016,10,-3
Group 3,RRG,-0.5,11,14,1723,11,2016,11,0
Group 3,RRG,-0.5,11,14,1724,11,2016,5,6
Group 3,RRG,-0.5,11,14,1725,12,2016,12,0
Group 3,RRG,-0.5,11,14,1726,9,2016,5,4
Group 3,RRG,-0.5,11,14,1727,9,2016,8,1
Group 3,RRG,-0.5,11,14,1728,8,2016,9,-1
Group 3,RRG,-0.5,11,14,1729,8,2016,5,3
Group 3,RRG,-0.5,11,14,1730,13,2016,10,3
Group 3,RRG,-0.5,11,14,1731,11,2016,7,4
Group 3,RRG,-0.5,11,14,1732,6,2016,11,-5
Group 3,RRG,-0.5,11,14,1733,10,2016,9,1
Group 3,RRG,-0.5,11,14,1734,9,2016,11,-2
Group 3,RRG,-0.5,11,14,1735,3,2016,7,-4
Group 3,RRG,-0.5,11,14,1736,6,2016,5,1
Group 3,RRG,-0.5,11,14,1737,10,2016,11,-1
Group 3,RRG,-0.5,11,14,1738,12,2016,13,-1
Group 3,RRG,-0.5,11,14,1739,11,2016,9,2
Group 3,RRG,-0.5,11,14,1740,9,2016,12,-3
Group 3,RRG,-0.5,11,14,1741,12,2016,11,1
Group 3,RRG,-0.5,11,14,1742,10,2016,10,0
Group 3,RRG,-0.5,11,14,1743,10,2016,10,0
Group 3,RRG,-0.5,11,14,1744,11,2016,8,3
Group 3,RRG,-0.5,11,14,1745,7,2016,5,2
Group 3,RRG,-0.5,11,14,1746,8,2016,9,-1
Group 3,RRG,-0.5,11,14,1747,12,2016,7,5
Group 3,RRG,-0.5,11,14,1748,8,2016,5,3
Group 3,RRG,-0.5,11,14,1749,10,2016,12,-2
Group 3,RRG,-0.5,11,14,1750,10,2016,7,3
Group 3,RRG,-0.5,11,14,1751,3,2016,7,-4
Group 3,RRG,-0.5,11,14,1752,2,2016,5,-3
Group 3,RRG,-0.5,11,14,1753,5,2016,5,0
Group 3,RRG,-0.5,11,14,1754,8,2016,11,-3
Group 3,RRG,-0.5,11,14,1755,7,2016,10,-3
Group 3,RRG,-0.5,11,14,1756,7,2016,6,1
Group 3,RRG,-0.5,11,14,1757,10,2016,10,0
Group 3,RRG,-0.5,11,14,1758,10,2016,5,5
Group 3,RRG,-0.5,11,14,1759,9,2016,7,2
Group 3,RRG,-0.5,11,14,1760,7,2016,9,-2
Group 3,RRG,-0.5,11,14,1761,12,2016,8,4
Group 3,RRG,-0.5,11,14,1762,13,2016,11,2
Group 3,RRG,-0.5,11,14,1763,11,2016,7,4
Group 3,RRG,-0.5,11,14,1764,11,2016,10,1
Group 3,RRG,-0.5,11,14,1765,6,2016,13,-7
Group 3,RRG,-0.5,11,14,1766,4,2016,11,-7
Group 3,RRG,-0.5,11,14,1767,9,2016,7,2
Group 3,RRG,-0.5,11,14,1768,4,2016,9,-5
Group 3,RRG,-0.5,11,14,1769,12,2016,9,3
Group 3,RRG,-0.5,11,14,1770,9,2016,9,0
Group 3,RRG,-0.5,11,14,1771,6,2016,9,-3
Group 3,RRG,-0.5,11,14,1772,6,2016,7,-1
Group 3,RRG,-0.5,11,14,1773,9,2016,6,3
Group 3,RRG,-0.5,11,14,1774,9,2016,7,2
Group 3,RRG,-0.5,11,14,1775,10,2016,6,4
Group 3,RRG,-0.5,11,14,1776,6,2016,10,-4
Group 3,RRG,-0.5,11,14,1777,6,2016,8,-2
Group 3,RRG,-0.5,11,14,1778,7,2016,6,1
Group 3,RRG,-0.5,11,14,1779,7,2016,11,-4
Group 3,RRG,-0.5,11,14,1780,10,2016,10,0
Group 3,RRG,-0.5,11,14,1781,7,2016,4,3
Group 3,RRG,-0.5,11,14,1782,9,2016,8,1
Group 3,RRG,-0.5,11,14,1783,8,2016,8,0
Group 3,RRG,-0.5,11,14,1784,7,2016,5,2
Group 3,RRG,-0.5,11,14,1785,8,2016,9,-1
Group 3,RRG,-0.5,11,14,1786,12,2016,12,0
Group 3,RRG,-0.5,11,14,1787,9,2016,11,-2
Group 3,RRG,-0.5,11,14,1788,7,2016,8,-1
Group 3,RRG,-0.5,11,14,1789,4,2016,11,-7
Group 3,RRG,-0.5,11,14,1790,11,2016,6,5
Group 3,RRG,-0.5,11,14,1791,8,2016,10,-2
Group 3,RRG,-0.5,11,14,1792,11,2016,11,0
Group 3,RRG,-0.5,11,14,1793,11,2016,10,1
Group 3,RRG,-0.5,11,14,1794,10,2016,5,5
Group 3,RRG,-0.5,11,14,1795,10,2016,11,-1
Group 3,RRG,-0.5,11,14,1796,11,2016,10,1
Group 3,RRG,-0.5,11,14,1797,14,2016,14,0
Group 3,RRG,-0.5,11,14,1798,11,2016,7,4
Group 3,RRG,-0.5,11,14,1799,11,2016,13,-2
Group 3,RRG,-0.5,11,14,1800,8,2016,8,0
Group 3,RRG,-0.5,11,14,1801,7,2016,11,-4
Group 3,RRG,-0.5,11,14,1802,6,2016,6,0
Group 3,RRG,-0.5,11,14,1803,7,2016,5,2
Group 3,RRG,-0.5,11,14,1804,7,2016,8,-1
Group 3,RRG,-0.5,11,14,1805,10,2016,11,-1
Group 3,RRG,-0.5,11,14,1806,8,2016,9,-1
Group 3,RRG,-0.5,11,14,1807,9,2016,9,0
Group 3,RRG,-0.5,11,14,1808,13,2016,9,4
Group 3,RRG,-0.5,11,14,1809,9,2016,10,-1
Group 3,RRG,-0.5,11,14,1810,10,2016,7,3
Group 3,RRG,-0.5,11,14,1811,10,2016,7,3
Group 3,RRG,-0.5,11,14,1812,6,2016,13,-7
Group 3,RRG,-0.5,11,14,1813,5,2016,6,-1
Group 3,RRG,-0.5,11,14,1814,7,2016,8,-1
Group 3,RRG,-0.5,11,14,1815,10,2016,9,1
Group 3,RRG,-0.5,11,14,1816,11,2016,10,1
Group 3,RRG,-0.5,11,14,1817,10,2016,11,-1
Group 3,RRG,-0.5,11,14,1818,8,2016,10,-2
Group 3,RRG,-0.5,11,14,1819,12,2016,13,-1
Group 3,RRG,-0.5,11,14,1820,10,2016,11,-1
Group 3,RRG,-0.5,11,14,1821,10,2016,9,1
Group 3,RRG,-0.5,11,14,1822,10,2016,8,2
Group 3,RRG,-0.5,11,14,1823,10,2016,10,0
Group 3,RRG,-0.5,11,14,1824,8,2016,9,-1
Group 3,RRG,-0.5,11,14,1825,8,2016,7,1
Group 3,RRG,-0.5,11,14,1826,5,2016,9,-4
Group 3,RRG,-0.5,11,14,1827,9,2016,10,-1
Group 3,RRG,-0.5,11,14,1828,5,2016,4,1
Group 3,RRG,-0.5,11,14,1829,7,2016,8,-1
Group 3,RRG,-0.5,11,14,1830,8,2016,9,-1
Group 3,RRG,-0.5,11,14,1831,5,2016,7,-2
Group 3,RRG,-0.5,11,14,1832,8,2016,9,-1
Group 3,RRG,-0.5,11,14,1833,11,2016,8,3
Group 3,RRG,-0.5,11,14,1834,4,2016,10,-6
Group 3,RRG,-0.5,11,14,1835,14,2016,13,1
Group 3,RRG,-0.5,11,14,1836,8,2016,7,1
Group 3,RRG,-0.5,11,14,1837,8,2016,6,2
Group 3,RRG,-0.5,11,14,1838,6,2016,7,-1
Group 3,RRG,-0.5,11,14,1839,13,2016,7,6
Group 3,RRG,-0.5,11,14,1840,11,2016,7,4
Group 3,RRG,-0.5,11,14,1841,9,2016,11,-2
Group 3,RRG,-0.5,11,14,1842,10,2016,9,1
Group 3,RRG,-0.5,11,14,1843,11,2016,7,4
Group 3,RRG,-0.5,11,14,1844,7,2016,10,-3
Group 3,RRG,-0.5,11,14,1845,2,2016,5,-3
Group 3,RRG,-0.5,11,14,1846,3,2016,6,-3
Group 3,RRG,-0.5,11,14,1847,14,2016,10,4
Group 3,RRG,-0.5,11,14,1848,13,2016,11,2
Group 3,RRG,-0.5,11,14,1849,12,2016,7,5
Group 3,RRG,-0.5,11,14,1850,9,2016,8,1
Group 3,RRG,-0.5,11,14,1851,7,2016,7,0
Group 3,RRG,-0.5,11,14,1852,10,2016,11,-1
Group 3,RRG,-0.5,11,14,1853,7,2016,8,-1
Group 3,RRG,-0.5,11,14,1854,9,2016,11,-2
Group 3,RRG,-0.5,11,14,1855,10,2016,12,-2
Group 3,RRG,-0.5,11,14,1856,10,2016,9,1
Group 3,RRG,-0.5,11,14,1857,12,2016,10,2
Group 3,RRG,-0.5,11,14,1858,11,2016,8,3
Group 3,RRG,-0.5,11,14,1859,10,2016,10,0
Group 3,RRG,-0.5,11,14,1860,5,2016,8,-3
Group 3,RRG,-0.5,11,14,1861,3,2016,9,-6
Group 3,RRG,-0.5,11,14,1862,10,2016,10,0
Group 3,RRG,-0.5,11,14,1863,8,2016,6,2
Group 3,RRG,-0.5,11,14,1864,8,2016,9,-1
Group 3,RRG,-0.5,11,14,1865,9,2016,9,0
Group 3,RRG,-0.5,11,14,1866,10,2016,9,1
Group 3,RRG,-0.5,11,14,1867,8,2016,12,-4
Group 3,RRG,-0.5,11,14,1868,5,2016,8,-3
Group 3,RRG,-0.5,11,14,1869,7,2016,5,2
Group 3,RRG,-0.5,11,14,1870,4,2016,4,0
Group 3,RRG,-0.5,11,14,1871,12,2016,11,1
Group 3,RRG,-0.5,11,14,1872,10,2016,8,2
Group 3,RRG,-0.5,11,14,1873,12,2016,7,5
Group 3,RRG,-0.5,11,14,1874,4,2016,12,-8
Group 3,RRG,-0.5,11,14,1875,7,2016,5,2
Group 3,RRG,-0.5,11,14,1876,6,2016,6,0
Group 3,RRG,-0.5,11,14,1877,7,2016,5,2
Group 3,RRG,-0.5,11,14,1878,7,2016,9,-2
Group 3,RRG,-0.5,11,14,1879,8,2016,9,-1
Group 3,RRG,-0.5,11,14,1880,11,2016,10,1
Group 3,RRG,-0.5,11,14,1881,5,2016,10,-5
Group 3,RRG,-0.5,11,14,1882,4,2016,5,-1
Group 3,RRG,-0.5,11,14,1883,7,2016,8,-1
Group 3,RRG,-0.5,11,14,1884,1,2016,4,-3
Group 3,RRG,-0.5,11,14,1885,11,2016,4,7
Group 3,RRG,-0.5,11,14,1886,9,2016,9,0
Group 3,RRG,-0.5,11,14,1887,12,2016,9,3
Group 3,RRG,-0.5,11,14,1888,7,2016,10,-3
Group 3,RRG,-0.5,11,14,1889,8,2016,8,0
Group 3,RRG,-0.5,11,14,1890,9,2016,5,4
Group 3,RRG,-0.5,11,14,1891,11,2016,6,5
Group 3,RRG,-0.5,11,14,1892,7,2016,10,-3
Group 3,RRG,-0.5,11,14,1893,9,2016,4,5
Group 3,RRG,-0.5,11,14,1894,10,2016,9,1
Group 3,RRG,-0.5,11,14,1895,7,2016,11,-4
Group 3,RRG,-0.5,11,14,1896,10,2016,7,3
Group 3,RRG,-0.5,11,14,1897,10,2016,9,1
Group 3,RRG,-0.5,11,14,1898,11,2016,8,3
Group 3,RRG,-0.5,11,14,1899,11,2016,7,4
Group 3,RRG,-0.5,11,14,1900,11,2016,9,2
Group 3,RRG,-0.5,11,14,1901,8,2016,7,1
Group 3,RRG,-0.5,11,14,1902,8,2016,9,-1
Group 3,RRG,-0.5,11,14,1903,8,2016,9,-1
Group 3,RRG,-0.5,11,14,1904,7,2016,4,3
Group 3,RRG,-0.5,11,14,1905,6,2016,7,-1
Group 3,RRG,-0.5,11,14,1906,6,2016,6,0
Group 3,RRG,-0.5,11,14,1907,9,2016,8,1
Group 3,RRG,-0.5,11,14,1908,4,2016,7,-3
Group 3,RRG,-0.5,11,14,1909,10,2016,5,5
Group 3,RRG,-0.5,11,14,1910,12,2016,12,0
Group 3,RRG,-0.5,11,14,1911,7,2016,12,-5
Group 3,RRG,-0.5,11,14,1912,11,2016,9,2
Group 3,RRG,-0.5,11,14,1913,8,2016,8,0
Group 3,RRG,-0.5,11,14,1914,11,2016,12,-1
Group 3,RRG,-0.5,11,14,1915,9,2016,12,-3
Group 3,RRG,-0.5,11,14,1916,5,2016,11,-6
Group 3,RRG,-0.5,11,14,1917,6,2016,6,0
Group 3,RRG,-0.5,11,14,1918,3,2016,6,-3
Group 3,RRG,-0.5,11,14,1919,8,2016,7,1
Group 3,RRG,-0.5,11,14,1920,11,2016,9,2
Group 3,RRG,-0.5,11,14,1921,10,2016,3,7
Group 3,RRG,-0.5,11,14,1922,10,2016,12,-2
Group 3,RRG,-0.5,11,14,1923,8,2016,6,2
Group 3,RRG,-0.5,11,14,1924,9,2016,12,-3
Group 3,RRG,-0.5,11,14,1925,7,2016,9,-2
Group 3,RRG,-0.5,11,14,1926,11,2016,9,2
Group 3,RRG,-0.5,11,14,1927,7,2016,9,-2
Group 3,RRG,-0.5,11,14,1928,8,2016,6,2
Group 3,RRG,-0.5,11,14,1929,9,2016,5,4
Group 3,RRG,-0.5,11,14,1930,4,2016,5,-1
Group 3,RRG,-0.5,11,14,1931,4,2016,8,-4
Group 3,RRG,-0.5,11,14,1932,9,2016,11,-2
Group 3,RRG,-0.5,11,14,1933,11,2016,13,-2
Group 3,RRG,-0.5,11,14,1934,12,2016,11,1
Group 3,RRG,-0.5,11,14,1935,9,2016,5,4
Group 3,RRG,-0.5,11,14,1936,11,2016,7,4
Group 3,RRG,-0.5,11,14,1937,10,2016,10,0
Group 3,RRG,-0.5,11,14,1938,9,2016,9,0
Group 3,RRG,-0.5,11,14,1939,7,2016,10,-3
Group 3,RRG,-0.5,11,14,1940,11,2016,12,-1
Group 3,RRG,-0.5,11,14,1941,6,2016,12,-6
Group 3,RRG,-0.5,11,14,1942,9,2016,9,0
Group 3,RRG,-0.5,11,14,1943,10,2016,8,2
Group 3,RRG,-0.5,11,14,1944,9,2016,8,1
Group 3,RRG,-0.5,11,14,1945,8,2016,8,0
Group 3,RRG,-0.5,11,14,1946,10,2016,7,3
Group 3,RRG,-0.5,11,14,1947,7,2016,9,-2
Group 3,RRG,-0.5,11,14,1948,9,2016,5,4
Group 3,RRG,-0.5,11,14,1949,11,2016,9,2
Group 3,RRG,-0.5,11,14,1950,5,2016,9,-4
Group 3,RRG,-0.5,11,14,1951,8,2016,5,3
Group 3,RRG,-0.5,11,14,1952,9,2016,8,1
Group 3,RRG,-0.5,11,14,1953,8,2016,8,0
Group 3,RRG,-0.5,11,14,1954,13,2016,7,6
Group 3,RRG,-0.5,11,14,1955,9,2016,11,-2
Group 3,RRG,-0.5,11,14,1956,8,2016,7,1
Group 3,RRG,-0.5,11,14,1957,8,2016,8,0
Group 3,RRG,-0.5,11,14,1958,6,2016,9,-3
Group 3,RRG,-0.5,11,14,1959,8,2016,9,-1
Group 3,RRG,-0.5,11,14,1960,6,2016,9,-3
Group 3,RRG,-0.5,11,14,1961,8,2016,10,-2
Group 3,RRG,-0.5,11,14,1962,13,2016,6,7
Group 3,RRG,-0.5,11,14,1963,12,2016,9,3
Group 3,RRG,-0.5,11,14,1964,13,2016,12,1
Group 3,RRG,-0.5,11,14,1965,5,2016,7,-2
Group 3,RRG,-0.5,11,14,1966,11,2016,7,4
Group 3,RRG,-0.5,11,14,1967,9,2016,11,-2
Group 3,RRG,-0.5,11,14,1968,6,2016,10,-4
Group 3,RRG,-0.5,11,14,1969,7,2016,10,-3
Group 3,RRG,-0.5,11,14,1970,5,2016,7,-2
Group 3,RRG,-0.5,11,14,1971,5,2016,3,2
Group 3,RRG,-0.5,11,14,1972,4,2016,10,-6
Group 3,RRG,-0.5,11,14,1973,13,2016,8,5
Group 3,RRG,-0.5,11,14,1974,10,2016,10,0
Group 3,RRG,-0.5,11,14,1975,14,2016,11,3
Group 3,RRG,-0.5,11,14,1976,14,2016,8,6
Group 3,RRG,-0.5,11,14,1977,14,2016,11,3
Group 3,RRG,-0.5,11,14,1978,6,2016,9,-3
Group 3,RRG,-0.5,11,14,1979,4,2016,8,-4
Group 3,RRG,-0.5,11,14,1980,6,2016,8,-2
Group 3,RRG,-0.5,11,14,1981,6,2016,7,-1
Group 3,RRG,-0.5,11,14,1982,5,2016,9,-4
Group 3,RRG,-0.5,11,14,1983,12,2016,11,1
Group 3,RRG,-0.5,11,14,1984,9,2016,10,-1
Group 3,RRG,-0.5,11,14,1985,7,2016,3,4
Group 3,RRG,-0.5,11,14,1986,10,2016,7,3
Group 3,RRG,-0.5,11,14,1987,6,2016,10,-4
Group 3,RRG,-0.5,11,14,1988,3,2016,9,-6
Group 3,RRG,-0.5,11,14,1989,9,2016,11,-2
Group 3,RRG,-0.5,11,14,1990,10,2016,7,3
Group 3,RRG,-0.5,11,14,1991,8,2016,4,4
Group 3,RRG,-0.5,11,14,1992,8,2016,11,-3
Group 3,RRG,-0.5,11,14,1993,11,2016,9,2
Group 3,RRG,-0.5,11,14,1994,4,2016,9,-5
Group 3,RRG,-0.5,11,14,1995,8,2016,9,-1
Group 3,RRG,-0.5,11,14,1996,8,2016,13,-5
Group 3,RRG,-0.5,11,14,1997,11,2016,9,2
Group 3,RRG,-0.5,11,14,1998,3,2016,5,-2
Group 3,RRG,-0.5,11,14,1999,4,2016,4,0
Group 3,RRG,-0.5,11,14,2000,7,2016,7,0
Group 3,RRG,-0.5,11,14,2001,7,2016,4,3
Group 3,RRG,-0.5,11,14,2002,3,2016,5,-2
Group 3,RRG,-0.5,11,14,2003,8,2016,5,3
Group 3,RRG,-0.5,11,14,2004,7,2016,5,2
Group 3,RRG,-0.5,11,14,2005,6,2016,5,1
Group 3,RRG,-0.5,11,14,2006,5,2016,8,-3
Group 3,RRG,-0.5,11,14,2007,10,2016,10,0
Group 3,RRG,-0.5,11,14,2008,11,2016,9,2
Group 3,RRG,-0.5,11,14,2009,8,2016,9,-1
Group 3,RRG,-0.5,11,14,2010,8,2016,7,1
Group 3,RRG,-0.5,11,14,2011,6,2016,12,-6
Group 3,RRG,-0.5,11,14,2012,9,2016,6,3
Group 3,RRG,-0.5,11,14,2013,10,2016,6,4
Group 3,RRG,-0.5,11,14,2014,12,2016,7,5
Group 3,RRG,-0.5,11,14,2015,8,2016,10,-2
Group 3,RRG,-0.5,11,14,2016,9,2016,9,0
Group 3,RRG,-0.5,11,14,2017,10,2016,7,3
Group 3,RRG,-0.5,11,14,2018,9,2016,8,1
Group 3,RRG,-0.5,11,14,2019,8,2016,11,-3
Group 3,RRG,-0.5,11,14,2020,12,2016,8,4
Group 3,RRG,-0.5,11,14,2021,11,2016,7,4
Group 3,RRG,-0.5,11,14,2022,6,2016,9,-3
Group 3,RRG,-0.5,11,14,2023,7,2016,10,-3
Group 3,RRG,-0.5,11,14,2024,4,2016,10,-6
Group 3,RRG,-0.5,11,14,2025,7,2016,9,-2
Group 3,RRG,-0.5,11,14,2026,12,2016,8,4
Group 3,RRG,-0.5,11,14,2027,7,2016,5,2
Group 3,RRG,-0.5,11,14,2028,6,2016,7,-1
Group 3,RRG,-0.5,11,14,2029,0,2016,7,-7
Group 3,RRG,-0.5,11,14,2030,1,2016,2,-1
Group 3,RRG,-0.5,11,14,2031,13,2016,11,2
Group 3,RRG,-0.5,11,14,2032,1,2016,7,-6
Group 3,RRG,-0.5,11,14,2033,4,2016,8,-4
Group 3,RRG,-0.5,11,14,2034,3,2016,6,-3
Group 3,RRG,-0.5,11,14,2035,11,2016,11,0
Group 3,RRG,-0.5,11,14,2036,9,2016,9,0
Group 3,RRG,-0.5,11,14,2037,9,2016,13,-4
Group 3,RRG,-0.5,11,14,2038,10,2016,9,1
Group 3,RRG,-0.5,11,14,2039,10,2016,10,0
Group 3,RRG,-0.5,11,14,2040,10,2016,6,4
Group 3,RRG,-0.5,11,14,2041,10,2016,9,1
Group 3,RRG,-0.5,11,14,2042,10,2016,12,-2
Group 3,RRG,-0.5,11,14,2043,10,2016,10,0
Group 3,RRG,-0.5,11,14,2044,9,2016,11,-2
Group 3,RRG,-0.5,11,14,2045,10,2016,7,3
Group 3,RRG,-0.5,11,14,2046,11,2016,9,2
Group 3,RRG,-0.5,11,14,2047,12,2016,8,4
Group 3,RRG,-0.5,11,14,2048,11,2016,11,0
Group 3,RRG,-0.5,11,14,2049,9,2016,12,-3
Group 3,RRG,-0.5,11,14,2050,9,2016,12,-3
Group 3,RRG,-0.5,11,14,2051,8,2016,8,0
Group 3,RRG,-0.5,11,14,2052,11,2016,8,3
Group 3,RRG,-0.5,11,14,2053,10,2016,11,-1
Group 3,RRG,-0.5,11,14,2054,6,2016,8,-2
Group 3,RRG,-0.5,11,14,2055,6,2016,8,-2
Group 3,RRG,-0.5,11,14,2056,8,2016,6,2
Group 3,RRG,-0.5,11,14,2057,11,2016,11,0
Group 3,RRG,-0.5,11,14,2058,4,2016,7,-3
Group 3,RRG,-0.5,11,14,2059,10,2016,9,1
Group 3,RRG,-0.5,11,14,2060,8,2016,6,2
Group 3,RRG,-0.5,11,14,2061,9,2016,8,1
Group 3,RRG,-0.5,11,14,2062,8,2016,5,3
Group 3,RRG,-0.5,11,14,2063,11,2016,9,2
Group 3,RRG,-0.5,11,14,2064,12,2016,8,4
Group 3,RRG,-0.5,11,14,2065,7,2016,8,-1
Group 3,RRG,-0.5,11,14,2066,11,2016,8,3
Group 3,RRG,-0.5,11,14,2067,8,2016,3,5
Group 3,RRG,-0.5,11,14,2068,3,2016,5,-2
Group 3,RRG,-0.5,11,14,2069,4,2016,5,-1
Group 3,RRG,-0.5,11,14,2070,10,2016,7,3
Group 3,RRG,-0.5,11,14,2071,12,2016,9,3
Group 3,RRG,-0.5,11,14,2072,13,2016,9,4
Group 3,RRG,-0.5,11,14,2073,7,2016,5,2
Group 3,RRG,-0.5,11,14,2074,5,2016,9,-4
Group 3,RRG,-0.5,11,14,2075,5,2016,3,2
Group 3,RRG,-0.5,11,14,2076,5,2016,10,-5
Group 3,RRG,-0.5,11,14,2077,8,2016,11,-3
Group 3,RRG,-0.5,11,14,2078,6,2016,7,-1
Group 3,RRG,-0.5,11,14,2079,7,2016,8,-1
Group 3,RRG,-0.5,11,14,2080,11,2016,9,2
Group 3,RRG,-0.5,11,14,2081,12,2016,9,3
Group 3,RRG,-0.5,11,14,2082,4,2016,4,0
Group 3,RRG,-0.5,11,14,2083,10,2016,11,-1
Group 3,RRG,-0.5,11,14,2084,8,2016,9,-1
Group 3,RRG,-0.5,11,14,2085,11,2016,12,-1
Group 3,RRG,-0.5,11,14,2086,8,2016,12,-4
Group 3,RRG,-0.5,11,14,2087,5,2016,9,-4
Group 3,RRG,-0.5,11,14,2088,4,2016,7,-3
Group 3,RRG,-0.5,11,14,2089,6,2016,9,-3
Group 3,RRG,-0.5,11,14,2090,9,2016,8,1
Group 3,RRG,-0.5,11,14,2091,8,2016,12,-4
Group 3,RRG,-0.5,11,14,2092,11,2016,10,1
Group 3,RRG,-0.5,11,14,2093,8,2016,10,-2
Group 3,RRG,-0.5,11,14,2094,10,2016,10,0
Group 3,RRG,-0.5,11,14,2095,6,2016,7,-1
Group 3,RRG,-0.5,11,14,2096,7,2016,13,-6
Group 3,RRG,-0.5,11,14,2097,8,2016,12,-4
Group 3,RRG,-0.5,11,14,2098,9,2016,10,-1
Group 3,RRG,-0.5,11,14,2099,10,2016,9,1
Group 3,RRG,-0.5,11,14,2100,8,2016,7,1
Group 3,RRG,-0.5,11,14,2101,7,2016,10,-3
Group 3,RRG,-0.5,11,14,2102,6,2016,8,-2
Group 3,RRG,-0.5,11,14,2103,11,2016,10,1
Group 3,RRG,-0.5,11,14,2104,8,2016,11,-3
Group 3,RRG,-0.5,11,14,2105,8,2016,11,-3
Group 3,RRG,-0.5,11,14,2106,9,2016,10,-1
Group 3,RRG,-0.5,11,14,2107,10,2016,10,0
Group 3,RRG,-0.5,11,14,2108,5,2016,9,-4
Group 3,RRG,-0.5,11,14,2109,9,2016,9,0
Group 3,RRG,-0.5,11,14,2110,4,2016,8,-4
Group 3,RRG,-0.5,11,14,2111,6,2016,7,-1
Group 3,RRG,-0.5,11,14,2112,11,2016,7,4
Group 3,RRG,-0.5,11,14,2113,8,2016,10,-2
Group 3,RRG,-0.5,11,14,2114,9,2016,10,-1
Group 3,RRG,-0.5,11,14,2115,10,2016,7,3
Group 3,RRG,-0.5,11,14,2116,7,2016,9,-2
Group 3,RRG,-0.5,11,14,2117,10,2016,13,-3
Group 3,RRG,-0.5,11,14,2118,6,2016,7,-1
Group 3,RRG,-0.5,11,14,2119,8,2016,10,-2
Group 3,RRG,-0.5,11,14,2120,5,2016,8,-3
Group 3,RRG,-0.5,11,14,2121,6,2016,11,-5
Group 3,RRG,-0.5,11,14,2122,4,2016,5,-1
Group 3,RRG,-0.5,11,14,2123,4,2016,10,-6
Group 3,RRG,-0.5,11,14,2124,12,2016,7,5
Group 3,RRG,-0.5,11,14,2125,12,2016,8,4
Group 3,RRG,-0.5,11,14,2126,8,2016,3,5
Group 3,RRG,-0.5,11,14,2127,11,2016,4,7
Group 3,RRG,-0.5,11,14,2128,7,2016,11,-4
Group 3,RRG,-0.5,11,14,2129,6,2016,7,-1
Group 3,RRG,-0.5,11,14,2130,11,2016,10,1
Group 3,RRG,-0.5,11,14,2131,11,2016,11,0
Group 3,RRG,-0.5,11,14,2132,8,2016,7,1
Group 3,RRG,-0.5,11,14,2133,12,2016,12,0
Group 3,RRG,-0.5,11,14,2134,14,2016,9,5
Group 3,RRG,-0.5,11,14,2135,10,2016,9,1
Group 3,RRG,-0.5,11,14,2136,11,2016,8,3
Group 3,RRG,-0.5,11,14,2137,11,2016,5,6
Group 3,RRG,-0.5,11,14,2138,9,2016,9,0
Group 3,RRG,-0.5,11,14,2139,13,2016,11,2
Group 3,RRG,-0.5,11,14,2140,4,2016,7,-3
Group 3,RRG,-0.5,11,14,2141,4,2016,9,-5
Group 3,RRG,-0.5,11,14,2142,4,2016,8,-4
Group 3,RRG,-0.5,11,14,2143,14,2016,5,9
Group 3,RRG,-0.5,11,14,2144,9,2016,10,-1
Group 3,RRG,-0.5,11,14,2145,7,2016,8,-1
Group 3,RRG,-0.5,11,14,2146,8,2016,9,-1
Group 3,RRG,-0.5,11,14,2147,4,2016,10,-6
Group 3,RRG,-0.5,11,14,2148,5,2016,9,-4
Group 3,RRG,-0.5,11,14,2149,7,2016,7,0
Group 3,RRG,-0.5,11,14,2150,12,2016,8,4
Group 3,RRG,-0.5,11,14,2151,9,2016,5,4
Group 3,RRG,-0.5,11,14,2152,7,2016,9,-2
Group 3,RRG,-0.5,11,14,2153,10,2016,8,2
Group 3,RRG,-0.5,11,14,2154,1,2016,7,-6
Group 3,RRG,-0.5,11,14,2155,3,2016,2,1
Group 3,RRG,-0.5,11,14,2156,7,2016,7,0
Group 3,RRG,-0.5,11,14,2157,6,2016,7,-1
Group 3,RRG,-0.5,11,14,2158,9,2016,10,-1
Group 3,RRG,-0.5,11,14,2159,8,2016,11,-3
Group 3,RRG,-0.5,11,14,2160,11,2016,10,1
Group 3,RRG,-0.5,11,14,2161,9,2016,5,4
Group 3,RRG,-0.5,11,14,2162,8,2016,11,-3
Group 3,RRG,-0.5,11,14,2163,5,2016,7,-2
Group 3,RRG,-0.5,11,14,2164,5,2016,5,0
Group 3,RRG,-0.5,11,14,2165,10,2016,9,1
Group 3,RRG,-0.5,11,14,2166,10,2016,6,4
Group 3,RRG,-0.5,11,14,2167,9,2016,8,1
Group 3,RRG,-0.5,11,14,2168,10,2016,5,5
Group 3,RRG,-0.5,11,14,2169,14,2016,9,5
Group 3,RRG,-0.5,11,14,2170,13,2016,8,5
Group 3,RRG,-0.5,11,14,2171,13,2016,7,6
Group 3,RRG,-0.5,11,14,2172,7,2016,7,0
Group 3,RRG,-0.5,11,14,2173,7,2016,9,-2
Group 3,RRG,-0.5,11,14,2174,7,2016,10,-3
Group 3,RRG,-0.5,11,14,2175,7,2016,10,-3
Group 3,RRG,-0.5,11,14,2176,6,2016,8,-2
Group 3,RRG,-0.5,11,14,2177,8,2016,9,-1
Group 3,RRG,-0.5,11,14,2178,12,2016,6,6
Group 3,RRG,-0.5,11,14,2179,8,2016,6,2
Group 3,RRG,-0.5,11,14,2180,9,2016,8,1
Group 3,RRG,-0.5,11,14,2181,11,2016,10,1
Group 3,RRG,-0.5,11,14,2182,8,2016,10,-2
Group 3,RRG,-0.5,11,14,2183,8,2016,7,1
Group 3,RRG,-0.5,11,14,2184,10,2016,9,1
Group 3,RRG,-0.5,11,14,2185,9,2016,9,0
Group 3,RRG,-0.5,11,14,2186,9,2016,10,-1
Group 3,RRG,-0.5,11,14,2187,4,2016,3,1
Group 3,RRG,-0.5,11,14,2188,9,2016,7,2
Group 3,RRG,-0.5,11,14,2189,12,2016,9,3
Group 3,RRG,-0.5,11,14,2190,5,2016,12,-7
Group 3,RRG,-0.5,11,14,2191,11,2016,9,2
Group 3,RRG,-0.5,11,14,2192,7,2016,6,1
Group 3,RRG,-0.5,11,14,2193,12,2016,13,-1
Group 3,RRG,-0.5,11,14,2194,8,2016,8,0
Group 3,RRG,-0.5,11,14,2195,8,2016,8,0
Group 3,RRG,-0.5,11,14,2196,9,2016,12,-3
Group 3,RRG,-0.5,11,14,2197,7,2016,6,1
Group 3,RRG,-0.5,11,14,2198,10,2016,7,3
Group 3,RRG,-0.5,11,14,2199,9,2016,12,-3
Group 3,RRG,-0.5,11,14,2200,5,2016,12,-7
Group 3,RRG,-0.5,11,14,2201,12,2016,6,6
Group 3,RRG,-0.5,11,14,2202,6,2016,9,-3
Group 3,RRG,-0.5,11,14,2203,6,2016,6,0
Group 3,RRG,-0.5,11,14,2204,5,2016,10,-5
Group 3,RRG,-0.5,11,14,2205,7,2016,6,1
Group 3,RRG,-0.5,11,14,2206,3,2016,8,-5
Group 3,RRG,-0.5,11,14,2207,8,2016,6,2
Group 3,RRG,-0.5,11,14,2208,7,2016,6,1
Group 3,RRG,-0.5,11,14,2209,8,2016,10,-2
Group 3,RRG,-0.5,11,14,2210,8,2016,9,-1
Group 3,RRG,-0.5,11,14,2211,6,2016,9,-3
Group 3,RRG,-0.5,11,14,2212,9,2016,7,2
Group 3,RRG,-0.5,11,14,2213,7,2016,8,-1
Group 3,RRG,-0.5,11,14,2214,3,2016,10,-7
Group 3,RRG,-0.5,11,14,2215,4,2016,5,-1
Group 3,RRG,-0.5,11,14,2216,3,2016,8,-5
Group 3,RRG,-0.5,11,14,2217,7,2016,6,1
Group 3,RRG,-0.5,11,14,2218,11,2016,10,1
Group 3,RRG,-0.5,11,14,2219,12,2016,9,3
Group 3,RRG,-0.5,11,14,2220,10,2016,7,3
Group 3,RRG,-0.5,11,14,2221,9,2016,10,-1
Group 3,RRG,-0.5,11,14,2222,7,2016,6,1
Group 3,RRG,-0.5,11,14,2223,13,2016,12,1
Group 3,RRG,-0.5,11,14,2224,1,2016,6,-5
Group 3,RRG,-0.5,11,14,2225,1,2016,6,-5
Group 3,RRG,-0.5,11,14,2226,7,2016,11,-4
Group 3,RRG,-0.5,11,14,2227,9,2016,12,-3
Group 3,RRG,-0.5,11,14,2228,7,2016,6,1
Group 3,RRG,-0.5,11,14,2229,6,2016,9,-3
Group 3,RRG,-0.5,11,14,2230,8,2016,11,-3
Group 3,RRG,-0.5,11,14,2231,7,2016,7,0
Group 3,RRG,-0.5,11,14,2232,8,2016,2,6
Group 3,RRG,-0.5,11,14,2233,9,2016,2,7
Group 3,RRG,-0.5,11,14,2234,8,2016,8,0
Group 3,RRG,-0.5,11,14,2235,10,2016,12,-2
Group 3,RRG,-0.5,11,14,2236,7,2016,3,4
Group 3,RRG,-0.5,11,14,2237,12,2016,9,3
Group 3,RRG,-0.5,11,14,2238,8,2016,9,-1
Group 3,RRG,-0.5,11,14,2239,9,2016,7,2
Group 3,RRG,-0.5,11,14,2240,8,2016,7,1
Group 3,RRG,-0.5,11,14,2241,12,2016,6,6
Group 3,RRG,-0.5,11,14,2242,6,2016,10,-4
Group 3,RRG,-0.5,11,14,2243,11,2016,10,1
Group 3,RRG,-0.5,11,14,2244,6,2016,9,-3
Group 3,RRG,-0.5,11,14,2245,7,2016,8,-1
Group 3,RRG,-0.5,11,14,2246,9,2016,9,0
Group 3,RRG,-0.5,11,14,2247,14,2016,10,4
Group 3,RRG,-0.5,11,14,2248,11,2016,10,1
Group 3,RRG,-0.5,11,14,2249,8,2016,5,3
Group 3,RRG,-0.5,11,14,2250,11,2016,11,0
Group 3,RRG,-0.5,11,14,2251,11,2016,8,3
Group 3,RRG,-0.5,11,14,2252,11,2016,9,2
Group 3,RRG,-0.5,11,14,2253,9,2016,8,1
Group 3,RRG,-0.5,11,14,2254,9,2016,10,-1
Group 3,RRG,-0.5,11,14,2255,8,2016,12,-4
Group 3,RRG,-0.5,11,14,2256,7,2016,7,0
Group 3,RRG,-0.5,11,14,2257,7,2016,8,-1
Group 3,RRG,-0.5,11,14,2258,11,2016,6,5
Group 3,RRG,-0.5,11,14,2259,5,2016,6,-1
Group 3,RRG,-0.5,11,14,2260,7,2016,8,-1
Group 3,RRG,-0.5,11,14,2261,7,2016,7,0
Group 3,RRG,-0.5,11,14,2262,3,2016,7,-4
Group 3,RRG,-0.5,11,14,2263,7,2016,9,-2
Group 3,RRG,-0.5,11,14,2264,7,2016,8,-1
Group 3,RRG,-0.5,11,14,2265,6,2016,7,-1
Group 3,RRG,-0.5,11,14,2266,8,2016,8,0
Group 3,RRG,-0.5,11,14,2267,10,2016,5,5
Group 3,RRG,-0.5,11,14,2268,9,2016,12,-3
Group 3,RRG,-0.5,11,14,2269,3,2016,4,-1
Group 3,RRG,-0.5,11,14,2270,9,2016,8,1
Group 3,RRG,-0.5,11,14,2271,9,2016,8,1
Group 3,RRG,-0.5,11,14,2272,7,2016,4,3
Group 3,RRG,-0.5,11,14,2273,9,2016,9,0
Group 3,RRG,-0.5,11,14,2274,8,2016,8,0
Group 3,RRG,-0.5,11,14,2275,6,2016,10,-4
Group 3,RRG,-0.5,11,14,2276,4,2016,9,-5
Group 3,RRG,-0.5,11,14,2277,7,2016,9,-2
Group 3,RRG,-0.5,11,14,2278,8,2016,8,0
Group 3,RRG,-0.5,11,14,2279,9,2016,5,4
Group 3,RRG,-0.5,11,14,2280,7,2016,9,-2
Group 3,RRG,-0.5,11,14,2281,6,2016,11,-5
Group 3,RRG,-0.5,11,14,2282,10,2016,8,2
Group 3,RRG,-0.5,11,14,2283,9,2016,8,1
Group 3,RRG,-0.5,11,14,2284,5,2016,10,-5
Group 3,RRG,-0.5,11,14,2285,7,2016,8,-1
Group 3,RRG,-0.5,11,14,2286,4,2016,9,-5
Group 3,RRG,-0.5,11,14,2287,9,2016,10,-1
Group 3,RRG,-0.5,11,14,2288,5,2016,10,-5
Group 3,RRG,-0.5,11,14,2289,11,2016,12,-1
Group 3,RRG,-0.5,11,14,2290,6,2016,9,-3
Group 3,RRG,-0.5,11,14,2291,7,2016,8,-1
Group 3,RRG,-0.5,11,14,2292,5,2016,5,0
Group 3,RRG,-0.5,11,14,2293,5,2016,9,-4
Group 3,RRG,-0.5,11,14,2294,11,2016,9,2
Group 3,RRG,-0.5,11,14,2295,8,2016,9,-1
Group 3,RRG,-0.5,11,14,2296,7,2016,9,-2
Group 3,RRG,-0.5,11,14,2297,10,2016,9,1
Group 3,RRG,-0.5,11,14,2298,10,2016,6,4
Group 3,RRG,-0.5,11,14,2299,7,2016,9,-2
Group 3,RRG,-0.5,11,14,2300,8,2016,5,3
Group 3,RRG,-0.5,11,14,2301,8,2016,10,-2
Group 3,RRG,-0.5,11,14,2302,4,2016,7,-3
Group 3,RRG,-0.5,11,14,2303,9,2016,9,0
Group 3,RRG,-0.5,11,14,2304,8,2016,9,-1
Group 3,RRG,-0.5,11,14,2305,8,2016,9,-1
Group 3,RRG,-0.5,11,14,2306,5,2016,8,-3
Group 3,RRG,-0.5,11,14,2307,3,2016,3,0
Group 3,RRG,-0.5,11,14,2308,10,2016,11,-1
Group 3,RRG,-0.5,11,14,2309,10,2016,7,3
Group 3,RRG,-0.5,11,14,2310,9,2016,10,-1
Group 3,RRG,-0.5,11,14,2311,9,2016,7,2
Group 3,RRG,-0.5,11,14,2312,6,2016,4,2
Group 3,RRG,-0.5,11,14,2313,7,2016,3,4
Group 3,RRG,-0.5,11,14,2314,3,2016,7,-4
Group 3,RRG,-0.5,11,14,2315,9,2016,8,1
Group 3,RRG,-0.5,11,14,2316,11,2016,8,3
Group 3,RRG,-0.5,11,14,2317,11,2016,12,-1
Group 3,RRG,-0.5,11,14,2318,6,2016,7,-1
Group 3,RRG,-0.5,11,14,2319,11,2016,10,1
Group 3,RRG,-0.5,11,14,2320,10,2016,12,-2
Group 3,RRG,-0.5,11,14,2321,8,2016,8,0
Group 3,RRG,-0.5,11,14,2322,10,2016,4,6
Group 3,RRG,-0.5,11,14,2323,7,2016,11,-4
Group 3,RRG,-0.5,11,14,2324,7,2016,8,-1
Group 3,RRG,-0.5,11,14,2325,8,2016,11,-3
Group 3,RRG,-0.5,11,14,2326,10,2016,12,-2
Group 3,RRG,-0.5,11,14,2327,6,2016,11,-5
Group 3,RRG,-0.5,11,14,2328,8,2016,9,-1
Group 3,RRG,-0.5,11,14,2329,9,2016,8,1
Group 3,RRG,-0.5,11,14,2330,8,2016,5,3
Group 3,RRG,-0.5,11,14,2331,12,2016,7,5
Group 3,RRG,-0.5,11,14,2332,8,2016,12,-4
Group 3,RRG,-0.5,11,14,2333,6,2016,8,-2
Group 3,RRG,-0.5,11,14,2334,9,2016,5,4
Group 3,RRG,-0.5,11,14,2335,8,2016,7,1
Group 3,RRG,-0.5,11,14,2336,11,2016,10,1
Group 3,RRG,-0.5,11,14,2337,9,2016,8,1
Group 3,RRG,-0.5,11,14,2338,11,2016,5,6
Group 3,RRG,-0.5,11,14,2339,6,2016,8,-2
Group 3,RRG,-0.5,11,14,2340,11,2016,10,1
Group 3,RRG,-0.5,11,14,2341,6,2016,8,-2
Group 3,RRG,-0.5,11,14,2342,10,2016,7,3
Group 3,RRG,-0.5,11,14,2343,10,2016,6,4
Group 3,RRG,-0.5,11,14,2344,11,2016,9,2
Group 3,RRG,-0.5,11,14,2345,5,2016,9,-4
Group 3,RRG,-0.5,11,14,2346,8,2016,6,2
Group 3,RRG,-0.5,11,14,2347,5,2016,5,0
Group 3,RRG,-0.5,11,14,2348,8,2016,6,2
Group 3,RRG,-0.5,11,14,2349,9,2016,5,4
Group 3,RRG,-0.5,11,14,2350,9,2016,9,0
Group 3,RRG,-0.5,11,14,2351,8,2016,9,-1
Group 3,RRG,-0.5,11,14,2352,8,2016,10,-2
Group 3,RRG,-0.5,11,14,2353,12,2016,12,0
Group 3,RRG,-0.5,11,14,2354,1,2016,10,-9
Group 3,RRG,-0.5,11,14,2355,10,2016,12,-2
Group 3,RRG,-0.5,11,14,2356,11,2016,13,-2
Group 3,RRG,-0.5,11,14,2357,9,2016,7,2
Group 3,RRG,-0.5,11,14,2358,9,2016,8,1
Group 3,RRG,-0.5,11,14,2359,7,2016,6,1
Group 3,RRG,-0.5,11,14,2360,11,2016,8,3
Group 3,RRG,-0.5,11,14,2361,14,2016,11,3
Group 3,RRG,-0.5,11,14,2362,11,2016,14,-3
Group 3,RRG,-0.5,11,14,2363,10,2016,9,1
Group 3,RRG,-0.5,11,14,2364,7,2016,6,1
Group 3,RRG,-0.5,11,14,2365,12,2016,7,5
Group 3,RRG,-0.5,11,14,2366,8,2016,6,2
Group 3,RRG,-0.5,11,14,2367,5,2016,8,-3
Group 3,RRG,-0.5,11,14,2368,8,2016,9,-1
Group 3,RRG,-0.5,11,14,2369,6,2016,9,-3
Group 3,RRG,-0.5,11,14,2370,5,2016,9,-4
Group 3,RRG,-0.5,11,14,2371,8,2016,6,2
Group 3,RRG,-0.5,11,14,2372,9,2016,9,0
Group 3,RRG,-0.5,11,14,2373,4,2016,5,-1
Group 3,RRG,-0.5,11,14,2374,11,2016,10,1
Group 3,RRG,-0.5,11,14,2375,6,2016,10,-4
Group 3,RRG,-0.5,11,14,2376,10,2016,6,4
Group 3,RRG,-0.5,11,14,2377,7,2016,6,1
Group 3,RRG,-0.5,11,14,2378,14,2016,9,5
Group 3,RRG,-0.5,11,14,2379,3,2016,2,1
Group 3,RRG,-0.5,11,14,2380,13,2016,11,2
Group 3,RRG,-0.5,11,14,2381,8,2016,7,1
Group 3,RRG,-0.5,11,14,2382,10,2016,9,1
Group 3,RRG,-0.5,11,14,2383,8,2016,8,0
Group 3,RRG,-0.5,11,14,2384,13,2016,11,2
Group 3,RRG,-0.5,11,14,2385,8,2016,7,1
Group 3,RRG,-0.5,11,14,2386,2,2016,5,-3
Group 3,RRG,-0.5,11,14,2387,10,2016,12,-2
Group 3,RRG,-0.5,11,14,2388,9,2016,10,-1
Group 3,RRG,-0.5,11,14,2389,14,2016,13,1
Group 3,RRG,-0.5,11,14,2390,13,2016,12,1
Group 3,RRG,-0.5,11,14,2391,13,2016,10,3
Group 3,RRG,-0.5,11,14,2392,12,2016,8,4
Group 3,RRG,-0.5,11,14,2393,8,2016,10,-2
Group 3,RRG,-0.5,11,14,2394,12,2016,8,4
Group 3,RRG,-0.5,11,14,2395,8,2016,6,2
Group 3,RRG,-0.5,11,14,2396,8,2016,8,0
Group 3,RRG,-0.5,11,14,2397,12,2016,7,5
Group 3,RRG,-0.5,11,14,2398,2,2016,7,-5
Group 3,RRG,-0.5,11,14,2399,10,2016,7,3
Group 3,RRG,-0.5,11,14,2400,7,2016,9,-2
Group 3,RRG,-0.5,11,14,2401,13,2016,7,6
Group 3,RRG,-0.5,11,14,2402,7,2016,6,1
Group 3,RRG,-0.5,11,14,2403,9,2016,7,2
Group 3,RRG,-0.5,11,14,2404,14,2016,7,7
Group 3,RRG,-0.5,11,14,2405,12,2016,14,-2
Group 3,RRG,-0.5,11,14,2406,7,2016,7,0
Group 3,RRG,-0.5,11,14,2407,6,2016,9,-3
Group 3,RRG,-0.5,11,14,2408,7,2016,6,1
Group 3,RRG,-0.5,11,14,2409,11,2016,9,2
Group 3,RRG,-0.5,11,14,2410,12,2016,13,-1
Group 3,RRG,-0.5,11,14,2411,11,2016,12,-1
Group 3,RRG,-0.5,11,14,2412,9,2016,3,6
Group 3,RRG,-0.5,11,14,2413,8,2016,7,1
Group 3,RRG,-0.5,11,14,2414,11,2016,14,-3
Group 3,RRG,-0.5,11,14,2415,6,2016,8,-2
Group 3,RRG,-0.5,11,14,2416,9,2016,8,1
Group 3,RRG,-0.5,11,14,2417,12,2016,13,-1
Group 3,RRG,-0.5,11,14,2418,10,2016,11,-1
Group 3,RRG,-0.5,11,14,2419,8,2016,10,-2
Group 3,RRG,-0.5,11,14,2420,10,2016,6,4
Group 3,RRG,-0.5,11,14,2421,6,2016,7,-1
Group 3,RRG,-0.5,11,14,2422,7,2016,9,-2
Group 3,RRG,-0.5,11,14,2423,8,2016,11,-3
Group 3,RRG,-0.5,11,14,2424,8,2016,7,1
Group 3,RRG,-0.5,11,14,2425,5,2016,9,-4
Group 3,RRG,-0.5,11,14,2426,12,2016,7,5
Group 3,RRG,-0.5,11,14,2427,10,2016,3,7
Group 3,RRG,-0.5,11,14,2428,8,2016,8,0
Group 3,RRG,-0.5,11,14,2429,12,2016,10,2
Group 3,RRG,-0.5,11,14,2430,7,2016,8,-1
Group 3,RRG,-0.5,11,14,2431,10,2016,7,3
Group 3,RRG,-0.5,11,14,2432,8,2016,7,1
Group 3,RRG,-0.5,11,14,2433,12,2016,9,3
Group 3,RRG,-0.5,11,14,2434,9,2016,10,-1
Group 3,RRG,-0.5,11,14,2435,6,2016,7,-1
Group 3,RRG,-0.5,11,14,2436,14,2016,12,2
Group 3,RRG,-0.5,11,14,2437,7,2016,10,-3
Group 3,RRG,-0.5,11,14,2438,6,2016,10,-4
Group 3,RRG,-0.5,11,14,2439,11,2016,10,1
Group 3,RRG,-0.5,11,14,2440,8,2016,7,1
Group 3,RRG,-0.5,11,14,2441,12,2016,7,5
Group 3,RRG,-0.5,11,14,2442,11,2016,6,5
Group 3,RRG,-0.5,11,14,2443,8,2016,10,-2
Group 3,RRG,-0.5,11,14,2444,7,2016,8,-1
Group 3,RRG,-0.5,11,14,2445,12,2016,10,2
Group 3,RRG,-0.5,11,14,2446,7,2016,9,-2
Group 3,RRG,-0.5,11,14,2447,4,2016,7,-3
Group 3,RRG,-0.5,11,14,2448,8,2016,7,1
Group 3,RRG,-0.5,11,14,2449,8,2016,5,3
Group 3,RRG,-0.5,11,14,2450,10,2016,7,3
Group 3,RRG,-0.5,11,14,2451,5,2016,7,-2
Group 3,RRG,-0.5,11,14,2452,8,2016,8,0
Group 3,RRG,-0.5,11,14,2453,7,2016,10,-3
Group 3,RRG,-0.5,11,14,2454,2,2016,9,-7
Group 3,RRG,-0.5,11,14,2455,8,2016,3,5
Group 3,RRG,-0.5,11,14,2456,6,2016,6,0
Group 3,RRG,-0.5,11,14,2457,4,2016,7,-3
Group 3,RRG,-0.5,11,14,2458,12,2016,9,3
Group 3,RRG,-0.5,11,14,2459,6,2016,11,-5
Group 3,RRG,-0.5,11,14,2460,9,2016,9,0
Group 3,RRG,-0.5,11,14,2461,8,2016,8,0
Group 3,RRG,-0.5,11,14,2462,9,2016,7,2
Group 3,RRG,-0.5,11,14,2463,6,2016,8,-2
Group 3,RRG,-0.5,11,14,2464,10,2016,9,1
Group 3,RRG,-0.5,11,14,2465,8,2016,8,0
Group 3,RRG,-0.5,11,14,2466,13,2016,10,3
Group 3,RRG,-0.5,11,14,2467,9,2016,9,0
Group 3,RRG,-0.5,11,14,2468,11,2016,9,2
Group 3,RRG,-0.5,11,14,2469,12,2016,12,0
Group 3,RRG,-0.5,11,14,2470,7,2016,10,-3
Group 3,RRG,-0.5,11,14,2471,7,2016,7,0
Group 3,RRG,-0.5,11,14,2472,12,2016,9,3
Group 3,RRG,-0.5,11,14,2473,10,2016,5,5
Group 3,RRG,-0.5,11,14,2474,6,2016,11,-5
Group 3,RRG,-0.5,11,14,2475,10,2016,8,2
Group 3,RRG,-0.5,11,14,2476,11,2016,12,-1
Group 3,RRG,-0.5,11,14,2477,7,2016,8,-1
Group 3,RRG,-0.5,11,14,2478,13,2016,9,4
Group 3,RRG,-0.5,11,14,2479,5,2016,11,-6
Group 3,RRG,-0.5,11,14,2480,4,2016,8,-4
Group 3,RRG,-0.5,11,14,2481,11,2016,9,2
Group 3,RRG,-0.5,11,14,2482,10,2016,14,-4
Group 3,RRG,-0.5,11,14,2483,9,2016,13,-4
Group 3,RRG,-0.5,11,14,2484,9,2016,7,2
Group 3,RRG,-0.5,11,14,2485,8,2016,9,-1
Group 3,RRG,-0.5,11,14,2486,11,2016,11,0
Group 3,RRG,-0.5,11,14,2487,13,2016,3,10
Group 3,RRG,-0.5,11,14,2488,9,2016,10,-1
Group 3,RRG,-0.5,11,14,2489,9,2016,10,-1
Group 3,RRG,-0.5,11,14,2490,7,2016,9,-2
Group 3,RRG,-0.5,11,14,2491,11,2016,12,-1
Group 3,RRG,-0.5,11,14,2492,9,2016,3,6
Group 3,RRG,-0.5,11,14,2493,10,2016,8,2
Group 3,RRG,-0.5,11,14,2494,9,2016,9,0
Group 3,RRG,-0.5,11,14,2495,5,2016,7,-2
Group 3,RRG,-0.5,11,14,2496,13,2016,10,3
Group 3,RRG,-0.5,11,14,2497,12,2016,11,1
Group 3,RRG,-0.5,11,14,2498,8,2016,6,2
Group 3,RRG,-0.5,11,14,2499,10,2016,6,4
Group 3,RRG,-0.5,11,14,2500,10,2016,10,0
Group 3,RRG,-0.5,11,14,2501,6,2016,8,-2
Group 3,RRG,-0.5,11,14,2502,2,2016,6,-4
Group 3,RRG,-0.5,11,14,2503,10,2016,9,1
Group 3,RRG,-0.5,11,14,2504,11,2016,7,4
Group 3,RRG,-0.5,11,14,2505,7,2016,6,1
Group 3,RRG,-0.5,11,14,2506,5,2016,4,1
Group 3,RRG,-0.5,11,14,2507,7,2016,11,-4
Group 3,RRG,-0.5,11,14,2508,5,2016,9,-4
Group 3,RRG,-0.5,11,14,2509,10,2016,8,2
Group 3,RRG,-0.5,11,14,2510,3,2016,9,-6
Group 3,RRG,-0.5,11,14,2511,5,2016,11,-6
Group 3,RRG,-0.5,11,14,2512,6,2016,11,-5
Group 3,RRG,-0.5,11,14,2513,8,2016,12,-4
Group 3,RRG,-0.5,11,14,2514,6,2016,5,1
Group 3,RRG,-0.5,11,14,2515,6,2016,11,-5
Group 3,RRG,-0.5,11,14,2516,9,2016,9,0
Group 3,RRG,-0.5,11,14,2517,9,2016,11,-2
Group 3,RRG,-0.5,11,14,2518,9,2016,6,3
Group 3,RRG,-0.5,11,14,2519,8,2016,10,-2
Group 3,RRG,-0.5,11,14,2520,11,2016,10,1
Group 3,RRG,-0.5,11,14,2521,11,2016,7,4
Group 3,RRG,-0.5,11,14,2522,11,2016,7,4
Group 3,RRG,-0.5,11,14,2523,8,2016,9,-1
Group 3,RRG,-0.5,11,14,2524,12,2016,6,6
Group 3,RRG,-0.5,11,14,2525,9,2016,10,-1
Group 3,RRG,-0.5,11,14,2526,6,2016,6,0
Group 3,RRG,-0.5,11,14,2527,8,2016,9,-1
Group 3,RRG,-0.5,11,14,2528,6,2016,10,-4
Group 3,RRG,-0.5,11,14,2529,9,2016,10,-1
Group 3,RRG,-0.5,11,14,2530,12,2016,7,5
Group 3,RRG,-0.5,11,14,2531,11,2016,8,3
Group 3,RRG,-0.5,11,14,2532,13,2016,10,3
Group 3,RRG,-0.5,11,14,2533,4,2016,10,-6
Group 3,RRG,-0.5,11,14,2534,11,2016,10,1
Group 3,RRG,-0.5,11,14,2535,11,2016,12,-1
Group 3,RRG,-0.5,11,14,2536,10,2016,9,1
Group 3,RRG,-0.5,11,14,2537,12,2016,10,2
Group 3,RRG,-0.5,11,14,2538,9,2016,2,7
Group 3,RRG,-0.5,11,14,2539,8,2016,12,-4
Group 3,RRG,-0.5,11,14,2540,7,2016,5,2
Group 3,RRG,-0.5,11,14,2541,12,2016,9,3
Group 3,RRG,-0.5,11,14,2542,11,2016,7,4
Group 3,RRG,-0.5,11,14,2543,8,2016,9,-1
Group 3,RRG,-0.5,11,14,2544,11,2016,12,-1
Group 3,RRG,-0.5,11,14,2545,12,2016,11,1
Group 3,RRG,-0.5,11,14,2546,8,2016,10,-2
Group 3,RRG,-0.5,11,14,2547,7,2016,7,0
Group 3,RRG,-0.5,11,14,2548,3,2016,3,0
Group 3,RRG,-0.5,11,14,2549,12,2016,12,0
Group 3,RRG,-0.5,11,14,2550,10,2016,8,2
Group 3,RRG,-0.5,11,14,2551,8,2016,6,2
Group 3,RRG,-0.5,11,14,2552,4,2016,9,-5
Group 3,RRG,-0.5,11,14,2553,6,2016,5,1
Group 3,RRG,-0.5,11,14,2554,4,2016,6,-2
Group 3,RRG,-0.5,11,14,2555,8,2016,6,2
Group 3,RRG,-0.5,11,14,2556,5,2016,9,-4
Group 3,RRG,-0.5,11,14,2557,8,2016,6,2
Group 3,RRG,-0.5,11,14,2558,13,2016,7,6
Group 3,RRG,-0.5,11,14,2559,3,2016,9,-6
Group 3,RRG,-0.5,11,14,2560,4,2016,3,1
Group 3,RRG,-0.5,11,14,2561,9,2016,7,2
Group 3,RRG,-0.5,11,14,2562,7,2016,6,1
Group 3,RRG,-0.5,11,14,2563,9,2016,7,2
Group 3,RRG,-0.5,11,14,2564,9,2016,10,-1
Group 3,RRG,-0.5,11,14,2565,6,2016,10,-4
Group 3,RRG,-0.5,11,14,2566,11,2016,9,2
Group 3,RRG,-0.5,11,14,2567,12,2016,10,2
Group 3,RRG,-0.5,11,14,2568,9,2016,9,0
Group 3,RRG,-0.5,11,14,2569,8,2016,8,0
Group 3,RRG,-0.5,11,14,2570,4,2016,10,-6
Group 3,RRG,-0.5,11,14,2571,9,2016,13,-4
Group 3,RRG,-0.5,11,14,2572,6,2016,9,-3
Group 3,RRG,-0.5,11,14,2573,9,2016,8,1
Group 3,RRG,-0.5,11,14,2574,7,2016,8,-1
Group 3,RRG,-0.5,11,14,2575,10,2016,11,-1
Group 3,RRG,-0.5,11,14,2576,9,2016,6,3
Group 3,RRG,-0.5,11,14,2577,8,2016,10,-2
Group 3,RRG,-0.5,11,14,2578,12,2016,12,0
Group 3,RRG,-0.5,11,14,2579,7,2016,11,-4
Group 3,RRG,-0.5,11,14,2580,6,2016,6,0
Group 3,RRG,-0.5,11,14,2581,6,2016,6,0
Group 3,RRG,-0.5,11,14,2582,9,2016,7,2
Group 3,RRG,-0.5,11,14,2583,6,2016,5,1
Group 3,RRG,-0.5,11,14,2584,7,2016,10,-3
Group 3,RRG,-0.5,11,14,2585,8,2016,7,1
Group 3,RRG,-0.5,11,14,2586,8,2016,6,2
Group 3,RRG,-0.5,11,14,2587,10,2016,6,4
Group 3,RRG,-0.5,11,14,2588,8,2016,8,0
Group 3,RRG,-0.5,11,14,2589,6,2016,5,1
Group 3,RRG,-0.5,11,14,2590,6,2016,11,-5
Group 3,RRG,-0.5,11,14,2591,10,2016,5,5
Group 3,RRG,-0.5,11,14,2592,4,2016,8,-4
Group 3,RRG,-0.5,11,14,2593,14,2016,11,3
Group 3,RRG,-0.5,11,14,2594,6,2016,6,0
Group 3,RRG,-0.5,11,14,2595,10,2016,11,-1
Group 3,RRG,-0.5,11,14,2596,13,2016,11,2
Group 3,RRG,-0.5,11,14,2597,11,2016,12,-1
Group 3,RRG,-0.5,11,14,2598,10,2016,5,5
Group 3,RRG,-0.5,11,14,2599,4,2016,6,-2
Group 3,RRG,-0.5,11,14,2600,7,2016,8,-1
Group 3,RRG,-0.5,11,14,2601,9,2016,12,-3
Group 3,RRG,-0.5,11,14,2602,8,2016,4,4
Group 3,RRG,-0.5,11,14,2603,12,2016,10,2
Group 3,RRG,-0.5,11,14,2604,9,2016,6,3
Group 3,RRG,-0.5,11,14,2605,10,2016,8,2
Group 3,RRG,-0.5,11,14,2606,7,2016,6,1
Group 3,RRG,-0.5,11,14,2607,10,2016,11,-1
Group 3,RRG,-0.5,11,14,2608,13,2016,10,3
Group 3,RRG,-0.5,11,14,2609,4,2016,9,-5
Group 3,RRG,-0.5,11,14,2610,9,2016,5,4
Group 3,RRG,-0.5,11,14,2611,6,2016,11,-5
Group 3,RRG,-0.5,11,14,2612,8,2016,4,4
Group 3,RRG,-0.5,11,14,2613,6,2016,12,-6
Group 3,RRG,-0.5,11,14,2614,10,2016,10,0
Group 3,RRG,-0.5,11,14,2615,8,2016,7,1
Group 3,RRG,-0.5,11,14,2616,10,2016,8,2
Group 3,RRG,-0.5,11,14,2617,11,2016,8,3
Group 3,RRG,-0.5,11,14,2618,6,2016,8,-2
Group 3,RRG,-0.5,11,14,2619,8,2016,5,3
Group 3,RRG,-0.5,11,14,2620,8,2016,6,2
Group 3,RRG,-0.5,11,14,2621,7,2016,5,2
Group 3,RRG,-0.5,11,14,2622,9,2016,12,-3
Group 3,RRG,-0.5,11,14,2623,12,2016,9,3
Group 3,RRG,-0.5,11,14,2624,6,2016,7,-1
Group 3,RRG,-0.5,11,14,2625,8,2016,10,-2
Group 3,RRG,-0.5,11,14,2626,7,2016,10,-3
Group 3,RRG,-0.5,11,14,2627,11,2016,9,2
Group 3,RRG,-0.5,11,14,2628,6,2016,8,-2
Group 3,RRG,-0.5,11,14,2629,13,2016,8,5
Group 3,RRG,-0.5,11,14,2630,12,2016,11,1
Group 3,RRG,-0.5,11,14,2631,12,2016,9,3
Group 3,RRG,-0.5,11,14,2632,2,2016,4,-2
Group 3,RRG,-0.5,11,14,2633,11,2016,11,0
Group 3,RRG,-0.5,11,14,2634,2,2016,4,-2
Group 3,RRG,-0.5,11,14,2635,6,2016,5,1
Group 3,RRG,-0.5,11,14,2636,11,2016,6,5
Group 3,RRG,-0.5,11,14,2637,6,2016,7,-1
Group 3,RRG,-0.5,11,14,2638,8,2016,5,3
Group 3,RRG,-0.5,11,14,2639,11,2016,5,6
Group 3,RRG,-0.5,11,14,2640,12,2016,7,5
Group 3,RRG,-0.5,11,14,2641,10,2016,9,1
Group 3,RRG,-0.5,11,14,2642,10,2016,9,1
Group 3,RRG,-0.5,11,14,2643,10,2016,12,-2
Group 3,RRG,-0.5,11,14,2644,12,2016,9,3
Group 3,RRG,-0.5,11,14,2645,11,2016,9,2
Group 3,RRG,-0.5,11,14,2646,10,2016,7,3
Group 3,RRG,-0.5,11,14,2647,6,2016,10,-4
Group 3,RRG,-0.5,11,14,2648,7,2016,8,-1
Group 3,RRG,-0.5,11,14,2649,10,2016,9,1
Group 3,RRG,-0.5,11,14,2650,4,2016,8,-4
Group 3,RRG,-0.5,11,14,2651,7,2016,2,5
Group 3,RRG,-0.5,11,14,2652,7,2016,11,-4
Group 3,RRG,-0.5,11,14,2653,6,2016,9,-3
Group 3,RRG,-0.5,11,14,2654,7,2016,11,-4
Group 3,RRG,-0.5,11,14,2655,13,2016,11,2
Group 3,RRG,-0.5,11,14,2656,8,2016,9,-1
Group 3,RRG,-0.5,11,14,2657,8,2016,9,-1
Group 3,RRG,-0.5,11,14,2658,8,2016,5,3
Group 3,RRG,-0.5,11,14,2659,11,2016,8,3
Group 3,RRG,-0.5,11,14,2660,11,2016,6,5
Group 3,RRG,-0.5,11,14,2661,7,2016,9,-2
Group 3,RRG,-0.5,11,14,2662,7,2016,4,3
Group 3,RRG,-0.5,11,14,2663,9,2016,8,1
Group 3,RRG,-0.5,11,14,2664,8,2016,11,-3
Group 3,RRG,-0.5,11,14,2665,4,2016,6,-2
Group 3,RRG,-0.5,11,14,2666,6,2016,10,-4
Group 3,RRG,-0.5,11,14,2667,5,2016,9,-4
Group 3,RRG,-0.5,11,14,2668,10,2016,5,5
Group 3,RRG,-0.5,11,14,2669,5,2016,5,0
Group 3,RRG,-0.5,11,14,2670,6,2016,6,0
Group 3,RRG,-0.5,11,14,2671,6,2016,10,-4
Group 3,RRG,-0.5,11,14,2672,9,2016,10,-1
Group 3,RRG,-0.5,11,14,2673,12,2016,8,4
Group 3,RRG,-0.5,11,14,2674,8,2016,6,2
Group 3,RRG,-0.5,11,14,2675,10,2016,10,0
Group 3,RRG,-0.5,11,14,2676,10,2016,10,0
Group 3,RRG,-0.5,11,14,2677,7,2016,9,-2
Group 3,RRG,-0.5,11,14,2678,8,2016,11,-3
Group 3,RRG,-0.5,11,14,2679,10,2016,10,0
Group 3,RRG,-0.5,11,14,2680,8,2016,10,-2
Group 3,RRG,-0.5,11,14,2681,11,2016,10,1
Group 3,RRG,-0.5,11,14,2682,4,2016,7,-3
Group 3,RRG,-0.5,11,14,2683,13,2016,14,-1
Group 3,RRG,-0.5,11,14,2684,10,2016,11,-1
Group 3,RRG,-0.5,11,14,2685,10,2016,8,2
Group 3,RRG,-0.5,11,14,2686,13,2016,6,7
Group 3,RRG,-0.5,11,14,2687,9,2016,8,1
Group 3,RRG,-0.5,11,14,2688,6,2016,7,-1
Group 3,RRG,-0.5,11,14,2689,5,2016,4,1
Group 3,RRG,-0.5,11,14,2690,7,2016,8,-1
Group 3,RRG,-0.5,11,14,2691,11,2016,11,0
Group 3,RRG,-0.5,11,14,2692,14,2016,10,4
Group 3,RRG,-0.5,11,14,2693,13,2016,8,5
Group 3,RRG,-0.5,11,14,2694,11,2016,11,0
Group 3,RRG,-0.5,11,14,2695,9,2016,9,0
Group 3,RRG,-0.5,11,14,2696,9,2016,8,1
Group 3,RRG,-0.5,11,14,2697,9,2016,5,4
Group 3,RRG,-0.5,11,14,2698,8,2016,7,1
Group 3,RRG,-0.5,11,14,2699,4,2016,8,-4
Group 3,RRG,-0.5,11,14,2700,4,2016,6,-2
Group 3,RRG,-0.5,11,14,2701,11,2016,12,-1
Group 3,RRG,-0.5,11,14,2702,13,2016,6,7
Group 3,RRG,-0.5,11,14,2703,9,2016,10,-1
Group 3,RRG,-0.5,11,14,2704,9,2016,6,3
Group 3,RRG,-0.5,11,14,2705,8,2016,14,-6
Group 3,RRG,-0.5,11,14,2706,11,2016,8,3
Group 3,RRG,-0.5,11,14,2707,8,2016,9,-1
Group 3,RRG,-0.5,11,14,2708,7,2016,9,-2
Group 3,RRG,-0.5,11,14,2709,8,2016,11,-3
Group 3,RRG,-0.5,11,14,2710,5,2016,5,0
Group 3,RRG,-0.5,11,14,2711,14,2016,9,5
Group 3,RRG,-0.5,11,14,2712,2,2016,6,-4
Group 3,RRG,-0.5,11,14,2713,5,2016,6,-1
Group 3,RRG,-0.5,11,14,2714,3,2016,7,-4
Group 3,RRG,-0.5,11,14,2715,13,2016,12,1
Group 3,RRG,-0.5,11,14,2716,5,2016,3,2
Group 3,RRG,-0.5,11,14,2717,5,2016,6,-1
Group 3,RRG,-0.5,11,14,2718,8,2016,9,-1
Group 3,RRG,-0.5,11,14,2719,11,2016,7,4
Group 3,RRG,-0.5,11,14,2720,6,2016,7,-1
Group 3,RRG,-0.5,11,14,2721,11,2016,9,2
Group 3,RRG,-0.5,11,14,2722,11,2016,8,3
Group 3,RRG,-0.5,11,14,2723,8,2016,11,-3
Group 3,RRG,-0.5,11,14,2724,9,2016,11,-2
Group 3,RRG,-0.5,11,14,2725,5,2016,6,-1
Group 3,RRG,-0.5,11,14,2726,5,2016,5,0
Group 3,RRG,-0.5,11,14,2727,2,2016,5,-3
Group 3,RRG,-0.5,11,14,2728,3,2016,5,-2
Group 3,RRG,-0.5,11,14,2729,7,2016,10,-3
Group 3,RRG,-0.5,11,14,2730,6,2016,7,-1
Group 3,RRG,-0.5,11,14,2731,8,2016,11,-3
Group 3,RRG,-0.5,11,14,2732,9,2016,7,2
Group 3,RRG,-0.5,11,14,2733,10,2016,9,1
Group 3,RRG,-0.5,11,14,2734,7,2016,6,1
Group 3,RRG,-0.5,11,14,2735,0,2016,10,-10
Group 3,RRG,-0.5,11,14,2736,12,2016,8,4
Group 3,RRG,-0.5,11,14,2737,13,2016,9,4
Group 3,RRG,-0.5,11,14,2738,11,2016,9,2
Group 3,RRG,-0.5,11,14,2739,14,2016,9,5
Group 3,RRG,-0.5,11,14,2740,11,2016,10,1
Group 3,RRG,-0.5,11,14,2741,9,2016,11,-2
Group 3,RRG,-0.5,11,14,2742,7,2016,9,-2
Group 3,RRG,-0.5,11,14,2743,10,2016,4,6
Group 3,RRG,-0.5,11,14,2744,9,2016,11,-2
Group 3,RRG,-0.5,11,14,2745,10,2016,6,4
Group 3,RRG,-0.5,11,14,2746,9,2016,10,-1
Group 3,RRG,-0.5,11,14,2747,8,2016,12,-4
Group 3,RRG,-0.5,11,14,2748,9,2016,11,-2
Group 3,RRG,-0.5,11,14,2749,13,2016,10,3
Group 3,RRG,-0.5,11,14,2750,5,2016,5,0
Group 3,RRG,-0.5,11,14,2751,8,2016,8,0
Group 3,RRG,-0.5,11,14,2752,10,2016,11,-1
Group 3,RRG,-0.5,11,14,2753,10,2016,8,2
Group 3,RRG,-0.5,11,14,2754,7,2016,10,-3
Group 3,RRG,-0.5,11,14,2755,6,2016,9,-3
Group 3,RRG,-0.5,11,14,2756,13,2016,6,7
Group 3,RRG,-0.5,11,14,2757,2,2016,7,-5
Group 3,RRG,-0.5,11,14,2758,2,2016,6,-4
Group 3,RRG,-0.5,11,14,2759,9,2016,9,0
Group 3,RRG,-0.5,11,14,2760,9,2016,9,0
Group 3,RRG,-0.5,11,14,2761,11,2016,7,4
Group 3,RRG,-0.5,11,14,2762,8,2016,10,-2
Group 3,RRG,-0.5,11,14,2763,5,2016,8,-3
Group 3,RRG,-0.5,11,14,2764,8,2016,7,1
Group 3,RRG,-0.5,11,14,2765,9,2016,9,0
Group 3,RRG,-0.5,11,14,2766,7,2016,8,-1
Group 3,RRG,-0.5,11,14,2767,7,2016,10,-3
Group 3,RRG,-0.5,11,14,2768,6,2016,10,-4
Group 3,RRG,-0.5,11,14,2769,8,2016,12,-4
Group 3,RRG,-0.5,11,14,2770,10,2016,6,4
Group 3,RRG,-0.5,11,14,2771,7,2016,8,-1
Group 3,RRG,-0.5,11,14,2772,9,2016,7,2
Group 3,RRG,-0.5,11,14,2773,12,2016,9,3
Group 3,RRG,-0.5,11,14,2774,13,2016,12,1
Group 3,RRG,-0.5,11,14,2775,13,2016,12,1
Group 3,RRG,-0.5,11,14,2776,11,2016,10,1
Group 3,RRG,-0.5,11,14,2777,12,2016,10,2
Group 3,RRG,-0.5,11,14,2778,8,2016,9,-1
Group 3,RRG,-0.5,11,14,2779,12,2016,9,3
Group 3,RRG,-0.5,11,14,2780,11,2016,7,4
Group 3,RRG,-0.5,11,14,2781,7,2016,4,3
Group 3,RRG,-0.5,11,14,2782,8,2016,7,1
Group 3,RRG,-0.5,11,14,2783,8,2016,9,-1
Group 3,RRG,-0.5,11,14,2784,8,2016,7,1
Group 3,RRG,-0.5,11,14,2785,7,2016,6,1
Group 3,RRG,-0.5,11,14,2786,8,2016,8,0
Group 3,RRG,-0.5,11,14,2787,6,2016,5,1
Group 3,RRG,-0.5,11,14,2788,13,2016,11,2
Group 3,RRG,-0.5,11,14,2789,8,2016,11,-3
Group 3,RRG,-0.5,11,14,2790,5,2016,13,-8
Group 3,RRG,-0.5,11,14,2791,2,2016,5,-3
Group 3,RRG,-0.5,11,14,2792,8,2016,10,-2
Group 3,RRG,-0.5,11,14,2793,9,2016,9,0
Group 3,RRG,-0.5,11,14,2794,8,2016,8,0
Group 3,RRG,-0.5,11,14,2795,7,2016,3,4
Group 3,RRG,-0.5,11,14,2796,8,2016,9,-1
Group 3,RRG,-0.5,11,14,2797,8,2016,4,4
Group 3,RRG,-0.5,11,14,2798,7,2016,6,1
Group 3,RRG,-0.5,11,14,2799,10,2016,8,2
Group 3,RRG,-0.5,11,14,2800,4,2016,5,-1
Group 3,RRG,-0.5,11,14,2801,7,2016,10,-3
Group 3,RRG,-0.5,11,14,2802,9,2016,8,1
Group 3,RRG,-0.5,11,14,2803,7,2016,10,-3
Group 3,RRG,-0.5,11,14,2804,3,2016,9,-6
Group 3,RRG,-0.5,11,14,2805,9,2016,6,3
Group 3,RRG,-0.5,11,14,2806,12,2016,10,2
Group 3,RRG,-0.5,11,14,2807,6,2016,11,-5
Group 3,RRG,-0.5,11,14,2808,6,2016,10,-4
Group 3,RRG,-0.5,11,14,2809,12,2016,7,5
Group 3,RRG,-0.5,11,14,2810,7,2016,6,1
Group 3,RRG,-0.5,11,14,2811,8,2016,10,-2
Group 3,RRG,-0.5,11,14,2812,6,2016,7,-1
Group 3,RRG,-0.5,11,14,2813,4,2016,9,-5
Group 3,RRG,-0.5,11,14,2814,7,2016,7,0
Group 3,RRG,-0.5,11,14,2815,11,2016,6,5
Group 3,RRG,-0.5,11,14,2816,5,2016,3,2
Group 3,RRG,-0.5,11,14,2817,6,2016,5,1
Group 3,RRG,-0.5,11,14,2818,6,2016,7,-1
Group 3,RRG,-0.5,11,14,2819,9,2016,9,0
Group 3,RRG,-0.5,11,14,2820,4,2016,10,-6
Group 3,RRG,-0.5,11,14,2821,9,2016,6,3
Group 3,RRG,-0.5,11,14,2822,1,2016,7,-6
Group 3,RRG,-0.5,11,14,2823,10,2016,8,2
Group 3,RRG,-0.5,11,14,2824,13,2016,7,6
Group 3,RRG,-0.5,11,14,2825,10,2016,8,2
Group 3,RRG,-0.5,11,14,2826,9,2016,9,0
Group 3,RRG,-0.5,11,14,2827,9,2016,9,0
Group 3,RRG,-0.5,11,14,2828,10,2016,12,-2
Group 3,RRG,-0.5,11,14,2829,11,2016,7,4
Group 3,RRG,-0.5,11,14,2830,7,2016,9,-2
Group 3,RRG,-0.5,11,14,2831,5,2016,5,0
Group 3,RRG,-0.5,11,14,2832,3,2016,7,-4
Group 3,RRG,-0.5,11,14,2833,8,2016,7,1
Group 3,RRG,-0.5,11,14,2834,6,2016,10,-4
Group 3,RRG,-0.5,11,14,2835,9,2016,7,2
Group 3,RRG,-0.5,11,14,2836,10,2016,10,0
Group 3,RRG,-0.5,11,14,2837,10,2016,9,1
Group 3,RRG,-0.5,11,14,2838,9,2016,11,-2
Group 3,RRG,-0.5,11,14,2839,14,2016,10,4
Group 3,RRG,-0.5,11,14,2840,3,2016,6,-3
Group 3,RRG,-0.5,11,14,2841,8,2016,8,0
Group 3,RRG,-0.5,11,14,2842,10,2016,8,2
Group 3,RRG,-0.5,11,14,2843,11,2016,13,-2
Group 3,RRG,-0.5,11,14,2844,11,2016,11,0
Group 3,RRG,-0.5,11,14,2845,13,2016,11,2
Group 3,RRG,-0.5,11,14,2846,10,2016,12,-2
Group 3,RRG,-0.5,11,14,2847,11,2016,8,3
Group 3,RRG,-0.5,11,14,2848,10,2016,10,0
Group 3,RRG,-0.5,11,14,2849,9,2016,7,2
Group 3,RRG,-0.5,11,14,2850,8,2016,9,-1
Group 3,RRG,-0.5,11,14,2851,7,2016,4,3
Group 3,RRG,-0.5,11,14,2852,8,2016,11,-3
Group 3,RRG,-0.5,11,14,2853,7,2016,5,2
Group 3,RRG,-0.5,11,14,2854,13,2016,10,3
Group 3,RRG,-0.5,11,14,2855,8,2016,11,-3
Group 3,RRG,-0.5,11,14,2856,5,2016,7,-2
Group 3,RRG,-0.5,11,14,2857,5,2016,3,2
Group 3,RRG,-0.5,11,14,2858,11,2016,11,0
Group 3,RRG,-0.5,11,14,2859,3,2016,9,-6
Group 3,RRG,-0.5,11,14,2860,7,2016,6,1
Group 3,RRG,-0.5,11,14,2861,5,2016,4,1
Group 3,RRG,-0.5,11,14,2862,6,2016,7,-1
Group 3,RRG,-0.5,11,14,2863,10,2016,6,4
Group 3,RRG,-0.5,11,14,2864,9,2016,7,2
Group 3,RRG,-0.5,11,14,2865,5,2016,12,-7
Group 3,RRG,-0.5,11,14,2866,9,2016,5,4
Group 3,RRG,-0.5,11,14,2867,9,2016,7,2
Group 3,RRG,-0.5,11,14,2868,10,2016,9,1
Group 3,RRG,-0.5,11,14,2869,7,2016,7,0
Group 3,RRG,-0.5,11,14,2870,7,2016,11,-4
Group 3,RRG,-0.5,11,14,2871,7,2016,8,-1
Group 3,RRG,-0.5,11,14,2872,6,2016,9,-3
Group 3,RRG,-0.5,11,14,2873,3,2016,6,-3
Group 3,RRG,-0.5,11,14,2874,5,2016,7,-2
Group 3,RRG,-0.5,11,14,2875,10,2016,8,2
Group 3,RRG,-0.5,11,14,2876,12,2016,10,2
Group 3,RRG,-0.5,11,14,2877,14,2016,11,3
Group 3,RRG,-0.5,11,14,2878,11,2016,11,0
Group 3,RRG,-0.5,11,14,2879,14,2016,13,1
Group 3,RRG,-0.5,11,14,2880,9,2016,9,0
Group 3,RRG,-0.5,11,14,2881,8,2016,8,0
Group 3,RRG,-0.5,11,14,2882,7,2016,10,-3
Group 3,RRG,-0.5,11,14,2883,7,2016,7,0
Group 3,RRG,-0.5,11,14,2884,9,2016,10,-1
Group 3,RRG,-0.5,11,14,2885,8,2016,5,3
Group 3,RRG,-0.5,11,14,2886,11,2016,11,0
Group 3,RRG,-0.5,11,14,2887,11,2016,9,2
Group 3,RRG,-0.5,11,14,2888,13,2016,11,2
Group 3,RRG,-0.5,11,14,2889,7,2016,5,2
Group 3,RRG,-0.5,11,14,2890,7,2016,10,-3
Group 3,RRG,-0.5,11,14,2891,7,2016,6,1
Group 3,RRG,-0.5,11,14,2892,10,2016,7,3
Group 3,RRG,-0.5,11,14,2893,11,2016,6,5
Group 3,RRG,-0.5,11,14,2894,10,2016,6,4
Group 3,RRG,-0.5,11,14,2895,7,2016,8,-1
Group 3,RRG,-0.5,11,14,2896,12,2016,8,4
Group 3,RRG,-0.5,11,14,2897,10,2016,10,0
Group 3,RRG,-0.5,11,14,2898,5,2016,6,-1
Group 3,RRG,-0.5,11,14,2899,7,2016,6,1
Group 3,RRG,-0.5,11,14,2900,2,2016,12,-10
Group 3,RRG,-0.5,11,14,2901,5,2016,6,-1
Group 3,RRG,-0.5,11,14,2902,12,2016,9,3
Group 3,RRG,-0.5,11,14,2903,11,2016,9,2
Group 3,RRG,-0.5,11,14,2904,12,2016,10,2
Group 3,RRG,-0.5,11,14,2905,11,2016,10,1
Group 3,RRG,-0.5,11,14,2906,12,2016,10,2
Group 3,RRG,-0.5,11,14,2907,10,2016,8,2
Group 3,RRG,-0.5,11,14,2908,8,2016,6,2
Group 3,RRG,-0.5,11,14,2909,10,2016,10,0
Group 3,RRG,-0.5,11,14,2910,8,2016,4,4
Group 3,RRG,-0.5,11,14,2911,5,2016,10,-5
Group 3,RRG,-0.5,11,14,2912,8,2016,7,1
Group 3,RRG,-0.5,11,14,2913,9,2016,9,0
Group 3,RRG,-0.5,11,14,2914,10,2016,12,-2
Group 3,RRG,-0.5,11,14,2915,7,2016,8,-1
Group 3,RRG,-0.5,11,14,2916,8,2016,9,-1
Group 3,RRG,-0.5,11,14,2917,6,2016,8,-2
Group 3,RRG,-0.5,11,14,2918,9,2016,9,0
Group 3,RRG,-0.5,11,14,2919,12,2016,13,-1
Group 3,RRG,-0.5,11,14,2920,10,2016,12,-2
Group 3,RRG,-0.5,11,14,2921,12,2016,9,3
Group 3,RRG,-0.5,11,14,2922,13,2016,8,5
Group 3,RRG,-0.5,11,14,2923,11,2016,11,0
Group 3,RRG,-0.5,11,14,2924,13,2016,8,5
Group 3,RRG,-0.5,11,14,2925,8,2016,10,-2
Group 3,RRG,-0.5,11,14,2926,10,2016,10,0
Group 3,RRG,-0.5,11,14,2927,9,2016,4,5
Group 3,RRG,-0.5,11,14,2928,10,2016,10,0
Group 3,RRG,-0.5,11,14,2929,7,2016,6,1
Group 3,RRG,-0.5,11,14,2930,9,2016,8,1
Group 3,RRG,-0.5,11,14,2931,6,2016,7,-1
Group 3,RRG,-0.5,11,14,2932,7,2016,7,0
Group 3,RRG,-0.5,11,14,2933,7,2016,9,-2
Group 3,RRG,-0.5,11,14,2934,7,2016,7,0
Group 3,RRG,-0.5,11,14,2935,8,2016,10,-2
Group 3,RRG,-0.5,11,14,2936,12,2016,10,2
Group 3,RRG,-0.5,11,14,2937,10,2016,6,4
Group 3,RRG,-0.5,11,14,2938,12,2016,9,3
Group 3,RRG,-0.5,11,14,2939,11,2016,10,1
Group 3,RRG,-0.5,11,14,2940,8,2016,7,1
Group 3,RRG,-0.5,11,14,2941,7,2016,5,2
Group 3,RRG,-0.5,11,14,2942,5,2016,5,0
Group 3,RRG,-0.5,11,14,2943,5,2016,7,-2
Group 3,RRG,-0.5,11,14,2944,11,2016,6,5
Group 3,RRG,-0.5,11,14,2945,8,2016,6,2
Group 3,RRG,-0.5,11,14,2946,5,2016,7,-2
Group 3,RRG,-0.5,11,14,2947,8,2016,5,3
Group 3,RRG,-0.5,11,14,2948,6,2016,6,0
Group 3,RRG,-0.5,11,14,2949,10,2016,8,2
Group 3,RRG,-0.5,11,14,2950,10,2016,4,6
Group 3,RRG,-0.5,11,14,2951,8,2016,11,-3
Group 3,RRG,-0.5,11,14,2952,8,2016,5,3
Group 3,RRG,-0.5,11,14,2953,8,2016,9,-1
Group 3,RRG,-0.5,11,14,2954,8,2016,7,1
Group 3,RRG,-0.5,11,14,2955,11,2016,10,1
Group 3,RRG,-0.5,11,14,2956,10,2016,13,-3
Group 3,RRG,-0.5,11,14,2957,10,2016,9,1
Group 3,RRG,-0.5,11,14,2958,6,2016,10,-4
Group 3,RRG,-0.5,11,14,2959,7,2016,8,-1
Group 3,RRG,-0.5,11,14,2960,6,2016,3,3
Group 3,RRG,-0.5,11,14,2961,6,2016,6,0
Group 3,RRG,-0.5,11,14,2962,11,2016,10,1
Group 3,RRG,-0.5,11,14,2963,9,2016,9,0
Group 3,RRG,-0.5,11,14,2964,7,2016,9,-2
Group 3,RRG,-0.5,11,14,2965,10,2016,7,3
Group 3,RRG,-0.5,11,14,2966,8,2016,5,3
Group 3,RRG,-0.5,11,14,2967,11,2016,7,4
Group 3,RRG,-0.5,11,14,2968,11,2016,6,5
Group 3,RRG,-0.5,11,14,2969,12,2016,11,1
Group 3,RRG,-0.5,11,14,2970,10,2016,8,2
Group 3,RRG,-0.5,11,14,2971,7,2016,7,0
Group 3,RRG,-0.5,11,14,2972,11,2016,9,2
Group 3,RRG,-0.5,11,14,2973,10,2016,10,0
Group 3,RRG,-0.5,11,14,2974,10,2016,9,1
Group 3,RRG,-0.5,11,14,2975,8,2016,8,0
Group 3,RRG,-0.5,11,14,2976,8,2016,8,0
Group 3,RRG,-0.5,11,14,2977,8,2016,10,-2
Group 3,RRG,-0.5,11,14,2978,8,2016,8,0
Group 3,RRG,-0.5,11,14,2979,10,2016,9,1
Group 3,RRG,-0.5,11,14,2980,7,2016,9,-2
Group 3,RRG,-0.5,11,14,2981,5,2016,5,0
Group 3,RRG,-0.5,11,14,2982,7,2016,4,3
Group 3,RRG,-0.5,11,14,2983,11,2016,8,3
Group 3,RRG,-0.5,11,14,2984,5,2016,1,4
Group 3,RRG,-0.5,11,14,2985,6,2016,10,-4
Group 3,RRG,-0.5,11,14,2986,7,2016,7,0
Group 3,RRG,-0.5,11,14,2987,4,2016,1,3
Group 3,RRG,-0.5,11,14,2988,4,2016,5,-1
Group 3,RRG,-0.5,11,14,2989,10,2016,6,4
Group 3,RRG,-0.5,11,14,2990,13,2016,8,5
Group 3,RRG,-0.5,11,14,2991,7,2016,9,-2
Group 3,RRG,-0.5,11,14,2992,11,2016,8,3
Group 3,RRG,-0.5,11,14,2993,11,2016,8,3
Group 3,RRG,-0.5,11,14,2994,9,2016,5,4
Group 3,RRG,-0.5,11,14,2995,9,2016,7,2
Group 3,RRG,-0.5,11,14,2996,6,2016,6,0
Group 3,RRG,-0.5,11,14,2997,5,2016,6,-1
Group 3,RRG,-0.5,11,14,2998,4,2016,5,-1
Group 3,RRG,-0.5,11,14,2999,7,2016,8,-1
Group 3,RRG,-0.5,11,14,3000,3,2016,8,-5
Group 3,RRG,-0.5,11,14,3001,8,2016,8,0
Group 3,RRG,-0.5,11,14,3002,8,2016,11,-3
Group 3,RRG,-0.5,11,14,3003,3,2016,6,-3
Group 3,RRG,-0.5,11,14,3004,11,2016,10,1
Group 3,RRG,-0.5,11,14,3005,11,2016,7,4
Group 3,RRG,-0.5,11,14,3006,9,2016,10,-1
Group 3,RRG,-0.5,11,14,3007,9,2016,10,-1
Group 3,RRG,-0.5,11,14,3008,1,2016,7,-6
Group 3,RRG,-0.5,11,14,3009,11,2016,12,-1
Group 3,RRG,-0.5,11,14,3010,13,2016,10,3
Group 3,RRG,-0.5,11,14,3011,6,2016,9,-3
Group 3,RRG,-0.5,11,14,3012,5,2016,8,-3
Group 3,RRG,-0.5,11,14,3013,12,2016,10,2
Group 3,RRG,-0.5,11,14,3014,11,2016,7,4
Group 3,RRG,-0.5,11,14,3015,12,2016,10,2
Group 3,RRG,-0.5,11,14,3016,10,2016,11,-1
Group 3,RRG,-0.5,11,14,3017,5,2016,8,-3
Group 3,RRG,-0.5,11,14,3018,8,2016,9,-1
Group 3,RRG,-0.5,11,14,3019,6,2016,9,-3
Group 3,RRG,-0.5,11,14,3020,10,2016,9,1
Group 3,RRG,-0.5,11,14,3021,10,2016,9,1
Group 3,RRG,-0.5,11,14,3022,7,2016,10,-3
Group 3,RRG,-0.5,11,14,3023,5,2016,7,-2
Group 3,RRG,-0.5,11,14,3024,4,2016,11,-7
Group 3,RRG,-0.5,11,14,3025,8,2016,10,-2
Group 3,RRG,-0.5,11,14,3026,7,2016,8,-1
Group 3,RRG,-0.5,11,14,3027,11,2016,7,4
Group 3,RRG,-0.5,11,14,3028,9,2016,8,1
Group 3,RRG,-0.5,11,14,3029,5,2016,10,-5
Group 3,RRG,-0.5,11,14,3030,6,2016,8,-2
Group 3,RRG,-0.5,11,14,3031,7,2016,8,-1
Group 3,RRG,-0.5,11,14,3032,9,2016,7,2
Group 3,RRG,-0.5,11,14,3033,10,2016,10,0
Group 3,RRG,-0.5,11,14,3034,11,2016,9,2
Group 3,RRG,-0.5,11,14,3035,7,2016,9,-2
Group 3,RRG,-0.5,11,14,3036,12,2016,6,6
Group 3,RRG,-0.5,11,14,3037,12,2016,7,5
Group 3,RRG,-0.5,11,14,3038,9,2016,7,2
Group 3,RRG,-0.5,11,14,3039,8,2016,11,-3
Group 3,RRG,-0.5,11,14,3040,7,2016,8,-1
Group 3,RRG,-0.5,11,14,3041,8,2016,6,2
Group 3,RRG,-0.5,11,14,3042,5,2016,1,4
Group 3,RRG,-0.5,11,14,3043,13,2016,13,0
Group 3,RRG,-0.5,11,14,3044,13,2016,10,3
Group 3,RRG,-0.5,11,14,3045,6,2016,2,4
Group 3,RRG,-0.5,11,14,3046,7,2016,9,-2
Group 3,RRG,-0.5,11,14,3047,11,2016,6,5
Group 3,RRG,-0.5,11,14,3048,8,2016,7,1
Group 3,RRG,-0.5,11,14,3049,10,2016,8,2
Group 3,RRG,-0.5,11,14,3050,4,2016,11,-7
Group 3,RRG,-0.5,11,14,3051,7,2016,6,1
Group 3,RRG,-0.5,11,14,3052,6,2016,10,-4
Group 3,RRG,-0.5,11,14,3053,11,2016,11,0
Group 3,RRG,-0.5,11,14,3054,8,2016,11,-3
Group 3,RRG,-0.5,11,14,3055,10,2016,10,0
Group 3,RRG,-0.5,11,14,3056,13,2016,8,5
Group 3,RRG,-0.5,11,14,3057,11,2016,9,2
Group 3,RRG,-0.5,11,14,3058,14,2016,8,6
Group 3,RRG,-0.5,11,14,3059,11,2016,11,0
Group 3,RRG,-0.5,11,14,3060,12,2016,11,1
Group 3,RRG,-0.5,11,14,3061,10,2016,9,1
Group 3,RRG,-0.5,11,14,3062,6,2016,8,-2
Group 3,RRG,-0.5,11,14,3063,7,2016,8,-1
Group 3,RRG,-0.5,11,14,3064,6,2016,2,4
Group 3,RRG,-0.5,11,14,3065,11,2016,9,2
Group 3,RRG,-0.5,11,14,3066,10,2016,7,3
Group 3,RRG,-0.5,11,14,3067,11,2016,7,4
Group 3,RRG,-0.5,11,14,3068,12,2016,9,3
Group 3,RRG,-0.5,11,14,3069,8,2016,9,-1
Group 3,RRG,-0.5,11,14,3070,10,2016,8,2
Group 3,RRG,-0.5,11,14,3071,10,2016,9,1
Group 3,RRG,-0.5,11,14,3072,7,2016,10,-3
Group 3,RRG,-0.5,11,14,3073,6,2016,7,-1
Group 3,RRG,-0.5,11,14,3074,8,2016,9,-1
Group 3,RRG,-0.5,11,14,3075,2,2016,10,-8
Group 3,RRG,-0.5,11,14,3076,9,2016,4,5
Group 3,RRG,-0.5,11,14,3077,5,2016,4,1
Group 3,RRG,-0.5,11,14,3078,7,2016,5,2
Group 3,RRG,-0.5,11,14,3079,8,2016,12,-4
Group 3,RRG,-0.5,11,14,3080,7,2016,12,-5
Group 3,RRG,-0.5,11,14,3081,6,2016,9,-3
Group 3,RRG,-0.5,11,14,3082,7,2016,12,-5
Group 3,RRG,-0.5,11,14,3083,11,2016,7,4
Group 3,RRG,-0.5,11,14,3084,13,2016,12,1
Group 3,RRG,-0.5,11,14,3085,10,2016,8,2
Group 3,RRG,-0.5,11,14,3086,11,2016,10,1
Group 3,RRG,-0.5,11,14,3087,7,2016,11,-4
Group 3,RRG,-0.5,11,14,3088,10,2016,8,2
Group 3,RRG,-0.5,11,14,3089,3,2016,7,-4
Group 3,RRG,-0.5,11,14,3090,7,2016,5,2
Group 3,RRG,-0.5,11,14,3091,3,2016,9,-6
Group 3,RRG,-0.5,11,14,3092,6,2016,10,-4
Group 3,RRG,-0.5,11,14,3093,11,2016,9,2
Group 3,RRG,-0.5,11,14,3094,5,2016,5,0
Group 3,RRG,-0.5,11,14,3095,10,2016,12,-2
Group 3,RRG,-0.5,11,14,3096,11,2016,12,-1
Group 3,RRG,-0.5,11,14,3097,8,2016,7,1
Group 3,RRG,-0.5,11,14,3098,9,2016,6,3
Group 3,RRG,-0.5,11,14,3099,5,2016,6,-1
Group 3,RRG,-0.5,11,14,3100,5,2016,6,-1
Group 3,RRG,-0.5,11,14,3101,12,2016,11,1
Group 3,RRG,-0.5,11,14,3102,6,2016,6,0
Group 3,RRG,-0.5,11,14,3103,9,2016,11,-2
Group 3,RRG,-0.5,11,14,3104,9,2016,9,0
Group 3,RRG,-0.5,11,14,3105,12,2016,10,2
Group 3,RRG,-0.5,11,14,3106,8,2016,10,-2
Group 3,RRG,-0.5,11,14,3107,8,2016,12,-4
Group 3,RRG,-0.5,11,14,3108,8,2016,12,-4
Group 3,RRG,-0.5,11,14,3109,11,2016,10,1
Group 3,RRG,-0.5,11,14,3110,6,2016,9,-3
Group 3,RRG,-0.5,11,14,3111,10,2016,6,4
Group 3,RRG,-0.5,11,14,3112,6,2016,9,-3
Group 3,RRG,-0.5,11,14,3113,4,2016,6,-2
Group 3,RRG,-0.5,11,14,3114,9,2016,9,0
Group 3,RRG,-0.5,11,14,3115,8,2016,6,2
Group 3,RRG,-0.5,11,14,3116,4,2016,6,-2
Group 3,RRG,-0.5,11,14,3117,10,2016,9,1
Group 3,RRG,-0.5,11,14,3118,8,2016,10,-2
Group 3,RRG,-0.5,11,14,3119,11,2016,9,2
Group 3,RRG,-0.5,11,14,3120,10,2016,7,3
Group 3,RRG,-0.5,11,14,3121,12,2016,8,4
Group 3,RRG,-0.5,11,14,3122,8,2016,5,3
Group 3,RRG,-0.5,11,14,3123,10,2016,11,-1
Group 3,RRG,-0.5,11,14,3124,10,2016,6,4
Group 3,RRG,-0.5,11,14,3125,12,2016,12,0
Group 3,RRG,-0.5,11,14,3126,6,2016,9,-3
Group 3,RRG,-0.5,11,14,3127,10,2016,6,4
Group 3,RRG,-0.5,11,14,3128,6,2016,6,0
Group 3,RRG,-0.5,11,14,3129,5,2016,9,-4
Group 3,RRG,-0.5,11,14,3130,9,2016,1,8
Group 3,RRG,-0.5,11,14,3131,7,2016,10,-3
Group 3,RRG,-0.5,11,14,3132,12,2016,9,3
Group 3,RRG,-0.5,11,14,3133,10,2016,6,4
Group 3,RRG,-0.5,11,14,3134,9,2016,8,1
Group 3,RRG,-0.5,11,14,3135,8,2016,5,3
Group 3,RRG,-0.5,11,14,3136,7,2016,4,3
Group 3,RRG,-0.5,11,14,3137,7,2016,5,2
Group 3,RRG,-0.5,11,14,3138,7,2016,6,1
Group 3,RRG,-0.5,11,14,3139,6,2016,9,-3
Group 3,RRG,-0.5,11,14,3140,4,2016,6,-2
Group 3,RRG,-0.5,11,14,3141,5,2016,4,1
Group 3,RRG,-0.5,11,14,3142,10,2016,7,3
Group 3,RRG,-0.5,11,14,3143,4,2016,9,-5
Group 3,RRG,-0.5,11,14,3144,14,2016,11,3
Group 3,RRG,-0.5,11,14,3145,14,2016,10,4
Group 3,RRG,-0.5,11,14,3146,13,2016,8,5
Group 3,RRG,-0.5,11,14,3147,8,2016,8,0
Group 3,RRG,-0.5,11,14,3148,7,2016,14,-7
Group 3,RRG,-0.5,11,14,3149,6,2016,8,-2
Group 3,RRG,-0.5,11,14,3150,9,2016,10,-1
Group 3,RRG,-0.5,11,14,3151,13,2016,7,6
Group 3,RRG,-0.5,11,14,3152,12,2016,10,2
Group 3,RRG,-0.5,11,14,3153,7,2016,8,-1
Group 3,RRG,-0.5,11,14,3154,6,2016,7,-1
Group 3,RRG,-0.5,11,14,3155,9,2016,12,-3
Group 3,RRG,-0.5,11,14,3156,9,2016,10,-1
Group 3,RRG,-0.5,11,14,3157,9,2016,10,-1
Group 3,RRG,-0.5,11,14,3158,6,2016,7,-1
Group 3,RRG,-0.5,11,14,3159,6,2016,8,-2
Group 3,RRG,-0.5,11,14,3160,8,2016,11,-3
Group 3,RRG,-0.5,11,14,3161,6,2016,2,4
Group 3,RRG,-0.5,11,14,3162,11,2016,9,2
Group 3,RRG,-0.5,11,14,3163,12,2016,5,7
Group 3,RRG,-0.5,11,14,3164,8,2016,9,-1
Group 3,RRG,-0.5,11,14,3165,8,2016,6,2
Group 3,RRG,-0.5,11,14,3166,7,2016,7,0
Group 3,RRG,-0.5,11,14,3167,4,2016,7,-3
Group 3,RRG,-0.5,11,14,3168,9,2016,8,1
Group 3,RRG,-0.5,11,14,3169,8,2016,9,-1
Group 3,RRG,-0.5,11,14,3170,7,2016,9,-2
Group 3,RRG,-0.5,11,14,3171,5,2016,5,0
Group 3,RRG,-0.5,11,14,3172,5,2016,6,-1
Group 3,RRG,-0.5,11,14,3173,6,2016,7,-1
Group 3,RRG,-0.5,11,14,3174,8,2016,9,-1
Group 3,RRG,-0.5,11,14,3175,13,2016,5,8
Group 3,RRG,-0.5,11,14,3176,9,2016,8,1
Group 3,RRG,-0.5,11,14,3177,10,2016,11,-1
Group 3,RRG,-0.5,11,14,3178,13,2016,12,1
Group 3,RRG,-0.5,11,14,3179,6,2016,12,-6
Group 3,RRG,-0.5,11,14,3180,9,2016,10,-1
Group 3,RRG,-0.5,11,14,3181,10,2016,9,1
Group 3,RRG,-0.5,11,14,3182,12,2016,7,5
Group 3,RRG,-0.5,11,14,3183,7,2016,11,-4
Group 3,RRG,-0.5,11,14,3184,10,2016,8,2
Group 3,RRG,-0.5,11,14,3185,8,2016,11,-3
Group 3,RRG,-0.5,11,14,3186,11,2016,9,2
Group 3,RRG,-0.5,11,14,3187,10,2016,9,1
Group 3,RRG,-0.5,11,14,3188,8,2016,6,2
Group 3,RRG,-0.5,11,14,3189,14,2016,8,6
Group 3,RRG,-0.5,11,14,3190,11,2016,9,2
Group 3,RRG,-0.5,11,14,3191,11,2016,4,7
Group 3,RRG,-0.5,11,14,3192,8,2016,5,3
Group 3,RRG,-0.5,11,14,3193,9,2016,9,0
Group 3,RRG,-0.5,11,14,3194,13,2016,11,2
Group 3,RRG,-0.5,11,14,3195,5,2016,7,-2
Group 3,RRG,-0.5,11,14,3196,8,2016,11,-3
Group 3,RRG,-0.5,11,14,3197,6,2016,9,-3
Group 3,RRG,-0.5,11,14,3198,10,2016,9,1
Group 3,RRG,-0.5,11,14,3199,7,2016,9,-2
Group 3,RRG,-0.5,11,14,3200,4,2016,11,-7
Group 3,RRG,-0.5,11,14,3201,9,2016,9,0
Group 3,RRG,-0.5,11,14,3202,9,2016,10,-1
Group 3,RRG,-0.5,11,14,3203,14,2016,10,4
Group 3,RRG,-0.5,11,14,3204,10,2016,10,0
Group 3,RRG,-0.5,11,14,3205,10,2016,5,5
Group 3,RRG,-0.5,11,14,3206,8,2016,11,-3
Group 3,RRG,-0.5,11,14,3207,7,2016,8,-1
Group 3,RRG,-0.5,11,14,3208,5,2016,8,-3
Group 3,RRG,-0.5,11,14,3209,12,2016,9,3
Group 3,RRG,-0.5,11,14,3210,3,2016,8,-5
Group 3,RRG,-0.5,11,14,3211,13,2016,9,4
Group 3,RRG,-0.5,11,14,3212,5,2016,10,-5
Group 3,RRG,-0.5,11,14,3213,12,2016,11,1
Group 3,RRG,-0.5,11,14,3214,11,2016,8,3
Group 3,RRG,-0.5,11,14,3215,7,2016,12,-5
Group 3,RRG,-0.5,11,14,3216,9,2016,6,3
Group 3,RRG,-0.5,11,14,3217,11,2016,8,3
Group 3,RRG,-0.5,11,14,3218,10,2016,7,3
Group 3,RRG,-0.5,11,14,3219,6,2016,6,0
Group 3,RRG,-0.5,11,14,3220,5,2016,6,-1
Group 3,RRG,-0.5,11,14,3221,6,2016,4,2
Group 3,RRG,-0.5,11,14,3222,11,2016,12,-1
Group 3,RRG,-0.5,11,14,3223,5,2016,9,-4
Group 3,RRG,-0.5,11,14,3224,8,2016,9,-1
Group 3,RRG,-0.5,11,14,3225,2,2016,9,-7
Group 3,RRG,-0.5,11,14,3226,10,2016,11,-1
Group 3,RRG,-0.5,11,14,3227,12,2016,7,5
Group 3,RRG,-0.5,11,14,3228,3,2016,5,-2
Group 3,RRG,-0.5,11,14,3229,12,2016,9,3
Group 3,RRG,-0.5,11,14,3230,8,2016,10,-2
Group 3,RRG,-0.5,11,14,3231,12,2016,10,2
Group 3,RRG,-0.5,11,14,3232,7,2016,4,3
Group 3,RRG,-0.5,11,14,3233,11,2016,11,0
Group 3,RRG,-0.5,11,14,3234,4,2016,7,-3
Group 3,RRG,-0.5,11,14,3235,11,2016,9,2
Group 3,RRG,-0.5,11,14,3236,11,2016,12,-1
Group 3,RRG,-0.5,11,14,3237,12,2016,8,4
Group 3,RRG,-0.5,11,14,3238,12,2016,9,3
Group 3,RRG,-0.5,11,14,3239,10,2016,11,-1
Group 3,RRG,-0.5,11,14,3240,7,2016,10,-3
Group 3,RRG,-0.5,11,14,3241,10,2016,9,1
Group 3,RRG,-0.5,11,14,3242,9,2016,10,-1
Group 3,RRG,-0.5,11,14,3243,11,2016,8,3
Group 3,RRG,-0.5,11,14,3244,9,2016,8,1
Group 3,RRG,-0.5,11,14,3245,10,2016,8,2
Group 3,RRG,-0.5,11,14,3246,11,2016,9,2
Group 3,RRG,-0.5,11,14,3247,10,2016,14,-4
Group 3,RRG,-0.5,11,14,3248,10,2016,11,-1
Group 3,RRG,-0.5,11,14,3249,9,2016,8,1
Group 3,RRG,-0.5,11,14,3250,9,2016,9,0
Group 3,RRG,-0.5,11,14,3251,11,2016,6,5
Group 3,RRG,-0.5,11,14,3252,5,2016,11,-6
Group 3,RRG,-0.5,11,14,3253,9,2016,5,4
Group 3,RRG,-0.5,11,14,3254,10,2016,11,-1
Group 3,RRG,-0.5,11,14,3255,10,2016,9,1
Group 3,RRG,-0.5,11,14,3256,13,2016,9,4
Group 3,RRG,-0.5,11,14,3257,6,2016,12,-6
Group 3,RRG,-0.5,11,14,3258,6,2016,6,0
Group 3,RRG,-0.5,11,14,3259,4,2016,10,-6
Group 3,RRG,-0.5,11,14,3260,6,2016,7,-1
Group 3,RRG,-0.5,11,14,3261,5,2016,7,-2
Group 3,RRG,-0.5,11,14,3262,10,2016,9,1
Group 3,RRG,-0.5,11,14,3263,9,2016,7,2
Group 3,RRG,-0.5,11,14,3264,6,2016,8,-2
Group 3,RRG,-0.5,11,14,3265,9,2016,4,5
Group 3,RRG,-0.5,11,14,3266,7,2016,4,3
Group 3,RRG,-0.5,11,14,3267,8,2016,7,1
Group 3,RRG,-0.5,11,14,3268,9,2016,8,1
Group 3,RRG,-0.5,11,14,3269,12,2016,7,5
Group 3,RRG,-0.5,11,14,3270,8,2016,9,-1
Group 3,RRG,-0.5,11,14,3271,9,2016,10,-1
Group 3,RRG,-0.5,11,14,3272,13,2016,10,3
Group 3,RRG,-0.5,11,14,3273,11,2016,10,1
Group 3,RRG,-0.5,11,14,3274,9,2016,9,0
Group 3,RRG,-0.5,11,14,3275,10,2016,13,-3
Group 3,RRG,-0.5,11,14,3276,9,2016,5,4
Group 3,RRG,-0.5,11,14,3277,8,2016,6,2
Group 3,RRG,-0.5,11,14,3278,9,2016,6,3
Group 3,RRG,-0.5,11,14,3279,11,2016,8,3
Group 3,RRG,-0.5,11,14,3280,8,2016,4,4
Group 3,RRG,-0.5,11,14,3281,11,2016,8,3
Group 3,RRG,-0.5,11,14,3282,11,2016,8,3
Group 3,RRG,-0.5,11,14,3283,7,2016,7,0
Group 3,RRG,-0.5,11,14,3284,9,2016,12,-3
Group 3,RRG,-0.5,11,14,3285,13,2016,13,0
Group 3,RRG,-0.5,11,14,3286,5,2016,3,2
Group 3,RRG,-0.5,11,14,3287,9,2016,6,3
Group 3,RRG,-0.5,11,14,3288,10,2016,14,-4
Group 3,RRG,-0.5,11,14,3289,11,2016,11,0
Group 3,RRG,-0.5,11,14,3290,4,2016,5,-1
Group 3,RRG,-0.5,11,14,3291,4,2016,4,0
Group 3,RRG,-0.5,11,14,3292,2,2016,1,1
Group 3,RRG,-0.5,11,14,3293,7,2016,9,-2
Group 3,RRG,-0.5,11,14,3294,6,2016,7,-1
Group 3,RRG,-0.5,11,14,3295,7,2016,9,-2
Group 3,RRG,-0.5,11,14,3296,4,2016,4,0
Group 3,RRG,-0.5,11,14,3297,10,2016,7,3
Group 3,RRG,-0.5,11,14,3298,12,2016,10,2
Group 3,RRG,-0.5,11,14,3299,9,2016,6,3
Group 3,RRG,-0.5,11,14,3300,13,2016,12,1
Group 3,RRG,-0.5,11,14,3301,1,2016,9,-8
Group 3,RRG,-0.5,11,14,3302,8,2016,12,-4
Group 3,RRG,-0.5,11,14,3303,5,2016,5,0
Group 3,RRG,-0.5,11,14,3304,7,2016,11,-4
Group 3,RRG,-0.5,11,14,3305,6,2016,3,3
Group 3,RRG,-0.5,11,14,3306,1,2016,4,-3
Group 3,RRG,-0.5,11,14,3307,12,2016,13,-1
Group 3,RRG,-0.5,11,14,3308,7,2016,5,2
Group 3,RRG,-0.5,11,14,3309,11,2016,7,4
Group 3,RRG,-0.5,11,14,3310,11,2016,10,1
Group 3,RRG,-0.5,11,14,3311,11,2016,11,0
Group 3,RRG,-0.5,11,14,3312,10,2016,3,7
Group 3,RRG,-0.5,11,14,3313,10,2016,8,2
Group 3,RRG,-0.5,11,14,3314,9,2016,8,1
Group 3,RRG,-0.5,11,14,3315,7,2016,8,-1
Group 3,RRG,-0.5,11,14,3316,10,2016,10,0
Group 3,RRG,-0.5,11,14,3317,9,2016,5,4
Group 3,RRG,-0.5,11,14,3318,8,2016,7,1
Group 3,RRG,-0.5,11,14,3319,6,2016,12,-6
Group 3,RRG,-0.5,11,14,3320,10,2016,6,4
Group 3,RRG,-0.5,11,14,3321,7,2016,11,-4
Group 3,RRG,-0.5,11,14,3322,6,2016,7,-1
Group 3,RRG,-0.5,11,14,3323,6,2016,6,0
Group 3,RRG,-0.5,11,14,3324,2,2016,5,-3
Group 3,RRG,-0.5,11,14,3325,7,2016,8,-1
Group 3,RRG,-0.5,11,14,3326,12,2016,9,3
Group 3,RRG,-0.5,11,14,3327,8,2016,7,1
Group 3,RRG,-0.5,11,14,3328,4,2016,7,-3
Group 3,RRG,-0.5,11,14,3329,10,2016,8,2
Group 3,RRG,-0.5,11,14,3330,10,2016,9,1
Group 3,RRG,-0.5,11,14,3331,10,2016,9,1
Group 3,RRG,-0.5,11,14,3332,11,2016,5,6
Group 3,RRG,-0.5,11,14,3333,8,2016,8,0
Group 3,RRG,-0.5,11,14,3334,4,2016,8,-4
Group 3,RRG,-0.5,11,14,3335,8,2016,7,1
Group 3,RRG,-0.5,11,14,3336,11,2016,11,0
Group 3,RRG,-0.5,11,14,3337,8,2016,9,-1
Group 3,RRG,-0.5,11,14,3338,12,2016,9,3
Group 3,RRG,-0.5,11,14,3339,9,2016,11,-2
Group 3,RRG,-0.5,11,14,3340,10,2016,10,0
Group 3,RRG,-0.5,11,14,3341,9,2016,8,1
Group 3,RRG,-0.5,11,14,3342,12,2016,6,6
Group 3,RRG,-0.5,11,14,3343,8,2016,10,-2
Group 3,RRG,-0.5,11,14,3344,3,2016,9,-6
Group 3,RRG,-0.5,11,14,3345,7,2016,10,-3
Group 3,RRG,-0.5,11,14,3346,12,2016,7,5
Group 3,RRG,-0.5,11,14,3347,10,2016,10,0
Group 3,RRG,-0.5,11,14,3348,12,2016,9,3
Group 3,RRG,-0.5,11,14,3349,7,2016,10,-3
Group 3,RRG,-0.5,11,14,3350,5,2016,11,-6
Group 3,RRG,-0.5,11,14,3351,10,2016,10,0
Group 3,RRG,-0.5,11,14,3352,11,2016,9,2
Group 3,RRG,-0.5,11,14,3353,7,2016,7,0
Group 3,RRG,-0.5,11,14,3354,6,2016,9,-3
Group 3,RRG,-0.5,11,14,3355,12,2016,9,3
Group 3,RRG,-0.5,11,14,3356,5,2016,9,-4
Group 3,RRG,-0.5,11,14,3357,9,2016,12,-3
Group 3,RRG,-0.5,11,14,3358,8,2016,4,4
Group 3,RRG,-0.5,11,14,3359,4,2016,4,0
Group 3,RRG,-0.5,11,14,3360,8,2016,4,4
Group 3,RRG,-0.5,11,14,3361,13,2016,11,2
Group 3,RRG,-0.5,11,14,3362,10,2016,8,2
Group 3,RRG,-0.5,11,14,3363,8,2016,8,0
Group 3,RRG,-0.5,11,14,3364,6,2016,7,-1
Group 3,RRG,-0.5,11,14,3365,11,2016,12,-1
Group 3,RRG,-0.5,11,14,3366,7,2016,9,-2
Group 3,RRG,-0.5,11,14,3367,6,2016,10,-4
Group 3,RRG,-0.5,11,14,3368,9,2016,4,5
Group 3,RRG,-0.5,11,14,3369,6,2016,5,1
Group 3,RRG,-0.5,11,14,3370,9,2016,7,2
Group 3,RRG,-0.5,11,14,3371,8,2016,9,-1
Group 3,RRG,-0.5,11,14,3372,6,2016,3,3
Group 3,RRG,-0.5,11,14,3373,7,2016,9,-2
Group 3,RRG,-0.5,11,14,3374,9,2016,8,1
Group 3,RRG,-0.5,11,14,3375,12,2016,9,3
Group 3,RRG,-0.5,11,14,3376,10,2016,6,4
Group 3,RRG,-0.5,11,14,3377,10,2016,8,2
Group 3,RRG,-0.5,11,14,3378,6,2016,6,0
Group 3,RRG,-0.5,11,14,3379,2,2016,2,0
Group 3,RRG,-0.5,11,14,3380,12,2016,11,1
Group 3,RRG,-0.5,11,14,3381,10,2016,10,0
Group 3,RRG,-0.5,11,14,3382,14,2016,11,3
Group 3,RRG,-0.5,11,14,3383,6,2016,7,-1
Group 3,RRG,-0.5,11,14,3384,10,2016,5,5
Group 3,RRG,-0.5,11,14,3385,11,2016,10,1
Group 3,RRG,-0.5,11,14,3386,10,2016,9,1
Group 3,RRG,-0.5,11,14,3387,8,2016,11,-3
Group 3,RRG,-0.5,11,14,3388,11,2016,9,2
Group 3,RRG,-0.5,11,14,3389,4,2016,3,1
Group 3,RRG,-0.5,11,14,3390,12,2016,9,3
Group 3,RRG,-0.5,11,14,3391,13,2016,13,0
Group 3,RRG,-0.5,11,14,3392,8,2016,9,-1
Group 3,RRG,-0.5,11,14,3393,11,2016,11,0
Group 3,RRG,-0.5,11,14,3394,10,2016,12,-2
Group 3,RRG,-0.5,11,14,3395,9,2016,12,-3
Group 3,RRG,-0.5,11,14,3396,5,2016,9,-4
Group 3,RRG,-0.5,11,14,3397,6,2016,9,-3
Group 3,RRG,-0.5,11,14,3398,12,2016,8,4
Group 3,RRG,-0.5,11,14,3399,7,2016,7,0
Group 3,RRG,-0.5,11,14,3400,9,2016,10,-1
Group 3,RRG,-0.5,11,14,3401,10,2016,10,0
Group 3,RRG,-0.5,11,14,3402,6,2016,10,-4
Group 3,RRG,-0.5,11,14,3403,4,2016,11,-7
Group 3,RRG,-0.5,11,14,3404,3,2016,8,-5
Group 3,RRG,-0.5,11,14,3405,8,2016,5,3
Group 3,RRG,-0.5,11,14,3406,7,2016,6,1
Group 3,RRG,-0.5,11,14,3407,11,2016,4,7
Group 3,RRG,-0.5,11,14,3408,11,2016,6,5
Group 3,RRG,-0.5,11,14,3409,7,2016,6,1
Group 3,RRG,-0.5,11,14,3410,9,2016,9,0
Group 3,RRG,-0.5,11,14,3411,6,2016,8,-2
Group 3,RRG,-0.5,11,14,3412,9,2016,8,1
Group 3,RRG,-0.5,11,14,3413,8,2016,6,2
Group 3,RRG,-0.5,11,14,3414,8,2016,8,0
Group 3,RRG,-0.5,11,14,3415,8,2016,11,-3
Group 3,RRG,-0.5,11,14,3416,9,2016,12,-3
Group 3,RRG,-0.5,11,14,3417,8,2016,11,-3
Group 3,RRG,-0.5,11,14,3418,7,2016,7,0
Group 3,RRG,-0.5,11,14,3419,9,2016,6,3
Group 3,RRG,-0.5,11,14,3420,9,2016,9,0
Group 3,RRG,-0.5,11,14,3421,10,2016,8,2
Group 3,RRG,-0.5,11,14,3422,8,2016,10,-2
Group 3,RRG,-0.5,11,14,3423,14,2016,10,4
Group 3,RRG,-0.5,11,14,3424,13,2016,10,3
Group 3,RRG,-0.5,11,14,3425,13,2016,13,0
Group 3,RRG,-0.5,11,14,3426,9,2016,6,3
Group 3,RRG,-0.5,11,14,3427,9,2016,7,2
Group 3,RRG,-0.5,11,14,3428,9,2016,11,-2
Group 3,RRG,-0.5,11,14,3429,9,2016,9,0
Group 3,RRG,-0.5,11,14,3430,7,2016,8,-1
Group 3,RRG,-0.5,11,14,3431,12,2016,6,6
Group 3,RRG,-0.5,11,14,3432,11,2016,10,1
Group 3,RRG,-0.5,11,14,3433,8,2016,5,3
Group 3,RRG,-0.5,11,14,3434,9,2016,7,2
Group 3,RRG,-0.5,11,14,3435,8,2016,8,0
Group 3,RRG,-0.5,11,14,3436,10,2016,8,2
Group 3,RRG,-0.5,11,14,3437,7,2016,6,1
Group 3,RRG,-0.5,11,14,3438,9,2016,7,2
Group 3,RRG,-0.5,11,14,3439,7,2016,8,-1
Group 3,RRG,-0.5,11,14,3440,10,2016,11,-1
Group 3,RRG,-0.5,11,14,3441,10,2016,7,3
Group 3,RRG,-0.5,11,14,3442,13,2016,8,5
Group 3,RRG,-0.5,11,14,3443,5,2016,8,-3
Group 3,RRG,-0.5,11,14,3444,4,2016,11,-7
Group 3,RRG,-0.5,11,14,3445,5,2016,10,-5
Group 3,RRG,-0.5,11,14,3446,10,2016,11,-1
Group 3,RRG,-0.5,11,14,3447,10,2016,12,-2
Group 3,RRG,-0.5,11,14,3448,10,2016,10,0
Group 3,RRG,-0.5,11,14,3449,5,2016,5,0
Group 3,RRG,-0.5,11,14,3450,8,2016,8,0
Group 3,RRG,-0.5,11,14,3451,7,2016,7,0
Group 3,RRG,-0.5,11,14,3452,10,2016,9,1
Group 3,RRG,-0.5,11,14,3453,6,2016,6,0
Group 3,RRG,-0.5,11,14,3454,10,2016,9,1
Group 3,RRG,-0.5,11,14,3455,12,2016,11,1
Group 3,RRG,-0.5,11,14,3456,6,2016,8,-2
Group 3,RRG,-0.5,11,14,3457,4,2016,4,0
Group 3,RRG,-0.5,11,14,3458,7,2016,5,2
Group 3,RRG,-0.5,11,14,3459,9,2016,10,-1
Group 3,RRG,-0.5,11,14,3460,12,2016,10,2
Group 3,RRG,-0.5,11,14,3461,10,2016,9,1
Group 3,RRG,-0.5,11,14,3462,9,2016,10,-1
Group 3,RRG,-0.5,11,14,3463,7,2016,7,0
Group 3,RRG,-0.5,11,14,3464,7,2016,7,0
Group 3,RRG,-0.5,11,14,3465,8,2016,7,1
Group 3,RRG,-0.5,11,14,3466,9,2016,9,0
Group 3,RRG,-0.5,11,14,3467,9,2016,6,3
Group 3,RRG,-0.5,11,14,3468,8,2016,7,1
Group 3,RRG,-0.5,11,14,3469,10,2016,8,2
Group 3,RRG,-0.5,11,14,3470,8,2016,10,-2
Group 3,RRG,-0.5,11,14,3471,12,2016,7,5
Group 3,RRG,-0.5,11,14,3472,12,2016,7,5
Group 3,RRG,-0.5,11,14,3473,12,2016,8,4
Group 3,RRG,-0.5,11,14,3474,6,2016,11,-5
Group 3,RRG,-0.5,11,14,3475,7,2016,12,-5
Group 3,RRG,-0.5,11,14,3476,6,2016,9,-3
Group 3,RRG,-0.5,11,14,3477,7,2016,9,-2
Group 3,RRG,-0.5,11,14,3478,6,2016,9,-3
Group 3,RRG,-0.5,11,14,3479,7,2016,10,-3
Group 3,RRG,-0.5,11,14,3480,8,2016,9,-1
Group 3,RRG,-0.5,11,14,3481,3,2016,7,-4
Group 3,RRG,-0.5,11,14,3482,13,2016,11,2
Group 3,RRG,-0.5,11,14,3483,11,2016,7,4
Group 3,RRG,-0.5,11,14,3484,9,2016,10,-1
Group 3,RRG,-0.5,11,14,3485,9,2016,7,2
Group 3,RRG,-0.5,11,14,3486,8,2016,9,-1
Group 3,RRG,-0.5,11,14,3487,8,2016,11,-3
Group 3,RRG,-0.5,11,14,3488,4,2016,2,2
Group 3,RRG,-0.5,11,14,3489,3,2016,6,-3
Group 3,RRG,-0.5,11,14,3490,4,2016,9,-5
Group 3,RRG,-0.5,11,14,3491,7,2016,9,-2
Group 3,RRG,-0.5,11,14,3492,8,2016,8,0
Group 3,RRG,-0.5,11,14,3493,9,2016,10,-1
Group 3,RRG,-0.5,11,14,3494,13,2016,9,4
Group 3,RRG,-0.5,11,14,3495,12,2016,9,3
Group 3,RRG,-0.5,11,14,3496,6,2016,9,-3
Group 3,RRG,-0.5,11,14,3497,4,2016,7,-3
Group 3,RRG,-0.5,11,14,3498,9,2016,5,4
Group 3,RRG,-0.5,11,14,3499,5,2016,11,-6
Group 3,RRG,-0.5,11,14,3500,11,2016,12,-1
Group 3,RRG,-0.5,11,14,3501,7,2016,7,0
Group 3,RRG,-0.5,11,14,3502,13,2016,11,2
Group 3,RRG,-0.5,11,14,3503,12,2016,8,4
Group 3,RRG,-0.5,11,14,3504,5,2016,11,-6
Group 3,RRG,-0.5,11,14,3505,4,2016,7,-3
Group 3,RRG,-0.5,11,14,3506,8,2016,7,1
Group 3,RRG,-0.5,11,14,3507,5,2016,4,1
Group 3,RRG,-0.5,11,14,3508,7,2016,5,2
Group 3,RRG,-0.5,11,14,3509,13,2016,10,3
Group 3,RRG,-0.5,11,14,3510,10,2016,3,7
Group 3,RRG,-0.5,11,14,3511,9,2016,9,0
Group 3,RRG,-0.5,11,14,3512,6,2016,7,-1
Group 3,RRG,-0.5,11,14,3513,9,2016,9,0
Group 3,RRG,-0.5,11,14,3514,8,2016,12,-4
Group 3,RRG,-0.5,11,14,3515,9,2016,8,1
Group 3,RRG,-0.5,11,14,3516,9,2016,8,1
Group 3,RRG,-0.5,11,14,3517,5,2016,6,-1
Group 3,RRG,-0.5,11,14,3518,8,2016,6,2
Group 3,RRG,-0.5,11,14,3519,8,2016,5,3
Group 3,RRG,-0.5,11,14,3520,11,2016,8,3
Group 3,RRG,-0.5,11,14,3521,11,2016,9,2
Group 3,RRG,-0.5,11,14,3522,8,2016,8,0
Group 3,RRG,-0.5,11,14,3523,7,2016,5,2
Group 3,RRG,-0.5,11,14,3524,7,2016,13,-6
Group 3,RRG,-0.5,11,14,3525,5,2016,12,-7
Group 3,RRG,-0.5,11,14,3526,11,2016,8,3
Group 3,RRG,-0.5,11,14,3527,9,2016,8,1
Group 3,RRG,-0.5,11,14,3528,11,2016,8,3
Group 3,RRG,-0.5,11,14,3529,8,2016,9,-1
Group 3,RRG,-0.5,11,14,3530,10,2016,9,1
Group 3,RRG,-0.5,11,14,3531,13,2016,13,0
Group 3,RRG,-0.5,11,14,3532,10,2016,14,-4
Group 3,RRG,-0.5,11,14,3533,8,2016,7,1
Group 3,RRG,-0.5,11,14,3534,5,2016,5,0
Group 3,RRG,-0.5,11,14,3535,9,2016,14,-5
Group 3,RRG,-0.5,11,14,3536,10,2016,12,-2
Group 3,RRG,-0.5,11,14,3537,8,2016,9,-1
Group 3,RRG,-0.5,11,14,3538,10,2016,10,0
Group 3,RRG,-0.5,11,14,3539,6,2016,7,-1
Group 3,RRG,-0.5,11,14,3540,5,2016,10,-5
Group 3,RRG,-0.5,11,14,3541,11,2016,9,2
Group 3,RRG,-0.5,11,14,3542,5,2016,12,-7
Group 3,RRG,-0.5,11,14,3543,8,2016,6,2
Group 3,RRG,-0.5,11,14,3544,5,2016,11,-6
Group 3,RRG,-0.5,11,14,3545,8,2016,8,0
Group 3,RRG,-0.5,11,14,3546,7,2016,8,-1
Group 3,RRG,-0.5,11,14,3547,10,2016,9,1
Group 3,RRG,-0.5,11,14,3548,11,2016,10,1
Group 3,RRG,-0.5,11,14,3549,12,2016,9,3
Group 3,RRG,-0.5,11,14,3550,12,2016,12,0
Group 3,RRG,-0.5,11,14,3551,5,2016,7,-2
Group 3,RRG,-0.5,11,14,3552,6,2016,4,2
Group 3,RRG,-0.5,11,14,3553,10,2016,10,0
Group 3,RRG,-0.5,11,14,3554,8,2016,5,3
Group 3,RRG,-0.5,11,14,3555,12,2016,8,4
Group 3,RRG,-0.5,11,14,3556,4,2016,10,-6
Group 3,RRG,-0.5,11,14,3557,8,2016,5,3
Group 3,RRG,-0.5,11,14,3558,7,2016,12,-5
Group 3,RRG,-0.5,11,14,3559,11,2016,12,-1
Group 3,RRG,-0.5,11,14,3560,9,2016,8,1
Group 3,RRG,-0.5,11,14,3561,7,2016,6,1
Group 3,RRG,-0.5,11,14,3562,8,2016,10,-2
Group 3,RRG,-0.5,11,14,3563,4,2016,7,-3
Group 3,RRG,-0.5,11,14,3564,4,2016,7,-3
Group 3,RRG,-0.5,11,14,3565,14,2016,11,3
Group 3,RRG,-0.5,11,14,3566,3,2016,2,1
Group 3,RRG,-0.5,11,14,3567,12,2016,10,2
Group 3,RRG,-0.5,11,14,3568,10,2016,12,-2
Group 3,RRG,-0.5,11,14,3569,7,2016,10,-3
Group 3,RRG,-0.5,11,14,3570,6,2016,7,-1
Group 3,RRG,-0.5,11,14,3571,11,2016,9,2
Group 3,RRG,-0.5,11,14,3572,10,2016,12,-2
Group 3,RRG,-0.5,11,14,3573,5,2016,13,-8
Group 3,RRG,-0.5,11,14,3574,13,2016,6,7
Group 3,RRG,-0.5,11,14,3575,9,2016,8,1
Group 3,RRG,-0.5,11,14,3576,8,2016,6,2
Group 3,RRG,-0.5,11,14,3577,8,2016,6,2
Group 3,RRG,-0.5,11,14,3578,4,2016,10,-6
Group 3,RRG,-0.5,11,14,3579,8,2016,6,2
Group 3,RRG,-0.5,11,14,3580,12,2016,8,4
Group 3,RRG,-0.5,11,14,3581,10,2016,11,-1
Group 3,RRG,-0.5,11,14,3582,3,2016,5,-2
Group 3,RRG,-0.5,11,14,3583,3,2016,1,2
Group 3,RRG,-0.5,11,14,3584,9,2016,9,0
Group 3,RRG,-0.5,11,14,3585,9,2016,11,-2
Group 3,RRG,-0.5,11,14,3586,10,2016,11,-1
Group 3,RRG,-0.5,11,14,3587,11,2016,6,5
Group 3,RRG,-0.5,11,14,3588,7,2016,8,-1
Group 3,RRG,-0.5,11,14,3589,8,2016,7,1
Group 3,RRG,-0.5,11,14,3590,9,2016,5,4
Group 3,RRG,-0.5,11,14,3591,10,2016,7,3
Group 3,RRG,-0.5,11,14,3592,5,2016,8,-3
Group 3,RRG,-0.5,11,14,3593,11,2016,8,3
Group 3,RRG,-0.5,11,14,3594,9,2016,9,0
Group 3,RRG,-0.5,11,14,3595,12,2016,9,3
Group 3,RRG,-0.5,11,14,3596,6,2016,10,-4
Group 3,RRG,-0.5,11,14,3597,13,2016,7,6
Group 3,RRG,-0.5,11,14,3598,4,2016,9,-5
Group 3,RRG,-0.5,11,14,3599,12,2016,12,0
Group 3,RRG,-0.5,11,14,3600,12,2016,11,1
Group 3,RRG,-0.5,11,14,3601,11,2016,10,1
Group 3,RRG,-0.5,11,14,3602,11,2016,9,2
Group 3,RRG,-0.5,11,14,3603,11,2016,9,2
Group 3,RRG,-0.5,11,14,3604,10,2016,10,0
Group 3,RRG,-0.5,11,14,3605,6,2016,10,-4
Group 3,RRG,-0.5,11,14,3606,8,2016,5,3
Group 3,RRG,-0.5,11,14,3607,13,2016,9,4
Group 3,RRG,-0.5,11,14,3608,11,2016,5,6
Group 3,RRG,-0.5,11,14,3609,7,2016,9,-2
Group 3,RRG,-0.5,11,14,3610,9,2016,9,0
Group 3,RRG,-0.5,11,14,3611,5,2016,10,-5
Group 3,RRG,-0.5,11,14,3612,10,2016,9,1
Group 3,RRG,-0.5,11,14,3613,11,2016,8,3
Group 3,RRG,-0.5,11,14,3614,13,2016,10,3
Group 3,RRG,-0.5,11,14,3615,3,2016,10,-7
Group 3,RRG,-0.5,11,14,3616,9,2016,12,-3
Group 3,RRG,-0.5,11,14,3617,8,2016,9,-1
Group 3,RRG,-0.5,11,14,3618,7,2016,11,-4
Group 3,RRG,-0.5,11,14,3619,6,2016,7,-1
Group 3,RRG,-0.5,11,14,3620,8,2016,11,-3
Group 3,RRG,-0.5,11,14,3621,12,2016,10,2
Group 3,RRG,-0.5,11,14,3622,10,2016,6,4
Group 3,RRG,-0.5,11,14,3623,10,2016,6,4
Group 3,RRG,-0.5,11,14,3624,8,2016,7,1
Group 3,RRG,-0.5,11,14,3625,12,2016,6,6
Group 3,RRG,-0.5,11,14,3626,11,2016,8,3
Group 3,RRG,-0.5,11,14,3627,8,2016,7,1
Group 3,RRG,-0.5,11,14,3628,9,2016,10,-1
Group 3,RRG,-0.5,11,14,3629,7,2016,9,-2
Group 3,RRG,-0.5,11,14,3630,8,2016,11,-3
Group 3,RRG,-0.5,11,14,3631,7,2016,10,-3
Group 3,RRG,-0.5,11,14,3632,12,2016,9,3
Group 3,RRG,-0.5,11,14,3633,6,2016,6,0
Group 3,RRG,-0.5,11,14,3634,6,2016,13,-7
Group 3,RRG,-0.5,11,14,3635,8,2016,6,2
Group 3,RRG,-0.5,11,14,3636,9,2016,7,2
Group 3,RRG,-0.5,11,14,3637,9,2016,7,2
Group 3,RRG,-0.5,11,14,3638,10,2016,7,3
Group 3,RRG,-0.5,11,14,3639,5,2016,9,-4
Group 3,RRG,-0.5,11,14,3640,10,2016,11,-1
Group 3,RRG,-0.5,11,14,3641,10,2016,9,1
Group 3,RRG,-0.5,11,14,3642,11,2016,8,3
Group 3,RRG,-0.5,11,14,3643,13,2016,13,0
Group 3,RRG,-0.5,11,14,3644,8,2016,8,0
Group 3,RRG,-0.5,11,14,3645,9,2016,7,2
Group 3,RRG,-0.5,11,14,3646,8,2016,7,1
Group 3,RRG,-0.5,11,14,3647,9,2016,11,-2
Group 3,RRG,-0.5,11,14,3648,8,2016,10,-2
Group 3,RRG,-0.5,11,14,3649,8,2016,13,-5
Group 3,RRG,-0.5,11,14,3650,10,2016,10,0
Group 3,RRG,-0.5,11,14,3651,10,2016,7,3
Group 3,RRG,-0.5,11,14,3652,8,2016,5,3
Group 3,RRG,-0.5,11,14,3653,8,2016,12,-4
Group 3,RRG,-0.5,11,14,3654,11,2016,9,2
Group 3,RRG,-0.5,11,14,3655,9,2016,11,-2
Group 3,RRG,-0.5,11,14,3656,7,2016,9,-2
Group 3,RRG,-0.5,11,14,3657,7,2016,7,0
Group 3,RRG,-0.5,11,14,3658,6,2016,11,-5
Group 3,RRG,-0.5,11,14,3659,4,2016,9,-5
Group 3,RRG,-0.5,11,14,3660,7,2016,9,-2
Group 3,RRG,-0.5,11,14,3661,8,2016,6,2
Group 3,RRG,-0.5,11,14,3662,10,2016,6,4
Group 3,RRG,-0.5,11,14,3663,9,2016,10,-1
Group 3,RRG,-0.5,11,14,3664,6,2016,8,-2
Group 3,RRG,-0.5,11,14,3665,7,2016,11,-4
Group 3,RRG,-0.5,11,14,3666,8,2016,7,1
Group 3,RRG,-0.5,11,14,3667,8,2016,10,-2
Group 3,RRG,-0.5,11,14,3668,9,2016,6,3
Group 3,RRG,-0.5,11,14,3669,9,2016,8,1
Group 3,RRG,-0.5,11,14,3670,7,2016,9,-2
Group 3,RRG,-0.5,11,14,3671,6,2016,10,-4
Group 3,RRG,-0.5,11,14,3672,5,2016,8,-3
Group 3,RRG,-0.5,11,14,3673,7,2016,8,-1
Group 3,RRG,-0.5,11,14,3674,6,2016,7,-1
Group 3,RRG,-0.5,11,14,3675,4,2016,5,-1
Group 3,RRG,-0.5,11,14,3676,7,2016,10,-3
Group 3,RRG,-0.5,11,14,3677,8,2016,8,0
Group 3,RRG,-0.5,11,14,3678,7,2016,11,-4
Group 3,RRG,-0.5,11,14,3679,9,2016,10,-1
Group 3,RRG,-0.5,11,14,3680,7,2016,8,-1
Group 3,RRG,-0.5,11,14,3681,12,2016,9,3
Group 3,RRG,-0.5,11,14,3682,6,2016,8,-2
Group 3,RRG,-0.5,11,14,3683,10,2016,9,1
Group 3,RRG,-0.5,11,14,3684,12,2016,9,3
Group 3,RRG,-0.5,11,14,3685,4,2016,7,-3
Group 3,RRG,-0.5,11,14,3686,7,2016,8,-1
Group 3,RRG,-0.5,11,14,3687,10,2016,10,0
Group 3,RRG,-0.5,11,14,3688,9,2016,10,-1
Group 3,RRG,-0.5,11,14,3689,12,2016,11,1
Group 3,RRG,-0.5,11,14,3690,9,2016,9,0
Group 3,RRG,-0.5,11,14,3691,10,2016,4,6
Group 3,RRG,-0.5,11,14,3692,8,2016,6,2
Group 3,RRG,-0.5,11,14,3693,13,2016,10,3
Group 3,RRG,-0.5,11,14,3694,6,2016,9,-3
Group 3,RRG,-0.5,11,14,3695,9,2016,7,2
Group 3,RRG,-0.5,11,14,3696,6,2016,8,-2
Group 3,RRG,-0.5,11,14,3697,8,2016,7,1
Group 3,RRG,-0.5,11,14,3698,8,2016,10,-2
Group 3,RRG,-0.5,11,14,3699,8,2016,11,-3
Group 3,RRG,-0.5,11,14,3700,6,2016,9,-3
Group 3,RRG,-0.5,11,14,3701,3,2016,3,0
Group 3,RRG,-0.5,11,14,3702,11,2016,12,-1
Group 3,RRG,-0.5,11,14,3703,4,2016,8,-4
Group 3,RRG,-0.5,11,14,3704,5,2016,9,-4
Group 3,RRG,-0.5,11,14,3705,10,2016,12,-2
Group 3,RRG,-0.5,11,14,3706,9,2016,11,-2
Group 3,RRG,-0.5,11,14,3707,8,2016,9,-1
Group 3,RRG,-0.5,11,14,3708,8,2016,10,-2
Group 3,RRG,-0.5,11,14,3709,10,2016,11,-1
Group 3,RRG,-0.5,11,14,3710,13,2016,7,6
Group 3,RRG,-0.5,11,14,3711,9,2016,10,-1
Group 3,RRG,-0.5,11,14,3712,9,2016,11,-2
Group 3,RRG,-0.5,11,14,3713,4,2016,8,-4
Group 3,RRG,-0.5,11,14,3714,11,2016,11,0
Group 3,RRG,-0.5,11,14,3715,3,2016,8,-5
Group 3,RRG,-0.5,11,14,3716,8,2016,12,-4
Group 3,RRG,-0.5,11,14,3717,11,2016,11,0
Group 3,RRG,-0.5,11,14,3718,11,2016,9,2
Group 3,RRG,-0.5,11,14,3719,11,2016,2,9
Group 3,RRG,-0.5,11,14,3720,10,2016,3,7
Group 3,RRG,-0.5,11,14,3721,10,2016,10,0
Group 3,RRG,-0.5,11,14,3722,7,2016,9,-2
Group 3,RRG,-0.5,11,14,3723,8,2016,8,0
Group 3,RRG,-0.5,11,14,3724,7,2016,8,-1
Group 3,RRG,-0.5,11,14,3725,6,2016,6,0
Group 3,RRG,-0.5,11,14,3726,13,2016,10,3
Group 3,RRG,-0.5,11,14,3727,9,2016,11,-2
Group 3,RRG,-0.5,11,14,3728,6,2016,7,-1
Group 3,RRG,-0.5,11,14,3729,8,2016,7,1
Group 3,RRG,-0.5,11,14,3730,12,2016,10,2
Group 3,RRG,-0.5,11,14,3731,13,2016,8,5
Group 3,RRG,-0.5,11,14,3732,9,2016,11,-2
Group 3,RRG,-0.5,11,14,3733,10,2016,12,-2
Group 3,RRG,-0.5,11,14,3734,9,2016,9,0
Group 3,RRG,-0.5,11,14,3735,11,2016,11,0
Group 3,RRG,-0.5,11,14,3736,1,2016,7,-6
Group 3,RRG,-0.5,11,14,3737,7,2016,10,-3
Group 3,RRG,-0.5,11,14,3738,10,2016,10,0
Group 3,RRG,-0.5,11,14,3739,10,2016,8,2
Group 3,RRG,-0.5,11,14,3740,9,2016,10,-1
Group 3,RRG,-0.5,11,14,3741,6,2016,6,0
Group 3,RRG,-0.5,11,14,3742,8,2016,9,-1
Group 3,RRG,-0.5,11,14,3743,5,2016,6,-1
Group 3,RRG,-0.5,11,14,3744,10,2016,5,5
Group 3,RRG,-0.5,11,14,3745,13,2016,7,6
Group 3,RRG,-0.5,11,14,3746,10,2016,7,3
Group 3,RRG,-0.5,11,14,3747,10,2016,10,0
Group 3,RRG,-0.5,11,14,3748,10,2016,7,3
Group 3,RRG,-0.5,11,14,3749,11,2016,7,4
Group 3,RRG,-0.5,11,14,3750,10,2016,12,-2
Group 3,RRG,-0.5,11,14,3751,9,2016,7,2
Group 3,RRG,-0.5,11,14,3752,9,2016,4,5
Group 3,RRG,-0.5,11,14,3753,8,2016,7,1
Group 3,RRG,-0.5,11,14,3754,8,2016,10,-2
Group 3,RRG,-0.5,11,14,3755,9,2016,4,5
Group 3,RRG,-0.5,11,14,3756,7,2016,7,0
Group 3,RRG,-0.5,11,14,3757,8,2016,8,0
Group 3,RRG,-0.5,11,14,3758,9,2016,6,3
Group 3,RRG,-0.5,11,14,3759,8,2016,8,0
Group 3,RRG,-0.5,11,14,3760,5,2016,7,-2
Group 3,RRG,-0.5,11,14,3761,10,2016,12,-2
Group 3,RRG,-0.5,11,14,3762,9,2016,9,0
Group 3,RRG,-0.5,11,14,3763,7,2016,4,3
Group 3,RRG,-0.5,11,14,3764,4,2016,5,-1
Group 3,RRG,-0.5,11,14,3765,5,2016,9,-4
Group 3,RRG,-0.5,11,14,3766,5,2016,8,-3
Group 3,RRG,-0.5,11,14,3767,14,2016,7,7
Group 3,RRG,-0.5,11,14,3768,9,2016,13,-4
Group 3,RRG,-0.5,11,14,3769,13,2016,10,3
Group 3,RRG,-0.5,11,14,3770,11,2016,9,2
Group 3,RRG,-0.5,11,14,3771,12,2016,11,1
Group 3,RRG,-0.5,11,14,3772,13,2016,12,1
Group 3,RRG,-0.5,11,14,3773,8,2016,11,-3
Group 3,RRG,-0.5,11,14,3774,5,2016,5,0
Group 3,RRG,-0.5,11,14,3775,4,2016,6,-2
Group 3,RRG,-0.5,11,14,3776,11,2016,10,1
Group 3,RRG,-0.5,11,14,3777,8,2016,9,-1
Group 3,RRG,-0.5,11,14,3778,8,2016,8,0
Group 3,RRG,-0.5,11,14,3779,4,2016,8,-4
Group 3,RRG,-0.5,11,14,3780,7,2016,10,-3
Group 3,RRG,-0.5,11,14,3781,7,2016,7,0
Group 3,RRG,-0.5,11,14,3782,10,2016,8,2
Group 3,RRG,-0.5,11,14,3783,9,2016,8,1
Group 3,RRG,-0.5,11,14,3784,7,2016,4,3
Group 3,RRG,-0.5,11,14,3785,6,2016,7,-1
Group 3,RRG,-0.5,11,14,3786,11,2016,8,3
Group 3,RRG,-0.5,11,14,3787,5,2016,10,-5
Group 3,RRG,-0.5,11,14,3788,6,2016,9,-3
Group 3,RRG,-0.5,11,14,3789,8,2016,7,1
Group 3,RRG,-0.5,11,14,3790,9,2016,5,4
Group 3,RRG,-0.5,11,14,3791,7,2016,9,-2
Group 3,RRG,-0.5,11,14,3792,8,2016,6,2
Group 3,RRG,-0.5,11,14,3793,7,2016,9,-2
Group 3,RRG,-0.5,11,14,3794,12,2016,13,-1
Group 3,RRG,-0.5,11,14,3795,12,2016,10,2
Group 3,RRG,-0.5,11,14,3796,8,2016,10,-2
Group 3,RRG,-0.5,11,14,3797,5,2016,8,-3
Group 3,RRG,-0.5,11,14,3798,4,2016,9,-5
Group 3,RRG,-0.5,11,14,3799,8,2016,12,-4
Group 3,RRG,-0.5,11,14,3800,2,2016,8,-6
Group 3,RRG,-0.5,11,14,3801,7,2016,8,-1
Group 3,RRG,-0.5,11,14,3802,6,2016,4,2
Group 3,RRG,-0.5,11,14,3803,7,2016,11,-4
Group 3,RRG,-0.5,11,14,3804,7,2016,8,-1
Group 3,RRG,-0.5,11,14,3805,4,2016,11,-7
Group 3,RRG,-0.5,11,14,3806,13,2016,7,6
Group 3,RRG,-0.5,11,14,3807,13,2016,11,2
Group 3,RRG,-0.5,11,14,3808,10,2016,11,-1
Group 3,RRG,-0.5,11,14,3809,7,2016,7,0
Group 3,RRG,-0.5,11,14,3810,12,2016,7,5
Group 3,RRG,-0.5,11,14,3811,3,2016,10,-7
Group 3,RRG,-0.5,11,14,3812,9,2016,12,-3
Group 3,RRG,-0.5,11,14,3813,9,2016,11,-2
Group 3,RRG,-0.5,11,14,3814,6,2016,6,0
Group 3,RRG,-0.5,11,14,3815,8,2016,7,1
Group 3,RRG,-0.5,11,14,3816,5,2016,9,-4
Group 3,RRG,-0.5,11,14,3817,6,2016,9,-3
Group 3,RRG,-0.5,11,14,3818,8,2016,2,6
Group 3,RRG,-0.5,11,14,3819,5,2016,8,-3
Group 3,RRG,-0.5,11,14,3820,8,2016,10,-2
Group 3,RRG,-0.5,11,14,3821,7,2016,7,0
Group 3,RRG,-0.5,11,14,3822,8,2016,9,-1
Group 3,RRG,-0.5,11,14,3823,10,2016,3,7
Group 3,RRG,-0.5,11,14,3824,7,2016,7,0
Group 3,RRG,-0.5,11,14,3825,3,2016,9,-6
Group 3,RRG,-0.5,11,14,3826,7,2016,10,-3
Group 3,RRG,-0.5,11,14,3827,13,2016,5,8
Group 3,RRG,-0.5,11,14,3828,12,2016,6,6
Group 3,RRG,-0.5,11,14,3829,8,2016,4,4
Group 3,RRG,-0.5,11,14,3830,11,2016,6,5
Group 3,RRG,-0.5,11,14,3831,4,2016,10,-6
Group 3,RRG,-0.5,11,14,3832,9,2016,9,0
Group 3,RRG,-0.5,11,14,3833,9,2016,8,1
Group 3,RRG,-0.5,11,14,3834,12,2016,9,3
Group 3,RRG,-0.5,11,14,3835,10,2016,9,1
Group 3,RRG,-0.5,11,14,3836,10,2016,8,2
Group 3,RRG,-0.5,11,14,3837,7,2016,9,-2
Group 3,RRG,-0.5,11,14,3838,8,2016,5,3
Group 3,RRG,-0.5,11,14,3839,8,2016,7,1
Group 3,RRG,-0.5,11,14,3840,7,2016,7,0
Group 3,RRG,-0.5,11,14,3841,8,2016,11,-3
Group 3,RRG,-0.5,11,14,3842,2,2016,9,-7
Group 3,RRG,-0.5,11,14,3843,10,2016,10,0
Group 3,RRG,-0.5,11,14,3844,9,2016,10,-1
Group 3,RRG,-0.5,11,14,3845,10,2016,10,0
Group 3,RRG,-0.5,11,14,3846,7,2016,5,2
Group 3,RRG,-0.5,11,14,3847,8,2016,5,3
Group 3,RRG,-0.5,11,14,3848,9,2016,7,2
Group 3,RRG,-0.5,11,14,3849,10,2016,5,5
Group 3,RRG,-0.5,11,14,3850,7,2016,8,-1
Group 3,RRG,-0.5,11,14,3851,4,2016,9,-5
Group 3,RRG,-0.5,11,14,3852,10,2016,10,0
Group 3,RRG,-0.5,11,14,3853,8,2016,7,1
Group 3,RRG,-0.5,11,14,3854,8,2016,12,-4
Group 3,RRG,-0.5,11,14,3855,6,2016,7,-1
Group 3,RRG,-0.5,11,14,3856,13,2016,10,3
Group 3,RRG,-0.5,11,14,3857,11,2016,8,3
Group 3,RRG,-0.5,11,14,3858,10,2016,6,4
Group 3,RRG,-0.5,11,14,3859,5,2016,9,-4
Group 3,RRG,-0.5,11,14,3860,9,2016,9,0
Group 3,RRG,-0.5,11,14,3861,10,2016,11,-1
Group 3,RRG,-0.5,11,14,3862,10,2016,11,-1
Group 3,RRG,-0.5,11,14,3863,5,2016,10,-5
Group 3,RRG,-0.5,11,14,3864,10,2016,8,2
Group 3,RRG,-0.5,11,14,3865,12,2016,11,1
Group 3,RRG,-0.5,11,14,3866,11,2016,5,6
Group 3,RRG,-0.5,11,14,3867,5,2016,10,-5
Group 3,RRG,-0.5,11,14,3868,7,2016,10,-3
Group 3,RRG,-0.5,11,14,3869,1,2016,7,-6
Group 3,RRG,-0.5,11,14,3870,12,2016,11,1
Group 3,RRG,-0.5,11,14,3871,9,2016,10,-1
Group 3,RRG,-0.5,11,14,3872,8,2016,7,1
Group 3,RRG,-0.5,11,14,3873,4,2016,11,-7
Group 3,RRG,-0.5,11,14,3874,8,2016,12,-4
Group 3,RRG,-0.5,11,14,3875,9,2016,9,0
Group 3,RRG,-0.5,11,14,3876,7,2016,5,2
Group 3,RRG,-0.5,11,14,3877,6,2016,7,-1
Group 3,RRG,-0.5,11,14,3878,8,2016,8,0
Group 3,RRG,-0.5,11,14,3879,6,2016,7,-1
Group 3,RRG,-0.5,11,14,3880,7,2016,6,1
Group 3,RRG,-0.5,11,14,3881,9,2016,8,1
Group 3,RRG,-0.5,11,14,3882,11,2016,10,1
Group 3,RRG,-0.5,11,14,3883,4,2016,3,1
Group 3,RRG,-0.5,11,14,3884,4,2016,8,-4
Group 3,RRG,-0.5,11,14,3885,14,2016,8,6
Group 3,RRG,-0.5,11,14,3886,7,2016,9,-2
Group 3,RRG,-0.5,11,14,3887,5,2016,5,0
Group 3,RRG,-0.5,11,14,3888,4,2016,5,-1
Group 3,RRG,-0.5,11,14,3889,6,2016,8,-2
Group 3,RRG,-0.5,11,14,3890,8,2016,6,2
Group 3,RRG,-0.5,11,14,3891,10,2016,6,4
Group 3,RRG,-0.5,11,14,3892,11,2016,13,-2
Group 3,RRG,-0.5,11,14,3893,4,2016,5,-1
Group 3,RRG,-0.5,11,14,3894,11,2016,8,3
Group 3,RRG,-0.5,11,14,3895,8,2016,9,-1
Group 3,RRG,-0.5,11,14,3896,6,2016,10,-4
Group 3,RRG,-0.5,11,14,3897,6,2016,9,-3
Group 3,RRG,-0.5,11,14,3898,7,2016,9,-2
Group 3,RRG,-0.5,11,14,3899,11,2016,7,4
Group 3,RRG,-0.5,11,14,3900,12,2016,7,5
Group 3,RRG,-0.5,11,14,3901,8,2016,5,3
Group 3,RRG,-0.5,11,14,3902,13,2016,10,3
Group 3,RRG,-0.5,11,14,3903,7,2016,10,-3
Group 3,RRG,-0.5,11,14,3904,13,2016,12,1
Group 3,RRG,-0.5,11,14,3905,7,2016,6,1
Group 3,RRG,-0.5,11,14,3906,8,2016,9,-1
Group 3,RRG,-0.5,11,14,3907,10,2016,11,-1
Group 3,RRG,-0.5,11,14,3908,10,2016,8,2
Group 3,RRG,-0.5,11,14,3909,11,2016,10,1
Group 3,RRG,-0.5,11,14,3910,7,2016,8,-1
Group 3,RRG,-0.5,11,14,3911,10,2016,7,3
Group 3,RRG,-0.5,11,14,3912,12,2016,7,5
Group 3,RRG,-0.5,11,14,3913,10,2016,5,5
Group 3,RRG,-0.5,11,14,3914,9,2016,6,3
Group 3,RRG,-0.5,11,14,3915,13,2016,5,8
Group 3,RRG,-0.5,11,14,3916,9,2016,9,0
Group 3,RRG,-0.5,11,14,3917,8,2016,10,-2
Group 3,RRG,-0.5,11,14,3918,12,2016,7,5
Group 3,RRG,-0.5,11,14,3919,13,2016,8,5
Group 3,RRG,-0.5,11,14,3920,13,2016,7,6
Group 3,RRG,-0.5,11,14,3921,10,2016,9,1
Group 3,RRG,-0.5,11,14,3922,6,2016,11,-5
Group 3,RRG,-0.5,11,14,3923,9,2016,7,2
Group 3,RRG,-0.5,11,14,3924,11,2016,6,5
Group 3,RRG,-0.5,11,14,3925,8,2016,9,-1
Group 3,RRG,-0.5,11,14,3926,9,2016,9,0
Group 3,RRG,-0.5,11,14,3927,7,2016,12,-5
Group 3,RRG,-0.5,11,14,3928,5,2016,3,2
Group 3,RRG,-0.5,11,14,3929,7,2016,6,1
Group 3,RRG,-0.5,11,14,3930,13,2016,10,3
Group 3,RRG,-0.5,11,14,3931,8,2016,6,2
Group 3,RRG,-0.5,11,14,3932,7,2016,5,2
Group 3,RRG,-0.5,11,14,3933,8,2016,10,-2
Group 3,RRG,-0.5,11,14,3934,11,2016,12,-1
Group 3,RRG,-0.5,11,14,3935,10,2016,9,1
Group 3,RRG,-0.5,11,14,3936,2,2016,6,-4
Group 3,RRG,-0.5,11,14,3937,6,2016,4,2
Group 3,RRG,-0.5,11,14,3938,10,2016,6,4
Group 3,RRG,-0.5,11,14,3939,9,2016,9,0
Group 3,RRG,-0.5,11,14,3940,8,2016,9,-1
Group 3,RRG,-0.5,11,14,3941,11,2016,7,4
Group 3,RRG,-0.5,11,14,3942,4,2016,7,-3
Group 3,RRG,-0.5,11,14,3943,10,2016,9,1
Group 3,RRG,-0.5,11,14,3944,8,2016,9,-1
Group 3,RRG,-0.5,11,14,3945,8,2016,9,-1
Group 3,RRG,-0.5,11,14,3946,10,2016,11,-1
Group 3,RRG,-0.5,11,14,3947,11,2016,10,1
Group 3,RRG,-0.5,11,14,3948,13,2016,7,6
Group 3,RRG,-0.5,11,14,3949,6,2016,9,-3
Group 3,RRG,-0.5,11,14,3950,6,2016,8,-2
Group 3,RRG,-0.5,11,14,3951,9,2016,10,-1
Group 3,RRG,-0.5,11,14,3952,8,2016,10,-2
Group 3,RRG,-0.5,11,14,3953,5,2016,7,-2
Group 3,RRG,-0.5,11,14,3954,10,2016,8,2
Group 3,RRG,-0.5,11,14,3955,9,2016,8,1
Group 3,RRG,-0.5,11,14,3956,10,2016,7,3
Group 3,RRG,-0.5,11,14,3957,10,2016,13,-3
Group 3,RRG,-0.5,11,14,3958,10,2016,8,2
Group 3,RRG,-0.5,11,14,3959,14,2016,8,6
Group 3,RRG,-0.5,11,14,3960,10,2016,10,0
Group 3,RRG,-0.5,11,14,3961,11,2016,7,4
Group 3,RRG,-0.5,11,14,3962,8,2016,11,-3
Group 3,RRG,-0.5,11,14,3963,7,2016,10,-3
Group 3,RRG,-0.5,11,14,3964,3,2016,6,-3
Group 3,RRG,-0.5,11,14,3965,3,2016,6,-3
Group 3,RRG,-0.5,11,14,3966,7,2016,6,1
Group 3,RRG,-0.5,11,14,3967,11,2016,11,0
Group 3,RRG,-0.5,11,14,3968,12,2016,9,3
Group 3,RRG,-0.5,11,14,3969,6,2016,7,-1
Group 3,RRG,-0.5,11,14,3970,3,2016,7,-4
Group 3,RRG,-0.5,11,14,3971,3,2016,6,-3
Group 3,RRG,-0.5,11,14,3972,8,2016,8,0
Group 3,RRG,-0.5,11,14,3973,9,2016,9,0
Group 3,RRG,-0.5,11,14,3974,7,2016,8,-1
Group 3,RRG,-0.5,11,14,3975,9,2016,9,0
Group 3,RRG,-0.5,11,14,3976,10,2016,8,2
Group 3,RRG,-0.5,11,14,3977,8,2016,7,1
Group 3,RRG,-0.5,11,14,3978,12,2016,8,4
Group 3,RRG,-0.5,11,14,3979,8,2016,7,1
Group 3,RRG,-0.5,11,14,3980,4,2016,6,-2
Group 3,RRG,-0.5,11,14,3981,12,2016,9,3
Group 3,RRG,-0.5,11,14,3982,8,2016,8,0
Group 3,RRG,-0.5,11,14,3983,7,2016,9,-2
Group 3,RRG,-0.5,11,14,3984,3,2016,8,-5
Group 3,RRG,-0.5,11,14,3985,3,2016,8,-5
Group 3,RRG,-0.5,11,14,3986,7,2016,8,-1
Group 3,RRG,-0.5,11,14,3987,6,2016,4,2
Group 3,RRG,-0.5,11,14,3988,4,2016,7,-3
Group 3,RRG,-0.5,11,14,3989,8,2016,11,-3
Group 3,RRG,-0.5,11,14,3990,8,2016,8,0
Group 3,RRG,-0.5,11,14,3991,9,2016,7,2
Group 3,RRG,-0.5,11,14,3992,10,2016,7,3
Group 3,RRG,-0.5,11,14,3993,8,2016,8,0
Group 3,RRG,-0.5,11,14,3994,8,2016,11,-3
Group 3,RRG,-0.5,11,14,3995,10,2016,11,-1
Group 3,RRG,-0.5,11,14,3996,8,2016,11,-3
Group 3,RRG,-0.5,11,14,3997,3,2016,9,-6
Group 3,RRG,-0.5,11,14,3998,7,2016,9,-2
Group 3,RRG,-0.5,11,14,3999,8,2016,10,-2
Group 3,RRG,-0.5,11,14,4000,7,2016,8,-1
Group 5,RRG,-0.5,12,14,1,11,2016,5,6
Group 5,RRG,-0.5,12,14,2,10,2016,9,1
Group 5,RRG,-0.5,12,14,3,11,2016,7,4
Group 5,RRG,-0.5,12,14,4,10,2016,9,1
Group 5,RRG,-0.5,12,14,5,12,2016,8,4
Group 5,RRG,-0.5,12,14,6,9,2016,11,-2
Group 5,RRG,-0.5,12,14,7,11,2016,10,1
Group 5,RRG,-0.5,12,14,8,10,2016,10,0
Group 5,RRG,-0.5,12,14,9,12,2016,9,3
Group 5,RRG,-0.5,12,14,10,12,2016,9,3
Group 5,RRG,-0.5,12,14,11,10,2016,7,3
Group 5,RRG,-0.5,12,14,12,11,2016,10,1
Group 5,RRG,-0.5,12,14,13,11,2016,6,5
Group 5,RRG,-0.5,12,14,14,11,2016,5,6
Group 5,RRG,-0.5,12,14,15,9,2016,7,2
Group 5,RRG,-0.5,12,14,16,10,2016,7,3
Group 5,RRG,-0.5,12,14,17,11,2016,6,5
Group 5,RRG,-0.5,12,14,18,12,2016,11,1
Group 5,RRG,-0.5,12,14,19,9,2016,6,3
Group 5,RRG,-0.5,12,14,20,9,2016,7,2
Group 5,RRG,-0.5,12,14,21,9,2016,6,3
Group 5,RRG,-0.5,12,14,22,9,2016,8,1
Group 5,RRG,-0.5,12,14,23,10,2016,7,3
Group 5,RRG,-0.5,12,14,24,8,2016,11,-3
Group 5,RRG,-0.5,12,14,25,10,2016,10,0
Group 5,RRG,-0.5,12,14,26,8,2016,8,0
Group 5,RRG,-0.5,12,14,27,9,2016,8,1
Group 5,RRG,-0.5,12,14,28,8,2016,14,-6
Group 5,RRG,-0.5,12,14,29,11,2016,5,6
Group 5,RRG,-0.5,12,14,30,11,2016,6,5
Group 5,RRG,-0.5,12,14,31,6,2016,6,0
Group 5,RRG,-0.5,12,14,32,9,2016,8,1
Group 5,RRG,-0.5,12,14,33,9,2016,9,0
Group 5,RRG,-0.5,12,14,34,8,2016,8,0
Group 5,RRG,-0.5,12,14,35,11,2016,3,8
Group 5,RRG,-0.5,12,14,36,12,2016,10,2
Group 5,RRG,-0.5,12,14,37,10,2016,10,0
Group 5,RRG,-0.5,12,14,38,11,2016,12,-1
Group 5,RRG,-0.5,12,14,39,11,2016,9,2
Group 5,RRG,-0.5,12,14,40,10,2016,10,0
Group 5,RRG,-0.5,12,14,41,8,2016,11,-3
Group 5,RRG,-0.5,12,14,42,11,2016,10,1
Group 5,RRG,-0.5,12,14,43,8,2016,7,1
Group 5,RRG,-0.5,12,14,44,12,2016,7,5
Group 5,RRG,-0.5,12,14,45,13,2016,8,5
Group 5,RRG,-0.5,12,14,46,10,2016,6,4
Group 5,RRG,-0.5,12,14,47,10,2016,7,3
Group 5,RRG,-0.5,12,14,48,12,2016,8,4
Group 5,RRG,-0.5,12,14,49,7,2016,7,0
Group 5,RRG,-0.5,12,14,50,9,2016,8,1
Group 5,RRG,-0.5,12,14,51,10,2016,10,0
Group 5,RRG,-0.5,12,14,52,11,2016,8,3
Group 5,RRG,-0.5,12,14,53,12,2016,5,7
Group 5,RRG,-0.5,12,14,54,10,2016,12,-2
Group 5,RRG,-0.5,12,14,55,11,2016,10,1
Group 5,RRG,-0.5,12,14,56,10,2016,10,0
Group 5,RRG,-0.5,12,14,57,12,2016,9,3
Group 5,RRG,-0.5,12,14,58,11,2016,10,1
Group 5,RRG,-0.5,12,14,59,10,2016,12,-2
Group 5,RRG,-0.5,12,14,60,11,2016,7,4
Group 5,RRG,-0.5,12,14,61,10,2016,12,-2
Group 5,RRG,-0.5,12,14,62,7,2016,13,-6
Group 5,RRG,-0.5,12,14,63,9,2016,6,3
Group 5,RRG,-0.5,12,14,64,12,2016,9,3
Group 5,RRG,-0.5,12,14,65,11,2016,12,-1
Group 5,RRG,-0.5,12,14,66,12,2016,6,6
Group 5,RRG,-0.5,12,14,67,10,2016,6,4
Group 5,RRG,-0.5,12,14,68,10,2016,5,5
Group 5,RRG,-0.5,12,14,69,11,2016,1,10
Group 5,RRG,-0.5,12,14,70,9,2016,6,3
Group 5,RRG,-0.5,12,14,71,11,2016,4,7
Group 5,RRG,-0.5,12,14,72,9,2016,11,-2
Group 5,RRG,-0.5,12,14,73,11,2016,9,2
Group 5,RRG,-0.5,12,14,74,10,2016,10,0
Group 5,RRG,-0.5,12,14,75,11,2016,9,2
Group 5,RRG,-0.5,12,14,76,11,2016,4,7
Group 5,RRG,-0.5,12,14,77,9,2016,11,-2
Group 5,RRG,-0.5,12,14,78,12,2016,9,3
Group 5,RRG,-0.5,12,14,79,11,2016,6,5
Group 5,RRG,-0.5,12,14,80,9,2016,11,-2
Group 5,RRG,-0.5,12,14,81,12,2016,9,3
Group 5,RRG,-0.5,12,14,82,12,2016,9,3
Group 5,RRG,-0.5,12,14,83,12,2016,8,4
Group 5,RRG,-0.5,12,14,84,12,2016,8,4
Group 5,RRG,-0.5,12,14,85,9,2016,12,-3
Group 5,RRG,-0.5,12,14,86,11,2016,7,4
Group 5,RRG,-0.5,12,14,87,12,2016,9,3
Group 5,RRG,-0.5,12,14,88,10,2016,11,-1
Group 5,RRG,-0.5,12,14,89,10,2016,10,0
Group 5,RRG,-0.5,12,14,90,11,2016,9,2
Group 5,RRG,-0.5,12,14,91,12,2016,9,3
Group 5,RRG,-0.5,12,14,92,12,2016,8,4
Group 5,RRG,-0.5,12,14,93,11,2016,9,2
Group 5,RRG,-0.5,12,14,94,12,2016,8,4
Group 5,RRG,-0.5,12,14,95,14,2016,6,8
Group 5,RRG,-0.5,12,14,96,11,2016,8,3
Group 5,RRG,-0.5,12,14,97,11,2016,11,0
Group 5,RRG,-0.5,12,14,98,14,2016,7,7
Group 5,RRG,-0.5,12,14,99,12,2016,12,0
Group 5,RRG,-0.5,12,14,100,12,2016,7,5
Group 5,RRG,-0.5,12,14,101,9,2016,9,0
Group 5,RRG,-0.5,12,14,102,12,2016,10,2
Group 5,RRG,-0.5,12,14,103,10,2016,7,3
Group 5,RRG,-0.5,12,14,104,11,2016,8,3
Group 5,RRG,-0.5,12,14,105,9,2016,7,2
Group 5,RRG,-0.5,12,14,106,12,2016,9,3
Group 5,RRG,-0.5,12,14,107,12,2016,6,6
Group 5,RRG,-0.5,12,14,108,8,2016,8,0
Group 5,RRG,-0.5,12,14,109,11,2016,7,4
Group 5,RRG,-0.5,12,14,110,12,2016,9,3
Group 5,RRG,-0.5,12,14,111,10,2016,6,4
Group 5,RRG,-0.5,12,14,112,13,2016,10,3
Group 5,RRG,-0.5,12,14,113,9,2016,12,-3
Group 5,RRG,-0.5,12,14,114,12,2016,9,3
Group 5,RRG,-0.5,12,14,115,7,2016,4,3
Group 5,RRG,-0.5,12,14,116,9,2016,9,0
Group 5,RRG,-0.5,12,14,117,11,2016,8,3
Group 5,RRG,-0.5,12,14,118,13,2016,5,8
Group 5,RRG,-0.5,12,14,119,12,2016,9,3
Group 5,RRG,-0.5,12,14,120,11,2016,9,2
Group 5,RRG,-0.5,12,14,121,11,2016,11,0
Group 5,RRG,-0.5,12,14,122,11,2016,6,5
Group 5,RRG,-0.5,12,14,123,9,2016,11,-2
Group 5,RRG,-0.5,12,14,124,13,2016,12,1
Group 5,RRG,-0.5,12,14,125,7,2016,8,-1
Group 5,RRG,-0.5,12,14,126,10,2016,13,-3
Group 5,RRG,-0.5,12,14,127,10,2016,9,1
Group 5,RRG,-0.5,12,14,128,11,2016,11,0
Group 5,RRG,-0.5,12,14,129,11,2016,10,1
Group 5,RRG,-0.5,12,14,130,9,2016,10,-1
Group 5,RRG,-0.5,12,14,131,12,2016,10,2
Group 5,RRG,-0.5,12,14,132,7,2016,8,-1
Group 5,RRG,-0.5,12,14,133,9,2016,11,-2
Group 5,RRG,-0.5,12,14,134,11,2016,9,2
Group 5,RRG,-0.5,12,14,135,12,2016,8,4
Group 5,RRG,-0.5,12,14,136,11,2016,12,-1
Group 5,RRG,-0.5,12,14,137,10,2016,9,1
Group 5,RRG,-0.5,12,14,138,8,2016,7,1
Group 5,RRG,-0.5,12,14,139,12,2016,9,3
Group 5,RRG,-0.5,12,14,140,8,2016,8,0
Group 5,RRG,-0.5,12,14,141,12,2016,9,3
Group 5,RRG,-0.5,12,14,142,13,2016,14,-1
Group 5,RRG,-0.5,12,14,143,13,2016,9,4
Group 5,RRG,-0.5,12,14,144,9,2016,11,-2
Group 5,RRG,-0.5,12,14,145,8,2016,6,2
Group 5,RRG,-0.5,12,14,146,12,2016,9,3
Group 5,RRG,-0.5,12,14,147,11,2016,7,4
Group 5,RRG,-0.5,12,14,148,12,2016,7,5
Group 5,RRG,-0.5,12,14,149,11,2016,13,-2
Group 5,RRG,-0.5,12,14,150,10,2016,6,4
Group 5,RRG,-0.5,12,14,151,9,2016,12,-3
Group 5,RRG,-0.5,12,14,152,11,2016,10,1
Group 5,RRG,-0.5,12,14,153,12,2016,5,7
Group 5,RRG,-0.5,12,14,154,13,2016,12,1
Group 5,RRG,-0.5,12,14,155,12,2016,8,4
Group 5,RRG,-0.5,12,14,156,9,2016,8,1
Group 5,RRG,-0.5,12,14,157,12,2016,10,2
Group 5,RRG,-0.5,12,14,158,11,2016,4,7
Group 5,RRG,-0.5,12,14,159,10,2016,7,3
Group 5,RRG,-0.5,12,14,160,10,2016,4,6
Group 5,RRG,-0.5,12,14,161,11,2016,9,2
Group 5,RRG,-0.5,12,14,162,8,2016,9,-1
Group 5,RRG,-0.5,12,14,163,8,2016,7,1
Group 5,RRG,-0.5,12,14,164,8,2016,11,-3
Group 5,RRG,-0.5,12,14,165,10,2016,5,5
Group 5,RRG,-0.5,12,14,166,6,2016,9,-3
Group 5,RRG,-0.5,12,14,167,10,2016,9,1
Group 5,RRG,-0.5,12,14,168,11,2016,8,3
Group 5,RRG,-0.5,12,14,169,12,2016,7,5
Group 5,RRG,-0.5,12,14,170,10,2016,12,-2
Group 5,RRG,-0.5,12,14,171,9,2016,12,-3
Group 5,RRG,-0.5,12,14,172,12,2016,7,5
Group 5,RRG,-0.5,12,14,173,10,2016,5,5
Group 5,RRG,-0.5,12,14,174,9,2016,10,-1
Group 5,RRG,-0.5,12,14,175,11,2016,5,6
Group 5,RRG,-0.5,12,14,176,12,2016,13,-1
Group 5,RRG,-0.5,12,14,177,13,2016,7,6
Group 5,RRG,-0.5,12,14,178,12,2016,9,3
Group 5,RRG,-0.5,12,14,179,11,2016,9,2
Group 5,RRG,-0.5,12,14,180,8,2016,10,-2
Group 5,RRG,-0.5,12,14,181,13,2016,12,1
Group 5,RRG,-0.5,12,14,182,10,2016,7,3
Group 5,RRG,-0.5,12,14,183,13,2016,8,5
Group 5,RRG,-0.5,12,14,184,11,2016,8,3
Group 5,RRG,-0.5,12,14,185,10,2016,11,-1
Group 5,RRG,-0.5,12,14,186,11,2016,9,2
Group 5,RRG,-0.5,12,14,187,11,2016,7,4
Group 5,RRG,-0.5,12,14,188,7,2016,7,0
Group 5,RRG,-0.5,12,14,189,12,2016,10,2
Group 5,RRG,-0.5,12,14,190,10,2016,5,5
Group 5,RRG,-0.5,12,14,191,9,2016,10,-1
Group 5,RRG,-0.5,12,14,192,12,2016,7,5
Group 5,RRG,-0.5,12,14,193,10,2016,10,0
Group 5,RRG,-0.5,12,14,194,13,2016,11,2
Group 5,RRG,-0.5,12,14,195,11,2016,7,4
Group 5,RRG,-0.5,12,14,196,14,2016,10,4
Group 5,RRG,-0.5,12,14,197,13,2016,10,3
Group 5,RRG,-0.5,12,14,198,11,2016,6,5
Group 5,RRG,-0.5,12,14,199,12,2016,10,2
Group 5,RRG,-0.5,12,14,200,8,2016,9,-1
Group 5,RRG,-0.5,12,14,201,8,2016,10,-2
Group 5,RRG,-0.5,12,14,202,11,2016,9,2
Group 5,RRG,-0.5,12,14,203,11,2016,4,7
Group 5,RRG,-0.5,12,14,204,14,2016,11,3
Group 5,RRG,-0.5,12,14,205,9,2016,3,6
Group 5,RRG,-0.5,12,14,206,3,2016,7,-4
Group 5,RRG,-0.5,12,14,207,10,2016,5,5
Group 5,RRG,-0.5,12,14,208,13,2016,4,9
Group 5,RRG,-0.5,12,14,209,11,2016,10,1
Group 5,RRG,-0.5,12,14,210,9,2016,11,-2
Group 5,RRG,-0.5,12,14,211,11,2016,9,2
Group 5,RRG,-0.5,12,14,212,14,2016,8,6
Group 5,RRG,-0.5,12,14,213,10,2016,5,5
Group 5,RRG,-0.5,12,14,214,9,2016,7,2
Group 5,RRG,-0.5,12,14,215,11,2016,8,3
Group 5,RRG,-0.5,12,14,216,10,2016,7,3
Group 5,RRG,-0.5,12,14,217,10,2016,5,5
Group 5,RRG,-0.5,12,14,218,8,2016,9,-1
Group 5,RRG,-0.5,12,14,219,12,2016,5,7
Group 5,RRG,-0.5,12,14,220,9,2016,9,0
Group 5,RRG,-0.5,12,14,221,10,2016,8,2
Group 5,RRG,-0.5,12,14,222,8,2016,7,1
Group 5,RRG,-0.5,12,14,223,9,2016,4,5
Group 5,RRG,-0.5,12,14,224,11,2016,7,4
Group 5,RRG,-0.5,12,14,225,9,2016,6,3
Group 5,RRG,-0.5,12,14,226,10,2016,12,-2
Group 5,RRG,-0.5,12,14,227,8,2016,7,1
Group 5,RRG,-0.5,12,14,228,9,2016,12,-3
Group 5,RRG,-0.5,12,14,229,11,2016,7,4
Group 5,RRG,-0.5,12,14,230,8,2016,8,0
Group 5,RRG,-0.5,12,14,231,10,2016,10,0
Group 5,RRG,-0.5,12,14,232,14,2016,9,5
Group 5,RRG,-0.5,12,14,233,11,2016,4,7
Group 5,RRG,-0.5,12,14,234,12,2016,8,4
Group 5,RRG,-0.5,12,14,235,7,2016,10,-3
Group 5,RRG,-0.5,12,14,236,9,2016,7,2
Group 5,RRG,-0.5,12,14,237,9,2016,13,-4
Group 5,RRG,-0.5,12,14,238,7,2016,10,-3
Group 5,RRG,-0.5,12,14,239,11,2016,5,6
Group 5,RRG,-0.5,12,14,240,12,2016,11,1
Group 5,RRG,-0.5,12,14,241,11,2016,5,6
Group 5,RRG,-0.5,12,14,242,10,2016,9,1
Group 5,RRG,-0.5,12,14,243,11,2016,5,6
Group 5,RRG,-0.5,12,14,244,13,2016,12,1
Group 5,RRG,-0.5,12,14,245,12,2016,10,2
Group 5,RRG,-0.5,12,14,246,9,2016,7,2
Group 5,RRG,-0.5,12,14,247,9,2016,11,-2
Group 5,RRG,-0.5,12,14,248,9,2016,6,3
Group 5,RRG,-0.5,12,14,249,6,2016,8,-2
Group 5,RRG,-0.5,12,14,250,10,2016,9,1
Group 5,RRG,-0.5,12,14,251,11,2016,6,5
Group 5,RRG,-0.5,12,14,252,11,2016,9,2
Group 5,RRG,-0.5,12,14,253,13,2016,10,3
Group 5,RRG,-0.5,12,14,254,10,2016,8,2
Group 5,RRG,-0.5,12,14,255,7,2016,10,-3
Group 5,RRG,-0.5,12,14,256,7,2016,11,-4
Group 5,RRG,-0.5,12,14,257,11,2016,9,2
Group 5,RRG,-0.5,12,14,258,8,2016,10,-2
Group 5,RRG,-0.5,12,14,259,10,2016,11,-1
Group 5,RRG,-0.5,12,14,260,9,2016,8,1
Group 5,RRG,-0.5,12,14,261,10,2016,8,2
Group 5,RRG,-0.5,12,14,262,7,2016,9,-2
Group 5,RRG,-0.5,12,14,263,8,2016,2,6
Group 5,RRG,-0.5,12,14,264,13,2016,11,2
Group 5,RRG,-0.5,12,14,265,3,2016,7,-4
Group 5,RRG,-0.5,12,14,266,12,2016,5,7
Group 5,RRG,-0.5,12,14,267,7,2016,8,-1
Group 5,RRG,-0.5,12,14,268,11,2016,7,4
Group 5,RRG,-0.5,12,14,269,12,2016,10,2
Group 5,RRG,-0.5,12,14,270,9,2016,11,-2
Group 5,RRG,-0.5,12,14,271,10,2016,11,-1
Group 5,RRG,-0.5,12,14,272,11,2016,7,4
Group 5,RRG,-0.5,12,14,273,7,2016,8,-1
Group 5,RRG,-0.5,12,14,274,13,2016,7,6
Group 5,RRG,-0.5,12,14,275,9,2016,10,-1
Group 5,RRG,-0.5,12,14,276,13,2016,9,4
Group 5,RRG,-0.5,12,14,277,10,2016,6,4
Group 5,RRG,-0.5,12,14,278,11,2016,9,2
Group 5,RRG,-0.5,12,14,279,11,2016,9,2
Group 5,RRG,-0.5,12,14,280,10,2016,10,0
Group 5,RRG,-0.5,12,14,281,11,2016,11,0
Group 5,RRG,-0.5,12,14,282,12,2016,8,4
Group 5,RRG,-0.5,12,14,283,13,2016,5,8
Group 5,RRG,-0.5,12,14,284,9,2016,8,1
Group 5,RRG,-0.5,12,14,285,6,2016,7,-1
Group 5,RRG,-0.5,12,14,286,12,2016,10,2
Group 5,RRG,-0.5,12,14,287,12,2016,9,3
Group 5,RRG,-0.5,12,14,288,14,2016,11,3
Group 5,RRG,-0.5,12,14,289,12,2016,12,0
Group 5,RRG,-0.5,12,14,290,10,2016,6,4
Group 5,RRG,-0.5,12,14,291,11,2016,8,3
Group 5,RRG,-0.5,12,14,292,10,2016,9,1
Group 5,RRG,-0.5,12,14,293,11,2016,11,0
Group 5,RRG,-0.5,12,14,294,13,2016,11,2
Group 5,RRG,-0.5,12,14,295,10,2016,6,4
Group 5,RRG,-0.5,12,14,296,9,2016,9,0
Group 5,RRG,-0.5,12,14,297,12,2016,11,1
Group 5,RRG,-0.5,12,14,298,14,2016,6,8
Group 5,RRG,-0.5,12,14,299,12,2016,8,4
Group 5,RRG,-0.5,12,14,300,13,2016,7,6
Group 5,RRG,-0.5,12,14,301,10,2016,10,0
Group 5,RRG,-0.5,12,14,302,12,2016,10,2
Group 5,RRG,-0.5,12,14,303,12,2016,13,-1
Group 5,RRG,-0.5,12,14,304,8,2016,6,2
Group 5,RRG,-0.5,12,14,305,11,2016,9,2
Group 5,RRG,-0.5,12,14,306,12,2016,8,4
Group 5,RRG,-0.5,12,14,307,13,2016,7,6
Group 5,RRG,-0.5,12,14,308,9,2016,9,0
Group 5,RRG,-0.5,12,14,309,10,2016,7,3
Group 5,RRG,-0.5,12,14,310,7,2016,10,-3
Group 5,RRG,-0.5,12,14,311,13,2016,7,6
Group 5,RRG,-0.5,12,14,312,8,2016,9,-1
Group 5,RRG,-0.5,12,14,313,10,2016,12,-2
Group 5,RRG,-0.5,12,14,314,10,2016,6,4
Group 5,RRG,-0.5,12,14,315,11,2016,10,1
Group 5,RRG,-0.5,12,14,316,11,2016,8,3
Group 5,RRG,-0.5,12,14,317,12,2016,6,6
Group 5,RRG,-0.5,12,14,318,9,2016,11,-2
Group 5,RRG,-0.5,12,14,319,12,2016,9,3
Group 5,RRG,-0.5,12,14,320,11,2016,11,0
Group 5,RRG,-0.5,12,14,321,9,2016,9,0
Group 5,RRG,-0.5,12,14,322,11,2016,8,3
Group 5,RRG,-0.5,12,14,323,9,2016,11,-2
Group 5,RRG,-0.5,12,14,324,10,2016,9,1
Group 5,RRG,-0.5,12,14,325,8,2016,6,2
Group 5,RRG,-0.5,12,14,326,10,2016,5,5
Group 5,RRG,-0.5,12,14,327,11,2016,7,4
Group 5,RRG,-0.5,12,14,328,11,2016,10,1
Group 5,RRG,-0.5,12,14,329,10,2016,2,8
Group 5,RRG,-0.5,12,14,330,12,2016,12,0
Group 5,RRG,-0.5,12,14,331,10,2016,6,4
Group 5,RRG,-0.5,12,14,332,14,2016,5,9
Group 5,RRG,-0.5,12,14,333,10,2016,8,2
Group 5,RRG,-0.5,12,14,334,11,2016,6,5
Group 5,RRG,-0.5,12,14,335,10,2016,12,-2
Group 5,RRG,-0.5,12,14,336,10,2016,10,0
Group 5,RRG,-0.5,12,14,337,10,2016,5,5
Group 5,RRG,-0.5,12,14,338,8,2016,9,-1
Group 5,RRG,-0.5,12,14,339,11,2016,10,1
Group 5,RRG,-0.5,12,14,340,11,2016,10,1
Group 5,RRG,-0.5,12,14,341,10,2016,4,6
Group 5,RRG,-0.5,12,14,342,13,2016,10,3
Group 5,RRG,-0.5,12,14,343,8,2016,7,1
Group 5,RRG,-0.5,12,14,344,12,2016,11,1
Group 5,RRG,-0.5,12,14,345,12,2016,10,2
Group 5,RRG,-0.5,12,14,346,8,2016,9,-1
Group 5,RRG,-0.5,12,14,347,11,2016,9,2
Group 5,RRG,-0.5,12,14,348,12,2016,7,5
Group 5,RRG,-0.5,12,14,349,8,2016,10,-2
Group 5,RRG,-0.5,12,14,350,11,2016,7,4
Group 5,RRG,-0.5,12,14,351,10,2016,12,-2
Group 5,RRG,-0.5,12,14,352,9,2016,8,1
Group 5,RRG,-0.5,12,14,353,10,2016,8,2
Group 5,RRG,-0.5,12,14,354,11,2016,10,1
Group 5,RRG,-0.5,12,14,355,13,2016,10,3
Group 5,RRG,-0.5,12,14,356,11,2016,10,1
Group 5,RRG,-0.5,12,14,357,4,2016,6,-2
Group 5,RRG,-0.5,12,14,358,7,2016,8,-1
Group 5,RRG,-0.5,12,14,359,11,2016,6,5
Group 5,RRG,-0.5,12,14,360,12,2016,12,0
Group 5,RRG,-0.5,12,14,361,11,2016,7,4
Group 5,RRG,-0.5,12,14,362,13,2016,6,7
Group 5,RRG,-0.5,12,14,363,10,2016,10,0
Group 5,RRG,-0.5,12,14,364,7,2016,6,1
Group 5,RRG,-0.5,12,14,365,8,2016,5,3
Group 5,RRG,-0.5,12,14,366,12,2016,9,3
Group 5,RRG,-0.5,12,14,367,11,2016,7,4
Group 5,RRG,-0.5,12,14,368,8,2016,8,0
Group 5,RRG,-0.5,12,14,369,8,2016,6,2
Group 5,RRG,-0.5,12,14,370,11,2016,10,1
Group 5,RRG,-0.5,12,14,371,10,2016,6,4
Group 5,RRG,-0.5,12,14,372,11,2016,10,1
Group 5,RRG,-0.5,12,14,373,10,2016,8,2
Group 5,RRG,-0.5,12,14,374,11,2016,7,4
Group 5,RRG,-0.5,12,14,375,14,2016,10,4
Group 5,RRG,-0.5,12,14,376,10,2016,9,1
Group 5,RRG,-0.5,12,14,377,7,2016,5,2
Group 5,RRG,-0.5,12,14,378,13,2016,5,8
Group 5,RRG,-0.5,12,14,379,12,2016,5,7
Group 5,RRG,-0.5,12,14,380,11,2016,6,5
Group 5,RRG,-0.5,12,14,381,9,2016,5,4
Group 5,RRG,-0.5,12,14,382,8,2016,8,0
Group 5,RRG,-0.5,12,14,383,9,2016,6,3
Group 5,RRG,-0.5,12,14,384,13,2016,5,8
Group 5,RRG,-0.5,12,14,385,11,2016,10,1
Group 5,RRG,-0.5,12,14,386,9,2016,4,5
Group 5,RRG,-0.5,12,14,387,12,2016,8,4
Group 5,RRG,-0.5,12,14,388,10,2016,8,2
Group 5,RRG,-0.5,12,14,389,13,2016,12,1
Group 5,RRG,-0.5,12,14,390,11,2016,4,7
Group 5,RRG,-0.5,12,14,391,8,2016,7,1
Group 5,RRG,-0.5,12,14,392,11,2016,4,7
Group 5,RRG,-0.5,12,14,393,8,2016,12,-4
Group 5,RRG,-0.5,12,14,394,9,2016,5,4
Group 5,RRG,-0.5,12,14,395,10,2016,6,4
Group 5,RRG,-0.5,12,14,396,13,2016,11,2
Group 5,RRG,-0.5,12,14,397,12,2016,7,5
Group 5,RRG,-0.5,12,14,398,9,2016,6,3
Group 5,RRG,-0.5,12,14,399,11,2016,10,1
Group 5,RRG,-0.5,12,14,400,12,2016,8,4
Group 5,RRG,-0.5,12,14,401,9,2016,12,-3
Group 5,RRG,-0.5,12,14,402,10,2016,8,2
Group 5,RRG,-0.5,12,14,403,8,2016,7,1
Group 5,RRG,-0.5,12,14,404,4,2016,9,-5
Group 5,RRG,-0.5,12,14,405,11,2016,12,-1
Group 5,RRG,-0.5,12,14,406,13,2016,7,6
Group 5,RRG,-0.5,12,14,407,13,2016,7,6
Group 5,RRG,-0.5,12,14,408,10,2016,6,4
Group 5,RRG,-0.5,12,14,409,11,2016,9,2
Group 5,RRG,-0.5,12,14,410,11,2016,13,-2
Group 5,RRG,-0.5,12,14,411,11,2016,1,10
Group 5,RRG,-0.5,12,14,412,7,2016,7,0
Group 5,RRG,-0.5,12,14,413,6,2016,8,-2
Group 5,RRG,-0.5,12,14,414,12,2016,8,4
Group 5,RRG,-0.5,12,14,415,10,2016,12,-2
Group 5,RRG,-0.5,12,14,416,8,2016,8,0
Group 5,RRG,-0.5,12,14,417,9,2016,4,5
Group 5,RRG,-0.5,12,14,418,12,2016,11,1
Group 5,RRG,-0.5,12,14,419,11,2016,8,3
Group 5,RRG,-0.5,12,14,420,10,2016,11,-1
Group 5,RRG,-0.5,12,14,421,9,2016,11,-2
Group 5,RRG,-0.5,12,14,422,11,2016,10,1
Group 5,RRG,-0.5,12,14,423,12,2016,13,-1
Group 5,RRG,-0.5,12,14,424,13,2016,10,3
Group 5,RRG,-0.5,12,14,425,8,2016,10,-2
Group 5,RRG,-0.5,12,14,426,13,2016,7,6
Group 5,RRG,-0.5,12,14,427,10,2016,5,5
Group 5,RRG,-0.5,12,14,428,10,2016,12,-2
Group 5,RRG,-0.5,12,14,429,12,2016,8,4
Group 5,RRG,-0.5,12,14,430,10,2016,9,1
Group 5,RRG,-0.5,12,14,431,5,2016,10,-5
Group 5,RRG,-0.5,12,14,432,9,2016,9,0
Group 5,RRG,-0.5,12,14,433,8,2016,8,0
Group 5,RRG,-0.5,12,14,434,8,2016,5,3
Group 5,RRG,-0.5,12,14,435,11,2016,11,0
Group 5,RRG,-0.5,12,14,436,12,2016,11,1
Group 5,RRG,-0.5,12,14,437,10,2016,10,0
Group 5,RRG,-0.5,12,14,438,12,2016,8,4
Group 5,RRG,-0.5,12,14,439,9,2016,6,3
Group 5,RRG,-0.5,12,14,440,12,2016,8,4
Group 5,RRG,-0.5,12,14,441,10,2016,8,2
Group 5,RRG,-0.5,12,14,442,11,2016,11,0
Group 5,RRG,-0.5,12,14,443,13,2016,11,2
Group 5,RRG,-0.5,12,14,444,10,2016,12,-2
Group 5,RRG,-0.5,12,14,445,7,2016,7,0
Group 5,RRG,-0.5,12,14,446,11,2016,6,5
Group 5,RRG,-0.5,12,14,447,10,2016,11,-1
Group 5,RRG,-0.5,12,14,448,11,2016,10,1
Group 5,RRG,-0.5,12,14,449,11,2016,9,2
Group 5,RRG,-0.5,12,14,450,10,2016,8,2
Group 5,RRG,-0.5,12,14,451,13,2016,12,1
Group 5,RRG,-0.5,12,14,452,10,2016,11,-1
Group 5,RRG,-0.5,12,14,453,9,2016,8,1
Group 5,RRG,-0.5,12,14,454,11,2016,14,-3
Group 5,RRG,-0.5,12,14,455,7,2016,10,-3
Group 5,RRG,-0.5,12,14,456,11,2016,8,3
Group 5,RRG,-0.5,12,14,457,12,2016,12,0
Group 5,RRG,-0.5,12,14,458,10,2016,7,3
Group 5,RRG,-0.5,12,14,459,13,2016,7,6
Group 5,RRG,-0.5,12,14,460,9,2016,7,2
Group 5,RRG,-0.5,12,14,461,5,2016,6,-1
Group 5,RRG,-0.5,12,14,462,13,2016,9,4
Group 5,RRG,-0.5,12,14,463,12,2016,6,6
Group 5,RRG,-0.5,12,14,464,11,2016,10,1
Group 5,RRG,-0.5,12,14,465,8,2016,6,2
Group 5,RRG,-0.5,12,14,466,8,2016,1,7
Group 5,RRG,-0.5,12,14,467,13,2016,10,3
Group 5,RRG,-0.5,12,14,468,13,2016,9,4
Group 5,RRG,-0.5,12,14,469,13,2016,10,3
Group 5,RRG,-0.5,12,14,470,9,2016,10,-1
Group 5,RRG,-0.5,12,14,471,10,2016,8,2
Group 5,RRG,-0.5,12,14,472,11,2016,7,4
Group 5,RRG,-0.5,12,14,473,9,2016,9,0
Group 5,RRG,-0.5,12,14,474,14,2016,4,10
Group 5,RRG,-0.5,12,14,475,12,2016,5,7
Group 5,RRG,-0.5,12,14,476,9,2016,8,1
Group 5,RRG,-0.5,12,14,477,13,2016,7,6
Group 5,RRG,-0.5,12,14,478,10,2016,6,4
Group 5,RRG,-0.5,12,14,479,13,2016,10,3
Group 5,RRG,-0.5,12,14,480,10,2016,8,2
Group 5,RRG,-0.5,12,14,481,12,2016,10,2
Group 5,RRG,-0.5,12,14,482,6,2016,7,-1
Group 5,RRG,-0.5,12,14,483,10,2016,10,0
Group 5,RRG,-0.5,12,14,484,10,2016,10,0
Group 5,RRG,-0.5,12,14,485,11,2016,9,2
Group 5,RRG,-0.5,12,14,486,12,2016,9,3
Group 5,RRG,-0.5,12,14,487,13,2016,12,1
Group 5,RRG,-0.5,12,14,488,10,2016,7,3
Group 5,RRG,-0.5,12,14,489,7,2016,10,-3
Group 5,RRG,-0.5,12,14,490,11,2016,10,1
Group 5,RRG,-0.5,12,14,491,10,2016,12,-2
Group 5,RRG,-0.5,12,14,492,10,2016,7,3
Group 5,RRG,-0.5,12,14,493,7,2016,10,-3
Group 5,RRG,-0.5,12,14,494,9,2016,11,-2
Group 5,RRG,-0.5,12,14,495,12,2016,9,3
Group 5,RRG,-0.5,12,14,496,14,2016,5,9
Group 5,RRG,-0.5,12,14,497,11,2016,8,3
Group 5,RRG,-0.5,12,14,498,10,2016,13,-3
Group 5,RRG,-0.5,12,14,499,12,2016,11,1
Group 5,RRG,-0.5,12,14,500,9,2016,8,1
Group 5,RRG,-0.5,12,14,501,9,2016,9,0
Group 5,RRG,-0.5,12,14,502,9,2016,11,-2
Group 5,RRG,-0.5,12,14,503,13,2016,9,4
Group 5,RRG,-0.5,12,14,504,10,2016,12,-2
Group 5,RRG,-0.5,12,14,505,11,2016,11,0
Group 5,RRG,-0.5,12,14,506,11,2016,10,1
Group 5,RRG,-0.5,12,14,507,12,2016,9,3
Group 5,RRG,-0.5,12,14,508,10,2016,12,-2
Group 5,RRG,-0.5,12,14,509,11,2016,8,3
Group 5,RRG,-0.5,12,14,510,10,2016,11,-1
Group 5,RRG,-0.5,12,14,511,11,2016,8,3
Group 5,RRG,-0.5,12,14,512,5,2016,8,-3
Group 5,RRG,-0.5,12,14,513,11,2016,7,4
Group 5,RRG,-0.5,12,14,514,11,2016,11,0
Group 5,RRG,-0.5,12,14,515,7,2016,12,-5
Group 5,RRG,-0.5,12,14,516,11,2016,5,6
Group 5,RRG,-0.5,12,14,517,11,2016,9,2
Group 5,RRG,-0.5,12,14,518,14,2016,8,6
Group 5,RRG,-0.5,12,14,519,10,2016,5,5
Group 5,RRG,-0.5,12,14,520,13,2016,9,4
Group 5,RRG,-0.5,12,14,521,5,2016,10,-5
Group 5,RRG,-0.5,12,14,522,12,2016,5,7
Group 5,RRG,-0.5,12,14,523,12,2016,10,2
Group 5,RRG,-0.5,12,14,524,9,2016,4,5
Group 5,RRG,-0.5,12,14,525,10,2016,12,-2
Group 5,RRG,-0.5,12,14,526,13,2016,7,6
Group 5,RRG,-0.5,12,14,527,12,2016,7,5
Group 5,RRG,-0.5,12,14,528,9,2016,6,3
Group 5,RRG,-0.5,12,14,529,9,2016,10,-1
Group 5,RRG,-0.5,12,14,530,8,2016,10,-2
Group 5,RRG,-0.5,12,14,531,11,2016,6,5
Group 5,RRG,-0.5,12,14,532,12,2016,9,3
Group 5,RRG,-0.5,12,14,533,12,2016,7,5
Group 5,RRG,-0.5,12,14,534,10,2016,10,0
Group 5,RRG,-0.5,12,14,535,6,2016,7,-1
Group 5,RRG,-0.5,12,14,536,9,2016,11,-2
Group 5,RRG,-0.5,12,14,537,11,2016,9,2
Group 5,RRG,-0.5,12,14,538,12,2016,9,3
Group 5,RRG,-0.5,12,14,539,9,2016,11,-2
Group 5,RRG,-0.5,12,14,540,12,2016,9,3
Group 5,RRG,-0.5,12,14,541,9,2016,6,3
Group 5,RRG,-0.5,12,14,542,8,2016,9,-1
Group 5,RRG,-0.5,12,14,543,11,2016,5,6
Group 5,RRG,-0.5,12,14,544,11,2016,3,8
Group 5,RRG,-0.5,12,14,545,9,2016,10,-1
Group 5,RRG,-0.5,12,14,546,12,2016,6,6
Group 5,RRG,-0.5,12,14,547,11,2016,6,5
Group 5,RRG,-0.5,12,14,548,12,2016,7,5
Group 5,RRG,-0.5,12,14,549,9,2016,9,0
Group 5,RRG,-0.5,12,14,550,10,2016,7,3
Group 5,RRG,-0.5,12,14,551,11,2016,3,8
Group 5,RRG,-0.5,12,14,552,12,2016,6,6
Group 5,RRG,-0.5,12,14,553,4,2016,11,-7
Group 5,RRG,-0.5,12,14,554,7,2016,7,0
Group 5,RRG,-0.5,12,14,555,9,2016,9,0
Group 5,RRG,-0.5,12,14,556,12,2016,7,5
Group 5,RRG,-0.5,12,14,557,14,2016,11,3
Group 5,RRG,-0.5,12,14,558,10,2016,3,7
Group 5,RRG,-0.5,12,14,559,14,2016,13,1
Group 5,RRG,-0.5,12,14,560,10,2016,5,5
Group 5,RRG,-0.5,12,14,561,11,2016,11,0
Group 5,RRG,-0.5,12,14,562,6,2016,5,1
Group 5,RRG,-0.5,12,14,563,8,2016,12,-4
Group 5,RRG,-0.5,12,14,564,11,2016,9,2
Group 5,RRG,-0.5,12,14,565,11,2016,6,5
Group 5,RRG,-0.5,12,14,566,7,2016,7,0
Group 5,RRG,-0.5,12,14,567,8,2016,9,-1
Group 5,RRG,-0.5,12,14,568,14,2016,8,6
Group 5,RRG,-0.5,12,14,569,12,2016,12,0
Group 5,RRG,-0.5,12,14,570,13,2016,5,8
Group 5,RRG,-0.5,12,14,571,12,2016,6,6
Group 5,RRG,-0.5,12,14,572,11,2016,10,1
Group 5,RRG,-0.5,12,14,573,9,2016,8,1
Group 5,RRG,-0.5,12,14,574,8,2016,8,0
Group 5,RRG,-0.5,12,14,575,12,2016,5,7
Group 5,RRG,-0.5,12,14,576,5,2016,10,-5
Group 5,RRG,-0.5,12,14,577,7,2016,8,-1
Group 5,RRG,-0.5,12,14,578,11,2016,9,2
Group 5,RRG,-0.5,12,14,579,9,2016,8,1
Group 5,RRG,-0.5,12,14,580,14,2016,5,9
Group 5,RRG,-0.5,12,14,581,11,2016,9,2
Group 5,RRG,-0.5,12,14,582,8,2016,10,-2
Group 5,RRG,-0.5,12,14,583,9,2016,6,3
Group 5,RRG,-0.5,12,14,584,12,2016,8,4
Group 5,RRG,-0.5,12,14,585,11,2016,7,4
Group 5,RRG,-0.5,12,14,586,10,2016,7,3
Group 5,RRG,-0.5,12,14,587,8,2016,9,-1
Group 5,RRG,-0.5,12,14,588,10,2016,4,6
Group 5,RRG,-0.5,12,14,589,8,2016,6,2
Group 5,RRG,-0.5,12,14,590,10,2016,11,-1
Group 5,RRG,-0.5,12,14,591,11,2016,7,4
Group 5,RRG,-0.5,12,14,592,10,2016,8,2
Group 5,RRG,-0.5,12,14,593,11,2016,8,3
Group 5,RRG,-0.5,12,14,594,12,2016,7,5
Group 5,RRG,-0.5,12,14,595,13,2016,7,6
Group 5,RRG,-0.5,12,14,596,9,2016,9,0
Group 5,RRG,-0.5,12,14,597,9,2016,6,3
Group 5,RRG,-0.5,12,14,598,12,2016,5,7
Group 5,RRG,-0.5,12,14,599,8,2016,7,1
Group 5,RRG,-0.5,12,14,600,12,2016,8,4
Group 5,RRG,-0.5,12,14,601,13,2016,6,7
Group 5,RRG,-0.5,12,14,602,11,2016,5,6
Group 5,RRG,-0.5,12,14,603,12,2016,7,5
Group 5,RRG,-0.5,12,14,604,12,2016,10,2
Group 5,RRG,-0.5,12,14,605,11,2016,7,4
Group 5,RRG,-0.5,12,14,606,7,2016,13,-6
Group 5,RRG,-0.5,12,14,607,9,2016,9,0
Group 5,RRG,-0.5,12,14,608,14,2016,5,9
Group 5,RRG,-0.5,12,14,609,14,2016,6,8
Group 5,RRG,-0.5,12,14,610,10,2016,10,0
Group 5,RRG,-0.5,12,14,611,9,2016,9,0
Group 5,RRG,-0.5,12,14,612,14,2016,7,7
Group 5,RRG,-0.5,12,14,613,9,2016,6,3
Group 5,RRG,-0.5,12,14,614,12,2016,6,6
Group 5,RRG,-0.5,12,14,615,11,2016,6,5
Group 5,RRG,-0.5,12,14,616,13,2016,10,3
Group 5,RRG,-0.5,12,14,617,11,2016,7,4
Group 5,RRG,-0.5,12,14,618,12,2016,3,9
Group 5,RRG,-0.5,12,14,619,10,2016,8,2
Group 5,RRG,-0.5,12,14,620,10,2016,8,2
Group 5,RRG,-0.5,12,14,621,10,2016,6,4
Group 5,RRG,-0.5,12,14,622,11,2016,10,1
Group 5,RRG,-0.5,12,14,623,11,2016,9,2
Group 5,RRG,-0.5,12,14,624,10,2016,6,4
Group 5,RRG,-0.5,12,14,625,11,2016,8,3
Group 5,RRG,-0.5,12,14,626,11,2016,12,-1
Group 5,RRG,-0.5,12,14,627,8,2016,10,-2
Group 5,RRG,-0.5,12,14,628,11,2016,6,5
Group 5,RRG,-0.5,12,14,629,12,2016,10,2
Group 5,RRG,-0.5,12,14,630,12,2016,9,3
Group 5,RRG,-0.5,12,14,631,8,2016,8,0
Group 5,RRG,-0.5,12,14,632,6,2016,9,-3
Group 5,RRG,-0.5,12,14,633,9,2016,8,1
Group 5,RRG,-0.5,12,14,634,10,2016,8,2
Group 5,RRG,-0.5,12,14,635,14,2016,8,6
Group 5,RRG,-0.5,12,14,636,9,2016,9,0
Group 5,RRG,-0.5,12,14,637,7,2016,11,-4
Group 5,RRG,-0.5,12,14,638,10,2016,7,3
Group 5,RRG,-0.5,12,14,639,10,2016,7,3
Group 5,RRG,-0.5,12,14,640,13,2016,9,4
Group 5,RRG,-0.5,12,14,641,9,2016,6,3
Group 5,RRG,-0.5,12,14,642,13,2016,6,7
Group 5,RRG,-0.5,12,14,643,9,2016,5,4
Group 5,RRG,-0.5,12,14,644,10,2016,5,5
Group 5,RRG,-0.5,12,14,645,10,2016,9,1
Group 5,RRG,-0.5,12,14,646,13,2016,10,3
Group 5,RRG,-0.5,12,14,647,11,2016,9,2
Group 5,RRG,-0.5,12,14,648,12,2016,9,3
Group 5,RRG,-0.5,12,14,649,13,2016,7,6
Group 5,RRG,-0.5,12,14,650,9,2016,7,2
Group 5,RRG,-0.5,12,14,651,11,2016,9,2
Group 5,RRG,-0.5,12,14,652,11,2016,7,4
Group 5,RRG,-0.5,12,14,653,11,2016,8,3
Group 5,RRG,-0.5,12,14,654,9,2016,10,-1
Group 5,RRG,-0.5,12,14,655,8,2016,9,-1
Group 5,RRG,-0.5,12,14,656,12,2016,7,5
Group 5,RRG,-0.5,12,14,657,10,2016,11,-1
Group 5,RRG,-0.5,12,14,658,10,2016,9,1
Group 5,RRG,-0.5,12,14,659,10,2016,11,-1
Group 5,RRG,-0.5,12,14,660,13,2016,8,5
Group 5,RRG,-0.5,12,14,661,11,2016,6,5
Group 5,RRG,-0.5,12,14,662,11,2016,7,4
Group 5,RRG,-0.5,12,14,663,11,2016,9,2
Group 5,RRG,-0.5,12,14,664,9,2016,6,3
Group 5,RRG,-0.5,12,14,665,9,2016,11,-2
Group 5,RRG,-0.5,12,14,666,10,2016,8,2
Group 5,RRG,-0.5,12,14,667,11,2016,11,0
Group 5,RRG,-0.5,12,14,668,9,2016,6,3
Group 5,RRG,-0.5,12,14,669,9,2016,10,-1
Group 5,RRG,-0.5,12,14,670,8,2016,9,-1
Group 5,RRG,-0.5,12,14,671,13,2016,9,4
Group 5,RRG,-0.5,12,14,672,13,2016,6,7
Group 5,RRG,-0.5,12,14,673,10,2016,10,0
Group 5,RRG,-0.5,12,14,674,10,2016,2,8
Group 5,RRG,-0.5,12,14,675,12,2016,9,3
Group 5,RRG,-0.5,12,14,676,11,2016,8,3
Group 5,RRG,-0.5,12,14,677,11,2016,6,5
Group 5,RRG,-0.5,12,14,678,10,2016,12,-2
Group 5,RRG,-0.5,12,14,679,12,2016,7,5
Group 5,RRG,-0.5,12,14,680,12,2016,12,0
Group 5,RRG,-0.5,12,14,681,11,2016,11,0
Group 5,RRG,-0.5,12,14,682,9,2016,7,2
Group 5,RRG,-0.5,12,14,683,11,2016,7,4
Group 5,RRG,-0.5,12,14,684,9,2016,9,0
Group 5,RRG,-0.5,12,14,685,9,2016,11,-2
Group 5,RRG,-0.5,12,14,686,10,2016,6,4
Group 5,RRG,-0.5,12,14,687,10,2016,10,0
Group 5,RRG,-0.5,12,14,688,13,2016,11,2
Group 5,RRG,-0.5,12,14,689,11,2016,4,7
Group 5,RRG,-0.5,12,14,690,13,2016,9,4
Group 5,RRG,-0.5,12,14,691,11,2016,10,1
Group 5,RRG,-0.5,12,14,692,12,2016,8,4
Group 5,RRG,-0.5,12,14,693,10,2016,4,6
Group 5,RRG,-0.5,12,14,694,10,2016,8,2
Group 5,RRG,-0.5,12,14,695,9,2016,10,-1
Group 5,RRG,-0.5,12,14,696,11,2016,6,5
Group 5,RRG,-0.5,12,14,697,13,2016,10,3
Group 5,RRG,-0.5,12,14,698,13,2016,1,12
Group 5,RRG,-0.5,12,14,699,9,2016,8,1
Group 5,RRG,-0.5,12,14,700,10,2016,9,1
Group 5,RRG,-0.5,12,14,701,9,2016,7,2
Group 5,RRG,-0.5,12,14,702,10,2016,7,3
Group 5,RRG,-0.5,12,14,703,12,2016,11,1
Group 5,RRG,-0.5,12,14,704,13,2016,7,6
Group 5,RRG,-0.5,12,14,705,8,2016,7,1
Group 5,RRG,-0.5,12,14,706,10,2016,8,2
Group 5,RRG,-0.5,12,14,707,8,2016,3,5
Group 5,RRG,-0.5,12,14,708,12,2016,8,4
Group 5,RRG,-0.5,12,14,709,13,2016,5,8
Group 5,RRG,-0.5,12,14,710,9,2016,9,0
Group 5,RRG,-0.5,12,14,711,10,2016,7,3
Group 5,RRG,-0.5,12,14,712,6,2016,7,-1
Group 5,RRG,-0.5,12,14,713,10,2016,8,2
Group 5,RRG,-0.5,12,14,714,12,2016,4,8
Group 5,RRG,-0.5,12,14,715,10,2016,6,4
Group 5,RRG,-0.5,12,14,716,11,2016,1,10
Group 5,RRG,-0.5,12,14,717,12,2016,13,-1
Group 5,RRG,-0.5,12,14,718,10,2016,3,7
Group 5,RRG,-0.5,12,14,719,12,2016,12,0
Group 5,RRG,-0.5,12,14,720,13,2016,9,4
Group 5,RRG,-0.5,12,14,721,13,2016,9,4
Group 5,RRG,-0.5,12,14,722,11,2016,10,1
Group 5,RRG,-0.5,12,14,723,12,2016,11,1
Group 5,RRG,-0.5,12,14,724,11,2016,11,0
Group 5,RRG,-0.5,12,14,725,14,2016,11,3
Group 5,RRG,-0.5,12,14,726,10,2016,4,6
Group 5,RRG,-0.5,12,14,727,8,2016,10,-2
Group 5,RRG,-0.5,12,14,728,12,2016,14,-2
Group 5,RRG,-0.5,12,14,729,12,2016,3,9
Group 5,RRG,-0.5,12,14,730,9,2016,14,-5
Group 5,RRG,-0.5,12,14,731,13,2016,14,-1
Group 5,RRG,-0.5,12,14,732,11,2016,9,2
Group 5,RRG,-0.5,12,14,733,4,2016,5,-1
Group 5,RRG,-0.5,12,14,734,9,2016,11,-2
Group 5,RRG,-0.5,12,14,735,9,2016,9,0
Group 5,RRG,-0.5,12,14,736,9,2016,12,-3
Group 5,RRG,-0.5,12,14,737,12,2016,6,6
Group 5,RRG,-0.5,12,14,738,9,2016,7,2
Group 5,RRG,-0.5,12,14,739,13,2016,8,5
Group 5,RRG,-0.5,12,14,740,11,2016,8,3
Group 5,RRG,-0.5,12,14,741,10,2016,6,4
Group 5,RRG,-0.5,12,14,742,12,2016,7,5
Group 5,RRG,-0.5,12,14,743,11,2016,7,4
Group 5,RRG,-0.5,12,14,744,14,2016,11,3
Group 5,RRG,-0.5,12,14,745,12,2016,6,6
Group 5,RRG,-0.5,12,14,746,12,2016,6,6
Group 5,RRG,-0.5,12,14,747,10,2016,6,4
Group 5,RRG,-0.5,12,14,748,12,2016,10,2
Group 5,RRG,-0.5,12,14,749,8,2016,5,3
Group 5,RRG,-0.5,12,14,750,9,2016,7,2
Group 5,RRG,-0.5,12,14,751,11,2016,7,4
Group 5,RRG,-0.5,12,14,752,10,2016,7,3
Group 5,RRG,-0.5,12,14,753,11,2016,9,2
Group 5,RRG,-0.5,12,14,754,12,2016,7,5
Group 5,RRG,-0.5,12,14,755,8,2016,13,-5
Group 5,RRG,-0.5,12,14,756,11,2016,9,2
Group 5,RRG,-0.5,12,14,757,10,2016,13,-3
Group 5,RRG,-0.5,12,14,758,11,2016,6,5
Group 5,RRG,-0.5,12,14,759,9,2016,11,-2
Group 5,RRG,-0.5,12,14,760,10,2016,5,5
Group 5,RRG,-0.5,12,14,761,8,2016,12,-4
Group 5,RRG,-0.5,12,14,762,12,2016,7,5
Group 5,RRG,-0.5,12,14,763,7,2016,7,0
Group 5,RRG,-0.5,12,14,764,5,2016,7,-2
Group 5,RRG,-0.5,12,14,765,12,2016,7,5
Group 5,RRG,-0.5,12,14,766,12,2016,6,6
Group 5,RRG,-0.5,12,14,767,12,2016,10,2
Group 5,RRG,-0.5,12,14,768,9,2016,11,-2
Group 5,RRG,-0.5,12,14,769,10,2016,10,0
Group 5,RRG,-0.5,12,14,770,10,2016,5,5
Group 5,RRG,-0.5,12,14,771,7,2016,6,1
Group 5,RRG,-0.5,12,14,772,10,2016,12,-2
Group 5,RRG,-0.5,12,14,773,12,2016,8,4
Group 5,RRG,-0.5,12,14,774,7,2016,9,-2
Group 5,RRG,-0.5,12,14,775,10,2016,3,7
Group 5,RRG,-0.5,12,14,776,9,2016,7,2
Group 5,RRG,-0.5,12,14,777,10,2016,9,1
Group 5,RRG,-0.5,12,14,778,13,2016,7,6
Group 5,RRG,-0.5,12,14,779,9,2016,13,-4
Group 5,RRG,-0.5,12,14,780,12,2016,10,2
Group 5,RRG,-0.5,12,14,781,11,2016,6,5
Group 5,RRG,-0.5,12,14,782,12,2016,7,5
Group 5,RRG,-0.5,12,14,783,11,2016,10,1
Group 5,RRG,-0.5,12,14,784,12,2016,9,3
Group 5,RRG,-0.5,12,14,785,10,2016,8,2
Group 5,RRG,-0.5,12,14,786,8,2016,6,2
Group 5,RRG,-0.5,12,14,787,10,2016,3,7
Group 5,RRG,-0.5,12,14,788,12,2016,4,8
Group 5,RRG,-0.5,12,14,789,6,2016,10,-4
Group 5,RRG,-0.5,12,14,790,13,2016,11,2
Group 5,RRG,-0.5,12,14,791,11,2016,7,4
Group 5,RRG,-0.5,12,14,792,9,2016,8,1
Group 5,RRG,-0.5,12,14,793,12,2016,8,4
Group 5,RRG,-0.5,12,14,794,10,2016,10,0
Group 5,RRG,-0.5,12,14,795,7,2016,7,0
Group 5,RRG,-0.5,12,14,796,10,2016,9,1
Group 5,RRG,-0.5,12,14,797,10,2016,10,0
Group 5,RRG,-0.5,12,14,798,9,2016,8,1
Group 5,RRG,-0.5,12,14,799,9,2016,11,-2
Group 5,RRG,-0.5,12,14,800,10,2016,6,4
Group 5,RRG,-0.5,12,14,801,9,2016,7,2
Group 5,RRG,-0.5,12,14,802,8,2016,4,4
Group 5,RRG,-0.5,12,14,803,7,2016,5,2
Group 5,RRG,-0.5,12,14,804,11,2016,6,5
Group 5,RRG,-0.5,12,14,805,11,2016,6,5
Group 5,RRG,-0.5,12,14,806,13,2016,9,4
Group 5,RRG,-0.5,12,14,807,12,2016,8,4
Group 5,RRG,-0.5,12,14,808,10,2016,9,1
Group 5,RRG,-0.5,12,14,809,9,2016,11,-2
Group 5,RRG,-0.5,12,14,810,11,2016,12,-1
Group 5,RRG,-0.5,12,14,811,9,2016,6,3
Group 5,RRG,-0.5,12,14,812,12,2016,10,2
Group 5,RRG,-0.5,12,14,813,7,2016,13,-6
Group 5,RRG,-0.5,12,14,814,7,2016,9,-2
Group 5,RRG,-0.5,12,14,815,12,2016,11,1
Group 5,RRG,-0.5,12,14,816,9,2016,8,1
Group 5,RRG,-0.5,12,14,817,9,2016,8,1
Group 5,RRG,-0.5,12,14,818,12,2016,11,1
Group 5,RRG,-0.5,12,14,819,11,2016,12,-1
Group 5,RRG,-0.5,12,14,820,12,2016,10,2
Group 5,RRG,-0.5,12,14,821,6,2016,11,-5
Group 5,RRG,-0.5,12,14,822,9,2016,9,0
Group 5,RRG,-0.5,12,14,823,10,2016,10,0
Group 5,RRG,-0.5,12,14,824,10,2016,9,1
Group 5,RRG,-0.5,12,14,825,10,2016,7,3
Group 5,RRG,-0.5,12,14,826,8,2016,7,1
Group 5,RRG,-0.5,12,14,827,10,2016,7,3
Group 5,RRG,-0.5,12,14,828,8,2016,10,-2
Group 5,RRG,-0.5,12,14,829,7,2016,8,-1
Group 5,RRG,-0.5,12,14,830,11,2016,12,-1
Group 5,RRG,-0.5,12,14,831,12,2016,11,1
Group 5,RRG,-0.5,12,14,832,7,2016,8,-1
Group 5,RRG,-0.5,12,14,833,9,2016,12,-3
Group 5,RRG,-0.5,12,14,834,13,2016,9,4
Group 5,RRG,-0.5,12,14,835,12,2016,8,4
Group 5,RRG,-0.5,12,14,836,12,2016,10,2
Group 5,RRG,-0.5,12,14,837,10,2016,8,2
Group 5,RRG,-0.5,12,14,838,9,2016,5,4
Group 5,RRG,-0.5,12,14,839,13,2016,8,5
Group 5,RRG,-0.5,12,14,840,9,2016,6,3
Group 5,RRG,-0.5,12,14,841,11,2016,9,2
Group 5,RRG,-0.5,12,14,842,6,2016,11,-5
Group 5,RRG,-0.5,12,14,843,10,2016,8,2
Group 5,RRG,-0.5,12,14,844,13,2016,8,5
Group 5,RRG,-0.5,12,14,845,14,2016,7,7
Group 5,RRG,-0.5,12,14,846,12,2016,11,1
Group 5,RRG,-0.5,12,14,847,7,2016,5,2
Group 5,RRG,-0.5,12,14,848,12,2016,8,4
Group 5,RRG,-0.5,12,14,849,9,2016,5,4
Group 5,RRG,-0.5,12,14,850,6,2016,9,-3
Group 5,RRG,-0.5,12,14,851,14,2016,8,6
Group 5,RRG,-0.5,12,14,852,11,2016,10,1
Group 5,RRG,-0.5,12,14,853,13,2016,5,8
Group 5,RRG,-0.5,12,14,854,7,2016,10,-3
Group 5,RRG,-0.5,12,14,855,9,2016,10,-1
Group 5,RRG,-0.5,12,14,856,12,2016,11,1
Group 5,RRG,-0.5,12,14,857,8,2016,8,0
Group 5,RRG,-0.5,12,14,858,12,2016,4,8
Group 5,RRG,-0.5,12,14,859,12,2016,9,3
Group 5,RRG,-0.5,12,14,860,11,2016,8,3
Group 5,RRG,-0.5,12,14,861,10,2016,7,3
Group 5,RRG,-0.5,12,14,862,13,2016,11,2
Group 5,RRG,-0.5,12,14,863,13,2016,10,3
Group 5,RRG,-0.5,12,14,864,12,2016,6,6
Group 5,RRG,-0.5,12,14,865,10,2016,9,1
Group 5,RRG,-0.5,12,14,866,11,2016,10,1
Group 5,RRG,-0.5,12,14,867,8,2016,12,-4
Group 5,RRG,-0.5,12,14,868,8,2016,7,1
Group 5,RRG,-0.5,12,14,869,9,2016,10,-1
Group 5,RRG,-0.5,12,14,870,11,2016,8,3
Group 5,RRG,-0.5,12,14,871,10,2016,11,-1
Group 5,RRG,-0.5,12,14,872,10,2016,13,-3
Group 5,RRG,-0.5,12,14,873,11,2016,10,1
Group 5,RRG,-0.5,12,14,874,10,2016,10,0
Group 5,RRG,-0.5,12,14,875,10,2016,12,-2
Group 5,RRG,-0.5,12,14,876,9,2016,6,3
Group 5,RRG,-0.5,12,14,877,11,2016,13,-2
Group 5,RRG,-0.5,12,14,878,11,2016,7,4
Group 5,RRG,-0.5,12,14,879,12,2016,5,7
Group 5,RRG,-0.5,12,14,880,12,2016,4,8
Group 5,RRG,-0.5,12,14,881,9,2016,10,-1
Group 5,RRG,-0.5,12,14,882,11,2016,11,0
Group 5,RRG,-0.5,12,14,883,13,2016,13,0
Group 5,RRG,-0.5,12,14,884,11,2016,8,3
Group 5,RRG,-0.5,12,14,885,8,2016,7,1
Group 5,RRG,-0.5,12,14,886,13,2016,12,1
Group 5,RRG,-0.5,12,14,887,12,2016,9,3
Group 5,RRG,-0.5,12,14,888,10,2016,9,1
Group 5,RRG,-0.5,12,14,889,10,2016,7,3
Group 5,RRG,-0.5,12,14,890,13,2016,10,3
Group 5,RRG,-0.5,12,14,891,6,2016,10,-4
Group 5,RRG,-0.5,12,14,892,10,2016,7,3
Group 5,RRG,-0.5,12,14,893,6,2016,8,-2
Group 5,RRG,-0.5,12,14,894,8,2016,12,-4
Group 5,RRG,-0.5,12,14,895,8,2016,8,0
Group 5,RRG,-0.5,12,14,896,12,2016,11,1
Group 5,RRG,-0.5,12,14,897,11,2016,9,2
Group 5,RRG,-0.5,12,14,898,9,2016,4,5
Group 5,RRG,-0.5,12,14,899,12,2016,4,8
Group 5,RRG,-0.5,12,14,900,8,2016,9,-1
Group 5,RRG,-0.5,12,14,901,8,2016,9,-1
Group 5,RRG,-0.5,12,14,902,14,2016,7,7
Group 5,RRG,-0.5,12,14,903,13,2016,8,5
Group 5,RRG,-0.5,12,14,904,11,2016,8,3
Group 5,RRG,-0.5,12,14,905,12,2016,8,4
Group 5,RRG,-0.5,12,14,906,12,2016,7,5
Group 5,RRG,-0.5,12,14,907,10,2016,10,0
Group 5,RRG,-0.5,12,14,908,10,2016,9,1
Group 5,RRG,-0.5,12,14,909,9,2016,7,2
Group 5,RRG,-0.5,12,14,910,12,2016,3,9
Group 5,RRG,-0.5,12,14,911,11,2016,14,-3
Group 5,RRG,-0.5,12,14,912,11,2016,11,0
Group 5,RRG,-0.5,12,14,913,9,2016,1,8
Group 5,RRG,-0.5,12,14,914,6,2016,8,-2
Group 5,RRG,-0.5,12,14,915,8,2016,2,6
Group 5,RRG,-0.5,12,14,916,11,2016,2,9
Group 5,RRG,-0.5,12,14,917,11,2016,13,-2
Group 5,RRG,-0.5,12,14,918,7,2016,13,-6
Group 5,RRG,-0.5,12,14,919,8,2016,10,-2
Group 5,RRG,-0.5,12,14,920,12,2016,11,1
Group 5,RRG,-0.5,12,14,921,9,2016,8,1
Group 5,RRG,-0.5,12,14,922,9,2016,9,0
Group 5,RRG,-0.5,12,14,923,13,2016,9,4
Group 5,RRG,-0.5,12,14,924,10,2016,10,0
Group 5,RRG,-0.5,12,14,925,10,2016,7,3
Group 5,RRG,-0.5,12,14,926,10,2016,9,1
Group 5,RRG,-0.5,12,14,927,11,2016,7,4
Group 5,RRG,-0.5,12,14,928,8,2016,10,-2
Group 5,RRG,-0.5,12,14,929,12,2016,10,2
Group 5,RRG,-0.5,12,14,930,11,2016,11,0
Group 5,RRG,-0.5,12,14,931,11,2016,10,1
Group 5,RRG,-0.5,12,14,932,13,2016,9,4
Group 5,RRG,-0.5,12,14,933,12,2016,7,5
Group 5,RRG,-0.5,12,14,934,5,2016,8,-3
Group 5,RRG,-0.5,12,14,935,7,2016,9,-2
Group 5,RRG,-0.5,12,14,936,10,2016,8,2
Group 5,RRG,-0.5,12,14,937,9,2016,6,3
Group 5,RRG,-0.5,12,14,938,9,2016,7,2
Group 5,RRG,-0.5,12,14,939,8,2016,8,0
Group 5,RRG,-0.5,12,14,940,13,2016,9,4
Group 5,RRG,-0.5,12,14,941,8,2016,12,-4
Group 5,RRG,-0.5,12,14,942,9,2016,12,-3
Group 5,RRG,-0.5,12,14,943,11,2016,5,6
Group 5,RRG,-0.5,12,14,944,9,2016,10,-1
Group 5,RRG,-0.5,12,14,945,9,2016,9,0
Group 5,RRG,-0.5,12,14,946,13,2016,12,1
Group 5,RRG,-0.5,12,14,947,13,2016,10,3
Group 5,RRG,-0.5,12,14,948,6,2016,8,-2
Group 5,RRG,-0.5,12,14,949,12,2016,10,2
Group 5,RRG,-0.5,12,14,950,11,2016,9,2
Group 5,RRG,-0.5,12,14,951,12,2016,7,5
Group 5,RRG,-0.5,12,14,952,9,2016,7,2
Group 5,RRG,-0.5,12,14,953,10,2016,10,0
Group 5,RRG,-0.5,12,14,954,9,2016,10,-1
Group 5,RRG,-0.5,12,14,955,13,2016,10,3
Group 5,RRG,-0.5,12,14,956,11,2016,9,2
Group 5,RRG,-0.5,12,14,957,11,2016,13,-2
Group 5,RRG,-0.5,12,14,958,10,2016,7,3
Group 5,RRG,-0.5,12,14,959,11,2016,7,4
Group 5,RRG,-0.5,12,14,960,11,2016,6,5
Group 5,RRG,-0.5,12,14,961,11,2016,12,-1
Group 5,RRG,-0.5,12,14,962,10,2016,7,3
Group 5,RRG,-0.5,12,14,963,9,2016,7,2
Group 5,RRG,-0.5,12,14,964,13,2016,8,5
Group 5,RRG,-0.5,12,14,965,14,2016,5,9
Group 5,RRG,-0.5,12,14,966,12,2016,5,7
Group 5,RRG,-0.5,12,14,967,11,2016,12,-1
Group 5,RRG,-0.5,12,14,968,13,2016,9,4
Group 5,RRG,-0.5,12,14,969,10,2016,8,2
Group 5,RRG,-0.5,12,14,970,11,2016,7,4
Group 5,RRG,-0.5,12,14,971,11,2016,8,3
Group 5,RRG,-0.5,12,14,972,10,2016,5,5
Group 5,RRG,-0.5,12,14,973,13,2016,13,0
Group 5,RRG,-0.5,12,14,974,10,2016,5,5
Group 5,RRG,-0.5,12,14,975,10,2016,6,4
Group 5,RRG,-0.5,12,14,976,8,2016,7,1
Group 5,RRG,-0.5,12,14,977,13,2016,9,4
Group 5,RRG,-0.5,12,14,978,6,2016,6,0
Group 5,RRG,-0.5,12,14,979,11,2016,6,5
Group 5,RRG,-0.5,12,14,980,9,2016,8,1
Group 5,RRG,-0.5,12,14,981,11,2016,12,-1
Group 5,RRG,-0.5,12,14,982,12,2016,7,5
Group 5,RRG,-0.5,12,14,983,10,2016,12,-2
Group 5,RRG,-0.5,12,14,984,8,2016,6,2
Group 5,RRG,-0.5,12,14,985,11,2016,11,0
Group 5,RRG,-0.5,12,14,986,11,2016,7,4
Group 5,RRG,-0.5,12,14,987,10,2016,11,-1
Group 5,RRG,-0.5,12,14,988,5,2016,9,-4
Group 5,RRG,-0.5,12,14,989,12,2016,5,7
Group 5,RRG,-0.5,12,14,990,9,2016,8,1
Group 5,RRG,-0.5,12,14,991,12,2016,8,4
Group 5,RRG,-0.5,12,14,992,11,2016,5,6
Group 5,RRG,-0.5,12,14,993,10,2016,10,0
Group 5,RRG,-0.5,12,14,994,10,2016,10,0
Group 5,RRG,-0.5,12,14,995,8,2016,4,4
Group 5,RRG,-0.5,12,14,996,13,2016,11,2
Group 5,RRG,-0.5,12,14,997,11,2016,10,1
Group 5,RRG,-0.5,12,14,998,7,2016,10,-3
Group 5,RRG,-0.5,12,14,999,9,2016,9,0
Group 5,RRG,-0.5,12,14,1000,12,2016,12,0
Group 5,RRG,-0.5,12,14,1001,12,2016,13,-1
Group 5,RRG,-0.5,12,14,1002,10,2016,13,-3
Group 5,RRG,-0.5,12,14,1003,7,2016,9,-2
Group 5,RRG,-0.5,12,14,1004,9,2016,11,-2
Group 5,RRG,-0.5,12,14,1005,11,2016,8,3
Group 5,RRG,-0.5,12,14,1006,6,2016,9,-3
Group 5,RRG,-0.5,12,14,1007,10,2016,12,-2
Group 5,RRG,-0.5,12,14,1008,11,2016,8,3
Group 5,RRG,-0.5,12,14,1009,6,2016,6,0
Group 5,RRG,-0.5,12,14,1010,10,2016,9,1
Group 5,RRG,-0.5,12,14,1011,11,2016,5,6
Group 5,RRG,-0.5,12,14,1012,8,2016,8,0
Group 5,RRG,-0.5,12,14,1013,10,2016,8,2
Group 5,RRG,-0.5,12,14,1014,11,2016,10,1
Group 5,RRG,-0.5,12,14,1015,10,2016,6,4
Group 5,RRG,-0.5,12,14,1016,13,2016,7,6
Group 5,RRG,-0.5,12,14,1017,13,2016,5,8
Group 5,RRG,-0.5,12,14,1018,14,2016,5,9
Group 5,RRG,-0.5,12,14,1019,12,2016,7,5
Group 5,RRG,-0.5,12,14,1020,10,2016,8,2
Group 5,RRG,-0.5,12,14,1021,11,2016,9,2
Group 5,RRG,-0.5,12,14,1022,6,2016,11,-5
Group 5,RRG,-0.5,12,14,1023,10,2016,7,3
Group 5,RRG,-0.5,12,14,1024,11,2016,8,3
Group 5,RRG,-0.5,12,14,1025,12,2016,10,2
Group 5,RRG,-0.5,12,14,1026,9,2016,6,3
Group 5,RRG,-0.5,12,14,1027,12,2016,10,2
Group 5,RRG,-0.5,12,14,1028,9,2016,10,-1
Group 5,RRG,-0.5,12,14,1029,9,2016,8,1
Group 5,RRG,-0.5,12,14,1030,11,2016,10,1
Group 5,RRG,-0.5,12,14,1031,9,2016,10,-1
Group 5,RRG,-0.5,12,14,1032,12,2016,8,4
Group 5,RRG,-0.5,12,14,1033,4,2016,5,-1
Group 5,RRG,-0.5,12,14,1034,8,2016,3,5
Group 5,RRG,-0.5,12,14,1035,9,2016,7,2
Group 5,RRG,-0.5,12,14,1036,10,2016,10,0
Group 5,RRG,-0.5,12,14,1037,10,2016,10,0
Group 5,RRG,-0.5,12,14,1038,11,2016,9,2
Group 5,RRG,-0.5,12,14,1039,8,2016,8,0
Group 5,RRG,-0.5,12,14,1040,13,2016,7,6
Group 5,RRG,-0.5,12,14,1041,11,2016,9,2
Group 5,RRG,-0.5,12,14,1042,9,2016,8,1
Group 5,RRG,-0.5,12,14,1043,10,2016,10,0
Group 5,RRG,-0.5,12,14,1044,9,2016,10,-1
Group 5,RRG,-0.5,12,14,1045,9,2016,9,0
Group 5,RRG,-0.5,12,14,1046,12,2016,8,4
Group 5,RRG,-0.5,12,14,1047,8,2016,7,1
Group 5,RRG,-0.5,12,14,1048,12,2016,9,3
Group 5,RRG,-0.5,12,14,1049,8,2016,10,-2
Group 5,RRG,-0.5,12,14,1050,10,2016,7,3
Group 5,RRG,-0.5,12,14,1051,11,2016,6,5
Group 5,RRG,-0.5,12,14,1052,13,2016,2,11
Group 5,RRG,-0.5,12,14,1053,5,2016,7,-2
Group 5,RRG,-0.5,12,14,1054,9,2016,6,3
Group 5,RRG,-0.5,12,14,1055,12,2016,9,3
Group 5,RRG,-0.5,12,14,1056,12,2016,10,2
Group 5,RRG,-0.5,12,14,1057,10,2016,11,-1
Group 5,RRG,-0.5,12,14,1058,8,2016,8,0
Group 5,RRG,-0.5,12,14,1059,6,2016,8,-2
Group 5,RRG,-0.5,12,14,1060,9,2016,10,-1
Group 5,RRG,-0.5,12,14,1061,4,2016,7,-3
Group 5,RRG,-0.5,12,14,1062,7,2016,8,-1
Group 5,RRG,-0.5,12,14,1063,13,2016,6,7
Group 5,RRG,-0.5,12,14,1064,11,2016,11,0
Group 5,RRG,-0.5,12,14,1065,8,2016,11,-3
Group 5,RRG,-0.5,12,14,1066,10,2016,3,7
Group 5,RRG,-0.5,12,14,1067,10,2016,12,-2
Group 5,RRG,-0.5,12,14,1068,9,2016,12,-3
Group 5,RRG,-0.5,12,14,1069,12,2016,2,10
Group 5,RRG,-0.5,12,14,1070,10,2016,11,-1
Group 5,RRG,-0.5,12,14,1071,12,2016,6,6
Group 5,RRG,-0.5,12,14,1072,11,2016,9,2
Group 5,RRG,-0.5,12,14,1073,8,2016,11,-3
Group 5,RRG,-0.5,12,14,1074,13,2016,4,9
Group 5,RRG,-0.5,12,14,1075,8,2016,10,-2
Group 5,RRG,-0.5,12,14,1076,11,2016,13,-2
Group 5,RRG,-0.5,12,14,1077,8,2016,13,-5
Group 5,RRG,-0.5,12,14,1078,6,2016,14,-8
Group 5,RRG,-0.5,12,14,1079,11,2016,10,1
Group 5,RRG,-0.5,12,14,1080,10,2016,10,0
Group 5,RRG,-0.5,12,14,1081,12,2016,10,2
Group 5,RRG,-0.5,12,14,1082,12,2016,11,1
Group 5,RRG,-0.5,12,14,1083,10,2016,7,3
Group 5,RRG,-0.5,12,14,1084,10,2016,5,5
Group 5,RRG,-0.5,12,14,1085,11,2016,8,3
Group 5,RRG,-0.5,12,14,1086,11,2016,8,3
Group 5,RRG,-0.5,12,14,1087,7,2016,3,4
Group 5,RRG,-0.5,12,14,1088,12,2016,7,5
Group 5,RRG,-0.5,12,14,1089,12,2016,11,1
Group 5,RRG,-0.5,12,14,1090,11,2016,9,2
Group 5,RRG,-0.5,12,14,1091,11,2016,6,5
Group 5,RRG,-0.5,12,14,1092,14,2016,6,8
Group 5,RRG,-0.5,12,14,1093,11,2016,10,1
Group 5,RRG,-0.5,12,14,1094,11,2016,9,2
Group 5,RRG,-0.5,12,14,1095,7,2016,9,-2
Group 5,RRG,-0.5,12,14,1096,10,2016,4,6
Group 5,RRG,-0.5,12,14,1097,9,2016,4,5
Group 5,RRG,-0.5,12,14,1098,11,2016,9,2
Group 5,RRG,-0.5,12,14,1099,9,2016,4,5
Group 5,RRG,-0.5,12,14,1100,13,2016,4,9
Group 5,RRG,-0.5,12,14,1101,8,2016,9,-1
Group 5,RRG,-0.5,12,14,1102,13,2016,6,7
Group 5,RRG,-0.5,12,14,1103,12,2016,9,3
Group 5,RRG,-0.5,12,14,1104,7,2016,12,-5
Group 5,RRG,-0.5,12,14,1105,11,2016,3,8
Group 5,RRG,-0.5,12,14,1106,8,2016,6,2
Group 5,RRG,-0.5,12,14,1107,14,2016,4,10
Group 5,RRG,-0.5,12,14,1108,11,2016,7,4
Group 5,RRG,-0.5,12,14,1109,12,2016,11,1
Group 5,RRG,-0.5,12,14,1110,9,2016,6,3
Group 5,RRG,-0.5,12,14,1111,12,2016,7,5
Group 5,RRG,-0.5,12,14,1112,12,2016,5,7
Group 5,RRG,-0.5,12,14,1113,8,2016,6,2
Group 5,RRG,-0.5,12,14,1114,11,2016,6,5
Group 5,RRG,-0.5,12,14,1115,10,2016,9,1
Group 5,RRG,-0.5,12,14,1116,11,2016,10,1
Group 5,RRG,-0.5,12,14,1117,10,2016,8,2
Group 5,RRG,-0.5,12,14,1118,11,2016,11,0
Group 5,RRG,-0.5,12,14,1119,12,2016,11,1
Group 5,RRG,-0.5,12,14,1120,14,2016,8,6
Group 5,RRG,-0.5,12,14,1121,12,2016,4,8
Group 5,RRG,-0.5,12,14,1122,12,2016,5,7
Group 5,RRG,-0.5,12,14,1123,12,2016,12,0
Group 5,RRG,-0.5,12,14,1124,9,2016,9,0
Group 5,RRG,-0.5,12,14,1125,8,2016,8,0
Group 5,RRG,-0.5,12,14,1126,11,2016,9,2
Group 5,RRG,-0.5,12,14,1127,11,2016,7,4
Group 5,RRG,-0.5,12,14,1128,10,2016,7,3
Group 5,RRG,-0.5,12,14,1129,6,2016,9,-3
Group 5,RRG,-0.5,12,14,1130,10,2016,7,3
Group 5,RRG,-0.5,12,14,1131,9,2016,12,-3
Group 5,RRG,-0.5,12,14,1132,8,2016,8,0
Group 5,RRG,-0.5,12,14,1133,11,2016,11,0
Group 5,RRG,-0.5,12,14,1134,11,2016,12,-1
Group 5,RRG,-0.5,12,14,1135,9,2016,13,-4
Group 5,RRG,-0.5,12,14,1136,12,2016,10,2
Group 5,RRG,-0.5,12,14,1137,13,2016,4,9
Group 5,RRG,-0.5,12,14,1138,10,2016,6,4
Group 5,RRG,-0.5,12,14,1139,13,2016,10,3
Group 5,RRG,-0.5,12,14,1140,12,2016,10,2
Group 5,RRG,-0.5,12,14,1141,10,2016,4,6
Group 5,RRG,-0.5,12,14,1142,14,2016,8,6
Group 5,RRG,-0.5,12,14,1143,12,2016,9,3
Group 5,RRG,-0.5,12,14,1144,12,2016,7,5
Group 5,RRG,-0.5,12,14,1145,10,2016,8,2
Group 5,RRG,-0.5,12,14,1146,6,2016,6,0
Group 5,RRG,-0.5,12,14,1147,11,2016,9,2
Group 5,RRG,-0.5,12,14,1148,11,2016,12,-1
Group 5,RRG,-0.5,12,14,1149,7,2016,8,-1
Group 5,RRG,-0.5,12,14,1150,9,2016,7,2
Group 5,RRG,-0.5,12,14,1151,11,2016,9,2
Group 5,RRG,-0.5,12,14,1152,13,2016,7,6
Group 5,RRG,-0.5,12,14,1153,10,2016,11,-1
Group 5,RRG,-0.5,12,14,1154,8,2016,10,-2
Group 5,RRG,-0.5,12,14,1155,4,2016,10,-6
Group 5,RRG,-0.5,12,14,1156,12,2016,12,0
Group 5,RRG,-0.5,12,14,1157,13,2016,6,7
Group 5,RRG,-0.5,12,14,1158,11,2016,11,0
Group 5,RRG,-0.5,12,14,1159,11,2016,8,3
Group 5,RRG,-0.5,12,14,1160,12,2016,7,5
Group 5,RRG,-0.5,12,14,1161,10,2016,11,-1
Group 5,RRG,-0.5,12,14,1162,10,2016,9,1
Group 5,RRG,-0.5,12,14,1163,12,2016,7,5
Group 5,RRG,-0.5,12,14,1164,13,2016,8,5
Group 5,RRG,-0.5,12,14,1165,10,2016,9,1
Group 5,RRG,-0.5,12,14,1166,14,2016,9,5
Group 5,RRG,-0.5,12,14,1167,10,2016,7,3
Group 5,RRG,-0.5,12,14,1168,10,2016,10,0
Group 5,RRG,-0.5,12,14,1169,9,2016,10,-1
Group 5,RRG,-0.5,12,14,1170,10,2016,6,4
Group 5,RRG,-0.5,12,14,1171,9,2016,8,1
Group 5,RRG,-0.5,12,14,1172,7,2016,11,-4
Group 5,RRG,-0.5,12,14,1173,12,2016,10,2
Group 5,RRG,-0.5,12,14,1174,9,2016,7,2
Group 5,RRG,-0.5,12,14,1175,13,2016,12,1
Group 5,RRG,-0.5,12,14,1176,10,2016,10,0
Group 5,RRG,-0.5,12,14,1177,13,2016,9,4
Group 5,RRG,-0.5,12,14,1178,9,2016,5,4
Group 5,RRG,-0.5,12,14,1179,10,2016,11,-1
Group 5,RRG,-0.5,12,14,1180,12,2016,7,5
Group 5,RRG,-0.5,12,14,1181,13,2016,7,6
Group 5,RRG,-0.5,12,14,1182,11,2016,7,4
Group 5,RRG,-0.5,12,14,1183,11,2016,9,2
Group 5,RRG,-0.5,12,14,1184,10,2016,9,1
Group 5,RRG,-0.5,12,14,1185,10,2016,5,5
Group 5,RRG,-0.5,12,14,1186,9,2016,10,-1
Group 5,RRG,-0.5,12,14,1187,9,2016,8,1
Group 5,RRG,-0.5,12,14,1188,13,2016,11,2
Group 5,RRG,-0.5,12,14,1189,9,2016,8,1
Group 5,RRG,-0.5,12,14,1190,13,2016,11,2
Group 5,RRG,-0.5,12,14,1191,13,2016,9,4
Group 5,RRG,-0.5,12,14,1192,11,2016,10,1
Group 5,RRG,-0.5,12,14,1193,11,2016,8,3
Group 5,RRG,-0.5,12,14,1194,7,2016,8,-1
Group 5,RRG,-0.5,12,14,1195,12,2016,7,5
Group 5,RRG,-0.5,12,14,1196,9,2016,7,2
Group 5,RRG,-0.5,12,14,1197,7,2016,10,-3
Group 5,RRG,-0.5,12,14,1198,12,2016,4,8
Group 5,RRG,-0.5,12,14,1199,11,2016,6,5
Group 5,RRG,-0.5,12,14,1200,8,2016,6,2
Group 5,RRG,-0.5,12,14,1201,11,2016,11,0
Group 5,RRG,-0.5,12,14,1202,8,2016,5,3
Group 5,RRG,-0.5,12,14,1203,9,2016,2,7
Group 5,RRG,-0.5,12,14,1204,9,2016,10,-1
Group 5,RRG,-0.5,12,14,1205,11,2016,10,1
Group 5,RRG,-0.5,12,14,1206,13,2016,8,5
Group 5,RRG,-0.5,12,14,1207,11,2016,7,4
Group 5,RRG,-0.5,12,14,1208,10,2016,9,1
Group 5,RRG,-0.5,12,14,1209,11,2016,6,5
Group 5,RRG,-0.5,12,14,1210,11,2016,8,3
Group 5,RRG,-0.5,12,14,1211,12,2016,10,2
Group 5,RRG,-0.5,12,14,1212,12,2016,8,4
Group 5,RRG,-0.5,12,14,1213,13,2016,8,5
Group 5,RRG,-0.5,12,14,1214,12,2016,9,3
Group 5,RRG,-0.5,12,14,1215,8,2016,7,1
Group 5,RRG,-0.5,12,14,1216,8,2016,6,2
Group 5,RRG,-0.5,12,14,1217,12,2016,4,8
Group 5,RRG,-0.5,12,14,1218,11,2016,4,7
Group 5,RRG,-0.5,12,14,1219,5,2016,12,-7
Group 5,RRG,-0.5,12,14,1220,13,2016,9,4
Group 5,RRG,-0.5,12,14,1221,9,2016,8,1
Group 5,RRG,-0.5,12,14,1222,12,2016,9,3
Group 5,RRG,-0.5,12,14,1223,11,2016,12,-1
Group 5,RRG,-0.5,12,14,1224,10,2016,10,0
Group 5,RRG,-0.5,12,14,1225,11,2016,8,3
Group 5,RRG,-0.5,12,14,1226,12,2016,9,3
Group 5,RRG,-0.5,12,14,1227,14,2016,9,5
Group 5,RRG,-0.5,12,14,1228,12,2016,9,3
Group 5,RRG,-0.5,12,14,1229,12,2016,9,3
Group 5,RRG,-0.5,12,14,1230,11,2016,10,1
Group 5,RRG,-0.5,12,14,1231,12,2016,6,6
Group 5,RRG,-0.5,12,14,1232,10,2016,11,-1
Group 5,RRG,-0.5,12,14,1233,8,2016,9,-1
Group 5,RRG,-0.5,12,14,1234,12,2016,7,5
Group 5,RRG,-0.5,12,14,1235,11,2016,7,4
Group 5,RRG,-0.5,12,14,1236,11,2016,6,5
Group 5,RRG,-0.5,12,14,1237,12,2016,7,5
Group 5,RRG,-0.5,12,14,1238,12,2016,4,8
Group 5,RRG,-0.5,12,14,1239,8,2016,4,4
Group 5,RRG,-0.5,12,14,1240,6,2016,9,-3
Group 5,RRG,-0.5,12,14,1241,8,2016,8,0
Group 5,RRG,-0.5,12,14,1242,10,2016,8,2
Group 5,RRG,-0.5,12,14,1243,7,2016,8,-1
Group 5,RRG,-0.5,12,14,1244,11,2016,6,5
Group 5,RRG,-0.5,12,14,1245,11,2016,11,0
Group 5,RRG,-0.5,12,14,1246,11,2016,9,2
Group 5,RRG,-0.5,12,14,1247,13,2016,10,3
Group 5,RRG,-0.5,12,14,1248,8,2016,12,-4
Group 5,RRG,-0.5,12,14,1249,10,2016,12,-2
Group 5,RRG,-0.5,12,14,1250,9,2016,13,-4
Group 5,RRG,-0.5,12,14,1251,9,2016,10,-1
Group 5,RRG,-0.5,12,14,1252,11,2016,8,3
Group 5,RRG,-0.5,12,14,1253,13,2016,6,7
Group 5,RRG,-0.5,12,14,1254,12,2016,12,0
Group 5,RRG,-0.5,12,14,1255,12,2016,8,4
Group 5,RRG,-0.5,12,14,1256,8,2016,8,0
Group 5,RRG,-0.5,12,14,1257,13,2016,12,1
Group 5,RRG,-0.5,12,14,1258,11,2016,10,1
Group 5,RRG,-0.5,12,14,1259,10,2016,4,6
Group 5,RRG,-0.5,12,14,1260,11,2016,6,5
Group 5,RRG,-0.5,12,14,1261,10,2016,9,1
Group 5,RRG,-0.5,12,14,1262,9,2016,11,-2
Group 5,RRG,-0.5,12,14,1263,11,2016,8,3
Group 5,RRG,-0.5,12,14,1264,12,2016,9,3
Group 5,RRG,-0.5,12,14,1265,9,2016,7,2
Group 5,RRG,-0.5,12,14,1266,11,2016,5,6
Group 5,RRG,-0.5,12,14,1267,10,2016,8,2
Group 5,RRG,-0.5,12,14,1268,11,2016,10,1
Group 5,RRG,-0.5,12,14,1269,11,2016,6,5
Group 5,RRG,-0.5,12,14,1270,8,2016,10,-2
Group 5,RRG,-0.5,12,14,1271,9,2016,10,-1
Group 5,RRG,-0.5,12,14,1272,9,2016,8,1
Group 5,RRG,-0.5,12,14,1273,11,2016,10,1
Group 5,RRG,-0.5,12,14,1274,9,2016,6,3
Group 5,RRG,-0.5,12,14,1275,12,2016,7,5
Group 5,RRG,-0.5,12,14,1276,9,2016,6,3
Group 5,RRG,-0.5,12,14,1277,12,2016,6,6
Group 5,RRG,-0.5,12,14,1278,13,2016,7,6
Group 5,RRG,-0.5,12,14,1279,7,2016,3,4
Group 5,RRG,-0.5,12,14,1280,10,2016,12,-2
Group 5,RRG,-0.5,12,14,1281,13,2016,9,4
Group 5,RRG,-0.5,12,14,1282,11,2016,6,5
Group 5,RRG,-0.5,12,14,1283,10,2016,9,1
Group 5,RRG,-0.5,12,14,1284,8,2016,12,-4
Group 5,RRG,-0.5,12,14,1285,10,2016,9,1
Group 5,RRG,-0.5,12,14,1286,9,2016,10,-1
Group 5,RRG,-0.5,12,14,1287,10,2016,6,4
Group 5,RRG,-0.5,12,14,1288,9,2016,6,3
Group 5,RRG,-0.5,12,14,1289,10,2016,5,5
Group 5,RRG,-0.5,12,14,1290,12,2016,10,2
Group 5,RRG,-0.5,12,14,1291,11,2016,6,5
Group 5,RRG,-0.5,12,14,1292,11,2016,13,-2
Group 5,RRG,-0.5,12,14,1293,11,2016,10,1
Group 5,RRG,-0.5,12,14,1294,12,2016,10,2
Group 5,RRG,-0.5,12,14,1295,13,2016,12,1
Group 5,RRG,-0.5,12,14,1296,8,2016,4,4
Group 5,RRG,-0.5,12,14,1297,7,2016,7,0
Group 5,RRG,-0.5,12,14,1298,8,2016,9,-1
Group 5,RRG,-0.5,12,14,1299,12,2016,10,2
Group 5,RRG,-0.5,12,14,1300,12,2016,8,4
Group 5,RRG,-0.5,12,14,1301,9,2016,7,2
Group 5,RRG,-0.5,12,14,1302,11,2016,3,8
Group 5,RRG,-0.5,12,14,1303,11,2016,4,7
Group 5,RRG,-0.5,12,14,1304,13,2016,5,8
Group 5,RRG,-0.5,12,14,1305,8,2016,12,-4
Group 5,RRG,-0.5,12,14,1306,8,2016,4,4
Group 5,RRG,-0.5,12,14,1307,10,2016,7,3
Group 5,RRG,-0.5,12,14,1308,9,2016,11,-2
Group 5,RRG,-0.5,12,14,1309,10,2016,6,4
Group 5,RRG,-0.5,12,14,1310,9,2016,10,-1
Group 5,RRG,-0.5,12,14,1311,12,2016,8,4
Group 5,RRG,-0.5,12,14,1312,11,2016,8,3
Group 5,RRG,-0.5,12,14,1313,12,2016,9,3
Group 5,RRG,-0.5,12,14,1314,9,2016,6,3
Group 5,RRG,-0.5,12,14,1315,9,2016,8,1
Group 5,RRG,-0.5,12,14,1316,14,2016,10,4
Group 5,RRG,-0.5,12,14,1317,10,2016,12,-2
Group 5,RRG,-0.5,12,14,1318,9,2016,9,0
Group 5,RRG,-0.5,12,14,1319,10,2016,6,4
Group 5,RRG,-0.5,12,14,1320,10,2016,7,3
Group 5,RRG,-0.5,12,14,1321,10,2016,12,-2
Group 5,RRG,-0.5,12,14,1322,7,2016,11,-4
Group 5,RRG,-0.5,12,14,1323,13,2016,12,1
Group 5,RRG,-0.5,12,14,1324,11,2016,9,2
Group 5,RRG,-0.5,12,14,1325,13,2016,13,0
Group 5,RRG,-0.5,12,14,1326,13,2016,7,6
Group 5,RRG,-0.5,12,14,1327,10,2016,7,3
Group 5,RRG,-0.5,12,14,1328,6,2016,8,-2
Group 5,RRG,-0.5,12,14,1329,11,2016,11,0
Group 5,RRG,-0.5,12,14,1330,7,2016,6,1
Group 5,RRG,-0.5,12,14,1331,11,2016,6,5
Group 5,RRG,-0.5,12,14,1332,13,2016,9,4
Group 5,RRG,-0.5,12,14,1333,13,2016,10,3
Group 5,RRG,-0.5,12,14,1334,11,2016,7,4
Group 5,RRG,-0.5,12,14,1335,9,2016,12,-3
Group 5,RRG,-0.5,12,14,1336,13,2016,9,4
Group 5,RRG,-0.5,12,14,1337,11,2016,9,2
Group 5,RRG,-0.5,12,14,1338,11,2016,10,1
Group 5,RRG,-0.5,12,14,1339,10,2016,9,1
Group 5,RRG,-0.5,12,14,1340,12,2016,11,1
Group 5,RRG,-0.5,12,14,1341,11,2016,5,6
Group 5,RRG,-0.5,12,14,1342,12,2016,5,7
Group 5,RRG,-0.5,12,14,1343,9,2016,9,0
Group 5,RRG,-0.5,12,14,1344,7,2016,3,4
Group 5,RRG,-0.5,12,14,1345,9,2016,8,1
Group 5,RRG,-0.5,12,14,1346,10,2016,12,-2
Group 5,RRG,-0.5,12,14,1347,7,2016,10,-3
Group 5,RRG,-0.5,12,14,1348,12,2016,10,2
Group 5,RRG,-0.5,12,14,1349,8,2016,7,1
Group 5,RRG,-0.5,12,14,1350,10,2016,10,0
Group 5,RRG,-0.5,12,14,1351,7,2016,8,-1
Group 5,RRG,-0.5,12,14,1352,9,2016,5,4
Group 5,RRG,-0.5,12,14,1353,11,2016,8,3
Group 5,RRG,-0.5,12,14,1354,12,2016,5,7
Group 5,RRG,-0.5,12,14,1355,13,2016,8,5
Group 5,RRG,-0.5,12,14,1356,11,2016,12,-1
Group 5,RRG,-0.5,12,14,1357,10,2016,9,1
Group 5,RRG,-0.5,12,14,1358,6,2016,11,-5
Group 5,RRG,-0.5,12,14,1359,9,2016,11,-2
Group 5,RRG,-0.5,12,14,1360,10,2016,5,5
Group 5,RRG,-0.5,12,14,1361,9,2016,11,-2
Group 5,RRG,-0.5,12,14,1362,9,2016,7,2
Group 5,RRG,-0.5,12,14,1363,5,2016,9,-4
Group 5,RRG,-0.5,12,14,1364,11,2016,11,0
Group 5,RRG,-0.5,12,14,1365,9,2016,9,0
Group 5,RRG,-0.5,12,14,1366,12,2016,9,3
Group 5,RRG,-0.5,12,14,1367,7,2016,7,0
Group 5,RRG,-0.5,12,14,1368,9,2016,9,0
Group 5,RRG,-0.5,12,14,1369,8,2016,8,0
Group 5,RRG,-0.5,12,14,1370,7,2016,8,-1
Group 5,RRG,-0.5,12,14,1371,11,2016,8,3
Group 5,RRG,-0.5,12,14,1372,11,2016,11,0
Group 5,RRG,-0.5,12,14,1373,9,2016,9,0
Group 5,RRG,-0.5,12,14,1374,10,2016,9,1
Group 5,RRG,-0.5,12,14,1375,11,2016,8,3
Group 5,RRG,-0.5,12,14,1376,10,2016,9,1
Group 5,RRG,-0.5,12,14,1377,14,2016,9,5
Group 5,RRG,-0.5,12,14,1378,9,2016,7,2
Group 5,RRG,-0.5,12,14,1379,12,2016,9,3
Group 5,RRG,-0.5,12,14,1380,8,2016,7,1
Group 5,RRG,-0.5,12,14,1381,10,2016,10,0
Group 5,RRG,-0.5,12,14,1382,7,2016,9,-2
Group 5,RRG,-0.5,12,14,1383,9,2016,4,5
Group 5,RRG,-0.5,12,14,1384,12,2016,10,2
Group 5,RRG,-0.5,12,14,1385,11,2016,11,0
Group 5,RRG,-0.5,12,14,1386,12,2016,10,2
Group 5,RRG,-0.5,12,14,1387,9,2016,10,-1
Group 5,RRG,-0.5,12,14,1388,12,2016,7,5
Group 5,RRG,-0.5,12,14,1389,12,2016,8,4
Group 5,RRG,-0.5,12,14,1390,9,2016,7,2
Group 5,RRG,-0.5,12,14,1391,11,2016,9,2
Group 5,RRG,-0.5,12,14,1392,10,2016,9,1
Group 5,RRG,-0.5,12,14,1393,10,2016,12,-2
Group 5,RRG,-0.5,12,14,1394,12,2016,9,3
Group 5,RRG,-0.5,12,14,1395,13,2016,10,3
Group 5,RRG,-0.5,12,14,1396,11,2016,7,4
Group 5,RRG,-0.5,12,14,1397,11,2016,5,6
Group 5,RRG,-0.5,12,14,1398,12,2016,7,5
Group 5,RRG,-0.5,12,14,1399,12,2016,4,8
Group 5,RRG,-0.5,12,14,1400,9,2016,10,-1
Group 5,RRG,-0.5,12,14,1401,8,2016,7,1
Group 5,RRG,-0.5,12,14,1402,9,2016,6,3
Group 5,RRG,-0.5,12,14,1403,10,2016,11,-1
Group 5,RRG,-0.5,12,14,1404,11,2016,6,5
Group 5,RRG,-0.5,12,14,1405,11,2016,11,0
Group 5,RRG,-0.5,12,14,1406,9,2016,10,-1
Group 5,RRG,-0.5,12,14,1407,9,2016,8,1
Group 5,RRG,-0.5,12,14,1408,12,2016,7,5
Group 5,RRG,-0.5,12,14,1409,12,2016,3,9
Group 5,RRG,-0.5,12,14,1410,6,2016,9,-3
Group 5,RRG,-0.5,12,14,1411,11,2016,10,1
Group 5,RRG,-0.5,12,14,1412,10,2016,10,0
Group 5,RRG,-0.5,12,14,1413,11,2016,12,-1
Group 5,RRG,-0.5,12,14,1414,11,2016,8,3
Group 5,RRG,-0.5,12,14,1415,9,2016,6,3
Group 5,RRG,-0.5,12,14,1416,11,2016,10,1
Group 5,RRG,-0.5,12,14,1417,9,2016,8,1
Group 5,RRG,-0.5,12,14,1418,12,2016,10,2
Group 5,RRG,-0.5,12,14,1419,12,2016,2,10
Group 5,RRG,-0.5,12,14,1420,7,2016,10,-3
Group 5,RRG,-0.5,12,14,1421,12,2016,7,5
Group 5,RRG,-0.5,12,14,1422,13,2016,8,5
Group 5,RRG,-0.5,12,14,1423,9,2016,3,6
Group 5,RRG,-0.5,12,14,1424,12,2016,9,3
Group 5,RRG,-0.5,12,14,1425,8,2016,7,1
Group 5,RRG,-0.5,12,14,1426,13,2016,12,1
Group 5,RRG,-0.5,12,14,1427,11,2016,8,3
Group 5,RRG,-0.5,12,14,1428,11,2016,9,2
Group 5,RRG,-0.5,12,14,1429,14,2016,10,4
Group 5,RRG,-0.5,12,14,1430,7,2016,10,-3
Group 5,RRG,-0.5,12,14,1431,12,2016,9,3
Group 5,RRG,-0.5,12,14,1432,13,2016,8,5
Group 5,RRG,-0.5,12,14,1433,12,2016,12,0
Group 5,RRG,-0.5,12,14,1434,11,2016,8,3
Group 5,RRG,-0.5,12,14,1435,6,2016,6,0
Group 5,RRG,-0.5,12,14,1436,10,2016,6,4
Group 5,RRG,-0.5,12,14,1437,9,2016,7,2
Group 5,RRG,-0.5,12,14,1438,9,2016,5,4
Group 5,RRG,-0.5,12,14,1439,8,2016,5,3
Group 5,RRG,-0.5,12,14,1440,14,2016,13,1
Group 5,RRG,-0.5,12,14,1441,13,2016,12,1
Group 5,RRG,-0.5,12,14,1442,10,2016,9,1
Group 5,RRG,-0.5,12,14,1443,9,2016,8,1
Group 5,RRG,-0.5,12,14,1444,12,2016,6,6
Group 5,RRG,-0.5,12,14,1445,8,2016,6,2
Group 5,RRG,-0.5,12,14,1446,7,2016,9,-2
Group 5,RRG,-0.5,12,14,1447,8,2016,8,0
Group 5,RRG,-0.5,12,14,1448,9,2016,11,-2
Group 5,RRG,-0.5,12,14,1449,11,2016,7,4
Group 5,RRG,-0.5,12,14,1450,11,2016,11,0
Group 5,RRG,-0.5,12,14,1451,10,2016,9,1
Group 5,RRG,-0.5,12,14,1452,11,2016,7,4
Group 5,RRG,-0.5,12,14,1453,7,2016,9,-2
Group 5,RRG,-0.5,12,14,1454,7,2016,3,4
Group 5,RRG,-0.5,12,14,1455,8,2016,9,-1
Group 5,RRG,-0.5,12,14,1456,9,2016,4,5
Group 5,RRG,-0.5,12,14,1457,11,2016,13,-2
Group 5,RRG,-0.5,12,14,1458,11,2016,12,-1
Group 5,RRG,-0.5,12,14,1459,8,2016,10,-2
Group 5,RRG,-0.5,12,14,1460,10,2016,2,8
Group 5,RRG,-0.5,12,14,1461,12,2016,11,1
Group 5,RRG,-0.5,12,14,1462,8,2016,10,-2
Group 5,RRG,-0.5,12,14,1463,8,2016,7,1
Group 5,RRG,-0.5,12,14,1464,10,2016,7,3
Group 5,RRG,-0.5,12,14,1465,10,2016,9,1
Group 5,RRG,-0.5,12,14,1466,12,2016,11,1
Group 5,RRG,-0.5,12,14,1467,12,2016,6,6
Group 5,RRG,-0.5,12,14,1468,14,2016,8,6
Group 5,RRG,-0.5,12,14,1469,10,2016,8,2
Group 5,RRG,-0.5,12,14,1470,10,2016,8,2
Group 5,RRG,-0.5,12,14,1471,12,2016,9,3
Group 5,RRG,-0.5,12,14,1472,11,2016,10,1
Group 5,RRG,-0.5,12,14,1473,13,2016,6,7
Group 5,RRG,-0.5,12,14,1474,9,2016,8,1
Group 5,RRG,-0.5,12,14,1475,13,2016,7,6
Group 5,RRG,-0.5,12,14,1476,11,2016,9,2
Group 5,RRG,-0.5,12,14,1477,12,2016,10,2
Group 5,RRG,-0.5,12,14,1478,12,2016,9,3
Group 5,RRG,-0.5,12,14,1479,9,2016,10,-1
Group 5,RRG,-0.5,12,14,1480,11,2016,7,4
Group 5,RRG,-0.5,12,14,1481,12,2016,9,3
Group 5,RRG,-0.5,12,14,1482,11,2016,8,3
Group 5,RRG,-0.5,12,14,1483,13,2016,6,7
Group 5,RRG,-0.5,12,14,1484,11,2016,7,4
Group 5,RRG,-0.5,12,14,1485,12,2016,10,2
Group 5,RRG,-0.5,12,14,1486,10,2016,11,-1
Group 5,RRG,-0.5,12,14,1487,8,2016,11,-3
Group 5,RRG,-0.5,12,14,1488,10,2016,7,3
Group 5,RRG,-0.5,12,14,1489,12,2016,12,0
Group 5,RRG,-0.5,12,14,1490,12,2016,10,2
Group 5,RRG,-0.5,12,14,1491,11,2016,4,7
Group 5,RRG,-0.5,12,14,1492,9,2016,12,-3
Group 5,RRG,-0.5,12,14,1493,10,2016,5,5
Group 5,RRG,-0.5,12,14,1494,10,2016,7,3
Group 5,RRG,-0.5,12,14,1495,11,2016,3,8
Group 5,RRG,-0.5,12,14,1496,10,2016,12,-2
Group 5,RRG,-0.5,12,14,1497,9,2016,10,-1
Group 5,RRG,-0.5,12,14,1498,12,2016,9,3
Group 5,RRG,-0.5,12,14,1499,12,2016,8,4
Group 5,RRG,-0.5,12,14,1500,10,2016,9,1
Group 5,RRG,-0.5,12,14,1501,13,2016,9,4
Group 5,RRG,-0.5,12,14,1502,10,2016,3,7
Group 5,RRG,-0.5,12,14,1503,10,2016,9,1
Group 5,RRG,-0.5,12,14,1504,7,2016,5,2
Group 5,RRG,-0.5,12,14,1505,11,2016,8,3
Group 5,RRG,-0.5,12,14,1506,12,2016,9,3
Group 5,RRG,-0.5,12,14,1507,11,2016,8,3
Group 5,RRG,-0.5,12,14,1508,8,2016,8,0
Group 5,RRG,-0.5,12,14,1509,12,2016,7,5
Group 5,RRG,-0.5,12,14,1510,11,2016,12,-1
Group 5,RRG,-0.5,12,14,1511,7,2016,11,-4
Group 5,RRG,-0.5,12,14,1512,11,2016,8,3
Group 5,RRG,-0.5,12,14,1513,10,2016,9,1
Group 5,RRG,-0.5,12,14,1514,11,2016,5,6
Group 5,RRG,-0.5,12,14,1515,10,2016,9,1
Group 5,RRG,-0.5,12,14,1516,9,2016,7,2
Group 5,RRG,-0.5,12,14,1517,8,2016,8,0
Group 5,RRG,-0.5,12,14,1518,14,2016,4,10
Group 5,RRG,-0.5,12,14,1519,12,2016,9,3
Group 5,RRG,-0.5,12,14,1520,12,2016,3,9
Group 5,RRG,-0.5,12,14,1521,11,2016,7,4
Group 5,RRG,-0.5,12,14,1522,12,2016,6,6
Group 5,RRG,-0.5,12,14,1523,12,2016,6,6
Group 5,RRG,-0.5,12,14,1524,14,2016,10,4
Group 5,RRG,-0.5,12,14,1525,11,2016,13,-2
Group 5,RRG,-0.5,12,14,1526,8,2016,9,-1
Group 5,RRG,-0.5,12,14,1527,9,2016,12,-3
Group 5,RRG,-0.5,12,14,1528,9,2016,8,1
Group 5,RRG,-0.5,12,14,1529,11,2016,8,3
Group 5,RRG,-0.5,12,14,1530,7,2016,10,-3
Group 5,RRG,-0.5,12,14,1531,8,2016,7,1
Group 5,RRG,-0.5,12,14,1532,11,2016,8,3
Group 5,RRG,-0.5,12,14,1533,14,2016,11,3
Group 5,RRG,-0.5,12,14,1534,13,2016,7,6
Group 5,RRG,-0.5,12,14,1535,6,2016,5,1
Group 5,RRG,-0.5,12,14,1536,13,2016,8,5
Group 5,RRG,-0.5,12,14,1537,10,2016,7,3
Group 5,RRG,-0.5,12,14,1538,8,2016,9,-1
Group 5,RRG,-0.5,12,14,1539,14,2016,11,3
Group 5,RRG,-0.5,12,14,1540,12,2016,6,6
Group 5,RRG,-0.5,12,14,1541,9,2016,9,0
Group 5,RRG,-0.5,12,14,1542,12,2016,8,4
Group 5,RRG,-0.5,12,14,1543,11,2016,7,4
Group 5,RRG,-0.5,12,14,1544,10,2016,10,0
Group 5,RRG,-0.5,12,14,1545,13,2016,5,8
Group 5,RRG,-0.5,12,14,1546,9,2016,4,5
Group 5,RRG,-0.5,12,14,1547,4,2016,10,-6
Group 5,RRG,-0.5,12,14,1548,10,2016,12,-2
Group 5,RRG,-0.5,12,14,1549,7,2016,10,-3
Group 5,RRG,-0.5,12,14,1550,9,2016,6,3
Group 5,RRG,-0.5,12,14,1551,12,2016,9,3
Group 5,RRG,-0.5,12,14,1552,13,2016,10,3
Group 5,RRG,-0.5,12,14,1553,11,2016,6,5
Group 5,RRG,-0.5,12,14,1554,6,2016,4,2
Group 5,RRG,-0.5,12,14,1555,7,2016,6,1
Group 5,RRG,-0.5,12,14,1556,12,2016,5,7
Group 5,RRG,-0.5,12,14,1557,11,2016,12,-1
Group 5,RRG,-0.5,12,14,1558,11,2016,14,-3
Group 5,RRG,-0.5,12,14,1559,12,2016,7,5
Group 5,RRG,-0.5,12,14,1560,9,2016,11,-2
Group 5,RRG,-0.5,12,14,1561,10,2016,8,2
Group 5,RRG,-0.5,12,14,1562,13,2016,7,6
Group 5,RRG,-0.5,12,14,1563,11,2016,8,3
Group 5,RRG,-0.5,12,14,1564,7,2016,11,-4
Group 5,RRG,-0.5,12,14,1565,12,2016,7,5
Group 5,RRG,-0.5,12,14,1566,9,2016,7,2
Group 5,RRG,-0.5,12,14,1567,11,2016,8,3
Group 5,RRG,-0.5,12,14,1568,11,2016,6,5
Group 5,RRG,-0.5,12,14,1569,12,2016,10,2
Group 5,RRG,-0.5,12,14,1570,12,2016,4,8
Group 5,RRG,-0.5,12,14,1571,12,2016,10,2
Group 5,RRG,-0.5,12,14,1572,11,2016,9,2
Group 5,RRG,-0.5,12,14,1573,13,2016,14,-1
Group 5,RRG,-0.5,12,14,1574,12,2016,5,7
Group 5,RRG,-0.5,12,14,1575,12,2016,10,2
Group 5,RRG,-0.5,12,14,1576,11,2016,9,2
Group 5,RRG,-0.5,12,14,1577,11,2016,3,8
Group 5,RRG,-0.5,12,14,1578,8,2016,10,-2
Group 5,RRG,-0.5,12,14,1579,11,2016,8,3
Group 5,RRG,-0.5,12,14,1580,12,2016,11,1
Group 5,RRG,-0.5,12,14,1581,11,2016,12,-1
Group 5,RRG,-0.5,12,14,1582,9,2016,6,3
Group 5,RRG,-0.5,12,14,1583,11,2016,9,2
Group 5,RRG,-0.5,12,14,1584,7,2016,5,2
Group 5,RRG,-0.5,12,14,1585,9,2016,13,-4
Group 5,RRG,-0.5,12,14,1586,5,2016,8,-3
Group 5,RRG,-0.5,12,14,1587,12,2016,13,-1
Group 5,RRG,-0.5,12,14,1588,12,2016,10,2
Group 5,RRG,-0.5,12,14,1589,11,2016,2,9
Group 5,RRG,-0.5,12,14,1590,11,2016,7,4
Group 5,RRG,-0.5,12,14,1591,9,2016,9,0
Group 5,RRG,-0.5,12,14,1592,11,2016,10,1
Group 5,RRG,-0.5,12,14,1593,8,2016,6,2
Group 5,RRG,-0.5,12,14,1594,11,2016,8,3
Group 5,RRG,-0.5,12,14,1595,10,2016,7,3
Group 5,RRG,-0.5,12,14,1596,8,2016,7,1
Group 5,RRG,-0.5,12,14,1597,11,2016,10,1
Group 5,RRG,-0.5,12,14,1598,12,2016,5,7
Group 5,RRG,-0.5,12,14,1599,8,2016,11,-3
Group 5,RRG,-0.5,12,14,1600,12,2016,9,3
Group 5,RRG,-0.5,12,14,1601,10,2016,8,2
Group 5,RRG,-0.5,12,14,1602,12,2016,8,4
Group 5,RRG,-0.5,12,14,1603,13,2016,6,7
Group 5,RRG,-0.5,12,14,1604,11,2016,5,6
Group 5,RRG,-0.5,12,14,1605,11,2016,8,3
Group 5,RRG,-0.5,12,14,1606,12,2016,9,3
Group 5,RRG,-0.5,12,14,1607,9,2016,8,1
Group 5,RRG,-0.5,12,14,1608,11,2016,9,2
Group 5,RRG,-0.5,12,14,1609,7,2016,11,-4
Group 5,RRG,-0.5,12,14,1610,10,2016,9,1
Group 5,RRG,-0.5,12,14,1611,9,2016,9,0
Group 5,RRG,-0.5,12,14,1612,9,2016,4,5
Group 5,RRG,-0.5,12,14,1613,10,2016,9,1
Group 5,RRG,-0.5,12,14,1614,7,2016,10,-3
Group 5,RRG,-0.5,12,14,1615,13,2016,10,3
Group 5,RRG,-0.5,12,14,1616,12,2016,10,2
Group 5,RRG,-0.5,12,14,1617,10,2016,10,0
Group 5,RRG,-0.5,12,14,1618,12,2016,8,4
Group 5,RRG,-0.5,12,14,1619,12,2016,3,9
Group 5,RRG,-0.5,12,14,1620,11,2016,9,2
Group 5,RRG,-0.5,12,14,1621,13,2016,9,4
Group 5,RRG,-0.5,12,14,1622,11,2016,10,1
Group 5,RRG,-0.5,12,14,1623,13,2016,5,8
Group 5,RRG,-0.5,12,14,1624,13,2016,9,4
Group 5,RRG,-0.5,12,14,1625,7,2016,7,0
Group 5,RRG,-0.5,12,14,1626,11,2016,11,0
Group 5,RRG,-0.5,12,14,1627,10,2016,12,-2
Group 5,RRG,-0.5,12,14,1628,7,2016,9,-2
Group 5,RRG,-0.5,12,14,1629,8,2016,5,3
Group 5,RRG,-0.5,12,14,1630,12,2016,8,4
Group 5,RRG,-0.5,12,14,1631,6,2016,6,0
Group 5,RRG,-0.5,12,14,1632,10,2016,6,4
Group 5,RRG,-0.5,12,14,1633,9,2016,9,0
Group 5,RRG,-0.5,12,14,1634,14,2016,7,7
Group 5,RRG,-0.5,12,14,1635,14,2016,6,8
Group 5,RRG,-0.5,12,14,1636,11,2016,11,0
Group 5,RRG,-0.5,12,14,1637,7,2016,7,0
Group 5,RRG,-0.5,12,14,1638,12,2016,9,3
Group 5,RRG,-0.5,12,14,1639,9,2016,1,8
Group 5,RRG,-0.5,12,14,1640,12,2016,8,4
Group 5,RRG,-0.5,12,14,1641,10,2016,9,1
Group 5,RRG,-0.5,12,14,1642,11,2016,10,1
Group 5,RRG,-0.5,12,14,1643,9,2016,8,1
Group 5,RRG,-0.5,12,14,1644,11,2016,6,5
Group 5,RRG,-0.5,12,14,1645,9,2016,10,-1
Group 5,RRG,-0.5,12,14,1646,12,2016,5,7
Group 5,RRG,-0.5,12,14,1647,7,2016,4,3
Group 5,RRG,-0.5,12,14,1648,11,2016,6,5
Group 5,RRG,-0.5,12,14,1649,13,2016,13,0
Group 5,RRG,-0.5,12,14,1650,6,2016,7,-1
Group 5,RRG,-0.5,12,14,1651,11,2016,9,2
Group 5,RRG,-0.5,12,14,1652,12,2016,6,6
Group 5,RRG,-0.5,12,14,1653,12,2016,5,7
Group 5,RRG,-0.5,12,14,1654,13,2016,7,6
Group 5,RRG,-0.5,12,14,1655,11,2016,8,3
Group 5,RRG,-0.5,12,14,1656,9,2016,10,-1
Group 5,RRG,-0.5,12,14,1657,12,2016,5,7
Group 5,RRG,-0.5,12,14,1658,11,2016,6,5
Group 5,RRG,-0.5,12,14,1659,11,2016,5,6
Group 5,RRG,-0.5,12,14,1660,11,2016,4,7
Group 5,RRG,-0.5,12,14,1661,13,2016,6,7
Group 5,RRG,-0.5,12,14,1662,14,2016,6,8
Group 5,RRG,-0.5,12,14,1663,14,2016,10,4
Group 5,RRG,-0.5,12,14,1664,13,2016,8,5
Group 5,RRG,-0.5,12,14,1665,3,2016,7,-4
Group 5,RRG,-0.5,12,14,1666,8,2016,10,-2
Group 5,RRG,-0.5,12,14,1667,11,2016,11,0
Group 5,RRG,-0.5,12,14,1668,12,2016,8,4
Group 5,RRG,-0.5,12,14,1669,8,2016,9,-1
Group 5,RRG,-0.5,12,14,1670,11,2016,7,4
Group 5,RRG,-0.5,12,14,1671,12,2016,9,3
Group 5,RRG,-0.5,12,14,1672,10,2016,13,-3
Group 5,RRG,-0.5,12,14,1673,7,2016,10,-3
Group 5,RRG,-0.5,12,14,1674,9,2016,10,-1
Group 5,RRG,-0.5,12,14,1675,11,2016,10,1
Group 5,RRG,-0.5,12,14,1676,6,2016,7,-1
Group 5,RRG,-0.5,12,14,1677,9,2016,9,0
Group 5,RRG,-0.5,12,14,1678,12,2016,8,4
Group 5,RRG,-0.5,12,14,1679,14,2016,12,2
Group 5,RRG,-0.5,12,14,1680,8,2016,8,0
Group 5,RRG,-0.5,12,14,1681,9,2016,8,1
Group 5,RRG,-0.5,12,14,1682,13,2016,8,5
Group 5,RRG,-0.5,12,14,1683,11,2016,9,2
Group 5,RRG,-0.5,12,14,1684,14,2016,8,6
Group 5,RRG,-0.5,12,14,1685,11,2016,10,1
Group 5,RRG,-0.5,12,14,1686,11,2016,4,7
Group 5,RRG,-0.5,12,14,1687,11,2016,7,4
Group 5,RRG,-0.5,12,14,1688,11,2016,8,3
Group 5,RRG,-0.5,12,14,1689,8,2016,7,1
Group 5,RRG,-0.5,12,14,1690,9,2016,8,1
Group 5,RRG,-0.5,12,14,1691,6,2016,6,0
Group 5,RRG,-0.5,12,14,1692,12,2016,7,5
Group 5,RRG,-0.5,12,14,1693,10,2016,7,3
Group 5,RRG,-0.5,12,14,1694,10,2016,6,4
Group 5,RRG,-0.5,12,14,1695,11,2016,8,3
Group 5,RRG,-0.5,12,14,1696,9,2016,9,0
Group 5,RRG,-0.5,12,14,1697,10,2016,9,1
Group 5,RRG,-0.5,12,14,1698,12,2016,2,10
Group 5,RRG,-0.5,12,14,1699,12,2016,4,8
Group 5,RRG,-0.5,12,14,1700,10,2016,7,3
Group 5,RRG,-0.5,12,14,1701,11,2016,6,5
Group 5,RRG,-0.5,12,14,1702,13,2016,8,5
Group 5,RRG,-0.5,12,14,1703,9,2016,6,3
Group 5,RRG,-0.5,12,14,1704,8,2016,8,0
Group 5,RRG,-0.5,12,14,1705,8,2016,12,-4
Group 5,RRG,-0.5,12,14,1706,7,2016,10,-3
Group 5,RRG,-0.5,12,14,1707,13,2016,4,9
Group 5,RRG,-0.5,12,14,1708,11,2016,5,6
Group 5,RRG,-0.5,12,14,1709,7,2016,2,5
Group 5,RRG,-0.5,12,14,1710,12,2016,3,9
Group 5,RRG,-0.5,12,14,1711,7,2016,3,4
Group 5,RRG,-0.5,12,14,1712,10,2016,12,-2
Group 5,RRG,-0.5,12,14,1713,9,2016,13,-4
Group 5,RRG,-0.5,12,14,1714,12,2016,8,4
Group 5,RRG,-0.5,12,14,1715,9,2016,9,0
Group 5,RRG,-0.5,12,14,1716,9,2016,10,-1
Group 5,RRG,-0.5,12,14,1717,11,2016,8,3
Group 5,RRG,-0.5,12,14,1718,13,2016,6,7
Group 5,RRG,-0.5,12,14,1719,12,2016,11,1
Group 5,RRG,-0.5,12,14,1720,13,2016,6,7
Group 5,RRG,-0.5,12,14,1721,6,2016,7,-1
Group 5,RRG,-0.5,12,14,1722,11,2016,10,1
Group 5,RRG,-0.5,12,14,1723,7,2016,11,-4
Group 5,RRG,-0.5,12,14,1724,8,2016,5,3
Group 5,RRG,-0.5,12,14,1725,13,2016,12,1
Group 5,RRG,-0.5,12,14,1726,9,2016,5,4
Group 5,RRG,-0.5,12,14,1727,8,2016,8,0
Group 5,RRG,-0.5,12,14,1728,10,2016,9,1
Group 5,RRG,-0.5,12,14,1729,9,2016,5,4
Group 5,RRG,-0.5,12,14,1730,9,2016,10,-1
Group 5,RRG,-0.5,12,14,1731,12,2016,7,5
Group 5,RRG,-0.5,12,14,1732,12,2016,11,1
Group 5,RRG,-0.5,12,14,1733,10,2016,9,1
Group 5,RRG,-0.5,12,14,1734,10,2016,11,-1
Group 5,RRG,-0.5,12,14,1735,5,2016,7,-2
Group 5,RRG,-0.5,12,14,1736,12,2016,5,7
Group 5,RRG,-0.5,12,14,1737,14,2016,11,3
Group 5,RRG,-0.5,12,14,1738,13,2016,13,0
Group 5,RRG,-0.5,12,14,1739,14,2016,9,5
Group 5,RRG,-0.5,12,14,1740,11,2016,12,-1
Group 5,RRG,-0.5,12,14,1741,13,2016,11,2
Group 5,RRG,-0.5,12,14,1742,13,2016,10,3
Group 5,RRG,-0.5,12,14,1743,14,2016,10,4
Group 5,RRG,-0.5,12,14,1744,12,2016,8,4
Group 5,RRG,-0.5,12,14,1745,9,2016,5,4
Group 5,RRG,-0.5,12,14,1746,9,2016,9,0
Group 5,RRG,-0.5,12,14,1747,10,2016,7,3
Group 5,RRG,-0.5,12,14,1748,9,2016,5,4
Group 5,RRG,-0.5,12,14,1749,9,2016,12,-3
Group 5,RRG,-0.5,12,14,1750,6,2016,7,-1
Group 5,RRG,-0.5,12,14,1751,13,2016,7,6
Group 5,RRG,-0.5,12,14,1752,10,2016,5,5
Group 5,RRG,-0.5,12,14,1753,9,2016,5,4
Group 5,RRG,-0.5,12,14,1754,10,2016,11,-1
Group 5,RRG,-0.5,12,14,1755,11,2016,10,1
Group 5,RRG,-0.5,12,14,1756,8,2016,6,2
Group 5,RRG,-0.5,12,14,1757,10,2016,10,0
Group 5,RRG,-0.5,12,14,1758,11,2016,5,6
Group 5,RRG,-0.5,12,14,1759,8,2016,7,1
Group 5,RRG,-0.5,12,14,1760,10,2016,9,1
Group 5,RRG,-0.5,12,14,1761,11,2016,8,3
Group 5,RRG,-0.5,12,14,1762,12,2016,11,1
Group 5,RRG,-0.5,12,14,1763,13,2016,7,6
Group 5,RRG,-0.5,12,14,1764,8,2016,10,-2
Group 5,RRG,-0.5,12,14,1765,12,2016,13,-1
Group 5,RRG,-0.5,12,14,1766,11,2016,11,0
Group 5,RRG,-0.5,12,14,1767,12,2016,7,5
Group 5,RRG,-0.5,12,14,1768,10,2016,9,1
Group 5,RRG,-0.5,12,14,1769,8,2016,9,-1
Group 5,RRG,-0.5,12,14,1770,11,2016,9,2
Group 5,RRG,-0.5,12,14,1771,13,2016,9,4
Group 5,RRG,-0.5,12,14,1772,8,2016,7,1
Group 5,RRG,-0.5,12,14,1773,13,2016,6,7
Group 5,RRG,-0.5,12,14,1774,6,2016,7,-1
Group 5,RRG,-0.5,12,14,1775,11,2016,6,5
Group 5,RRG,-0.5,12,14,1776,6,2016,10,-4
Group 5,RRG,-0.5,12,14,1777,8,2016,8,0
Group 5,RRG,-0.5,12,14,1778,9,2016,6,3
Group 5,RRG,-0.5,12,14,1779,9,2016,11,-2
Group 5,RRG,-0.5,12,14,1780,8,2016,10,-2
Group 5,RRG,-0.5,12,14,1781,8,2016,4,4
Group 5,RRG,-0.5,12,14,1782,11,2016,8,3
Group 5,RRG,-0.5,12,14,1783,12,2016,8,4
Group 5,RRG,-0.5,12,14,1784,14,2016,5,9
Group 5,RRG,-0.5,12,14,1785,9,2016,9,0
Group 5,RRG,-0.5,12,14,1786,8,2016,12,-4
Group 5,RRG,-0.5,12,14,1787,10,2016,11,-1
Group 5,RRG,-0.5,12,14,1788,6,2016,8,-2
Group 5,RRG,-0.5,12,14,1789,8,2016,11,-3
Group 5,RRG,-0.5,12,14,1790,12,2016,6,6
Group 5,RRG,-0.5,12,14,1791,10,2016,10,0
Group 5,RRG,-0.5,12,14,1792,9,2016,11,-2
Group 5,RRG,-0.5,12,14,1793,9,2016,10,-1
Group 5,RRG,-0.5,12,14,1794,12,2016,5,7
Group 5,RRG,-0.5,12,14,1795,9,2016,11,-2
Group 5,RRG,-0.5,12,14,1796,5,2016,10,-5
Group 5,RRG,-0.5,12,14,1797,10,2016,14,-4
Group 5,RRG,-0.5,12,14,1798,13,2016,7,6
Group 5,RRG,-0.5,12,14,1799,10,2016,13,-3
Group 5,RRG,-0.5,12,14,1800,11,2016,8,3
Group 5,RRG,-0.5,12,14,1801,9,2016,11,-2
Group 5,RRG,-0.5,12,14,1802,13,2016,6,7
Group 5,RRG,-0.5,12,14,1803,9,2016,5,4
Group 5,RRG,-0.5,12,14,1804,9,2016,8,1
Group 5,RRG,-0.5,12,14,1805,12,2016,11,1
Group 5,RRG,-0.5,12,14,1806,7,2016,9,-2
Group 5,RRG,-0.5,12,14,1807,11,2016,9,2
Group 5,RRG,-0.5,12,14,1808,11,2016,9,2
Group 5,RRG,-0.5,12,14,1809,11,2016,10,1
Group 5,RRG,-0.5,12,14,1810,13,2016,7,6
Group 5,RRG,-0.5,12,14,1811,9,2016,7,2
Group 5,RRG,-0.5,12,14,1812,11,2016,13,-2
Group 5,RRG,-0.5,12,14,1813,9,2016,6,3
Group 5,RRG,-0.5,12,14,1814,9,2016,8,1
Group 5,RRG,-0.5,12,14,1815,10,2016,9,1
Group 5,RRG,-0.5,12,14,1816,6,2016,10,-4
Group 5,RRG,-0.5,12,14,1817,11,2016,11,0
Group 5,RRG,-0.5,12,14,1818,10,2016,10,0
Group 5,RRG,-0.5,12,14,1819,14,2016,13,1
Group 5,RRG,-0.5,12,14,1820,9,2016,11,-2
Group 5,RRG,-0.5,12,14,1821,10,2016,9,1
Group 5,RRG,-0.5,12,14,1822,11,2016,8,3
Group 5,RRG,-0.5,12,14,1823,11,2016,10,1
Group 5,RRG,-0.5,12,14,1824,11,2016,9,2
Group 5,RRG,-0.5,12,14,1825,6,2016,7,-1
Group 5,RRG,-0.5,12,14,1826,10,2016,9,1
Group 5,RRG,-0.5,12,14,1827,9,2016,10,-1
Group 5,RRG,-0.5,12,14,1828,6,2016,4,2
Group 5,RRG,-0.5,12,14,1829,9,2016,8,1
Group 5,RRG,-0.5,12,14,1830,8,2016,9,-1
Group 5,RRG,-0.5,12,14,1831,6,2016,7,-1
Group 5,RRG,-0.5,12,14,1832,8,2016,9,-1
Group 5,RRG,-0.5,12,14,1833,11,2016,8,3
Group 5,RRG,-0.5,12,14,1834,10,2016,10,0
Group 5,RRG,-0.5,12,14,1835,10,2016,13,-3
Group 5,RRG,-0.5,12,14,1836,11,2016,7,4
Group 5,RRG,-0.5,12,14,1837,12,2016,6,6
Group 5,RRG,-0.5,12,14,1838,13,2016,7,6
Group 5,RRG,-0.5,12,14,1839,12,2016,7,5
Group 5,RRG,-0.5,12,14,1840,8,2016,7,1
Group 5,RRG,-0.5,12,14,1841,12,2016,11,1
Group 5,RRG,-0.5,12,14,1842,12,2016,9,3
Group 5,RRG,-0.5,12,14,1843,11,2016,7,4
Group 5,RRG,-0.5,12,14,1844,12,2016,10,2
Group 5,RRG,-0.5,12,14,1845,8,2016,5,3
Group 5,RRG,-0.5,12,14,1846,11,2016,6,5
Group 5,RRG,-0.5,12,14,1847,9,2016,10,-1
Group 5,RRG,-0.5,12,14,1848,10,2016,11,-1
Group 5,RRG,-0.5,12,14,1849,8,2016,7,1
Group 5,RRG,-0.5,12,14,1850,10,2016,8,2
Group 5,RRG,-0.5,12,14,1851,14,2016,7,7
Group 5,RRG,-0.5,12,14,1852,14,2016,11,3
Group 5,RRG,-0.5,12,14,1853,11,2016,8,3
Group 5,RRG,-0.5,12,14,1854,6,2016,11,-5
Group 5,RRG,-0.5,12,14,1855,10,2016,12,-2
Group 5,RRG,-0.5,12,14,1856,9,2016,9,0
Group 5,RRG,-0.5,12,14,1857,12,2016,10,2
Group 5,RRG,-0.5,12,14,1858,11,2016,8,3
Group 5,RRG,-0.5,12,14,1859,9,2016,10,-1
Group 5,RRG,-0.5,12,14,1860,9,2016,8,1
Group 5,RRG,-0.5,12,14,1861,8,2016,9,-1
Group 5,RRG,-0.5,12,14,1862,10,2016,10,0
Group 5,RRG,-0.5,12,14,1863,7,2016,6,1
Group 5,RRG,-0.5,12,14,1864,14,2016,9,5
Group 5,RRG,-0.5,12,14,1865,13,2016,9,4
Group 5,RRG,-0.5,12,14,1866,10,2016,9,1
Group 5,RRG,-0.5,12,14,1867,13,2016,12,1
Group 5,RRG,-0.5,12,14,1868,7,2016,8,-1
Group 5,RRG,-0.5,12,14,1869,8,2016,5,3
Group 5,RRG,-0.5,12,14,1870,12,2016,4,8
Group 5,RRG,-0.5,12,14,1871,9,2016,11,-2
Group 5,RRG,-0.5,12,14,1872,10,2016,8,2
Group 5,RRG,-0.5,12,14,1873,12,2016,7,5
Group 5,RRG,-0.5,12,14,1874,11,2016,12,-1
Group 5,RRG,-0.5,12,14,1875,9,2016,5,4
Group 5,RRG,-0.5,12,14,1876,10,2016,6,4
Group 5,RRG,-0.5,12,14,1877,10,2016,5,5
Group 5,RRG,-0.5,12,14,1878,11,2016,9,2
Group 5,RRG,-0.5,12,14,1879,8,2016,9,-1
Group 5,RRG,-0.5,12,14,1880,11,2016,10,1
Group 5,RRG,-0.5,12,14,1881,9,2016,10,-1
Group 5,RRG,-0.5,12,14,1882,13,2016,5,8
Group 5,RRG,-0.5,12,14,1883,12,2016,8,4
Group 5,RRG,-0.5,12,14,1884,10,2016,4,6
Group 5,RRG,-0.5,12,14,1885,8,2016,4,4
Group 5,RRG,-0.5,12,14,1886,8,2016,9,-1
Group 5,RRG,-0.5,12,14,1887,12,2016,9,3
Group 5,RRG,-0.5,12,14,1888,8,2016,10,-2
Group 5,RRG,-0.5,12,14,1889,6,2016,8,-2
Group 5,RRG,-0.5,12,14,1890,12,2016,5,7
Group 5,RRG,-0.5,12,14,1891,14,2016,6,8
Group 5,RRG,-0.5,12,14,1892,13,2016,10,3
Group 5,RRG,-0.5,12,14,1893,12,2016,4,8
Group 5,RRG,-0.5,12,14,1894,11,2016,9,2
Group 5,RRG,-0.5,12,14,1895,12,2016,11,1
Group 5,RRG,-0.5,12,14,1896,13,2016,7,6
Group 5,RRG,-0.5,12,14,1897,10,2016,9,1
Group 5,RRG,-0.5,12,14,1898,9,2016,8,1
Group 5,RRG,-0.5,12,14,1899,9,2016,7,2
Group 5,RRG,-0.5,12,14,1900,9,2016,9,0
Group 5,RRG,-0.5,12,14,1901,11,2016,7,4
Group 5,RRG,-0.5,12,14,1902,11,2016,9,2
Group 5,RRG,-0.5,12,14,1903,10,2016,9,1
Group 5,RRG,-0.5,12,14,1904,9,2016,4,5
Group 5,RRG,-0.5,12,14,1905,11,2016,7,4
Group 5,RRG,-0.5,12,14,1906,8,2016,6,2
Group 5,RRG,-0.5,12,14,1907,8,2016,8,0
Group 5,RRG,-0.5,12,14,1908,9,2016,7,2
Group 5,RRG,-0.5,12,14,1909,10,2016,5,5
Group 5,RRG,-0.5,12,14,1910,12,2016,12,0
Group 5,RRG,-0.5,12,14,1911,10,2016,12,-2
Group 5,RRG,-0.5,12,14,1912,10,2016,9,1
Group 5,RRG,-0.5,12,14,1913,13,2016,8,5
Group 5,RRG,-0.5,12,14,1914,5,2016,12,-7
Group 5,RRG,-0.5,12,14,1915,12,2016,12,0
Group 5,RRG,-0.5,12,14,1916,10,2016,11,-1
Group 5,RRG,-0.5,12,14,1917,13,2016,6,7
Group 5,RRG,-0.5,12,14,1918,11,2016,6,5
Group 5,RRG,-0.5,12,14,1919,7,2016,7,0
Group 5,RRG,-0.5,12,14,1920,10,2016,9,1
Group 5,RRG,-0.5,12,14,1921,8,2016,3,5
Group 5,RRG,-0.5,12,14,1922,6,2016,12,-6
Group 5,RRG,-0.5,12,14,1923,9,2016,6,3
Group 5,RRG,-0.5,12,14,1924,10,2016,12,-2
Group 5,RRG,-0.5,12,14,1925,8,2016,9,-1
Group 5,RRG,-0.5,12,14,1926,13,2016,9,4
Group 5,RRG,-0.5,12,14,1927,12,2016,9,3
Group 5,RRG,-0.5,12,14,1928,10,2016,6,4
Group 5,RRG,-0.5,12,14,1929,9,2016,5,4
Group 5,RRG,-0.5,12,14,1930,10,2016,5,5
Group 5,RRG,-0.5,12,14,1931,13,2016,8,5
Group 5,RRG,-0.5,12,14,1932,11,2016,11,0
Group 5,RRG,-0.5,12,14,1933,6,2016,13,-7
Group 5,RRG,-0.5,12,14,1934,10,2016,11,-1
Group 5,RRG,-0.5,12,14,1935,13,2016,5,8
Group 5,RRG,-0.5,12,14,1936,12,2016,7,5
Group 5,RRG,-0.5,12,14,1937,7,2016,10,-3
Group 5,RRG,-0.5,12,14,1938,10,2016,9,1
Group 5,RRG,-0.5,12,14,1939,7,2016,10,-3
Group 5,RRG,-0.5,12,14,1940,9,2016,12,-3
Group 5,RRG,-0.5,12,14,1941,14,2016,12,2
Group 5,RRG,-0.5,12,14,1942,14,2016,9,5
Group 5,RRG,-0.5,12,14,1943,13,2016,8,5
Group 5,RRG,-0.5,12,14,1944,11,2016,8,3
Group 5,RRG,-0.5,12,14,1945,14,2016,8,6
Group 5,RRG,-0.5,12,14,1946,11,2016,7,4
Group 5,RRG,-0.5,12,14,1947,12,2016,9,3
Group 5,RRG,-0.5,12,14,1948,8,2016,5,3
Group 5,RRG,-0.5,12,14,1949,10,2016,9,1
Group 5,RRG,-0.5,12,14,1950,12,2016,9,3
Group 5,RRG,-0.5,12,14,1951,10,2016,5,5
Group 5,RRG,-0.5,12,14,1952,11,2016,8,3
Group 5,RRG,-0.5,12,14,1953,11,2016,8,3
Group 5,RRG,-0.5,12,14,1954,10,2016,7,3
Group 5,RRG,-0.5,12,14,1955,11,2016,11,0
Group 5,RRG,-0.5,12,14,1956,11,2016,7,4
Group 5,RRG,-0.5,12,14,1957,12,2016,8,4
Group 5,RRG,-0.5,12,14,1958,10,2016,9,1
Group 5,RRG,-0.5,12,14,1959,12,2016,9,3
Group 5,RRG,-0.5,12,14,1960,13,2016,9,4
Group 5,RRG,-0.5,12,14,1961,12,2016,10,2
Group 5,RRG,-0.5,12,14,1962,12,2016,6,6
Group 5,RRG,-0.5,12,14,1963,12,2016,9,3
Group 5,RRG,-0.5,12,14,1964,12,2016,12,0
Group 5,RRG,-0.5,12,14,1965,9,2016,7,2
Group 5,RRG,-0.5,12,14,1966,9,2016,7,2
Group 5,RRG,-0.5,12,14,1967,10,2016,11,-1
Group 5,RRG,-0.5,12,14,1968,11,2016,10,1
Group 5,RRG,-0.5,12,14,1969,9,2016,10,-1
Group 5,RRG,-0.5,12,14,1970,12,2016,7,5
Group 5,RRG,-0.5,12,14,1971,11,2016,3,8
Group 5,RRG,-0.5,12,14,1972,8,2016,10,-2
Group 5,RRG,-0.5,12,14,1973,11,2016,8,3
Group 5,RRG,-0.5,12,14,1974,11,2016,10,1
Group 5,RRG,-0.5,12,14,1975,9,2016,11,-2
Group 5,RRG,-0.5,12,14,1976,9,2016,8,1
Group 5,RRG,-0.5,12,14,1977,9,2016,11,-2
Group 5,RRG,-0.5,12,14,1978,11,2016,9,2
Group 5,RRG,-0.5,12,14,1979,8,2016,8,0
Group 5,RRG,-0.5,12,14,1980,13,2016,8,5
Group 5,RRG,-0.5,12,14,1981,11,2016,7,4
Group 5,RRG,-0.5,12,14,1982,12,2016,9,3
Group 5,RRG,-0.5,12,14,1983,7,2016,11,-4
Group 5,RRG,-0.5,12,14,1984,10,2016,10,0
Group 5,RRG,-0.5,12,14,1985,12,2016,3,9
Group 5,RRG,-0.5,12,14,1986,10,2016,7,3
Group 5,RRG,-0.5,12,14,1987,9,2016,10,-1
Group 5,RRG,-0.5,12,14,1988,13,2016,9,4
Group 5,RRG,-0.5,12,14,1989,13,2016,11,2
Group 5,RRG,-0.5,12,14,1990,9,2016,7,2
Group 5,RRG,-0.5,12,14,1991,11,2016,4,7
Group 5,RRG,-0.5,12,14,1992,6,2016,11,-5
Group 5,RRG,-0.5,12,14,1993,9,2016,9,0
Group 5,RRG,-0.5,12,14,1994,11,2016,9,2
Group 5,RRG,-0.5,12,14,1995,12,2016,9,3
Group 5,RRG,-0.5,12,14,1996,10,2016,13,-3
Group 5,RRG,-0.5,12,14,1997,12,2016,9,3
Group 5,RRG,-0.5,12,14,1998,10,2016,5,5
Group 5,RRG,-0.5,12,14,1999,8,2016,4,4
Group 5,RRG,-0.5,12,14,2000,12,2016,7,5
Group 5,RRG,-0.5,12,14,2001,8,2016,4,4
Group 5,RRG,-0.5,12,14,2002,10,2016,5,5
Group 5,RRG,-0.5,12,14,2003,11,2016,5,6
Group 5,RRG,-0.5,12,14,2004,11,2016,5,6
Group 5,RRG,-0.5,12,14,2005,11,2016,5,6
Group 5,RRG,-0.5,12,14,2006,8,2016,8,0
Group 5,RRG,-0.5,12,14,2007,11,2016,10,1
Group 5,RRG,-0.5,12,14,2008,8,2016,9,-1
Group 5,RRG,-0.5,12,14,2009,9,2016,9,0
Group 5,RRG,-0.5,12,14,2010,12,2016,7,5
Group 5,RRG,-0.5,12,14,2011,11,2016,12,-1
Group 5,RRG,-0.5,12,14,2012,12,2016,6,6
Group 5,RRG,-0.5,12,14,2013,12,2016,6,6
Group 5,RRG,-0.5,12,14,2014,12,2016,7,5
Group 5,RRG,-0.5,12,14,2015,12,2016,10,2
Group 5,RRG,-0.5,12,14,2016,10,2016,9,1
Group 5,RRG,-0.5,12,14,2017,9,2016,7,2
Group 5,RRG,-0.5,12,14,2018,8,2016,8,0
Group 5,RRG,-0.5,12,14,2019,11,2016,11,0
Group 5,RRG,-0.5,12,14,2020,11,2016,8,3
Group 5,RRG,-0.5,12,14,2021,11,2016,7,4
Group 5,RRG,-0.5,12,14,2022,11,2016,9,2
Group 5,RRG,-0.5,12,14,2023,10,2016,10,0
Group 5,RRG,-0.5,12,14,2024,14,2016,10,4
Group 5,RRG,-0.5,12,14,2025,13,2016,9,4
Group 5,RRG,-0.5,12,14,2026,10,2016,8,2
Group 5,RRG,-0.5,12,14,2027,12,2016,5,7
Group 5,RRG,-0.5,12,14,2028,13,2016,7,6
Group 5,RRG,-0.5,12,14,2029,9,2016,7,2
Group 5,RRG,-0.5,12,14,2030,10,2016,2,8
Group 5,RRG,-0.5,12,14,2031,11,2016,11,0
Group 5,RRG,-0.5,12,14,2032,10,2016,7,3
Group 5,RRG,-0.5,12,14,2033,9,2016,8,1
Group 5,RRG,-0.5,12,14,2034,10,2016,6,4
Group 5,RRG,-0.5,12,14,2035,8,2016,11,-3
Group 5,RRG,-0.5,12,14,2036,9,2016,9,0
Group 5,RRG,-0.5,12,14,2037,10,2016,13,-3
Group 5,RRG,-0.5,12,14,2038,8,2016,9,-1
Group 5,RRG,-0.5,12,14,2039,12,2016,10,2
Group 5,RRG,-0.5,12,14,2040,13,2016,6,7
Group 5,RRG,-0.5,12,14,2041,9,2016,9,0
Group 5,RRG,-0.5,12,14,2042,10,2016,12,-2
Group 5,RRG,-0.5,12,14,2043,10,2016,10,0
Group 5,RRG,-0.5,12,14,2044,10,2016,11,-1
Group 5,RRG,-0.5,12,14,2045,10,2016,7,3
Group 5,RRG,-0.5,12,14,2046,11,2016,9,2
Group 5,RRG,-0.5,12,14,2047,10,2016,8,2
Group 5,RRG,-0.5,12,14,2048,10,2016,11,-1
Group 5,RRG,-0.5,12,14,2049,11,2016,12,-1
Group 5,RRG,-0.5,12,14,2050,9,2016,12,-3
Group 5,RRG,-0.5,12,14,2051,10,2016,8,2
Group 5,RRG,-0.5,12,14,2052,11,2016,8,3
Group 5,RRG,-0.5,12,14,2053,10,2016,11,-1
Group 5,RRG,-0.5,12,14,2054,9,2016,8,1
Group 5,RRG,-0.5,12,14,2055,11,2016,8,3
Group 5,RRG,-0.5,12,14,2056,11,2016,6,5
Group 5,RRG,-0.5,12,14,2057,12,2016,11,1
Group 5,RRG,-0.5,12,14,2058,10,2016,7,3
Group 5,RRG,-0.5,12,14,2059,11,2016,9,2
Group 5,RRG,-0.5,12,14,2060,13,2016,6,7
Group 5,RRG,-0.5,12,14,2061,11,2016,8,3
Group 5,RRG,-0.5,12,14,2062,11,2016,5,6
Group 5,RRG,-0.5,12,14,2063,9,2016,9,0
Group 5,RRG,-0.5,12,14,2064,10,2016,8,2
Group 5,RRG,-0.5,12,14,2065,11,2016,8,3
Group 5,RRG,-0.5,12,14,2066,8,2016,8,0
Group 5,RRG,-0.5,12,14,2067,9,2016,3,6
Group 5,RRG,-0.5,12,14,2068,12,2016,5,7
Group 5,RRG,-0.5,12,14,2069,10,2016,5,5
Group 5,RRG,-0.5,12,14,2070,8,2016,7,1
Group 5,RRG,-0.5,12,14,2071,10,2016,9,1
Group 5,RRG,-0.5,12,14,2072,11,2016,9,2
Group 5,RRG,-0.5,12,14,2073,8,2016,5,3
Group 5,RRG,-0.5,12,14,2074,12,2016,9,3
Group 5,RRG,-0.5,12,14,2075,8,2016,3,5
Group 5,RRG,-0.5,12,14,2076,11,2016,10,1
Group 5,RRG,-0.5,12,14,2077,7,2016,11,-4
Group 5,RRG,-0.5,12,14,2078,11,2016,7,4
Group 5,RRG,-0.5,12,14,2079,8,2016,8,0
Group 5,RRG,-0.5,12,14,2080,9,2016,9,0
Group 5,RRG,-0.5,12,14,2081,10,2016,9,1
Group 5,RRG,-0.5,12,14,2082,8,2016,4,4
Group 5,RRG,-0.5,12,14,2083,12,2016,11,1
Group 5,RRG,-0.5,12,14,2084,12,2016,9,3
Group 5,RRG,-0.5,12,14,2085,11,2016,12,-1
Group 5,RRG,-0.5,12,14,2086,11,2016,12,-1
Group 5,RRG,-0.5,12,14,2087,7,2016,9,-2
Group 5,RRG,-0.5,12,14,2088,11,2016,7,4
Group 5,RRG,-0.5,12,14,2089,10,2016,9,1
Group 5,RRG,-0.5,12,14,2090,8,2016,8,0
Group 5,RRG,-0.5,12,14,2091,10,2016,12,-2
Group 5,RRG,-0.5,12,14,2092,11,2016,10,1
Group 5,RRG,-0.5,12,14,2093,8,2016,10,-2
Group 5,RRG,-0.5,12,14,2094,12,2016,10,2
Group 5,RRG,-0.5,12,14,2095,10,2016,7,3
Group 5,RRG,-0.5,12,14,2096,6,2016,13,-7
Group 5,RRG,-0.5,12,14,2097,7,2016,12,-5
Group 5,RRG,-0.5,12,14,2098,10,2016,10,0
Group 5,RRG,-0.5,12,14,2099,12,2016,9,3
Group 5,RRG,-0.5,12,14,2100,14,2016,7,7
Group 5,RRG,-0.5,12,14,2101,13,2016,10,3
Group 5,RRG,-0.5,12,14,2102,7,2016,8,-1
Group 5,RRG,-0.5,12,14,2103,12,2016,10,2
Group 5,RRG,-0.5,12,14,2104,10,2016,11,-1
Group 5,RRG,-0.5,12,14,2105,10,2016,11,-1
Group 5,RRG,-0.5,12,14,2106,12,2016,10,2
Group 5,RRG,-0.5,12,14,2107,7,2016,10,-3
Group 5,RRG,-0.5,12,14,2108,9,2016,9,0
Group 5,RRG,-0.5,12,14,2109,8,2016,9,-1
Group 5,RRG,-0.5,12,14,2110,8,2016,8,0
Group 5,RRG,-0.5,12,14,2111,11,2016,7,4
Group 5,RRG,-0.5,12,14,2112,11,2016,7,4
Group 5,RRG,-0.5,12,14,2113,7,2016,10,-3
Group 5,RRG,-0.5,12,14,2114,8,2016,10,-2
Group 5,RRG,-0.5,12,14,2115,12,2016,7,5
Group 5,RRG,-0.5,12,14,2116,9,2016,9,0
Group 5,RRG,-0.5,12,14,2117,12,2016,13,-1
Group 5,RRG,-0.5,12,14,2118,12,2016,7,5
Group 5,RRG,-0.5,12,14,2119,9,2016,10,-1
Group 5,RRG,-0.5,12,14,2120,14,2016,8,6
Group 5,RRG,-0.5,12,14,2121,13,2016,11,2
Group 5,RRG,-0.5,12,14,2122,10,2016,5,5
Group 5,RRG,-0.5,12,14,2123,12,2016,10,2
Group 5,RRG,-0.5,12,14,2124,11,2016,7,4
Group 5,RRG,-0.5,12,14,2125,9,2016,8,1
Group 5,RRG,-0.5,12,14,2126,11,2016,3,8
Group 5,RRG,-0.5,12,14,2127,10,2016,4,6
Group 5,RRG,-0.5,12,14,2128,10,2016,11,-1
Group 5,RRG,-0.5,12,14,2129,10,2016,7,3
Group 5,RRG,-0.5,12,14,2130,9,2016,10,-1
Group 5,RRG,-0.5,12,14,2131,9,2016,11,-2
Group 5,RRG,-0.5,12,14,2132,12,2016,7,5
Group 5,RRG,-0.5,12,14,2133,9,2016,12,-3
Group 5,RRG,-0.5,12,14,2134,10,2016,9,1
Group 5,RRG,-0.5,12,14,2135,7,2016,9,-2
Group 5,RRG,-0.5,12,14,2136,10,2016,8,2
Group 5,RRG,-0.5,12,14,2137,13,2016,5,8
Group 5,RRG,-0.5,12,14,2138,9,2016,9,0
Group 5,RRG,-0.5,12,14,2139,12,2016,11,1
Group 5,RRG,-0.5,12,14,2140,10,2016,7,3
Group 5,RRG,-0.5,12,14,2141,10,2016,9,1
Group 5,RRG,-0.5,12,14,2142,10,2016,8,2
Group 5,RRG,-0.5,12,14,2143,10,2016,5,5
Group 5,RRG,-0.5,12,14,2144,11,2016,10,1
Group 5,RRG,-0.5,12,14,2145,10,2016,8,2
Group 5,RRG,-0.5,12,14,2146,8,2016,9,-1
Group 5,RRG,-0.5,12,14,2147,13,2016,10,3
Group 5,RRG,-0.5,12,14,2148,12,2016,9,3
Group 5,RRG,-0.5,12,14,2149,12,2016,7,5
Group 5,RRG,-0.5,12,14,2150,10,2016,8,2
Group 5,RRG,-0.5,12,14,2151,12,2016,5,7
Group 5,RRG,-0.5,12,14,2152,6,2016,9,-3
Group 5,RRG,-0.5,12,14,2153,12,2016,8,4
Group 5,RRG,-0.5,12,14,2154,10,2016,7,3
Group 5,RRG,-0.5,12,14,2155,8,2016,2,6
Group 5,RRG,-0.5,12,14,2156,10,2016,7,3
Group 5,RRG,-0.5,12,14,2157,12,2016,7,5
Group 5,RRG,-0.5,12,14,2158,11,2016,10,1
Group 5,RRG,-0.5,12,14,2159,8,2016,11,-3
Group 5,RRG,-0.5,12,14,2160,7,2016,10,-3
Group 5,RRG,-0.5,12,14,2161,10,2016,5,5
Group 5,RRG,-0.5,12,14,2162,9,2016,11,-2
Group 5,RRG,-0.5,12,14,2163,10,2016,7,3
Group 5,RRG,-0.5,12,14,2164,13,2016,5,8
Group 5,RRG,-0.5,12,14,2165,11,2016,9,2
Group 5,RRG,-0.5,12,14,2166,11,2016,6,5
Group 5,RRG,-0.5,12,14,2167,5,2016,8,-3
Group 5,RRG,-0.5,12,14,2168,10,2016,5,5
Group 5,RRG,-0.5,12,14,2169,14,2016,9,5
Group 5,RRG,-0.5,12,14,2170,13,2016,8,5
Group 5,RRG,-0.5,12,14,2171,12,2016,7,5
Group 5,RRG,-0.5,12,14,2172,8,2016,7,1
Group 5,RRG,-0.5,12,14,2173,10,2016,9,1
Group 5,RRG,-0.5,12,14,2174,8,2016,10,-2
Group 5,RRG,-0.5,12,14,2175,10,2016,10,0
Group 5,RRG,-0.5,12,14,2176,9,2016,8,1
Group 5,RRG,-0.5,12,14,2177,11,2016,9,2
Group 5,RRG,-0.5,12,14,2178,10,2016,6,4
Group 5,RRG,-0.5,12,14,2179,9,2016,6,3
Group 5,RRG,-0.5,12,14,2180,10,2016,8,2
Group 5,RRG,-0.5,12,14,2181,9,2016,10,-1
Group 5,RRG,-0.5,12,14,2182,10,2016,10,0
Group 5,RRG,-0.5,12,14,2183,11,2016,7,4
Group 5,RRG,-0.5,12,14,2184,8,2016,9,-1
Group 5,RRG,-0.5,12,14,2185,8,2016,9,-1
Group 5,RRG,-0.5,12,14,2186,11,2016,10,1
Group 5,RRG,-0.5,12,14,2187,8,2016,3,5
Group 5,RRG,-0.5,12,14,2188,10,2016,7,3
Group 5,RRG,-0.5,12,14,2189,11,2016,9,2
Group 5,RRG,-0.5,12,14,2190,13,2016,12,1
Group 5,RRG,-0.5,12,14,2191,14,2016,9,5
Group 5,RRG,-0.5,12,14,2192,13,2016,6,7
Group 5,RRG,-0.5,12,14,2193,12,2016,13,-1
Group 5,RRG,-0.5,12,14,2194,10,2016,8,2
Group 5,RRG,-0.5,12,14,2195,9,2016,8,1
Group 5,RRG,-0.5,12,14,2196,10,2016,12,-2
Group 5,RRG,-0.5,12,14,2197,12,2016,6,6
Group 5,RRG,-0.5,12,14,2198,8,2016,7,1
Group 5,RRG,-0.5,12,14,2199,13,2016,12,1
Group 5,RRG,-0.5,12,14,2200,11,2016,12,-1
Group 5,RRG,-0.5,12,14,2201,11,2016,6,5
Group 5,RRG,-0.5,12,14,2202,9,2016,9,0
Group 5,RRG,-0.5,12,14,2203,11,2016,6,5
Group 5,RRG,-0.5,12,14,2204,10,2016,10,0
Group 5,RRG,-0.5,12,14,2205,11,2016,6,5
Group 5,RRG,-0.5,12,14,2206,13,2016,8,5
Group 5,RRG,-0.5,12,14,2207,8,2016,6,2
Group 5,RRG,-0.5,12,14,2208,8,2016,6,2
Group 5,RRG,-0.5,12,14,2209,9,2016,10,-1
Group 5,RRG,-0.5,12,14,2210,14,2016,9,5
Group 5,RRG,-0.5,12,14,2211,10,2016,9,1
Group 5,RRG,-0.5,12,14,2212,11,2016,7,4
Group 5,RRG,-0.5,12,14,2213,9,2016,8,1
Group 5,RRG,-0.5,12,14,2214,8,2016,10,-2
Group 5,RRG,-0.5,12,14,2215,10,2016,5,5
Group 5,RRG,-0.5,12,14,2216,10,2016,8,2
Group 5,RRG,-0.5,12,14,2217,10,2016,6,4
Group 5,RRG,-0.5,12,14,2218,10,2016,10,0
Group 5,RRG,-0.5,12,14,2219,13,2016,9,4
Group 5,RRG,-0.5,12,14,2220,12,2016,7,5
Group 5,RRG,-0.5,12,14,2221,9,2016,10,-1
Group 5,RRG,-0.5,12,14,2222,12,2016,6,6
Group 5,RRG,-0.5,12,14,2223,14,2016,12,2
Group 5,RRG,-0.5,12,14,2224,10,2016,6,4
Group 5,RRG,-0.5,12,14,2225,4,2016,6,-2
Group 5,RRG,-0.5,12,14,2226,13,2016,11,2
Group 5,RRG,-0.5,12,14,2227,9,2016,12,-3
Group 5,RRG,-0.5,12,14,2228,10,2016,6,4
Group 5,RRG,-0.5,12,14,2229,12,2016,9,3
Group 5,RRG,-0.5,12,14,2230,11,2016,11,0
Group 5,RRG,-0.5,12,14,2231,12,2016,7,5
Group 5,RRG,-0.5,12,14,2232,9,2016,2,7
Group 5,RRG,-0.5,12,14,2233,11,2016,2,9
Group 5,RRG,-0.5,12,14,2234,12,2016,8,4
Group 5,RRG,-0.5,12,14,2235,9,2016,12,-3
Group 5,RRG,-0.5,12,14,2236,8,2016,3,5
Group 5,RRG,-0.5,12,14,2237,9,2016,9,0
Group 5,RRG,-0.5,12,14,2238,9,2016,9,0
Group 5,RRG,-0.5,12,14,2239,6,2016,7,-1
Group 5,RRG,-0.5,12,14,2240,5,2016,7,-2
Group 5,RRG,-0.5,12,14,2241,11,2016,6,5
Group 5,RRG,-0.5,12,14,2242,7,2016,10,-3
Group 5,RRG,-0.5,12,14,2243,8,2016,10,-2
Group 5,RRG,-0.5,12,14,2244,9,2016,9,0
Group 5,RRG,-0.5,12,14,2245,10,2016,8,2
Group 5,RRG,-0.5,12,14,2246,12,2016,9,3
Group 5,RRG,-0.5,12,14,2247,10,2016,10,0
Group 5,RRG,-0.5,12,14,2248,8,2016,10,-2
Group 5,RRG,-0.5,12,14,2249,11,2016,5,6
Group 5,RRG,-0.5,12,14,2250,10,2016,11,-1
Group 5,RRG,-0.5,12,14,2251,10,2016,8,2
Group 5,RRG,-0.5,12,14,2252,13,2016,9,4
Group 5,RRG,-0.5,12,14,2253,9,2016,8,1
Group 5,RRG,-0.5,12,14,2254,9,2016,10,-1
Group 5,RRG,-0.5,12,14,2255,11,2016,12,-1
Group 5,RRG,-0.5,12,14,2256,10,2016,7,3
Group 5,RRG,-0.5,12,14,2257,11,2016,8,3
Group 5,RRG,-0.5,12,14,2258,11,2016,6,5
Group 5,RRG,-0.5,12,14,2259,9,2016,6,3
Group 5,RRG,-0.5,12,14,2260,9,2016,8,1
Group 5,RRG,-0.5,12,14,2261,9,2016,7,2
Group 5,RRG,-0.5,12,14,2262,9,2016,7,2
Group 5,RRG,-0.5,12,14,2263,14,2016,9,5
Group 5,RRG,-0.5,12,14,2264,10,2016,8,2
Group 5,RRG,-0.5,12,14,2265,12,2016,7,5
Group 5,RRG,-0.5,12,14,2266,12,2016,8,4
Group 5,RRG,-0.5,12,14,2267,11,2016,5,6
Group 5,RRG,-0.5,12,14,2268,11,2016,12,-1
Group 5,RRG,-0.5,12,14,2269,10,2016,4,6
Group 5,RRG,-0.5,12,14,2270,12,2016,8,4
Group 5,RRG,-0.5,12,14,2271,12,2016,8,4
Group 5,RRG,-0.5,12,14,2272,11,2016,4,7
Group 5,RRG,-0.5,12,14,2273,12,2016,9,3
Group 5,RRG,-0.5,12,14,2274,6,2016,8,-2
Group 5,RRG,-0.5,12,14,2275,9,2016,10,-1
Group 5,RRG,-0.5,12,14,2276,10,2016,9,1
Group 5,RRG,-0.5,12,14,2277,13,2016,9,4
Group 5,RRG,-0.5,12,14,2278,10,2016,8,2
Group 5,RRG,-0.5,12,14,2279,11,2016,5,6
Group 5,RRG,-0.5,12,14,2280,7,2016,9,-2
Group 5,RRG,-0.5,12,14,2281,6,2016,11,-5
Group 5,RRG,-0.5,12,14,2282,11,2016,8,3
Group 5,RRG,-0.5,12,14,2283,9,2016,8,1
Group 5,RRG,-0.5,12,14,2284,9,2016,10,-1
Group 5,RRG,-0.5,12,14,2285,8,2016,8,0
Group 5,RRG,-0.5,12,14,2286,11,2016,9,2
Group 5,RRG,-0.5,12,14,2287,12,2016,10,2
Group 5,RRG,-0.5,12,14,2288,11,2016,10,1
Group 5,RRG,-0.5,12,14,2289,10,2016,12,-2
Group 5,RRG,-0.5,12,14,2290,7,2016,9,-2
Group 5,RRG,-0.5,12,14,2291,8,2016,8,0
Group 5,RRG,-0.5,12,14,2292,11,2016,5,6
Group 5,RRG,-0.5,12,14,2293,6,2016,9,-3
Group 5,RRG,-0.5,12,14,2294,12,2016,9,3
Group 5,RRG,-0.5,12,14,2295,10,2016,9,1
Group 5,RRG,-0.5,12,14,2296,13,2016,9,4
Group 5,RRG,-0.5,12,14,2297,11,2016,9,2
Group 5,RRG,-0.5,12,14,2298,13,2016,6,7
Group 5,RRG,-0.5,12,14,2299,10,2016,9,1
Group 5,RRG,-0.5,12,14,2300,13,2016,5,8
Group 5,RRG,-0.5,12,14,2301,9,2016,10,-1
Group 5,RRG,-0.5,12,14,2302,14,2016,7,7
Group 5,RRG,-0.5,12,14,2303,9,2016,9,0
Group 5,RRG,-0.5,12,14,2304,10,2016,9,1
Group 5,RRG,-0.5,12,14,2305,11,2016,9,2
Group 5,RRG,-0.5,12,14,2306,10,2016,8,2
Group 5,RRG,-0.5,12,14,2307,13,2016,3,10
Group 5,RRG,-0.5,12,14,2308,10,2016,11,-1
Group 5,RRG,-0.5,12,14,2309,7,2016,7,0
Group 5,RRG,-0.5,12,14,2310,12,2016,10,2
Group 5,RRG,-0.5,12,14,2311,9,2016,7,2
Group 5,RRG,-0.5,12,14,2312,10,2016,4,6
Group 5,RRG,-0.5,12,14,2313,9,2016,3,6
Group 5,RRG,-0.5,12,14,2314,8,2016,7,1
Group 5,RRG,-0.5,12,14,2315,10,2016,8,2
Group 5,RRG,-0.5,12,14,2316,7,2016,8,-1
Group 5,RRG,-0.5,12,14,2317,12,2016,12,0
Group 5,RRG,-0.5,12,14,2318,11,2016,7,4
Group 5,RRG,-0.5,12,14,2319,12,2016,10,2
Group 5,RRG,-0.5,12,14,2320,11,2016,12,-1
Group 5,RRG,-0.5,12,14,2321,9,2016,8,1
Group 5,RRG,-0.5,12,14,2322,11,2016,4,7
Group 5,RRG,-0.5,12,14,2323,12,2016,11,1
Group 5,RRG,-0.5,12,14,2324,10,2016,8,2
Group 5,RRG,-0.5,12,14,2325,9,2016,11,-2
Group 5,RRG,-0.5,12,14,2326,12,2016,12,0
Group 5,RRG,-0.5,12,14,2327,11,2016,11,0
Group 5,RRG,-0.5,12,14,2328,10,2016,9,1
Group 5,RRG,-0.5,12,14,2329,9,2016,8,1
Group 5,RRG,-0.5,12,14,2330,11,2016,5,6
Group 5,RRG,-0.5,12,14,2331,12,2016,7,5
Group 5,RRG,-0.5,12,14,2332,10,2016,12,-2
Group 5,RRG,-0.5,12,14,2333,13,2016,8,5
Group 5,RRG,-0.5,12,14,2334,13,2016,5,8
Group 5,RRG,-0.5,12,14,2335,10,2016,7,3
Group 5,RRG,-0.5,12,14,2336,9,2016,10,-1
Group 5,RRG,-0.5,12,14,2337,8,2016,8,0
Group 5,RRG,-0.5,12,14,2338,10,2016,5,5
Group 5,RRG,-0.5,12,14,2339,11,2016,8,3
Group 5,RRG,-0.5,12,14,2340,12,2016,10,2
Group 5,RRG,-0.5,12,14,2341,12,2016,8,4
Group 5,RRG,-0.5,12,14,2342,7,2016,7,0
Group 5,RRG,-0.5,12,14,2343,7,2016,6,1
Group 5,RRG,-0.5,12,14,2344,12,2016,9,3
Group 5,RRG,-0.5,12,14,2345,10,2016,9,1
Group 5,RRG,-0.5,12,14,2346,11,2016,6,5
Group 5,RRG,-0.5,12,14,2347,9,2016,5,4
Group 5,RRG,-0.5,12,14,2348,11,2016,6,5
Group 5,RRG,-0.5,12,14,2349,11,2016,5,6
Group 5,RRG,-0.5,12,14,2350,13,2016,9,4
Group 5,RRG,-0.5,12,14,2351,10,2016,9,1
Group 5,RRG,-0.5,12,14,2352,10,2016,10,0
Group 5,RRG,-0.5,12,14,2353,9,2016,12,-3
Group 5,RRG,-0.5,12,14,2354,9,2016,10,-1
Group 5,RRG,-0.5,12,14,2355,13,2016,12,1
Group 5,RRG,-0.5,12,14,2356,12,2016,13,-1
Group 5,RRG,-0.5,12,14,2357,10,2016,7,3
Group 5,RRG,-0.5,12,14,2358,14,2016,8,6
Group 5,RRG,-0.5,12,14,2359,12,2016,6,6
Group 5,RRG,-0.5,12,14,2360,7,2016,8,-1
Group 5,RRG,-0.5,12,14,2361,10,2016,11,-1
Group 5,RRG,-0.5,12,14,2362,7,2016,14,-7
Group 5,RRG,-0.5,12,14,2363,9,2016,9,0
Group 5,RRG,-0.5,12,14,2364,10,2016,6,4
Group 5,RRG,-0.5,12,14,2365,12,2016,7,5
Group 5,RRG,-0.5,12,14,2366,7,2016,6,1
Group 5,RRG,-0.5,12,14,2367,10,2016,8,2
Group 5,RRG,-0.5,12,14,2368,11,2016,9,2
Group 5,RRG,-0.5,12,14,2369,12,2016,9,3
Group 5,RRG,-0.5,12,14,2370,12,2016,9,3
Group 5,RRG,-0.5,12,14,2371,10,2016,6,4
Group 5,RRG,-0.5,12,14,2372,11,2016,9,2
Group 5,RRG,-0.5,12,14,2373,9,2016,5,4
Group 5,RRG,-0.5,12,14,2374,11,2016,10,1
Group 5,RRG,-0.5,12,14,2375,12,2016,10,2
Group 5,RRG,-0.5,12,14,2376,10,2016,6,4
Group 5,RRG,-0.5,12,14,2377,9,2016,6,3
Group 5,RRG,-0.5,12,14,2378,8,2016,9,-1
Group 5,RRG,-0.5,12,14,2379,9,2016,2,7
Group 5,RRG,-0.5,12,14,2380,11,2016,11,0
Group 5,RRG,-0.5,12,14,2381,11,2016,7,4
Group 5,RRG,-0.5,12,14,2382,10,2016,9,1
Group 5,RRG,-0.5,12,14,2383,13,2016,8,5
Group 5,RRG,-0.5,12,14,2384,10,2016,11,-1
Group 5,RRG,-0.5,12,14,2385,13,2016,7,6
Group 5,RRG,-0.5,12,14,2386,11,2016,5,6
Group 5,RRG,-0.5,12,14,2387,12,2016,12,0
Group 5,RRG,-0.5,12,14,2388,13,2016,10,3
Group 5,RRG,-0.5,12,14,2389,7,2016,13,-6
Group 5,RRG,-0.5,12,14,2390,11,2016,12,-1
Group 5,RRG,-0.5,12,14,2391,12,2016,10,2
Group 5,RRG,-0.5,12,14,2392,13,2016,8,5
Group 5,RRG,-0.5,12,14,2393,7,2016,10,-3
Group 5,RRG,-0.5,12,14,2394,11,2016,8,3
Group 5,RRG,-0.5,12,14,2395,11,2016,6,5
Group 5,RRG,-0.5,12,14,2396,11,2016,8,3
Group 5,RRG,-0.5,12,14,2397,8,2016,7,1
Group 5,RRG,-0.5,12,14,2398,10,2016,7,3
Group 5,RRG,-0.5,12,14,2399,12,2016,7,5
Group 5,RRG,-0.5,12,14,2400,13,2016,9,4
Group 5,RRG,-0.5,12,14,2401,12,2016,7,5
Group 5,RRG,-0.5,12,14,2402,11,2016,6,5
Group 5,RRG,-0.5,12,14,2403,11,2016,7,4
Group 5,RRG,-0.5,12,14,2404,11,2016,7,4
Group 5,RRG,-0.5,12,14,2405,10,2016,14,-4
Group 5,RRG,-0.5,12,14,2406,14,2016,7,7
Group 5,RRG,-0.5,12,14,2407,12,2016,9,3
Group 5,RRG,-0.5,12,14,2408,8,2016,6,2
Group 5,RRG,-0.5,12,14,2409,11,2016,9,2
Group 5,RRG,-0.5,12,14,2410,13,2016,13,0
Group 5,RRG,-0.5,12,14,2411,7,2016,12,-5
Group 5,RRG,-0.5,12,14,2412,12,2016,3,9
Group 5,RRG,-0.5,12,14,2413,12,2016,7,5
Group 5,RRG,-0.5,12,14,2414,9,2016,14,-5
Group 5,RRG,-0.5,12,14,2415,10,2016,8,2
Group 5,RRG,-0.5,12,14,2416,9,2016,8,1
Group 5,RRG,-0.5,12,14,2417,10,2016,13,-3
Group 5,RRG,-0.5,12,14,2418,9,2016,11,-2
Group 5,RRG,-0.5,12,14,2419,8,2016,10,-2
Group 5,RRG,-0.5,12,14,2420,8,2016,6,2
Group 5,RRG,-0.5,12,14,2421,10,2016,7,3
Group 5,RRG,-0.5,12,14,2422,12,2016,9,3
Group 5,RRG,-0.5,12,14,2423,11,2016,11,0
Group 5,RRG,-0.5,12,14,2424,7,2016,7,0
Group 5,RRG,-0.5,12,14,2425,10,2016,9,1
Group 5,RRG,-0.5,12,14,2426,10,2016,7,3
Group 5,RRG,-0.5,12,14,2427,12,2016,3,9
Group 5,RRG,-0.5,12,14,2428,9,2016,8,1
Group 5,RRG,-0.5,12,14,2429,12,2016,10,2
Group 5,RRG,-0.5,12,14,2430,10,2016,8,2
Group 5,RRG,-0.5,12,14,2431,11,2016,7,4
Group 5,RRG,-0.5,12,14,2432,13,2016,7,6
Group 5,RRG,-0.5,12,14,2433,11,2016,9,2
Group 5,RRG,-0.5,12,14,2434,11,2016,10,1
Group 5,RRG,-0.5,12,14,2435,11,2016,7,4
Group 5,RRG,-0.5,12,14,2436,12,2016,12,0
Group 5,RRG,-0.5,12,14,2437,11,2016,10,1
Group 5,RRG,-0.5,12,14,2438,12,2016,10,2
Group 5,RRG,-0.5,12,14,2439,13,2016,10,3
Group 5,RRG,-0.5,12,14,2440,11,2016,7,4
Group 5,RRG,-0.5,12,14,2441,9,2016,7,2
Group 5,RRG,-0.5,12,14,2442,7,2016,6,1
Group 5,RRG,-0.5,12,14,2443,10,2016,10,0
Group 5,RRG,-0.5,12,14,2444,12,2016,8,4
Group 5,RRG,-0.5,12,14,2445,12,2016,10,2
Group 5,RRG,-0.5,12,14,2446,10,2016,9,1
Group 5,RRG,-0.5,12,14,2447,11,2016,7,4
Group 5,RRG,-0.5,12,14,2448,9,2016,7,2
Group 5,RRG,-0.5,12,14,2449,10,2016,5,5
Group 5,RRG,-0.5,12,14,2450,11,2016,7,4
Group 5,RRG,-0.5,12,14,2451,12,2016,7,5
Group 5,RRG,-0.5,12,14,2452,4,2016,8,-4
Group 5,RRG,-0.5,12,14,2453,10,2016,10,0
Group 5,RRG,-0.5,12,14,2454,8,2016,9,-1
Group 5,RRG,-0.5,12,14,2455,9,2016,3,6
Group 5,RRG,-0.5,12,14,2456,6,2016,6,0
Group 5,RRG,-0.5,12,14,2457,11,2016,7,4
Group 5,RRG,-0.5,12,14,2458,12,2016,9,3
Group 5,RRG,-0.5,12,14,2459,10,2016,11,-1
Group 5,RRG,-0.5,12,14,2460,9,2016,9,0
Group 5,RRG,-0.5,12,14,2461,9,2016,8,1
Group 5,RRG,-0.5,12,14,2462,11,2016,7,4
Group 5,RRG,-0.5,12,14,2463,10,2016,8,2
Group 5,RRG,-0.5,12,14,2464,13,2016,9,4
Group 5,RRG,-0.5,12,14,2465,12,2016,8,4
Group 5,RRG,-0.5,12,14,2466,11,2016,10,1
Group 5,RRG,-0.5,12,14,2467,10,2016,9,1
Group 5,RRG,-0.5,12,14,2468,10,2016,9,1
Group 5,RRG,-0.5,12,14,2469,11,2016,12,-1
Group 5,RRG,-0.5,12,14,2470,12,2016,10,2
Group 5,RRG,-0.5,12,14,2471,12,2016,7,5
Group 5,RRG,-0.5,12,14,2472,9,2016,9,0
Group 5,RRG,-0.5,12,14,2473,6,2016,5,1
Group 5,RRG,-0.5,12,14,2474,10,2016,11,-1
Group 5,RRG,-0.5,12,14,2475,8,2016,8,0
Group 5,RRG,-0.5,12,14,2476,7,2016,12,-5
Group 5,RRG,-0.5,12,14,2477,12,2016,8,4
Group 5,RRG,-0.5,12,14,2478,12,2016,9,3
Group 5,RRG,-0.5,12,14,2479,14,2016,11,3
Group 5,RRG,-0.5,12,14,2480,11,2016,8,3
Group 5,RRG,-0.5,12,14,2481,8,2016,9,-1
Group 5,RRG,-0.5,12,14,2482,14,2016,14,0
Group 5,RRG,-0.5,12,14,2483,11,2016,13,-2
Group 5,RRG,-0.5,12,14,2484,10,2016,7,3
Group 5,RRG,-0.5,12,14,2485,9,2016,9,0
Group 5,RRG,-0.5,12,14,2486,8,2016,11,-3
Group 5,RRG,-0.5,12,14,2487,10,2016,3,7
Group 5,RRG,-0.5,12,14,2488,13,2016,10,3
Group 5,RRG,-0.5,12,14,2489,10,2016,10,0
Group 5,RRG,-0.5,12,14,2490,8,2016,9,-1
Group 5,RRG,-0.5,12,14,2491,11,2016,12,-1
Group 5,RRG,-0.5,12,14,2492,8,2016,3,5
Group 5,RRG,-0.5,12,14,2493,7,2016,8,-1
Group 5,RRG,-0.5,12,14,2494,9,2016,9,0
Group 5,RRG,-0.5,12,14,2495,9,2016,7,2
Group 5,RRG,-0.5,12,14,2496,10,2016,10,0
Group 5,RRG,-0.5,12,14,2497,12,2016,11,1
Group 5,RRG,-0.5,12,14,2498,10,2016,6,4
Group 5,RRG,-0.5,12,14,2499,12,2016,6,6
Group 5,RRG,-0.5,12,14,2500,10,2016,10,0
Group 5,RRG,-0.5,12,14,2501,6,2016,8,-2
Group 5,RRG,-0.5,12,14,2502,8,2016,6,2
Group 5,RRG,-0.5,12,14,2503,10,2016,9,1
Group 5,RRG,-0.5,12,14,2504,11,2016,7,4
Group 5,RRG,-0.5,12,14,2505,12,2016,6,6
Group 5,RRG,-0.5,12,14,2506,11,2016,4,7
Group 5,RRG,-0.5,12,14,2507,13,2016,11,2
Group 5,RRG,-0.5,12,14,2508,7,2016,9,-2
Group 5,RRG,-0.5,12,14,2509,11,2016,8,3
Group 5,RRG,-0.5,12,14,2510,8,2016,9,-1
Group 5,RRG,-0.5,12,14,2511,11,2016,11,0
Group 5,RRG,-0.5,12,14,2512,6,2016,11,-5
Group 5,RRG,-0.5,12,14,2513,11,2016,12,-1
Group 5,RRG,-0.5,12,14,2514,10,2016,5,5
Group 5,RRG,-0.5,12,14,2515,14,2016,11,3
Group 5,RRG,-0.5,12,14,2516,9,2016,9,0
Group 5,RRG,-0.5,12,14,2517,13,2016,11,2
Group 5,RRG,-0.5,12,14,2518,10,2016,6,4
Group 5,RRG,-0.5,12,14,2519,12,2016,10,2
Group 5,RRG,-0.5,12,14,2520,13,2016,10,3
Group 5,RRG,-0.5,12,14,2521,10,2016,7,3
Group 5,RRG,-0.5,12,14,2522,11,2016,7,4
Group 5,RRG,-0.5,12,14,2523,12,2016,9,3
Group 5,RRG,-0.5,12,14,2524,13,2016,6,7
Group 5,RRG,-0.5,12,14,2525,12,2016,10,2
Group 5,RRG,-0.5,12,14,2526,10,2016,6,4
Group 5,RRG,-0.5,12,14,2527,11,2016,9,2
Group 5,RRG,-0.5,12,14,2528,11,2016,10,1
Group 5,RRG,-0.5,12,14,2529,14,2016,10,4
Group 5,RRG,-0.5,12,14,2530,10,2016,7,3
Group 5,RRG,-0.5,12,14,2531,13,2016,8,5
Group 5,RRG,-0.5,12,14,2532,13,2016,10,3
Group 5,RRG,-0.5,12,14,2533,12,2016,10,2
Group 5,RRG,-0.5,12,14,2534,12,2016,10,2
Group 5,RRG,-0.5,12,14,2535,12,2016,12,0
Group 5,RRG,-0.5,12,14,2536,12,2016,9,3
Group 5,RRG,-0.5,12,14,2537,10,2016,10,0
Group 5,RRG,-0.5,12,14,2538,7,2016,2,5
Group 5,RRG,-0.5,12,14,2539,9,2016,12,-3
Group 5,RRG,-0.5,12,14,2540,11,2016,5,6
Group 5,RRG,-0.5,12,14,2541,13,2016,9,4
Group 5,RRG,-0.5,12,14,2542,11,2016,7,4
Group 5,RRG,-0.5,12,14,2543,10,2016,9,1
Group 5,RRG,-0.5,12,14,2544,9,2016,12,-3
Group 5,RRG,-0.5,12,14,2545,7,2016,11,-4
Group 5,RRG,-0.5,12,14,2546,6,2016,10,-4
Group 5,RRG,-0.5,12,14,2547,12,2016,7,5
Group 5,RRG,-0.5,12,14,2548,7,2016,3,4
Group 5,RRG,-0.5,12,14,2549,9,2016,12,-3
Group 5,RRG,-0.5,12,14,2550,9,2016,8,1
Group 5,RRG,-0.5,12,14,2551,10,2016,6,4
Group 5,RRG,-0.5,12,14,2552,11,2016,9,2
Group 5,RRG,-0.5,12,14,2553,9,2016,5,4
Group 5,RRG,-0.5,12,14,2554,11,2016,6,5
Group 5,RRG,-0.5,12,14,2555,12,2016,6,6
Group 5,RRG,-0.5,12,14,2556,8,2016,9,-1
Group 5,RRG,-0.5,12,14,2557,9,2016,6,3
Group 5,RRG,-0.5,12,14,2558,14,2016,7,7
Group 5,RRG,-0.5,12,14,2559,10,2016,9,1
Group 5,RRG,-0.5,12,14,2560,11,2016,3,8
Group 5,RRG,-0.5,12,14,2561,12,2016,7,5
Group 5,RRG,-0.5,12,14,2562,13,2016,6,7
Group 5,RRG,-0.5,12,14,2563,10,2016,7,3
Group 5,RRG,-0.5,12,14,2564,9,2016,10,-1
Group 5,RRG,-0.5,12,14,2565,9,2016,10,-1
Group 5,RRG,-0.5,12,14,2566,9,2016,9,0
Group 5,RRG,-0.5,12,14,2567,12,2016,10,2
Group 5,RRG,-0.5,12,14,2568,8,2016,9,-1
Group 5,RRG,-0.5,12,14,2569,8,2016,8,0
Group 5,RRG,-0.5,12,14,2570,10,2016,10,0
Group 5,RRG,-0.5,12,14,2571,13,2016,13,0
Group 5,RRG,-0.5,12,14,2572,12,2016,9,3
Group 5,RRG,-0.5,12,14,2573,11,2016,8,3
Group 5,RRG,-0.5,12,14,2574,10,2016,8,2
Group 5,RRG,-0.5,12,14,2575,9,2016,11,-2
Group 5,RRG,-0.5,12,14,2576,9,2016,6,3
Group 5,RRG,-0.5,12,14,2577,10,2016,10,0
Group 5,RRG,-0.5,12,14,2578,12,2016,12,0
Group 5,RRG,-0.5,12,14,2579,13,2016,11,2
Group 5,RRG,-0.5,12,14,2580,11,2016,6,5
Group 5,RRG,-0.5,12,14,2581,12,2016,6,6
Group 5,RRG,-0.5,12,14,2582,6,2016,7,-1
Group 5,RRG,-0.5,12,14,2583,11,2016,5,6
Group 5,RRG,-0.5,12,14,2584,8,2016,10,-2
Group 5,RRG,-0.5,12,14,2585,8,2016,7,1
Group 5,RRG,-0.5,12,14,2586,10,2016,6,4
Group 5,RRG,-0.5,12,14,2587,12,2016,6,6
Group 5,RRG,-0.5,12,14,2588,7,2016,8,-1
Group 5,RRG,-0.5,12,14,2589,9,2016,5,4
Group 5,RRG,-0.5,12,14,2590,7,2016,11,-4
Group 5,RRG,-0.5,12,14,2591,9,2016,5,4
Group 5,RRG,-0.5,12,14,2592,8,2016,8,0
Group 5,RRG,-0.5,12,14,2593,8,2016,11,-3
Group 5,RRG,-0.5,12,14,2594,9,2016,6,3
Group 5,RRG,-0.5,12,14,2595,10,2016,11,-1
Group 5,RRG,-0.5,12,14,2596,9,2016,11,-2
Group 5,RRG,-0.5,12,14,2597,8,2016,12,-4
Group 5,RRG,-0.5,12,14,2598,10,2016,5,5
Group 5,RRG,-0.5,12,14,2599,9,2016,6,3
Group 5,RRG,-0.5,12,14,2600,14,2016,8,6
Group 5,RRG,-0.5,12,14,2601,10,2016,12,-2
Group 5,RRG,-0.5,12,14,2602,14,2016,4,10
Group 5,RRG,-0.5,12,14,2603,10,2016,10,0
Group 5,RRG,-0.5,12,14,2604,10,2016,6,4
Group 5,RRG,-0.5,12,14,2605,10,2016,8,2
Group 5,RRG,-0.5,12,14,2606,10,2016,6,4
Group 5,RRG,-0.5,12,14,2607,11,2016,11,0
Group 5,RRG,-0.5,12,14,2608,9,2016,10,-1
Group 5,RRG,-0.5,12,14,2609,12,2016,9,3
Group 5,RRG,-0.5,12,14,2610,11,2016,5,6
Group 5,RRG,-0.5,12,14,2611,12,2016,11,1
Group 5,RRG,-0.5,12,14,2612,10,2016,4,6
Group 5,RRG,-0.5,12,14,2613,10,2016,12,-2
Group 5,RRG,-0.5,12,14,2614,11,2016,10,1
Group 5,RRG,-0.5,12,14,2615,13,2016,7,6
Group 5,RRG,-0.5,12,14,2616,12,2016,8,4
Group 5,RRG,-0.5,12,14,2617,13,2016,8,5
Group 5,RRG,-0.5,12,14,2618,6,2016,8,-2
Group 5,RRG,-0.5,12,14,2619,11,2016,5,6
Group 5,RRG,-0.5,12,14,2620,10,2016,6,4
Group 5,RRG,-0.5,12,14,2621,9,2016,5,4
Group 5,RRG,-0.5,12,14,2622,10,2016,12,-2
Group 5,RRG,-0.5,12,14,2623,9,2016,9,0
Group 5,RRG,-0.5,12,14,2624,11,2016,7,4
Group 5,RRG,-0.5,12,14,2625,13,2016,10,3
Group 5,RRG,-0.5,12,14,2626,11,2016,10,1
Group 5,RRG,-0.5,12,14,2627,9,2016,9,0
Group 5,RRG,-0.5,12,14,2628,7,2016,8,-1
Group 5,RRG,-0.5,12,14,2629,11,2016,8,3
Group 5,RRG,-0.5,12,14,2630,6,2016,11,-5
Group 5,RRG,-0.5,12,14,2631,11,2016,9,2
Group 5,RRG,-0.5,12,14,2632,11,2016,4,7
Group 5,RRG,-0.5,12,14,2633,12,2016,11,1
Group 5,RRG,-0.5,12,14,2634,12,2016,4,8
Group 5,RRG,-0.5,12,14,2635,10,2016,5,5
Group 5,RRG,-0.5,12,14,2636,10,2016,6,4
Group 5,RRG,-0.5,12,14,2637,10,2016,7,3
Group 5,RRG,-0.5,12,14,2638,12,2016,5,7
Group 5,RRG,-0.5,12,14,2639,12,2016,5,7
Group 5,RRG,-0.5,12,14,2640,11,2016,7,4
Group 5,RRG,-0.5,12,14,2641,10,2016,9,1
Group 5,RRG,-0.5,12,14,2642,11,2016,9,2
Group 5,RRG,-0.5,12,14,2643,12,2016,12,0
Group 5,RRG,-0.5,12,14,2644,12,2016,9,3
Group 5,RRG,-0.5,12,14,2645,10,2016,9,1
Group 5,RRG,-0.5,12,14,2646,12,2016,7,5
Group 5,RRG,-0.5,12,14,2647,11,2016,10,1
Group 5,RRG,-0.5,12,14,2648,7,2016,8,-1
Group 5,RRG,-0.5,12,14,2649,10,2016,9,1
Group 5,RRG,-0.5,12,14,2650,11,2016,8,3
Group 5,RRG,-0.5,12,14,2651,13,2016,2,11
Group 5,RRG,-0.5,12,14,2652,10,2016,11,-1
Group 5,RRG,-0.5,12,14,2653,12,2016,9,3
Group 5,RRG,-0.5,12,14,2654,13,2016,11,2
Group 5,RRG,-0.5,12,14,2655,12,2016,11,1
Group 5,RRG,-0.5,12,14,2656,10,2016,9,1
Group 5,RRG,-0.5,12,14,2657,11,2016,9,2
Group 5,RRG,-0.5,12,14,2658,13,2016,5,8
Group 5,RRG,-0.5,12,14,2659,14,2016,8,6
Group 5,RRG,-0.5,12,14,2660,11,2016,6,5
Group 5,RRG,-0.5,12,14,2661,8,2016,9,-1
Group 5,RRG,-0.5,12,14,2662,8,2016,4,4
Group 5,RRG,-0.5,12,14,2663,11,2016,8,3
Group 5,RRG,-0.5,12,14,2664,11,2016,11,0
Group 5,RRG,-0.5,12,14,2665,11,2016,6,5
Group 5,RRG,-0.5,12,14,2666,14,2016,10,4
Group 5,RRG,-0.5,12,14,2667,12,2016,9,3
Group 5,RRG,-0.5,12,14,2668,11,2016,5,6
Group 5,RRG,-0.5,12,14,2669,12,2016,5,7
Group 5,RRG,-0.5,12,14,2670,8,2016,6,2
Group 5,RRG,-0.5,12,14,2671,10,2016,10,0
Group 5,RRG,-0.5,12,14,2672,13,2016,10,3
Group 5,RRG,-0.5,12,14,2673,12,2016,8,4
Group 5,RRG,-0.5,12,14,2674,9,2016,6,3
Group 5,RRG,-0.5,12,14,2675,10,2016,10,0
Group 5,RRG,-0.5,12,14,2676,12,2016,10,2
Group 5,RRG,-0.5,12,14,2677,10,2016,9,1
Group 5,RRG,-0.5,12,14,2678,9,2016,11,-2
Group 5,RRG,-0.5,12,14,2679,12,2016,10,2
Group 5,RRG,-0.5,12,14,2680,11,2016,10,1
Group 5,RRG,-0.5,12,14,2681,13,2016,10,3
Group 5,RRG,-0.5,12,14,2682,10,2016,7,3
Group 5,RRG,-0.5,12,14,2683,12,2016,14,-2
Group 5,RRG,-0.5,12,14,2684,12,2016,11,1
Group 5,RRG,-0.5,12,14,2685,9,2016,8,1
Group 5,RRG,-0.5,12,14,2686,12,2016,6,6
Group 5,RRG,-0.5,12,14,2687,12,2016,8,4
Group 5,RRG,-0.5,12,14,2688,12,2016,7,5
Group 5,RRG,-0.5,12,14,2689,10,2016,4,6
Group 5,RRG,-0.5,12,14,2690,10,2016,8,2
Group 5,RRG,-0.5,12,14,2691,11,2016,11,0
Group 5,RRG,-0.5,12,14,2692,12,2016,10,2
Group 5,RRG,-0.5,12,14,2693,13,2016,8,5
Group 5,RRG,-0.5,12,14,2694,12,2016,11,1
Group 5,RRG,-0.5,12,14,2695,12,2016,9,3
Group 5,RRG,-0.5,12,14,2696,11,2016,8,3
Group 5,RRG,-0.5,12,14,2697,10,2016,5,5
Group 5,RRG,-0.5,12,14,2698,11,2016,7,4
Group 5,RRG,-0.5,12,14,2699,14,2016,8,6
Group 5,RRG,-0.5,12,14,2700,11,2016,6,5
Group 5,RRG,-0.5,12,14,2701,9,2016,12,-3
Group 5,RRG,-0.5,12,14,2702,10,2016,6,4
Group 5,RRG,-0.5,12,14,2703,10,2016,10,0
Group 5,RRG,-0.5,12,14,2704,13,2016,6,7
Group 5,RRG,-0.5,12,14,2705,11,2016,14,-3
Group 5,RRG,-0.5,12,14,2706,10,2016,8,2
Group 5,RRG,-0.5,12,14,2707,9,2016,9,0
Group 5,RRG,-0.5,12,14,2708,11,2016,9,2
Group 5,RRG,-0.5,12,14,2709,11,2016,11,0
Group 5,RRG,-0.5,12,14,2710,12,2016,5,7
Group 5,RRG,-0.5,12,14,2711,12,2016,9,3
Group 5,RRG,-0.5,12,14,2712,9,2016,6,3
Group 5,RRG,-0.5,12,14,2713,12,2016,6,6
Group 5,RRG,-0.5,12,14,2714,13,2016,7,6
Group 5,RRG,-0.5,12,14,2715,10,2016,12,-2
Group 5,RRG,-0.5,12,14,2716,10,2016,3,7
Group 5,RRG,-0.5,12,14,2717,7,2016,6,1
Group 5,RRG,-0.5,12,14,2718,13,2016,9,4
Group 5,RRG,-0.5,12,14,2719,11,2016,7,4
Group 5,RRG,-0.5,12,14,2720,11,2016,7,4
Group 5,RRG,-0.5,12,14,2721,13,2016,9,4
Group 5,RRG,-0.5,12,14,2722,11,2016,8,3
Group 5,RRG,-0.5,12,14,2723,12,2016,11,1
Group 5,RRG,-0.5,12,14,2724,13,2016,11,2
Group 5,RRG,-0.5,12,14,2725,13,2016,6,7
Group 5,RRG,-0.5,12,14,2726,10,2016,5,5
Group 5,RRG,-0.5,12,14,2727,12,2016,5,7
Group 5,RRG,-0.5,12,14,2728,13,2016,5,8
Group 5,RRG,-0.5,12,14,2729,13,2016,10,3
Group 5,RRG,-0.5,12,14,2730,13,2016,7,6
Group 5,RRG,-0.5,12,14,2731,14,2016,11,3
Group 5,RRG,-0.5,12,14,2732,9,2016,7,2
Group 5,RRG,-0.5,12,14,2733,10,2016,9,1
Group 5,RRG,-0.5,12,14,2734,7,2016,6,1
Group 5,RRG,-0.5,12,14,2735,9,2016,10,-1
Group 5,RRG,-0.5,12,14,2736,11,2016,8,3
Group 5,RRG,-0.5,12,14,2737,13,2016,9,4
Group 5,RRG,-0.5,12,14,2738,13,2016,9,4
Group 5,RRG,-0.5,12,14,2739,12,2016,9,3
Group 5,RRG,-0.5,12,14,2740,13,2016,10,3
Group 5,RRG,-0.5,12,14,2741,5,2016,11,-6
Group 5,RRG,-0.5,12,14,2742,8,2016,9,-1
Group 5,RRG,-0.5,12,14,2743,9,2016,4,5
Group 5,RRG,-0.5,12,14,2744,10,2016,11,-1
Group 5,RRG,-0.5,12,14,2745,7,2016,6,1
Group 5,RRG,-0.5,12,14,2746,12,2016,10,2
Group 5,RRG,-0.5,12,14,2747,10,2016,12,-2
Group 5,RRG,-0.5,12,14,2748,13,2016,11,2
Group 5,RRG,-0.5,12,14,2749,11,2016,10,1
Group 5,RRG,-0.5,12,14,2750,13,2016,5,8
Group 5,RRG,-0.5,12,14,2751,11,2016,8,3
Group 5,RRG,-0.5,12,14,2752,8,2016,11,-3
Group 5,RRG,-0.5,12,14,2753,12,2016,8,4
Group 5,RRG,-0.5,12,14,2754,6,2016,10,-4
Group 5,RRG,-0.5,12,14,2755,9,2016,9,0
Group 5,RRG,-0.5,12,14,2756,5,2016,6,-1
Group 5,RRG,-0.5,12,14,2757,11,2016,7,4
Group 5,RRG,-0.5,12,14,2758,7,2016,6,1
Group 5,RRG,-0.5,12,14,2759,12,2016,9,3
Group 5,RRG,-0.5,12,14,2760,11,2016,9,2
Group 5,RRG,-0.5,12,14,2761,13,2016,7,6
Group 5,RRG,-0.5,12,14,2762,11,2016,10,1
Group 5,RRG,-0.5,12,14,2763,11,2016,8,3
Group 5,RRG,-0.5,12,14,2764,9,2016,7,2
Group 5,RRG,-0.5,12,14,2765,10,2016,9,1
Group 5,RRG,-0.5,12,14,2766,11,2016,8,3
Group 5,RRG,-0.5,12,14,2767,11,2016,10,1
Group 5,RRG,-0.5,12,14,2768,9,2016,10,-1
Group 5,RRG,-0.5,12,14,2769,13,2016,12,1
Group 5,RRG,-0.5,12,14,2770,11,2016,6,5
Group 5,RRG,-0.5,12,14,2771,13,2016,8,5
Group 5,RRG,-0.5,12,14,2772,13,2016,7,6
Group 5,RRG,-0.5,12,14,2773,10,2016,9,1
Group 5,RRG,-0.5,12,14,2774,8,2016,12,-4
Group 5,RRG,-0.5,12,14,2775,10,2016,12,-2
Group 5,RRG,-0.5,12,14,2776,13,2016,10,3
Group 5,RRG,-0.5,12,14,2777,12,2016,10,2
Group 5,RRG,-0.5,12,14,2778,12,2016,9,3
Group 5,RRG,-0.5,12,14,2779,9,2016,9,0
Group 5,RRG,-0.5,12,14,2780,10,2016,7,3
Group 5,RRG,-0.5,12,14,2781,12,2016,4,8
Group 5,RRG,-0.5,12,14,2782,7,2016,7,0
Group 5,RRG,-0.5,12,14,2783,7,2016,9,-2
Group 5,RRG,-0.5,12,14,2784,12,2016,7,5
Group 5,RRG,-0.5,12,14,2785,10,2016,6,4
Group 5,RRG,-0.5,12,14,2786,9,2016,8,1
Group 5,RRG,-0.5,12,14,2787,9,2016,5,4
Group 5,RRG,-0.5,12,14,2788,12,2016,11,1
Group 5,RRG,-0.5,12,14,2789,14,2016,11,3
Group 5,RRG,-0.5,12,14,2790,9,2016,13,-4
Group 5,RRG,-0.5,12,14,2791,12,2016,5,7
Group 5,RRG,-0.5,12,14,2792,14,2016,10,4
Group 5,RRG,-0.5,12,14,2793,12,2016,9,3
Group 5,RRG,-0.5,12,14,2794,11,2016,8,3
Group 5,RRG,-0.5,12,14,2795,9,2016,3,6
Group 5,RRG,-0.5,12,14,2796,7,2016,9,-2
Group 5,RRG,-0.5,12,14,2797,9,2016,4,5
Group 5,RRG,-0.5,12,14,2798,10,2016,6,4
Group 5,RRG,-0.5,12,14,2799,12,2016,8,4
Group 5,RRG,-0.5,12,14,2800,11,2016,5,6
Group 5,RRG,-0.5,12,14,2801,12,2016,10,2
Group 5,RRG,-0.5,12,14,2802,13,2016,8,5
Group 5,RRG,-0.5,12,14,2803,13,2016,10,3
Group 5,RRG,-0.5,12,14,2804,13,2016,9,4
Group 5,RRG,-0.5,12,14,2805,10,2016,6,4
Group 5,RRG,-0.5,12,14,2806,10,2016,10,0
Group 5,RRG,-0.5,12,14,2807,12,2016,11,1
Group 5,RRG,-0.5,12,14,2808,12,2016,10,2
Group 5,RRG,-0.5,12,14,2809,12,2016,7,5
Group 5,RRG,-0.5,12,14,2810,11,2016,6,5
Group 5,RRG,-0.5,12,14,2811,9,2016,10,-1
Group 5,RRG,-0.5,12,14,2812,12,2016,7,5
Group 5,RRG,-0.5,12,14,2813,8,2016,9,-1
Group 5,RRG,-0.5,12,14,2814,12,2016,7,5
Group 5,RRG,-0.5,12,14,2815,9,2016,6,3
Group 5,RRG,-0.5,12,14,2816,11,2016,3,8
Group 5,RRG,-0.5,12,14,2817,12,2016,5,7
Group 5,RRG,-0.5,12,14,2818,13,2016,7,6
Group 5,RRG,-0.5,12,14,2819,10,2016,9,1
Group 5,RRG,-0.5,12,14,2820,13,2016,10,3
Group 5,RRG,-0.5,12,14,2821,11,2016,6,5
Group 5,RRG,-0.5,12,14,2822,10,2016,7,3
Group 5,RRG,-0.5,12,14,2823,10,2016,8,2
Group 5,RRG,-0.5,12,14,2824,10,2016,7,3
Group 5,RRG,-0.5,12,14,2825,9,2016,8,1
Group 5,RRG,-0.5,12,14,2826,12,2016,9,3
Group 5,RRG,-0.5,12,14,2827,9,2016,9,0
Group 5,RRG,-0.5,12,14,2828,14,2016,12,2
Group 5,RRG,-0.5,12,14,2829,10,2016,7,3
Group 5,RRG,-0.5,12,14,2830,11,2016,9,2
Group 5,RRG,-0.5,12,14,2831,11,2016,5,6
Group 5,RRG,-0.5,12,14,2832,8,2016,7,1
Group 5,RRG,-0.5,12,14,2833,11,2016,7,4
Group 5,RRG,-0.5,12,14,2834,10,2016,10,0
Group 5,RRG,-0.5,12,14,2835,13,2016,7,6
Group 5,RRG,-0.5,12,14,2836,10,2016,10,0
Group 5,RRG,-0.5,12,14,2837,12,2016,9,3
Group 5,RRG,-0.5,12,14,2838,10,2016,11,-1
Group 5,RRG,-0.5,12,14,2839,8,2016,10,-2
Group 5,RRG,-0.5,12,14,2840,10,2016,6,4
Group 5,RRG,-0.5,12,14,2841,11,2016,8,3
Group 5,RRG,-0.5,12,14,2842,12,2016,8,4
Group 5,RRG,-0.5,12,14,2843,12,2016,13,-1
Group 5,RRG,-0.5,12,14,2844,9,2016,11,-2
Group 5,RRG,-0.5,12,14,2845,12,2016,11,1
Group 5,RRG,-0.5,12,14,2846,10,2016,12,-2
Group 5,RRG,-0.5,12,14,2847,9,2016,8,1
Group 5,RRG,-0.5,12,14,2848,12,2016,10,2
Group 5,RRG,-0.5,12,14,2849,9,2016,7,2
Group 5,RRG,-0.5,12,14,2850,9,2016,9,0
Group 5,RRG,-0.5,12,14,2851,10,2016,4,6
Group 5,RRG,-0.5,12,14,2852,11,2016,11,0
Group 5,RRG,-0.5,12,14,2853,10,2016,5,5
Group 5,RRG,-0.5,12,14,2854,9,2016,10,-1
Group 5,RRG,-0.5,12,14,2855,7,2016,11,-4
Group 5,RRG,-0.5,12,14,2856,10,2016,7,3
Group 5,RRG,-0.5,12,14,2857,5,2016,3,2
Group 5,RRG,-0.5,12,14,2858,11,2016,11,0
Group 5,RRG,-0.5,12,14,2859,7,2016,9,-2
Group 5,RRG,-0.5,12,14,2860,12,2016,6,6
Group 5,RRG,-0.5,12,14,2861,9,2016,4,5
Group 5,RRG,-0.5,12,14,2862,13,2016,7,6
Group 5,RRG,-0.5,12,14,2863,13,2016,6,7
Group 5,RRG,-0.5,12,14,2864,9,2016,7,2
Group 5,RRG,-0.5,12,14,2865,11,2016,12,-1
Group 5,RRG,-0.5,12,14,2866,11,2016,5,6
Group 5,RRG,-0.5,12,14,2867,11,2016,7,4
Group 5,RRG,-0.5,12,14,2868,12,2016,9,3
Group 5,RRG,-0.5,12,14,2869,9,2016,7,2
Group 5,RRG,-0.5,12,14,2870,11,2016,11,0
Group 5,RRG,-0.5,12,14,2871,10,2016,8,2
Group 5,RRG,-0.5,12,14,2872,7,2016,9,-2
Group 5,RRG,-0.5,12,14,2873,9,2016,6,3
Group 5,RRG,-0.5,12,14,2874,11,2016,7,4
Group 5,RRG,-0.5,12,14,2875,11,2016,8,3
Group 5,RRG,-0.5,12,14,2876,9,2016,10,-1
Group 5,RRG,-0.5,12,14,2877,12,2016,11,1
Group 5,RRG,-0.5,12,14,2878,6,2016,11,-5
Group 5,RRG,-0.5,12,14,2879,13,2016,13,0
Group 5,RRG,-0.5,12,14,2880,11,2016,9,2
Group 5,RRG,-0.5,12,14,2881,7,2016,8,-1
Group 5,RRG,-0.5,12,14,2882,10,2016,10,0
Group 5,RRG,-0.5,12,14,2883,12,2016,7,5
Group 5,RRG,-0.5,12,14,2884,7,2016,10,-3
Group 5,RRG,-0.5,12,14,2885,12,2016,5,7
Group 5,RRG,-0.5,12,14,2886,11,2016,11,0
Group 5,RRG,-0.5,12,14,2887,11,2016,9,2
Group 5,RRG,-0.5,12,14,2888,12,2016,11,1
Group 5,RRG,-0.5,12,14,2889,13,2016,5,8
Group 5,RRG,-0.5,12,14,2890,11,2016,10,1
Group 5,RRG,-0.5,12,14,2891,12,2016,6,6
Group 5,RRG,-0.5,12,14,2892,11,2016,7,4
Group 5,RRG,-0.5,12,14,2893,11,2016,6,5
Group 5,RRG,-0.5,12,14,2894,12,2016,6,6
Group 5,RRG,-0.5,12,14,2895,10,2016,8,2
Group 5,RRG,-0.5,12,14,2896,10,2016,8,2
Group 5,RRG,-0.5,12,14,2897,10,2016,10,0
Group 5,RRG,-0.5,12,14,2898,10,2016,6,4
Group 5,RRG,-0.5,12,14,2899,12,2016,6,6
Group 5,RRG,-0.5,12,14,2900,11,2016,12,-1
Group 5,RRG,-0.5,12,14,2901,6,2016,6,0
Group 5,RRG,-0.5,12,14,2902,13,2016,9,4
Group 5,RRG,-0.5,12,14,2903,10,2016,9,1
Group 5,RRG,-0.5,12,14,2904,12,2016,10,2
Group 5,RRG,-0.5,12,14,2905,8,2016,10,-2
Group 5,RRG,-0.5,12,14,2906,9,2016,10,-1
Group 5,RRG,-0.5,12,14,2907,8,2016,8,0
Group 5,RRG,-0.5,12,14,2908,8,2016,6,2
Group 5,RRG,-0.5,12,14,2909,11,2016,10,1
Group 5,RRG,-0.5,12,14,2910,11,2016,4,7
Group 5,RRG,-0.5,12,14,2911,10,2016,10,0
Group 5,RRG,-0.5,12,14,2912,13,2016,7,6
Group 5,RRG,-0.5,12,14,2913,11,2016,9,2
Group 5,RRG,-0.5,12,14,2914,10,2016,12,-2
Group 5,RRG,-0.5,12,14,2915,10,2016,8,2
Group 5,RRG,-0.5,12,14,2916,11,2016,9,2
Group 5,RRG,-0.5,12,14,2917,9,2016,8,1
Group 5,RRG,-0.5,12,14,2918,10,2016,9,1
Group 5,RRG,-0.5,12,14,2919,9,2016,13,-4
Group 5,RRG,-0.5,12,14,2920,8,2016,12,-4
Group 5,RRG,-0.5,12,14,2921,10,2016,9,1
Group 5,RRG,-0.5,12,14,2922,10,2016,8,2
Group 5,RRG,-0.5,12,14,2923,3,2016,11,-8
Group 5,RRG,-0.5,12,14,2924,10,2016,8,2
Group 5,RRG,-0.5,12,14,2925,10,2016,10,0
Group 5,RRG,-0.5,12,14,2926,10,2016,10,0
Group 5,RRG,-0.5,12,14,2927,11,2016,4,7
Group 5,RRG,-0.5,12,14,2928,8,2016,10,-2
Group 5,RRG,-0.5,12,14,2929,9,2016,6,3
Group 5,RRG,-0.5,12,14,2930,13,2016,8,5
Group 5,RRG,-0.5,12,14,2931,13,2016,7,6
Group 5,RRG,-0.5,12,14,2932,10,2016,7,3
Group 5,RRG,-0.5,12,14,2933,14,2016,9,5
Group 5,RRG,-0.5,12,14,2934,12,2016,7,5
Group 5,RRG,-0.5,12,14,2935,11,2016,10,1
Group 5,RRG,-0.5,12,14,2936,6,2016,10,-4
Group 5,RRG,-0.5,12,14,2937,9,2016,6,3
Group 5,RRG,-0.5,12,14,2938,12,2016,9,3
Group 5,RRG,-0.5,12,14,2939,13,2016,10,3
Group 5,RRG,-0.5,12,14,2940,7,2016,7,0
Group 5,RRG,-0.5,12,14,2941,9,2016,5,4
Group 5,RRG,-0.5,12,14,2942,5,2016,5,0
Group 5,RRG,-0.5,12,14,2943,9,2016,7,2
Group 5,RRG,-0.5,12,14,2944,8,2016,6,2
Group 5,RRG,-0.5,12,14,2945,9,2016,6,3
Group 5,RRG,-0.5,12,14,2946,10,2016,7,3
Group 5,RRG,-0.5,12,14,2947,12,2016,5,7
Group 5,RRG,-0.5,12,14,2948,12,2016,6,6
Group 5,RRG,-0.5,12,14,2949,6,2016,8,-2
Group 5,RRG,-0.5,12,14,2950,13,2016,4,9
Group 5,RRG,-0.5,12,14,2951,11,2016,11,0
Group 5,RRG,-0.5,12,14,2952,10,2016,5,5
Group 5,RRG,-0.5,12,14,2953,12,2016,9,3
Group 5,RRG,-0.5,12,14,2954,14,2016,7,7
Group 5,RRG,-0.5,12,14,2955,13,2016,10,3
Group 5,RRG,-0.5,12,14,2956,11,2016,13,-2
Group 5,RRG,-0.5,12,14,2957,13,2016,9,4
Group 5,RRG,-0.5,12,14,2958,8,2016,10,-2
Group 5,RRG,-0.5,12,14,2959,13,2016,8,5
Group 5,RRG,-0.5,12,14,2960,8,2016,3,5
Group 5,RRG,-0.5,12,14,2961,9,2016,6,3
Group 5,RRG,-0.5,12,14,2962,12,2016,10,2
Group 5,RRG,-0.5,12,14,2963,13,2016,9,4
Group 5,RRG,-0.5,12,14,2964,12,2016,9,3
Group 5,RRG,-0.5,12,14,2965,9,2016,7,2
Group 5,RRG,-0.5,12,14,2966,13,2016,5,8
Group 5,RRG,-0.5,12,14,2967,13,2016,7,6
Group 5,RRG,-0.5,12,14,2968,9,2016,6,3
Group 5,RRG,-0.5,12,14,2969,10,2016,11,-1
Group 5,RRG,-0.5,12,14,2970,11,2016,8,3
Group 5,RRG,-0.5,12,14,2971,8,2016,7,1
Group 5,RRG,-0.5,12,14,2972,10,2016,9,1
Group 5,RRG,-0.5,12,14,2973,9,2016,10,-1
Group 5,RRG,-0.5,12,14,2974,13,2016,9,4
Group 5,RRG,-0.5,12,14,2975,9,2016,8,1
Group 5,RRG,-0.5,12,14,2976,9,2016,8,1
Group 5,RRG,-0.5,12,14,2977,12,2016,10,2
Group 5,RRG,-0.5,12,14,2978,6,2016,8,-2
Group 5,RRG,-0.5,12,14,2979,11,2016,9,2
Group 5,RRG,-0.5,12,14,2980,11,2016,9,2
Group 5,RRG,-0.5,12,14,2981,8,2016,5,3
Group 5,RRG,-0.5,12,14,2982,14,2016,4,10
Group 5,RRG,-0.5,12,14,2983,8,2016,8,0
Group 5,RRG,-0.5,12,14,2984,11,2016,1,10
Group 5,RRG,-0.5,12,14,2985,10,2016,10,0
Group 5,RRG,-0.5,12,14,2986,9,2016,7,2
Group 5,RRG,-0.5,12,14,2987,12,2016,1,11
Group 5,RRG,-0.5,12,14,2988,10,2016,5,5
Group 5,RRG,-0.5,12,14,2989,8,2016,6,2
Group 5,RRG,-0.5,12,14,2990,10,2016,8,2
Group 5,RRG,-0.5,12,14,2991,11,2016,9,2
Group 5,RRG,-0.5,12,14,2992,11,2016,8,3
Group 5,RRG,-0.5,12,14,2993,10,2016,8,2
Group 5,RRG,-0.5,12,14,2994,8,2016,5,3
Group 5,RRG,-0.5,12,14,2995,13,2016,7,6
Group 5,RRG,-0.5,12,14,2996,14,2016,6,8
Group 5,RRG,-0.5,12,14,2997,8,2016,6,2
Group 5,RRG,-0.5,12,14,2998,12,2016,5,7
Group 5,RRG,-0.5,12,14,2999,11,2016,8,3
Group 5,RRG,-0.5,12,14,3000,9,2016,8,1
Group 5,RRG,-0.5,12,14,3001,8,2016,8,0
Group 5,RRG,-0.5,12,14,3002,8,2016,11,-3
Group 5,RRG,-0.5,12,14,3003,9,2016,6,3
Group 5,RRG,-0.5,12,14,3004,8,2016,10,-2
Group 5,RRG,-0.5,12,14,3005,10,2016,7,3
Group 5,RRG,-0.5,12,14,3006,11,2016,10,1
Group 5,RRG,-0.5,12,14,3007,10,2016,10,0
Group 5,RRG,-0.5,12,14,3008,12,2016,7,5
Group 5,RRG,-0.5,12,14,3009,12,2016,12,0
Group 5,RRG,-0.5,12,14,3010,12,2016,10,2
Group 5,RRG,-0.5,12,14,3011,7,2016,9,-2
Group 5,RRG,-0.5,12,14,3012,8,2016,8,0
Group 5,RRG,-0.5,12,14,3013,11,2016,10,1
Group 5,RRG,-0.5,12,14,3014,11,2016,7,4
Group 5,RRG,-0.5,12,14,3015,12,2016,10,2
Group 5,RRG,-0.5,12,14,3016,11,2016,11,0
Group 5,RRG,-0.5,12,14,3017,13,2016,8,5
Group 5,RRG,-0.5,12,14,3018,9,2016,9,0
Group 5,RRG,-0.5,12,14,3019,10,2016,9,1
Group 5,RRG,-0.5,12,14,3020,10,2016,9,1
Group 5,RRG,-0.5,12,14,3021,9,2016,9,0
Group 5,RRG,-0.5,12,14,3022,13,2016,10,3
Group 5,RRG,-0.5,12,14,3023,14,2016,7,7
Group 5,RRG,-0.5,12,14,3024,10,2016,11,-1
Group 5,RRG,-0.5,12,14,3025,11,2016,10,1
Group 5,RRG,-0.5,12,14,3026,8,2016,8,0
Group 5,RRG,-0.5,12,14,3027,11,2016,7,4
Group 5,RRG,-0.5,12,14,3028,10,2016,8,2
Group 5,RRG,-0.5,12,14,3029,9,2016,10,-1
Group 5,RRG,-0.5,12,14,3030,10,2016,8,2
Group 5,RRG,-0.5,12,14,3031,10,2016,8,2
Group 5,RRG,-0.5,12,14,3032,14,2016,7,7
Group 5,RRG,-0.5,12,14,3033,11,2016,10,1
Group 5,RRG,-0.5,12,14,3034,11,2016,9,2
Group 5,RRG,-0.5,12,14,3035,12,2016,9,3
Group 5,RRG,-0.5,12,14,3036,10,2016,6,4
Group 5,RRG,-0.5,12,14,3037,11,2016,7,4
Group 5,RRG,-0.5,12,14,3038,7,2016,7,0
Group 5,RRG,-0.5,12,14,3039,10,2016,11,-1
Group 5,RRG,-0.5,12,14,3040,10,2016,8,2
Group 5,RRG,-0.5,12,14,3041,11,2016,6,5
Group 5,RRG,-0.5,12,14,3042,13,2016,1,12
Group 5,RRG,-0.5,12,14,3043,12,2016,13,-1
Group 5,RRG,-0.5,12,14,3044,12,2016,10,2
Group 5,RRG,-0.5,12,14,3045,11,2016,2,9
Group 5,RRG,-0.5,12,14,3046,10,2016,9,1
Group 5,RRG,-0.5,12,14,3047,11,2016,6,5
Group 5,RRG,-0.5,12,14,3048,13,2016,7,6
Group 5,RRG,-0.5,12,14,3049,11,2016,8,3
Group 5,RRG,-0.5,12,14,3050,12,2016,11,1
Group 5,RRG,-0.5,12,14,3051,12,2016,6,6
Group 5,RRG,-0.5,12,14,3052,13,2016,10,3
Group 5,RRG,-0.5,12,14,3053,12,2016,11,1
Group 5,RRG,-0.5,12,14,3054,10,2016,11,-1
Group 5,RRG,-0.5,12,14,3055,13,2016,10,3
Group 5,RRG,-0.5,12,14,3056,8,2016,8,0
Group 5,RRG,-0.5,12,14,3057,8,2016,9,-1
Group 5,RRG,-0.5,12,14,3058,12,2016,8,4
Group 5,RRG,-0.5,12,14,3059,12,2016,11,1
Group 5,RRG,-0.5,12,14,3060,8,2016,11,-3
Group 5,RRG,-0.5,12,14,3061,9,2016,9,0
Group 5,RRG,-0.5,12,14,3062,10,2016,8,2
Group 5,RRG,-0.5,12,14,3063,8,2016,8,0
Group 5,RRG,-0.5,12,14,3064,11,2016,2,9
Group 5,RRG,-0.5,12,14,3065,10,2016,9,1
Group 5,RRG,-0.5,12,14,3066,11,2016,7,4
Group 5,RRG,-0.5,12,14,3067,8,2016,7,1
Group 5,RRG,-0.5,12,14,3068,9,2016,9,0
Group 5,RRG,-0.5,12,14,3069,9,2016,9,0
Group 5,RRG,-0.5,12,14,3070,10,2016,8,2
Group 5,RRG,-0.5,12,14,3071,11,2016,9,2
Group 5,RRG,-0.5,12,14,3072,9,2016,10,-1
Group 5,RRG,-0.5,12,14,3073,13,2016,7,6
Group 5,RRG,-0.5,12,14,3074,11,2016,9,2
Group 5,RRG,-0.5,12,14,3075,11,2016,10,1
Group 5,RRG,-0.5,12,14,3076,9,2016,4,5
Group 5,RRG,-0.5,12,14,3077,10,2016,4,6
Group 5,RRG,-0.5,12,14,3078,8,2016,5,3
Group 5,RRG,-0.5,12,14,3079,10,2016,12,-2
Group 5,RRG,-0.5,12,14,3080,13,2016,12,1
Group 5,RRG,-0.5,12,14,3081,13,2016,9,4
Group 5,RRG,-0.5,12,14,3082,13,2016,12,1
Group 5,RRG,-0.5,12,14,3083,13,2016,7,6
Group 5,RRG,-0.5,12,14,3084,8,2016,12,-4
Group 5,RRG,-0.5,12,14,3085,9,2016,8,1
Group 5,RRG,-0.5,12,14,3086,9,2016,10,-1
Group 5,RRG,-0.5,12,14,3087,11,2016,11,0
Group 5,RRG,-0.5,12,14,3088,7,2016,8,-1
Group 5,RRG,-0.5,12,14,3089,12,2016,7,5
Group 5,RRG,-0.5,12,14,3090,10,2016,5,5
Group 5,RRG,-0.5,12,14,3091,11,2016,9,2
Group 5,RRG,-0.5,12,14,3092,10,2016,10,0
Group 5,RRG,-0.5,12,14,3093,7,2016,9,-2
Group 5,RRG,-0.5,12,14,3094,11,2016,5,6
Group 5,RRG,-0.5,12,14,3095,8,2016,12,-4
Group 5,RRG,-0.5,12,14,3096,9,2016,12,-3
Group 5,RRG,-0.5,12,14,3097,12,2016,7,5
Group 5,RRG,-0.5,12,14,3098,14,2016,6,8
Group 5,RRG,-0.5,12,14,3099,8,2016,6,2
Group 5,RRG,-0.5,12,14,3100,12,2016,6,6
Group 5,RRG,-0.5,12,14,3101,12,2016,11,1
Group 5,RRG,-0.5,12,14,3102,9,2016,6,3
Group 5,RRG,-0.5,12,14,3103,11,2016,11,0
Group 5,RRG,-0.5,12,14,3104,11,2016,9,2
Group 5,RRG,-0.5,12,14,3105,11,2016,10,1
Group 5,RRG,-0.5,12,14,3106,12,2016,10,2
Group 5,RRG,-0.5,12,14,3107,7,2016,12,-5
Group 5,RRG,-0.5,12,14,3108,14,2016,12,2
Group 5,RRG,-0.5,12,14,3109,14,2016,10,4
Group 5,RRG,-0.5,12,14,3110,14,2016,9,5
Group 5,RRG,-0.5,12,14,3111,6,2016,6,0
Group 5,RRG,-0.5,12,14,3112,11,2016,9,2
Group 5,RRG,-0.5,12,14,3113,9,2016,6,3
Group 5,RRG,-0.5,12,14,3114,12,2016,9,3
Group 5,RRG,-0.5,12,14,3115,11,2016,6,5
Group 5,RRG,-0.5,12,14,3116,9,2016,6,3
Group 5,RRG,-0.5,12,14,3117,8,2016,9,-1
Group 5,RRG,-0.5,12,14,3118,9,2016,10,-1
Group 5,RRG,-0.5,12,14,3119,10,2016,9,1
Group 5,RRG,-0.5,12,14,3120,12,2016,7,5
Group 5,RRG,-0.5,12,14,3121,12,2016,8,4
Group 5,RRG,-0.5,12,14,3122,11,2016,5,6
Group 5,RRG,-0.5,12,14,3123,10,2016,11,-1
Group 5,RRG,-0.5,12,14,3124,11,2016,6,5
Group 5,RRG,-0.5,12,14,3125,8,2016,12,-4
Group 5,RRG,-0.5,12,14,3126,12,2016,9,3
Group 5,RRG,-0.5,12,14,3127,14,2016,6,8
Group 5,RRG,-0.5,12,14,3128,9,2016,6,3
Group 5,RRG,-0.5,12,14,3129,9,2016,9,0
Group 5,RRG,-0.5,12,14,3130,13,2016,1,12
Group 5,RRG,-0.5,12,14,3131,11,2016,10,1
Group 5,RRG,-0.5,12,14,3132,12,2016,9,3
Group 5,RRG,-0.5,12,14,3133,13,2016,6,7
Group 5,RRG,-0.5,12,14,3134,11,2016,8,3
Group 5,RRG,-0.5,12,14,3135,12,2016,5,7
Group 5,RRG,-0.5,12,14,3136,11,2016,4,7
Group 5,RRG,-0.5,12,14,3137,10,2016,5,5
Group 5,RRG,-0.5,12,14,3138,12,2016,6,6
Group 5,RRG,-0.5,12,14,3139,11,2016,9,2
Group 5,RRG,-0.5,12,14,3140,13,2016,6,7
Group 5,RRG,-0.5,12,14,3141,6,2016,4,2
Group 5,RRG,-0.5,12,14,3142,12,2016,7,5
Group 5,RRG,-0.5,12,14,3143,12,2016,9,3
Group 5,RRG,-0.5,12,14,3144,11,2016,11,0
Group 5,RRG,-0.5,12,14,3145,10,2016,10,0
Group 5,RRG,-0.5,12,14,3146,7,2016,8,-1
Group 5,RRG,-0.5,12,14,3147,10,2016,8,2
Group 5,RRG,-0.5,12,14,3148,6,2016,14,-8
Group 5,RRG,-0.5,12,14,3149,12,2016,8,4
Group 5,RRG,-0.5,12,14,3150,8,2016,10,-2
Group 5,RRG,-0.5,12,14,3151,12,2016,7,5
Group 5,RRG,-0.5,12,14,3152,9,2016,10,-1
Group 5,RRG,-0.5,12,14,3153,11,2016,8,3
Group 5,RRG,-0.5,12,14,3154,13,2016,7,6
Group 5,RRG,-0.5,12,14,3155,10,2016,12,-2
Group 5,RRG,-0.5,12,14,3156,13,2016,10,3
Group 5,RRG,-0.5,12,14,3157,10,2016,10,0
Group 5,RRG,-0.5,12,14,3158,7,2016,7,0
Group 5,RRG,-0.5,12,14,3159,13,2016,8,5
Group 5,RRG,-0.5,12,14,3160,10,2016,11,-1
Group 5,RRG,-0.5,12,14,3161,11,2016,2,9
Group 5,RRG,-0.5,12,14,3162,10,2016,9,1
Group 5,RRG,-0.5,12,14,3163,11,2016,5,6
Group 5,RRG,-0.5,12,14,3164,11,2016,9,2
Group 5,RRG,-0.5,12,14,3165,14,2016,6,8
Group 5,RRG,-0.5,12,14,3166,8,2016,7,1
Group 5,RRG,-0.5,12,14,3167,8,2016,7,1
Group 5,RRG,-0.5,12,14,3168,12,2016,8,4
Group 5,RRG,-0.5,12,14,3169,12,2016,9,3
Group 5,RRG,-0.5,12,14,3170,10,2016,9,1
Group 5,RRG,-0.5,12,14,3171,14,2016,5,9
Group 5,RRG,-0.5,12,14,3172,10,2016,6,4
Group 5,RRG,-0.5,12,14,3173,13,2016,7,6
Group 5,RRG,-0.5,12,14,3174,8,2016,9,-1
Group 5,RRG,-0.5,12,14,3175,8,2016,5,3
Group 5,RRG,-0.5,12,14,3176,12,2016,8,4
Group 5,RRG,-0.5,12,14,3177,6,2016,11,-5
Group 5,RRG,-0.5,12,14,3178,10,2016,12,-2
Group 5,RRG,-0.5,12,14,3179,12,2016,12,0
Group 5,RRG,-0.5,12,14,3180,11,2016,10,1
Group 5,RRG,-0.5,12,14,3181,14,2016,9,5
Group 5,RRG,-0.5,12,14,3182,12,2016,7,5
Group 5,RRG,-0.5,12,14,3183,10,2016,11,-1
Group 5,RRG,-0.5,12,14,3184,11,2016,8,3
Group 5,RRG,-0.5,12,14,3185,12,2016,11,1
Group 5,RRG,-0.5,12,14,3186,9,2016,9,0
Group 5,RRG,-0.5,12,14,3187,6,2016,9,-3
Group 5,RRG,-0.5,12,14,3188,12,2016,6,6
Group 5,RRG,-0.5,12,14,3189,10,2016,8,2
Group 5,RRG,-0.5,12,14,3190,11,2016,9,2
Group 5,RRG,-0.5,12,14,3191,9,2016,4,5
Group 5,RRG,-0.5,12,14,3192,10,2016,5,5
Group 5,RRG,-0.5,12,14,3193,13,2016,9,4
Group 5,RRG,-0.5,12,14,3194,10,2016,11,-1
Group 5,RRG,-0.5,12,14,3195,12,2016,7,5
Group 5,RRG,-0.5,12,14,3196,11,2016,11,0
Group 5,RRG,-0.5,12,14,3197,12,2016,9,3
Group 5,RRG,-0.5,12,14,3198,12,2016,9,3
Group 5,RRG,-0.5,12,14,3199,11,2016,9,2
Group 5,RRG,-0.5,12,14,3200,13,2016,11,2
Group 5,RRG,-0.5,12,14,3201,11,2016,9,2
Group 5,RRG,-0.5,12,14,3202,12,2016,10,2
Group 5,RRG,-0.5,12,14,3203,14,2016,10,4
Group 5,RRG,-0.5,12,14,3204,10,2016,10,0
Group 5,RRG,-0.5,12,14,3205,8,2016,5,3
Group 5,RRG,-0.5,12,14,3206,8,2016,11,-3
Group 5,RRG,-0.5,12,14,3207,11,2016,8,3
Group 5,RRG,-0.5,12,14,3208,10,2016,8,2
Group 5,RRG,-0.5,12,14,3209,12,2016,9,3
Group 5,RRG,-0.5,12,14,3210,12,2016,8,4
Group 5,RRG,-0.5,12,14,3211,9,2016,9,0
Group 5,RRG,-0.5,12,14,3212,12,2016,10,2
Group 5,RRG,-0.5,12,14,3213,11,2016,11,0
Group 5,RRG,-0.5,12,14,3214,11,2016,8,3
Group 5,RRG,-0.5,12,14,3215,9,2016,12,-3
Group 5,RRG,-0.5,12,14,3216,12,2016,6,6
Group 5,RRG,-0.5,12,14,3217,11,2016,8,3
Group 5,RRG,-0.5,12,14,3218,13,2016,7,6
Group 5,RRG,-0.5,12,14,3219,10,2016,6,4
Group 5,RRG,-0.5,12,14,3220,13,2016,6,7
Group 5,RRG,-0.5,12,14,3221,11,2016,4,7
Group 5,RRG,-0.5,12,14,3222,12,2016,12,0
Group 5,RRG,-0.5,12,14,3223,11,2016,9,2
Group 5,RRG,-0.5,12,14,3224,6,2016,9,-3
Group 5,RRG,-0.5,12,14,3225,8,2016,9,-1
Group 5,RRG,-0.5,12,14,3226,12,2016,11,1
Group 5,RRG,-0.5,12,14,3227,11,2016,7,4
Group 5,RRG,-0.5,12,14,3228,11,2016,5,6
Group 5,RRG,-0.5,12,14,3229,9,2016,9,0
Group 5,RRG,-0.5,12,14,3230,8,2016,10,-2
Group 5,RRG,-0.5,12,14,3231,9,2016,10,-1
Group 5,RRG,-0.5,12,14,3232,11,2016,4,7
Group 5,RRG,-0.5,12,14,3233,14,2016,11,3
Group 5,RRG,-0.5,12,14,3234,8,2016,7,1
Group 5,RRG,-0.5,12,14,3235,11,2016,9,2
Group 5,RRG,-0.5,12,14,3236,10,2016,12,-2
Group 5,RRG,-0.5,12,14,3237,13,2016,8,5
Group 5,RRG,-0.5,12,14,3238,8,2016,9,-1
Group 5,RRG,-0.5,12,14,3239,10,2016,11,-1
Group 5,RRG,-0.5,12,14,3240,11,2016,10,1
Group 5,RRG,-0.5,12,14,3241,9,2016,9,0
Group 5,RRG,-0.5,12,14,3242,12,2016,10,2
Group 5,RRG,-0.5,12,14,3243,9,2016,8,1
Group 5,RRG,-0.5,12,14,3244,8,2016,8,0
Group 5,RRG,-0.5,12,14,3245,9,2016,8,1
Group 5,RRG,-0.5,12,14,3246,12,2016,9,3
Group 5,RRG,-0.5,12,14,3247,9,2016,14,-5
Group 5,RRG,-0.5,12,14,3248,11,2016,11,0
Group 5,RRG,-0.5,12,14,3249,6,2016,8,-2
Group 5,RRG,-0.5,12,14,3250,10,2016,9,1
Group 5,RRG,-0.5,12,14,3251,11,2016,6,5
Group 5,RRG,-0.5,12,14,3252,10,2016,11,-1
Group 5,RRG,-0.5,12,14,3253,11,2016,5,6
Group 5,RRG,-0.5,12,14,3254,12,2016,11,1
Group 5,RRG,-0.5,12,14,3255,10,2016,9,1
Group 5,RRG,-0.5,12,14,3256,11,2016,9,2
Group 5,RRG,-0.5,12,14,3257,11,2016,12,-1
Group 5,RRG,-0.5,12,14,3258,10,2016,6,4
Group 5,RRG,-0.5,12,14,3259,8,2016,10,-2
Group 5,RRG,-0.5,12,14,3260,9,2016,7,2
Group 5,RRG,-0.5,12,14,3261,11,2016,7,4
Group 5,RRG,-0.5,12,14,3262,8,2016,9,-1
Group 5,RRG,-0.5,12,14,3263,7,2016,7,0
Group 5,RRG,-0.5,12,14,3264,12,2016,8,4
Group 5,RRG,-0.5,12,14,3265,11,2016,4,7
Group 5,RRG,-0.5,12,14,3266,11,2016,4,7
Group 5,RRG,-0.5,12,14,3267,8,2016,7,1
Group 5,RRG,-0.5,12,14,3268,10,2016,8,2
Group 5,RRG,-0.5,12,14,3269,12,2016,7,5
Group 5,RRG,-0.5,12,14,3270,10,2016,9,1
Group 5,RRG,-0.5,12,14,3271,10,2016,10,0
Group 5,RRG,-0.5,12,14,3272,11,2016,10,1
Group 5,RRG,-0.5,12,14,3273,12,2016,10,2
Group 5,RRG,-0.5,12,14,3274,12,2016,9,3
Group 5,RRG,-0.5,12,14,3275,10,2016,13,-3
Group 5,RRG,-0.5,12,14,3276,12,2016,5,7
Group 5,RRG,-0.5,12,14,3277,10,2016,6,4
Group 5,RRG,-0.5,12,14,3278,11,2016,6,5
Group 5,RRG,-0.5,12,14,3279,6,2016,8,-2
Group 5,RRG,-0.5,12,14,3280,6,2016,4,2
Group 5,RRG,-0.5,12,14,3281,12,2016,8,4
Group 5,RRG,-0.5,12,14,3282,12,2016,8,4
Group 5,RRG,-0.5,12,14,3283,11,2016,7,4
Group 5,RRG,-0.5,12,14,3284,9,2016,12,-3
Group 5,RRG,-0.5,12,14,3285,10,2016,13,-3
Group 5,RRG,-0.5,12,14,3286,13,2016,3,10
Group 5,RRG,-0.5,12,14,3287,9,2016,6,3
Group 5,RRG,-0.5,12,14,3288,10,2016,14,-4
Group 5,RRG,-0.5,12,14,3289,9,2016,11,-2
Group 5,RRG,-0.5,12,14,3290,10,2016,5,5
Group 5,RRG,-0.5,12,14,3291,10,2016,4,6
Group 5,RRG,-0.5,12,14,3292,11,2016,1,10
Group 5,RRG,-0.5,12,14,3293,9,2016,9,0
Group 5,RRG,-0.5,12,14,3294,13,2016,7,6
Group 5,RRG,-0.5,12,14,3295,9,2016,9,0
Group 5,RRG,-0.5,12,14,3296,10,2016,4,6
Group 5,RRG,-0.5,12,14,3297,10,2016,7,3
Group 5,RRG,-0.5,12,14,3298,13,2016,10,3
Group 5,RRG,-0.5,12,14,3299,8,2016,6,2
Group 5,RRG,-0.5,12,14,3300,13,2016,12,1
Group 5,RRG,-0.5,12,14,3301,10,2016,9,1
Group 5,RRG,-0.5,12,14,3302,13,2016,12,1
Group 5,RRG,-0.5,12,14,3303,13,2016,5,8
Group 5,RRG,-0.5,12,14,3304,9,2016,11,-2
Group 5,RRG,-0.5,12,14,3305,12,2016,3,9
Group 5,RRG,-0.5,12,14,3306,13,2016,4,9
Group 5,RRG,-0.5,12,14,3307,7,2016,13,-6
Group 5,RRG,-0.5,12,14,3308,8,2016,5,3
Group 5,RRG,-0.5,12,14,3309,9,2016,7,2
Group 5,RRG,-0.5,12,14,3310,9,2016,10,-1
Group 5,RRG,-0.5,12,14,3311,8,2016,11,-3
Group 5,RRG,-0.5,12,14,3312,13,2016,3,10
Group 5,RRG,-0.5,12,14,3313,8,2016,8,0
Group 5,RRG,-0.5,12,14,3314,12,2016,8,4
Group 5,RRG,-0.5,12,14,3315,9,2016,8,1
Group 5,RRG,-0.5,12,14,3316,10,2016,10,0
Group 5,RRG,-0.5,12,14,3317,9,2016,5,4
Group 5,RRG,-0.5,12,14,3318,7,2016,7,0
Group 5,RRG,-0.5,12,14,3319,12,2016,12,0
Group 5,RRG,-0.5,12,14,3320,7,2016,6,1
Group 5,RRG,-0.5,12,14,3321,7,2016,11,-4
Group 5,RRG,-0.5,12,14,3322,9,2016,7,2
Group 5,RRG,-0.5,12,14,3323,10,2016,6,4
Group 5,RRG,-0.5,12,14,3324,8,2016,5,3
Group 5,RRG,-0.5,12,14,3325,10,2016,8,2
Group 5,RRG,-0.5,12,14,3326,11,2016,9,2
Group 5,RRG,-0.5,12,14,3327,11,2016,7,4
Group 5,RRG,-0.5,12,14,3328,11,2016,7,4
Group 5,RRG,-0.5,12,14,3329,9,2016,8,1
Group 5,RRG,-0.5,12,14,3330,9,2016,9,0
Group 5,RRG,-0.5,12,14,3331,9,2016,9,0
Group 5,RRG,-0.5,12,14,3332,11,2016,5,6
Group 5,RRG,-0.5,12,14,3333,10,2016,8,2
Group 5,RRG,-0.5,12,14,3334,13,2016,8,5
Group 5,RRG,-0.5,12,14,3335,13,2016,7,6
Group 5,RRG,-0.5,12,14,3336,9,2016,11,-2
Group 5,RRG,-0.5,12,14,3337,9,2016,9,0
Group 5,RRG,-0.5,12,14,3338,12,2016,9,3
Group 5,RRG,-0.5,12,14,3339,11,2016,11,0
Group 5,RRG,-0.5,12,14,3340,9,2016,10,-1
Group 5,RRG,-0.5,12,14,3341,11,2016,8,3
Group 5,RRG,-0.5,12,14,3342,10,2016,6,4
Group 5,RRG,-0.5,12,14,3343,10,2016,10,0
Group 5,RRG,-0.5,12,14,3344,8,2016,9,-1
Group 5,RRG,-0.5,12,14,3345,11,2016,10,1
Group 5,RRG,-0.5,12,14,3346,12,2016,7,5
Group 5,RRG,-0.5,12,14,3347,11,2016,10,1
Group 5,RRG,-0.5,12,14,3348,10,2016,9,1
Group 5,RRG,-0.5,12,14,3349,8,2016,10,-2
Group 5,RRG,-0.5,12,14,3350,8,2016,11,-3
Group 5,RRG,-0.5,12,14,3351,9,2016,10,-1
Group 5,RRG,-0.5,12,14,3352,9,2016,9,0
Group 5,RRG,-0.5,12,14,3353,12,2016,7,5
Group 5,RRG,-0.5,12,14,3354,7,2016,9,-2
Group 5,RRG,-0.5,12,14,3355,11,2016,9,2
Group 5,RRG,-0.5,12,14,3356,9,2016,9,0
Group 5,RRG,-0.5,12,14,3357,9,2016,12,-3
Group 5,RRG,-0.5,12,14,3358,11,2016,4,7
Group 5,RRG,-0.5,12,14,3359,8,2016,4,4
Group 5,RRG,-0.5,12,14,3360,10,2016,4,6
Group 5,RRG,-0.5,12,14,3361,8,2016,11,-3
Group 5,RRG,-0.5,12,14,3362,8,2016,8,0
Group 5,RRG,-0.5,12,14,3363,8,2016,8,0
Group 5,RRG,-0.5,12,14,3364,7,2016,7,0
Group 5,RRG,-0.5,12,14,3365,11,2016,12,-1
Group 5,RRG,-0.5,12,14,3366,9,2016,9,0
Group 5,RRG,-0.5,12,14,3367,11,2016,10,1
Group 5,RRG,-0.5,12,14,3368,11,2016,4,7
Group 5,RRG,-0.5,12,14,3369,9,2016,5,4
Group 5,RRG,-0.5,12,14,3370,12,2016,7,5
Group 5,RRG,-0.5,12,14,3371,9,2016,9,0
Group 5,RRG,-0.5,12,14,3372,9,2016,3,6
Group 5,RRG,-0.5,12,14,3373,11,2016,9,2
Group 5,RRG,-0.5,12,14,3374,11,2016,8,3
Group 5,RRG,-0.5,12,14,3375,8,2016,9,-1
Group 5,RRG,-0.5,12,14,3376,7,2016,6,1
Group 5,RRG,-0.5,12,14,3377,7,2016,8,-1
Group 5,RRG,-0.5,12,14,3378,14,2016,6,8
Group 5,RRG,-0.5,12,14,3379,12,2016,2,10
Group 5,RRG,-0.5,12,14,3380,9,2016,11,-2
Group 5,RRG,-0.5,12,14,3381,11,2016,10,1
Group 5,RRG,-0.5,12,14,3382,10,2016,11,-1
Group 5,RRG,-0.5,12,14,3383,10,2016,7,3
Group 5,RRG,-0.5,12,14,3384,9,2016,5,4
Group 5,RRG,-0.5,12,14,3385,13,2016,10,3
Group 5,RRG,-0.5,12,14,3386,13,2016,9,4
Group 5,RRG,-0.5,12,14,3387,11,2016,11,0
Group 5,RRG,-0.5,12,14,3388,13,2016,9,4
Group 5,RRG,-0.5,12,14,3389,11,2016,3,8
Group 5,RRG,-0.5,12,14,3390,11,2016,9,2
Group 5,RRG,-0.5,12,14,3391,11,2016,13,-2
Group 5,RRG,-0.5,12,14,3392,8,2016,9,-1
Group 5,RRG,-0.5,12,14,3393,7,2016,11,-4
Group 5,RRG,-0.5,12,14,3394,9,2016,12,-3
Group 5,RRG,-0.5,12,14,3395,11,2016,12,-1
Group 5,RRG,-0.5,12,14,3396,10,2016,9,1
Group 5,RRG,-0.5,12,14,3397,13,2016,9,4
Group 5,RRG,-0.5,12,14,3398,11,2016,8,3
Group 5,RRG,-0.5,12,14,3399,11,2016,7,4
Group 5,RRG,-0.5,12,14,3400,10,2016,10,0
Group 5,RRG,-0.5,12,14,3401,12,2016,10,2
Group 5,RRG,-0.5,12,14,3402,11,2016,10,1
Group 5,RRG,-0.5,12,14,3403,11,2016,11,0
Group 5,RRG,-0.5,12,14,3404,11,2016,8,3
Group 5,RRG,-0.5,12,14,3405,12,2016,5,7
Group 5,RRG,-0.5,12,14,3406,12,2016,6,6
Group 5,RRG,-0.5,12,14,3407,12,2016,4,8
Group 5,RRG,-0.5,12,14,3408,11,2016,6,5
Group 5,RRG,-0.5,12,14,3409,10,2016,6,4
Group 5,RRG,-0.5,12,14,3410,7,2016,9,-2
Group 5,RRG,-0.5,12,14,3411,9,2016,8,1
Group 5,RRG,-0.5,12,14,3412,13,2016,8,5
Group 5,RRG,-0.5,12,14,3413,10,2016,6,4
Group 5,RRG,-0.5,12,14,3414,9,2016,8,1
Group 5,RRG,-0.5,12,14,3415,8,2016,11,-3
Group 5,RRG,-0.5,12,14,3416,11,2016,12,-1
Group 5,RRG,-0.5,12,14,3417,9,2016,11,-2
Group 5,RRG,-0.5,12,14,3418,7,2016,7,0
Group 5,RRG,-0.5,12,14,3419,11,2016,6,5
Group 5,RRG,-0.5,12,14,3420,8,2016,9,-1
Group 5,RRG,-0.5,12,14,3421,10,2016,8,2
Group 5,RRG,-0.5,12,14,3422,11,2016,10,1
Group 5,RRG,-0.5,12,14,3423,11,2016,10,1
Group 5,RRG,-0.5,12,14,3424,10,2016,10,0
Group 5,RRG,-0.5,12,14,3425,12,2016,13,-1
Group 5,RRG,-0.5,12,14,3426,11,2016,6,5
Group 5,RRG,-0.5,12,14,3427,7,2016,7,0
Group 5,RRG,-0.5,12,14,3428,7,2016,11,-4
Group 5,RRG,-0.5,12,14,3429,11,2016,9,2
Group 5,RRG,-0.5,12,14,3430,10,2016,8,2
Group 5,RRG,-0.5,12,14,3431,13,2016,6,7
Group 5,RRG,-0.5,12,14,3432,12,2016,10,2
Group 5,RRG,-0.5,12,14,3433,12,2016,5,7
Group 5,RRG,-0.5,12,14,3434,8,2016,7,1
Group 5,RRG,-0.5,12,14,3435,10,2016,8,2
Group 5,RRG,-0.5,12,14,3436,13,2016,8,5
Group 5,RRG,-0.5,12,14,3437,9,2016,6,3
Group 5,RRG,-0.5,12,14,3438,9,2016,7,2
Group 5,RRG,-0.5,12,14,3439,13,2016,8,5
Group 5,RRG,-0.5,12,14,3440,10,2016,11,-1
Group 5,RRG,-0.5,12,14,3441,7,2016,7,0
Group 5,RRG,-0.5,12,14,3442,11,2016,8,3
Group 5,RRG,-0.5,12,14,3443,10,2016,8,2
Group 5,RRG,-0.5,12,14,3444,12,2016,11,1
Group 5,RRG,-0.5,12,14,3445,11,2016,10,1
Group 5,RRG,-0.5,12,14,3446,11,2016,11,0
Group 5,RRG,-0.5,12,14,3447,8,2016,12,-4
Group 5,RRG,-0.5,12,14,3448,12,2016,10,2
Group 5,RRG,-0.5,12,14,3449,11,2016,5,6
Group 5,RRG,-0.5,12,14,3450,11,2016,8,3
Group 5,RRG,-0.5,12,14,3451,7,2016,7,0
Group 5,RRG,-0.5,12,14,3452,13,2016,9,4
Group 5,RRG,-0.5,12,14,3453,10,2016,6,4
Group 5,RRG,-0.5,12,14,3454,10,2016,9,1
Group 5,RRG,-0.5,12,14,3455,14,2016,11,3
Group 5,RRG,-0.5,12,14,3456,13,2016,8,5
Group 5,RRG,-0.5,12,14,3457,9,2016,4,5
Group 5,RRG,-0.5,12,14,3458,9,2016,5,4
Group 5,RRG,-0.5,12,14,3459,11,2016,10,1
Group 5,RRG,-0.5,12,14,3460,11,2016,10,1
Group 5,RRG,-0.5,12,14,3461,11,2016,9,2
Group 5,RRG,-0.5,12,14,3462,8,2016,10,-2
Group 5,RRG,-0.5,12,14,3463,10,2016,7,3
Group 5,RRG,-0.5,12,14,3464,10,2016,7,3
Group 5,RRG,-0.5,12,14,3465,11,2016,7,4
Group 5,RRG,-0.5,12,14,3466,9,2016,9,0
Group 5,RRG,-0.5,12,14,3467,10,2016,6,4
Group 5,RRG,-0.5,12,14,3468,10,2016,7,3
Group 5,RRG,-0.5,12,14,3469,12,2016,8,4
Group 5,RRG,-0.5,12,14,3470,9,2016,10,-1
Group 5,RRG,-0.5,12,14,3471,12,2016,7,5
Group 5,RRG,-0.5,12,14,3472,13,2016,7,6
Group 5,RRG,-0.5,12,14,3473,12,2016,8,4
Group 5,RRG,-0.5,12,14,3474,10,2016,11,-1
Group 5,RRG,-0.5,12,14,3475,12,2016,12,0
Group 5,RRG,-0.5,12,14,3476,12,2016,9,3
Group 5,RRG,-0.5,12,14,3477,12,2016,9,3
Group 5,RRG,-0.5,12,14,3478,10,2016,9,1
Group 5,RRG,-0.5,12,14,3479,5,2016,10,-5
Group 5,RRG,-0.5,12,14,3480,10,2016,9,1
Group 5,RRG,-0.5,12,14,3481,10,2016,7,3
Group 5,RRG,-0.5,12,14,3482,10,2016,11,-1
Group 5,RRG,-0.5,12,14,3483,10,2016,7,3
Group 5,RRG,-0.5,12,14,3484,6,2016,10,-4
Group 5,RRG,-0.5,12,14,3485,7,2016,7,0
Group 5,RRG,-0.5,12,14,3486,12,2016,9,3
Group 5,RRG,-0.5,12,14,3487,8,2016,11,-3
Group 5,RRG,-0.5,12,14,3488,10,2016,2,8
Group 5,RRG,-0.5,12,14,3489,11,2016,6,5
Group 5,RRG,-0.5,12,14,3490,9,2016,9,0
Group 5,RRG,-0.5,12,14,3491,12,2016,9,3
Group 5,RRG,-0.5,12,14,3492,12,2016,8,4
Group 5,RRG,-0.5,12,14,3493,12,2016,10,2
Group 5,RRG,-0.5,12,14,3494,11,2016,9,2
Group 5,RRG,-0.5,12,14,3495,9,2016,9,0
Group 5,RRG,-0.5,12,14,3496,12,2016,9,3
Group 5,RRG,-0.5,12,14,3497,10,2016,7,3
Group 5,RRG,-0.5,12,14,3498,11,2016,5,6
Group 5,RRG,-0.5,12,14,3499,6,2016,11,-5
Group 5,RRG,-0.5,12,14,3500,10,2016,12,-2
Group 5,RRG,-0.5,12,14,3501,10,2016,7,3
Group 5,RRG,-0.5,12,14,3502,10,2016,11,-1
Group 5,RRG,-0.5,12,14,3503,13,2016,8,5
Group 5,RRG,-0.5,12,14,3504,10,2016,11,-1
Group 5,RRG,-0.5,12,14,3505,14,2016,7,7
Group 5,RRG,-0.5,12,14,3506,14,2016,7,7
Group 5,RRG,-0.5,12,14,3507,14,2016,4,10
Group 5,RRG,-0.5,12,14,3508,12,2016,5,7
Group 5,RRG,-0.5,12,14,3509,10,2016,10,0
Group 5,RRG,-0.5,12,14,3510,13,2016,3,10
Group 5,RRG,-0.5,12,14,3511,9,2016,9,0
Group 5,RRG,-0.5,12,14,3512,11,2016,7,4
Group 5,RRG,-0.5,12,14,3513,9,2016,9,0
Group 5,RRG,-0.5,12,14,3514,11,2016,12,-1
Group 5,RRG,-0.5,12,14,3515,14,2016,8,6
Group 5,RRG,-0.5,12,14,3516,10,2016,8,2
Group 5,RRG,-0.5,12,14,3517,11,2016,6,5
Group 5,RRG,-0.5,12,14,3518,10,2016,6,4
Group 5,RRG,-0.5,12,14,3519,11,2016,5,6
Group 5,RRG,-0.5,12,14,3520,8,2016,8,0
Group 5,RRG,-0.5,12,14,3521,7,2016,9,-2
Group 5,RRG,-0.5,12,14,3522,8,2016,8,0
Group 5,RRG,-0.5,12,14,3523,13,2016,5,8
Group 5,RRG,-0.5,12,14,3524,10,2016,13,-3
Group 5,RRG,-0.5,12,14,3525,10,2016,12,-2
Group 5,RRG,-0.5,12,14,3526,10,2016,8,2
Group 5,RRG,-0.5,12,14,3527,10,2016,8,2
Group 5,RRG,-0.5,12,14,3528,12,2016,8,4
Group 5,RRG,-0.5,12,14,3529,11,2016,9,2
Group 5,RRG,-0.5,12,14,3530,12,2016,9,3
Group 5,RRG,-0.5,12,14,3531,11,2016,13,-2
Group 5,RRG,-0.5,12,14,3532,10,2016,14,-4
Group 5,RRG,-0.5,12,14,3533,9,2016,7,2
Group 5,RRG,-0.5,12,14,3534,10,2016,5,5
Group 5,RRG,-0.5,12,14,3535,13,2016,14,-1
Group 5,RRG,-0.5,12,14,3536,12,2016,12,0
Group 5,RRG,-0.5,12,14,3537,14,2016,9,5
Group 5,RRG,-0.5,12,14,3538,7,2016,10,-3
Group 5,RRG,-0.5,12,14,3539,6,2016,7,-1
Group 5,RRG,-0.5,12,14,3540,8,2016,10,-2
Group 5,RRG,-0.5,12,14,3541,8,2016,9,-1
Group 5,RRG,-0.5,12,14,3542,11,2016,12,-1
Group 5,RRG,-0.5,12,14,3543,10,2016,6,4
Group 5,RRG,-0.5,12,14,3544,13,2016,11,2
Group 5,RRG,-0.5,12,14,3545,12,2016,8,4
Group 5,RRG,-0.5,12,14,3546,11,2016,8,3
Group 5,RRG,-0.5,12,14,3547,8,2016,9,-1
Group 5,RRG,-0.5,12,14,3548,7,2016,10,-3
Group 5,RRG,-0.5,12,14,3549,11,2016,9,2
Group 5,RRG,-0.5,12,14,3550,12,2016,12,0
Group 5,RRG,-0.5,12,14,3551,8,2016,7,1
Group 5,RRG,-0.5,12,14,3552,11,2016,4,7
Group 5,RRG,-0.5,12,14,3553,8,2016,10,-2
Group 5,RRG,-0.5,12,14,3554,10,2016,5,5
Group 5,RRG,-0.5,12,14,3555,13,2016,8,5
Group 5,RRG,-0.5,12,14,3556,11,2016,10,1
Group 5,RRG,-0.5,12,14,3557,7,2016,5,2
Group 5,RRG,-0.5,12,14,3558,12,2016,12,0
Group 5,RRG,-0.5,12,14,3559,8,2016,12,-4
Group 5,RRG,-0.5,12,14,3560,8,2016,8,0
Group 5,RRG,-0.5,12,14,3561,9,2016,6,3
Group 5,RRG,-0.5,12,14,3562,11,2016,10,1
Group 5,RRG,-0.5,12,14,3563,10,2016,7,3
Group 5,RRG,-0.5,12,14,3564,10,2016,7,3
Group 5,RRG,-0.5,12,14,3565,9,2016,11,-2
Group 5,RRG,-0.5,12,14,3566,4,2016,2,2
Group 5,RRG,-0.5,12,14,3567,13,2016,10,3
Group 5,RRG,-0.5,12,14,3568,12,2016,12,0
Group 5,RRG,-0.5,12,14,3569,11,2016,10,1
Group 5,RRG,-0.5,12,14,3570,10,2016,7,3
Group 5,RRG,-0.5,12,14,3571,12,2016,9,3
Group 5,RRG,-0.5,12,14,3572,10,2016,12,-2
Group 5,RRG,-0.5,12,14,3573,9,2016,13,-4
Group 5,RRG,-0.5,12,14,3574,10,2016,6,4
Group 5,RRG,-0.5,12,14,3575,13,2016,8,5
Group 5,RRG,-0.5,12,14,3576,11,2016,6,5
Group 5,RRG,-0.5,12,14,3577,11,2016,6,5
Group 5,RRG,-0.5,12,14,3578,10,2016,10,0
Group 5,RRG,-0.5,12,14,3579,10,2016,6,4
Group 5,RRG,-0.5,12,14,3580,9,2016,8,1
Group 5,RRG,-0.5,12,14,3581,10,2016,11,-1
Group 5,RRG,-0.5,12,14,3582,8,2016,5,3
Group 5,RRG,-0.5,12,14,3583,11,2016,1,10
Group 5,RRG,-0.5,12,14,3584,10,2016,9,1
Group 5,RRG,-0.5,12,14,3585,9,2016,11,-2
Group 5,RRG,-0.5,12,14,3586,11,2016,11,0
Group 5,RRG,-0.5,12,14,3587,11,2016,6,5
Group 5,RRG,-0.5,12,14,3588,9,2016,8,1
Group 5,RRG,-0.5,12,14,3589,14,2016,7,7
Group 5,RRG,-0.5,12,14,3590,10,2016,5,5
Group 5,RRG,-0.5,12,14,3591,10,2016,7,3
Group 5,RRG,-0.5,12,14,3592,13,2016,8,5
Group 5,RRG,-0.5,12,14,3593,10,2016,8,2
Group 5,RRG,-0.5,12,14,3594,9,2016,9,0
Group 5,RRG,-0.5,12,14,3595,13,2016,9,4
Group 5,RRG,-0.5,12,14,3596,9,2016,10,-1
Group 5,RRG,-0.5,12,14,3597,9,2016,7,2
Group 5,RRG,-0.5,12,14,3598,10,2016,9,1
Group 5,RRG,-0.5,12,14,3599,12,2016,12,0
Group 5,RRG,-0.5,12,14,3600,12,2016,11,1
Group 5,RRG,-0.5,12,14,3601,13,2016,10,3
Group 5,RRG,-0.5,12,14,3602,9,2016,9,0
Group 5,RRG,-0.5,12,14,3603,11,2016,9,2
Group 5,RRG,-0.5,12,14,3604,11,2016,10,1
Group 5,RRG,-0.5,12,14,3605,13,2016,10,3
Group 5,RRG,-0.5,12,14,3606,10,2016,5,5
Group 5,RRG,-0.5,12,14,3607,11,2016,9,2
Group 5,RRG,-0.5,12,14,3608,12,2016,5,7
Group 5,RRG,-0.5,12,14,3609,11,2016,9,2
Group 5,RRG,-0.5,12,14,3610,8,2016,9,-1
Group 5,RRG,-0.5,12,14,3611,10,2016,10,0
Group 5,RRG,-0.5,12,14,3612,11,2016,9,2
Group 5,RRG,-0.5,12,14,3613,11,2016,8,3
Group 5,RRG,-0.5,12,14,3614,11,2016,10,1
Group 5,RRG,-0.5,12,14,3615,12,2016,10,2
Group 5,RRG,-0.5,12,14,3616,11,2016,12,-1
Group 5,RRG,-0.5,12,14,3617,10,2016,9,1
Group 5,RRG,-0.5,12,14,3618,8,2016,11,-3
Group 5,RRG,-0.5,12,14,3619,13,2016,7,6
Group 5,RRG,-0.5,12,14,3620,13,2016,11,2
Group 5,RRG,-0.5,12,14,3621,11,2016,10,1
Group 5,RRG,-0.5,12,14,3622,10,2016,6,4
Group 5,RRG,-0.5,12,14,3623,9,2016,6,3
Group 5,RRG,-0.5,12,14,3624,12,2016,7,5
Group 5,RRG,-0.5,12,14,3625,9,2016,6,3
Group 5,RRG,-0.5,12,14,3626,13,2016,8,5
Group 5,RRG,-0.5,12,14,3627,10,2016,7,3
Group 5,RRG,-0.5,12,14,3628,9,2016,10,-1
Group 5,RRG,-0.5,12,14,3629,10,2016,9,1
Group 5,RRG,-0.5,12,14,3630,10,2016,11,-1
Group 5,RRG,-0.5,12,14,3631,10,2016,10,0
Group 5,RRG,-0.5,12,14,3632,13,2016,9,4
Group 5,RRG,-0.5,12,14,3633,12,2016,6,6
Group 5,RRG,-0.5,12,14,3634,11,2016,13,-2
Group 5,RRG,-0.5,12,14,3635,9,2016,6,3
Group 5,RRG,-0.5,12,14,3636,12,2016,7,5
Group 5,RRG,-0.5,12,14,3637,9,2016,7,2
Group 5,RRG,-0.5,12,14,3638,12,2016,7,5
Group 5,RRG,-0.5,12,14,3639,9,2016,9,0
Group 5,RRG,-0.5,12,14,3640,8,2016,11,-3
Group 5,RRG,-0.5,12,14,3641,10,2016,9,1
Group 5,RRG,-0.5,12,14,3642,11,2016,8,3
Group 5,RRG,-0.5,12,14,3643,8,2016,13,-5
Group 5,RRG,-0.5,12,14,3644,11,2016,8,3
Group 5,RRG,-0.5,12,14,3645,9,2016,7,2
Group 5,RRG,-0.5,12,14,3646,11,2016,7,4
Group 5,RRG,-0.5,12,14,3647,11,2016,11,0
Group 5,RRG,-0.5,12,14,3648,10,2016,10,0
Group 5,RRG,-0.5,12,14,3649,11,2016,13,-2
Group 5,RRG,-0.5,12,14,3650,9,2016,10,-1
Group 5,RRG,-0.5,12,14,3651,13,2016,7,6
Group 5,RRG,-0.5,12,14,3652,12,2016,5,7
Group 5,RRG,-0.5,12,14,3653,11,2016,12,-1
Group 5,RRG,-0.5,12,14,3654,9,2016,9,0
Group 5,RRG,-0.5,12,14,3655,9,2016,11,-2
Group 5,RRG,-0.5,12,14,3656,14,2016,9,5
Group 5,RRG,-0.5,12,14,3657,13,2016,7,6
Group 5,RRG,-0.5,12,14,3658,11,2016,11,0
Group 5,RRG,-0.5,12,14,3659,11,2016,9,2
Group 5,RRG,-0.5,12,14,3660,10,2016,9,1
Group 5,RRG,-0.5,12,14,3661,10,2016,6,4
Group 5,RRG,-0.5,12,14,3662,11,2016,6,5
Group 5,RRG,-0.5,12,14,3663,11,2016,10,1
Group 5,RRG,-0.5,12,14,3664,11,2016,8,3
Group 5,RRG,-0.5,12,14,3665,12,2016,11,1
Group 5,RRG,-0.5,12,14,3666,10,2016,7,3
Group 5,RRG,-0.5,12,14,3667,10,2016,10,0
Group 5,RRG,-0.5,12,14,3668,7,2016,6,1
Group 5,RRG,-0.5,12,14,3669,11,2016,8,3
Group 5,RRG,-0.5,12,14,3670,11,2016,9,2
Group 5,RRG,-0.5,12,14,3671,11,2016,10,1
Group 5,RRG,-0.5,12,14,3672,9,2016,8,1
Group 5,RRG,-0.5,12,14,3673,12,2016,8,4
Group 5,RRG,-0.5,12,14,3674,7,2016,7,0
Group 5,RRG,-0.5,12,14,3675,8,2016,5,3
Group 5,RRG,-0.5,12,14,3676,13,2016,10,3
Group 5,RRG,-0.5,12,14,3677,13,2016,8,5
Group 5,RRG,-0.5,12,14,3678,8,2016,11,-3
Group 5,RRG,-0.5,12,14,3679,10,2016,10,0
Group 5,RRG,-0.5,12,14,3680,6,2016,8,-2
Group 5,RRG,-0.5,12,14,3681,11,2016,9,2
Group 5,RRG,-0.5,12,14,3682,11,2016,8,3
Group 5,RRG,-0.5,12,14,3683,9,2016,9,0
Group 5,RRG,-0.5,12,14,3684,7,2016,9,-2
Group 5,RRG,-0.5,12,14,3685,8,2016,7,1
Group 5,RRG,-0.5,12,14,3686,5,2016,8,-3
Group 5,RRG,-0.5,12,14,3687,14,2016,10,4
Group 5,RRG,-0.5,12,14,3688,12,2016,10,2
Group 5,RRG,-0.5,12,14,3689,12,2016,11,1
Group 5,RRG,-0.5,12,14,3690,8,2016,9,-1
Group 5,RRG,-0.5,12,14,3691,7,2016,4,3
Group 5,RRG,-0.5,12,14,3692,9,2016,6,3
Group 5,RRG,-0.5,12,14,3693,10,2016,10,0
Group 5,RRG,-0.5,12,14,3694,12,2016,9,3
Group 5,RRG,-0.5,12,14,3695,10,2016,7,3
Group 5,RRG,-0.5,12,14,3696,9,2016,8,1
Group 5,RRG,-0.5,12,14,3697,11,2016,7,4
Group 5,RRG,-0.5,12,14,3698,13,2016,10,3
Group 5,RRG,-0.5,12,14,3699,11,2016,11,0
Group 5,RRG,-0.5,12,14,3700,8,2016,9,-1
Group 5,RRG,-0.5,12,14,3701,11,2016,3,8
Group 5,RRG,-0.5,12,14,3702,9,2016,12,-3
Group 5,RRG,-0.5,12,14,3703,9,2016,8,1
Group 5,RRG,-0.5,12,14,3704,9,2016,9,0
Group 5,RRG,-0.5,12,14,3705,11,2016,12,-1
Group 5,RRG,-0.5,12,14,3706,10,2016,11,-1
Group 5,RRG,-0.5,12,14,3707,12,2016,9,3
Group 5,RRG,-0.5,12,14,3708,10,2016,10,0
Group 5,RRG,-0.5,12,14,3709,9,2016,11,-2
Group 5,RRG,-0.5,12,14,3710,11,2016,7,4
Group 5,RRG,-0.5,12,14,3711,9,2016,10,-1
Group 5,RRG,-0.5,12,14,3712,10,2016,11,-1
Group 5,RRG,-0.5,12,14,3713,10,2016,8,2
Group 5,RRG,-0.5,12,14,3714,11,2016,11,0
Group 5,RRG,-0.5,12,14,3715,10,2016,8,2
Group 5,RRG,-0.5,12,14,3716,11,2016,12,-1
Group 5,RRG,-0.5,12,14,3717,11,2016,11,0
Group 5,RRG,-0.5,12,14,3718,10,2016,9,1
Group 5,RRG,-0.5,12,14,3719,11,2016,2,9
Group 5,RRG,-0.5,12,14,3720,12,2016,3,9
Group 5,RRG,-0.5,12,14,3721,8,2016,10,-2
Group 5,RRG,-0.5,12,14,3722,12,2016,9,3
Group 5,RRG,-0.5,12,14,3723,10,2016,8,2
Group 5,RRG,-0.5,12,14,3724,9,2016,8,1
Group 5,RRG,-0.5,12,14,3725,12,2016,6,6
Group 5,RRG,-0.5,12,14,3726,11,2016,10,1
Group 5,RRG,-0.5,12,14,3727,11,2016,11,0
Group 5,RRG,-0.5,12,14,3728,6,2016,7,-1
Group 5,RRG,-0.5,12,14,3729,11,2016,7,4
Group 5,RRG,-0.5,12,14,3730,5,2016,10,-5
Group 5,RRG,-0.5,12,14,3731,10,2016,8,2
Group 5,RRG,-0.5,12,14,3732,7,2016,11,-4
Group 5,RRG,-0.5,12,14,3733,11,2016,12,-1
Group 5,RRG,-0.5,12,14,3734,13,2016,9,4
Group 5,RRG,-0.5,12,14,3735,14,2016,11,3
Group 5,RRG,-0.5,12,14,3736,9,2016,7,2
Group 5,RRG,-0.5,12,14,3737,9,2016,10,-1
Group 5,RRG,-0.5,12,14,3738,11,2016,10,1
Group 5,RRG,-0.5,12,14,3739,12,2016,8,4
Group 5,RRG,-0.5,12,14,3740,13,2016,10,3
Group 5,RRG,-0.5,12,14,3741,8,2016,6,2
Group 5,RRG,-0.5,12,14,3742,13,2016,9,4
Group 5,RRG,-0.5,12,14,3743,8,2016,6,2
Group 5,RRG,-0.5,12,14,3744,10,2016,5,5
Group 5,RRG,-0.5,12,14,3745,11,2016,7,4
Group 5,RRG,-0.5,12,14,3746,9,2016,7,2
Group 5,RRG,-0.5,12,14,3747,13,2016,10,3
Group 5,RRG,-0.5,12,14,3748,10,2016,7,3
Group 5,RRG,-0.5,12,14,3749,9,2016,7,2
Group 5,RRG,-0.5,12,14,3750,8,2016,12,-4
Group 5,RRG,-0.5,12,14,3751,11,2016,7,4
Group 5,RRG,-0.5,12,14,3752,7,2016,4,3
Group 5,RRG,-0.5,12,14,3753,13,2016,7,6
Group 5,RRG,-0.5,12,14,3754,10,2016,10,0
Group 5,RRG,-0.5,12,14,3755,10,2016,4,6
Group 5,RRG,-0.5,12,14,3756,9,2016,7,2
Group 5,RRG,-0.5,12,14,3757,9,2016,8,1
Group 5,RRG,-0.5,12,14,3758,12,2016,6,6
Group 5,RRG,-0.5,12,14,3759,11,2016,8,3
Group 5,RRG,-0.5,12,14,3760,9,2016,7,2
Group 5,RRG,-0.5,12,14,3761,11,2016,12,-1
Group 5,RRG,-0.5,12,14,3762,11,2016,9,2
Group 5,RRG,-0.5,12,14,3763,9,2016,4,5
Group 5,RRG,-0.5,12,14,3764,10,2016,5,5
Group 5,RRG,-0.5,12,14,3765,11,2016,9,2
Group 5,RRG,-0.5,12,14,3766,9,2016,8,1
Group 5,RRG,-0.5,12,14,3767,12,2016,7,5
Group 5,RRG,-0.5,12,14,3768,10,2016,13,-3
Group 5,RRG,-0.5,12,14,3769,7,2016,10,-3
Group 5,RRG,-0.5,12,14,3770,12,2016,9,3
Group 5,RRG,-0.5,12,14,3771,11,2016,11,0
Group 5,RRG,-0.5,12,14,3772,11,2016,12,-1
Group 5,RRG,-0.5,12,14,3773,11,2016,11,0
Group 5,RRG,-0.5,12,14,3774,10,2016,5,5
Group 5,RRG,-0.5,12,14,3775,9,2016,6,3
Group 5,RRG,-0.5,12,14,3776,12,2016,10,2
Group 5,RRG,-0.5,12,14,3777,13,2016,9,4
Group 5,RRG,-0.5,12,14,3778,7,2016,8,-1
Group 5,RRG,-0.5,12,14,3779,10,2016,8,2
Group 5,RRG,-0.5,12,14,3780,13,2016,10,3
Group 5,RRG,-0.5,12,14,3781,12,2016,7,5
Group 5,RRG,-0.5,12,14,3782,13,2016,8,5
Group 5,RRG,-0.5,12,14,3783,10,2016,8,2
Group 5,RRG,-0.5,12,14,3784,11,2016,4,7
Group 5,RRG,-0.5,12,14,3785,11,2016,7,4
Group 5,RRG,-0.5,12,14,3786,10,2016,8,2
Group 5,RRG,-0.5,12,14,3787,9,2016,10,-1
Group 5,RRG,-0.5,12,14,3788,10,2016,9,1
Group 5,RRG,-0.5,12,14,3789,11,2016,7,4
Group 5,RRG,-0.5,12,14,3790,8,2016,5,3
Group 5,RRG,-0.5,12,14,3791,11,2016,9,2
Group 5,RRG,-0.5,12,14,3792,8,2016,6,2
Group 5,RRG,-0.5,12,14,3793,9,2016,9,0
Group 5,RRG,-0.5,12,14,3794,12,2016,13,-1
Group 5,RRG,-0.5,12,14,3795,11,2016,10,1
Group 5,RRG,-0.5,12,14,3796,10,2016,10,0
Group 5,RRG,-0.5,12,14,3797,4,2016,8,-4
Group 5,RRG,-0.5,12,14,3798,8,2016,9,-1
Group 5,RRG,-0.5,12,14,3799,11,2016,12,-1
Group 5,RRG,-0.5,12,14,3800,12,2016,8,4
Group 5,RRG,-0.5,12,14,3801,11,2016,8,3
Group 5,RRG,-0.5,12,14,3802,12,2016,4,8
Group 5,RRG,-0.5,12,14,3803,11,2016,11,0
Group 5,RRG,-0.5,12,14,3804,12,2016,8,4
Group 5,RRG,-0.5,12,14,3805,9,2016,11,-2
Group 5,RRG,-0.5,12,14,3806,11,2016,7,4
Group 5,RRG,-0.5,12,14,3807,13,2016,11,2
Group 5,RRG,-0.5,12,14,3808,8,2016,11,-3
Group 5,RRG,-0.5,12,14,3809,10,2016,7,3
Group 5,RRG,-0.5,12,14,3810,12,2016,7,5
Group 5,RRG,-0.5,12,14,3811,9,2016,10,-1
Group 5,RRG,-0.5,12,14,3812,13,2016,12,1
Group 5,RRG,-0.5,12,14,3813,11,2016,11,0
Group 5,RRG,-0.5,12,14,3814,8,2016,6,2
Group 5,RRG,-0.5,12,14,3815,12,2016,7,5
Group 5,RRG,-0.5,12,14,3816,12,2016,9,3
Group 5,RRG,-0.5,12,14,3817,12,2016,9,3
Group 5,RRG,-0.5,12,14,3818,13,2016,2,11
Group 5,RRG,-0.5,12,14,3819,8,2016,8,0
Group 5,RRG,-0.5,12,14,3820,10,2016,10,0
Group 5,RRG,-0.5,12,14,3821,10,2016,7,3
Group 5,RRG,-0.5,12,14,3822,13,2016,9,4
Group 5,RRG,-0.5,12,14,3823,11,2016,3,8
Group 5,RRG,-0.5,12,14,3824,13,2016,7,6
Group 5,RRG,-0.5,12,14,3825,12,2016,9,3
Group 5,RRG,-0.5,12,14,3826,11,2016,10,1
Group 5,RRG,-0.5,12,14,3827,10,2016,5,5
Group 5,RRG,-0.5,12,14,3828,11,2016,6,5
Group 5,RRG,-0.5,12,14,3829,11,2016,4,7
Group 5,RRG,-0.5,12,14,3830,13,2016,6,7
Group 5,RRG,-0.5,12,14,3831,11,2016,10,1
Group 5,RRG,-0.5,12,14,3832,10,2016,9,1
Group 5,RRG,-0.5,12,14,3833,12,2016,8,4
Group 5,RRG,-0.5,12,14,3834,10,2016,9,1
Group 5,RRG,-0.5,12,14,3835,13,2016,9,4
Group 5,RRG,-0.5,12,14,3836,12,2016,8,4
Group 5,RRG,-0.5,12,14,3837,10,2016,9,1
Group 5,RRG,-0.5,12,14,3838,11,2016,5,6
Group 5,RRG,-0.5,12,14,3839,10,2016,7,3
Group 5,RRG,-0.5,12,14,3840,11,2016,7,4
Group 5,RRG,-0.5,12,14,3841,9,2016,11,-2
Group 5,RRG,-0.5,12,14,3842,8,2016,9,-1
Group 5,RRG,-0.5,12,14,3843,13,2016,10,3
Group 5,RRG,-0.5,12,14,3844,10,2016,10,0
Group 5,RRG,-0.5,12,14,3845,13,2016,10,3
Group 5,RRG,-0.5,12,14,3846,10,2016,5,5
Group 5,RRG,-0.5,12,14,3847,10,2016,5,5
Group 5,RRG,-0.5,12,14,3848,13,2016,7,6
Group 5,RRG,-0.5,12,14,3849,14,2016,5,9
Group 5,RRG,-0.5,12,14,3850,12,2016,8,4
Group 5,RRG,-0.5,12,14,3851,8,2016,9,-1
Group 5,RRG,-0.5,12,14,3852,10,2016,10,0
Group 5,RRG,-0.5,12,14,3853,7,2016,7,0
Group 5,RRG,-0.5,12,14,3854,13,2016,12,1
Group 5,RRG,-0.5,12,14,3855,13,2016,7,6
Group 5,RRG,-0.5,12,14,3856,8,2016,10,-2
Group 5,RRG,-0.5,12,14,3857,7,2016,8,-1
Group 5,RRG,-0.5,12,14,3858,10,2016,6,4
Group 5,RRG,-0.5,12,14,3859,10,2016,9,1
Group 5,RRG,-0.5,12,14,3860,12,2016,9,3
Group 5,RRG,-0.5,12,14,3861,11,2016,11,0
Group 5,RRG,-0.5,12,14,3862,12,2016,11,1
Group 5,RRG,-0.5,12,14,3863,12,2016,10,2
Group 5,RRG,-0.5,12,14,3864,11,2016,8,3
Group 5,RRG,-0.5,12,14,3865,13,2016,11,2
Group 5,RRG,-0.5,12,14,3866,10,2016,5,5
Group 5,RRG,-0.5,12,14,3867,10,2016,10,0
Group 5,RRG,-0.5,12,14,3868,10,2016,10,0
Group 5,RRG,-0.5,12,14,3869,10,2016,7,3
Group 5,RRG,-0.5,12,14,3870,9,2016,11,-2
Group 5,RRG,-0.5,12,14,3871,12,2016,10,2
Group 5,RRG,-0.5,12,14,3872,11,2016,7,4
Group 5,RRG,-0.5,12,14,3873,8,2016,11,-3
Group 5,RRG,-0.5,12,14,3874,10,2016,12,-2
Group 5,RRG,-0.5,12,14,3875,11,2016,9,2
Group 5,RRG,-0.5,12,14,3876,9,2016,5,4
Group 5,RRG,-0.5,12,14,3877,13,2016,7,6
Group 5,RRG,-0.5,12,14,3878,9,2016,8,1
Group 5,RRG,-0.5,12,14,3879,13,2016,7,6
Group 5,RRG,-0.5,12,14,3880,9,2016,6,3
Group 5,RRG,-0.5,12,14,3881,13,2016,8,5
Group 5,RRG,-0.5,12,14,3882,13,2016,10,3
Group 5,RRG,-0.5,12,14,3883,10,2016,3,7
Group 5,RRG,-0.5,12,14,3884,7,2016,8,-1
Group 5,RRG,-0.5,12,14,3885,10,2016,8,2
Group 5,RRG,-0.5,12,14,3886,9,2016,9,0
Group 5,RRG,-0.5,12,14,3887,11,2016,5,6
Group 5,RRG,-0.5,12,14,3888,14,2016,5,9
Group 5,RRG,-0.5,12,14,3889,13,2016,8,5
Group 5,RRG,-0.5,12,14,3890,8,2016,6,2
Group 5,RRG,-0.5,12,14,3891,9,2016,6,3
Group 5,RRG,-0.5,12,14,3892,10,2016,13,-3
Group 5,RRG,-0.5,12,14,3893,7,2016,5,2
Group 5,RRG,-0.5,12,14,3894,12,2016,8,4
Group 5,RRG,-0.5,12,14,3895,7,2016,9,-2
Group 5,RRG,-0.5,12,14,3896,11,2016,10,1
Group 5,RRG,-0.5,12,14,3897,8,2016,9,-1
Group 5,RRG,-0.5,12,14,3898,9,2016,9,0
Group 5,RRG,-0.5,12,14,3899,11,2016,7,4
Group 5,RRG,-0.5,12,14,3900,6,2016,7,-1
Group 5,RRG,-0.5,12,14,3901,12,2016,5,7
Group 5,RRG,-0.5,12,14,3902,8,2016,10,-2
Group 5,RRG,-0.5,12,14,3903,12,2016,10,2
Group 5,RRG,-0.5,12,14,3904,13,2016,12,1
Group 5,RRG,-0.5,12,14,3905,8,2016,6,2
Group 5,RRG,-0.5,12,14,3906,10,2016,9,1
Group 5,RRG,-0.5,12,14,3907,12,2016,11,1
Group 5,RRG,-0.5,12,14,3908,12,2016,8,4
Group 5,RRG,-0.5,12,14,3909,10,2016,10,0
Group 5,RRG,-0.5,12,14,3910,8,2016,8,0
Group 5,RRG,-0.5,12,14,3911,12,2016,7,5
Group 5,RRG,-0.5,12,14,3912,9,2016,7,2
Group 5,RRG,-0.5,12,14,3913,11,2016,5,6
Group 5,RRG,-0.5,12,14,3914,12,2016,6,6
Group 5,RRG,-0.5,12,14,3915,12,2016,5,7
Group 5,RRG,-0.5,12,14,3916,11,2016,9,2
Group 5,RRG,-0.5,12,14,3917,13,2016,10,3
Group 5,RRG,-0.5,12,14,3918,11,2016,7,4
Group 5,RRG,-0.5,12,14,3919,12,2016,8,4
Group 5,RRG,-0.5,12,14,3920,10,2016,7,3
Group 5,RRG,-0.5,12,14,3921,8,2016,9,-1
Group 5,RRG,-0.5,12,14,3922,4,2016,11,-7
Group 5,RRG,-0.5,12,14,3923,10,2016,7,3
Group 5,RRG,-0.5,12,14,3924,12,2016,6,6
Group 5,RRG,-0.5,12,14,3925,13,2016,9,4
Group 5,RRG,-0.5,12,14,3926,6,2016,9,-3
Group 5,RRG,-0.5,12,14,3927,9,2016,12,-3
Group 5,RRG,-0.5,12,14,3928,11,2016,3,8
Group 5,RRG,-0.5,12,14,3929,11,2016,6,5
Group 5,RRG,-0.5,12,14,3930,10,2016,10,0
Group 5,RRG,-0.5,12,14,3931,11,2016,6,5
Group 5,RRG,-0.5,12,14,3932,8,2016,5,3
Group 5,RRG,-0.5,12,14,3933,11,2016,10,1
Group 5,RRG,-0.5,12,14,3934,13,2016,12,1
Group 5,RRG,-0.5,12,14,3935,11,2016,9,2
Group 5,RRG,-0.5,12,14,3936,11,2016,6,5
Group 5,RRG,-0.5,12,14,3937,10,2016,4,6
Group 5,RRG,-0.5,12,14,3938,10,2016,6,4
Group 5,RRG,-0.5,12,14,3939,13,2016,9,4
Group 5,RRG,-0.5,12,14,3940,9,2016,9,0
Group 5,RRG,-0.5,12,14,3941,13,2016,7,6
Group 5,RRG,-0.5,12,14,3942,10,2016,7,3
Group 5,RRG,-0.5,12,14,3943,6,2016,9,-3
Group 5,RRG,-0.5,12,14,3944,7,2016,9,-2
Group 5,RRG,-0.5,12,14,3945,11,2016,9,2
Group 5,RRG,-0.5,12,14,3946,9,2016,11,-2
Group 5,RRG,-0.5,12,14,3947,10,2016,10,0
Group 5,RRG,-0.5,12,14,3948,14,2016,7,7
Group 5,RRG,-0.5,12,14,3949,6,2016,9,-3
Group 5,RRG,-0.5,12,14,3950,7,2016,8,-1
Group 5,RRG,-0.5,12,14,3951,9,2016,10,-1
Group 5,RRG,-0.5,12,14,3952,13,2016,10,3
Group 5,RRG,-0.5,12,14,3953,10,2016,7,3
Group 5,RRG,-0.5,12,14,3954,12,2016,8,4
Group 5,RRG,-0.5,12,14,3955,9,2016,8,1
Group 5,RRG,-0.5,12,14,3956,9,2016,7,2
Group 5,RRG,-0.5,12,14,3957,12,2016,13,-1
Group 5,RRG,-0.5,12,14,3958,11,2016,8,3
Group 5,RRG,-0.5,12,14,3959,12,2016,8,4
Group 5,RRG,-0.5,12,14,3960,12,2016,10,2
Group 5,RRG,-0.5,12,14,3961,12,2016,7,5
Group 5,RRG,-0.5,12,14,3962,9,2016,11,-2
Group 5,RRG,-0.5,12,14,3963,11,2016,10,1
Group 5,RRG,-0.5,12,14,3964,9,2016,6,3
Group 5,RRG,-0.5,12,14,3965,11,2016,6,5
Group 5,RRG,-0.5,12,14,3966,9,2016,6,3
Group 5,RRG,-0.5,12,14,3967,10,2016,11,-1
Group 5,RRG,-0.5,12,14,3968,9,2016,9,0
Group 5,RRG,-0.5,12,14,3969,11,2016,7,4
Group 5,RRG,-0.5,12,14,3970,13,2016,7,6
Group 5,RRG,-0.5,12,14,3971,12,2016,6,6
Group 5,RRG,-0.5,12,14,3972,10,2016,8,2
Group 5,RRG,-0.5,12,14,3973,14,2016,9,5
Group 5,RRG,-0.5,12,14,3974,10,2016,8,2
Group 5,RRG,-0.5,12,14,3975,13,2016,9,4
Group 5,RRG,-0.5,12,14,3976,13,2016,8,5
Group 5,RRG,-0.5,12,14,3977,13,2016,7,6
Group 5,RRG,-0.5,12,14,3978,13,2016,8,5
Group 5,RRG,-0.5,12,14,3979,10,2016,7,3
Group 5,RRG,-0.5,12,14,3980,10,2016,6,4
Group 5,RRG,-0.5,12,14,3981,7,2016,9,-2
Group 5,RRG,-0.5,12,14,3982,12,2016,8,4
Group 5,RRG,-0.5,12,14,3983,11,2016,9,2
Group 5,RRG,-0.5,12,14,3984,11,2016,8,3
Group 5,RRG,-0.5,12,14,3985,9,2016,8,1
Group 5,RRG,-0.5,12,14,3986,11,2016,8,3
Group 5,RRG,-0.5,12,14,3987,10,2016,4,6
Group 5,RRG,-0.5,12,14,3988,9,2016,7,2
Group 5,RRG,-0.5,12,14,3989,10,2016,11,-1
Group 5,RRG,-0.5,12,14,3990,10,2016,8,2
Group 5,RRG,-0.5,12,14,3991,10,2016,7,3
Group 5,RRG,-0.5,12,14,3992,12,2016,7,5
Group 5,RRG,-0.5,12,14,3993,14,2016,8,6
Group 5,RRG,-0.5,12,14,3994,11,2016,11,0
Group 5,RRG,-0.5,12,14,3995,11,2016,11,0
Group 5,RRG,-0.5,12,14,3996,11,2016,11,0
Group 5,RRG,-0.5,12,14,3997,9,2016,9,0
Group 5,RRG,-0.5,12,14,3998,12,2016,9,3
Group 5,RRG,-0.5,12,14,3999,7,2016,10,-3
Group 5,RRG,-0.5,12,14,4000,6,2016,8,-2
Group 1,BB,1.5,14,14,1,12,2018,11,1
Group 1,BB,1.5,14,14,2,11,2018,8,3
Group 1,BB,1.5,14,14,3,14,2018,12,2
Group 1,BB,1.5,14,14,4,9,2018,11,-2
Group 1,BB,1.5,14,14,5,10,2018,13,-3
Group 1,BB,1.5,14,14,6,8,2018,12,-4
Group 1,BB,1.5,14,14,7,14,2018,8,6
Group 1,BB,1.5,14,14,8,9,2018,12,-3
Group 1,BB,1.5,14,14,9,14,2018,10,4
Group 1,BB,1.5,14,14,10,9,2018,11,-2
Group 1,BB,1.5,14,14,11,9,2018,12,-3
Group 1,BB,1.5,14,14,12,12,2018,12,0
Group 1,BB,1.5,14,14,13,11,2018,11,0
Group 1,BB,1.5,14,14,14,10,2018,9,1
Group 1,BB,1.5,14,14,15,12,2018,8,4
Group 1,BB,1.5,14,14,16,14,2018,9,5
Group 1,BB,1.5,14,14,17,13,2018,9,4
Group 1,BB,1.5,14,14,18,8,2018,12,-4
Group 1,BB,1.5,14,14,19,7,2018,11,-4
Group 1,BB,1.5,14,14,20,12,2018,9,3
Group 1,BB,1.5,14,14,21,8,2018,11,-3
Group 1,BB,1.5,14,14,22,9,2018,8,1
Group 1,BB,1.5,14,14,23,12,2018,9,3
Group 1,BB,1.5,14,14,24,14,2018,11,3
Group 1,BB,1.5,14,14,25,7,2018,12,-5
Group 1,BB,1.5,14,14,26,10,2018,11,-1
Group 1,BB,1.5,14,14,27,13,2018,10,3
Group 1,BB,1.5,14,14,28,11,2018,10,1
Group 1,BB,1.5,14,14,29,9,2018,10,-1
Group 1,BB,1.5,14,14,30,10,2018,8,2
Group 1,BB,1.5,14,14,31,11,2018,8,3
Group 1,BB,1.5,14,14,32,10,2018,11,-1
Group 1,BB,1.5,14,14,33,10,2018,12,-2
Group 1,BB,1.5,14,14,34,10,2018,10,0
Group 1,BB,1.5,14,14,35,12,2018,9,3
Group 1,BB,1.5,14,14,36,14,2018,11,3
Group 1,BB,1.5,14,14,37,8,2018,10,-2
Group 1,BB,1.5,14,14,38,14,2018,8,6
Group 1,BB,1.5,14,14,39,13,2018,11,2
Group 1,BB,1.5,14,14,40,12,2018,8,4
Group 1,BB,1.5,14,14,41,12,2018,11,1
Group 1,BB,1.5,14,14,42,12,2018,9,3
Group 1,BB,1.5,14,14,43,10,2018,12,-2
Group 1,BB,1.5,14,14,44,9,2018,11,-2
Group 1,BB,1.5,14,14,45,11,2018,12,-1
Group 1,BB,1.5,14,14,46,10,2018,9,1
Group 1,BB,1.5,14,14,47,7,2018,10,-3
Group 1,BB,1.5,14,14,48,11,2018,8,3
Group 1,BB,1.5,14,14,49,9,2018,11,-2
Group 1,BB,1.5,14,14,50,12,2018,10,2
Group 1,BB,1.5,14,14,51,11,2018,11,0
Group 1,BB,1.5,14,14,52,13,2018,9,4
Group 1,BB,1.5,14,14,53,10,2018,10,0
Group 1,BB,1.5,14,14,54,13,2018,9,4
Group 1,BB,1.5,14,14,55,11,2018,8,3
Group 1,BB,1.5,14,14,56,8,2018,7,1
Group 1,BB,1.5,14,14,57,11,2018,13,-2
Group 1,BB,1.5,14,14,58,11,2018,10,1
Group 1,BB,1.5,14,14,59,10,2018,14,-4
Group 1,BB,1.5,14,14,60,10,2018,10,0
Group 1,BB,1.5,14,14,61,12,2018,10,2
Group 1,BB,1.5,14,14,62,12,2018,12,0
Group 1,BB,1.5,14,14,63,11,2018,10,1
Group 1,BB,1.5,14,14,64,11,2018,7,4
Group 1,BB,1.5,14,14,65,7,2018,7,0
Group 1,BB,1.5,14,14,66,13,2018,13,0
Group 1,BB,1.5,14,14,67,11,2018,8,3
Group 1,BB,1.5,14,14,68,12,2018,6,6
Group 1,BB,1.5,14,14,69,8,2018,10,-2
Group 1,BB,1.5,14,14,70,12,2018,12,0
Group 1,BB,1.5,14,14,71,11,2018,13,-2
Group 1,BB,1.5,14,14,72,11,2018,6,5
Group 1,BB,1.5,14,14,73,8,2018,10,-2
Group 1,BB,1.5,14,14,74,11,2018,8,3
Group 1,BB,1.5,14,14,75,8,2018,11,-3
Group 1,BB,1.5,14,14,76,12,2018,11,1
Group 1,BB,1.5,14,14,77,10,2018,12,-2
Group 1,BB,1.5,14,14,78,8,2018,10,-2
Group 1,BB,1.5,14,14,79,11,2018,10,1
Group 1,BB,1.5,14,14,80,10,2018,9,1
Group 1,BB,1.5,14,14,81,8,2018,10,-2
Group 1,BB,1.5,14,14,82,9,2018,10,-1
Group 1,BB,1.5,14,14,83,9,2018,8,1
Group 1,BB,1.5,14,14,84,12,2018,10,2
Group 1,BB,1.5,14,14,85,8,2018,10,-2
Group 1,BB,1.5,14,14,86,10,2018,8,2
Group 1,BB,1.5,14,14,87,10,2018,10,0
Group 1,BB,1.5,14,14,88,12,2018,11,1
Group 1,BB,1.5,14,14,89,9,2018,11,-2
Group 1,BB,1.5,14,14,90,12,2018,8,4
Group 1,BB,1.5,14,14,91,11,2018,8,3
Group 1,BB,1.5,14,14,92,13,2018,9,4
Group 1,BB,1.5,14,14,93,12,2018,11,1
Group 1,BB,1.5,14,14,94,12,2018,9,3
Group 1,BB,1.5,14,14,95,10,2018,9,1
Group 1,BB,1.5,14,14,96,14,2018,11,3
Group 1,BB,1.5,14,14,97,8,2018,12,-4
Group 1,BB,1.5,14,14,98,10,2018,11,-1
Group 1,BB,1.5,14,14,99,6,2018,8,-2
Group 1,BB,1.5,14,14,100,10,2018,14,-4
Group 1,BB,1.5,14,14,101,13,2018,13,0
Group 1,BB,1.5,14,14,102,8,2018,8,0
Group 1,BB,1.5,14,14,103,12,2018,8,4
Group 1,BB,1.5,14,14,104,9,2018,13,-4
Group 1,BB,1.5,14,14,105,10,2018,6,4
Group 1,BB,1.5,14,14,106,11,2018,10,1
Group 1,BB,1.5,14,14,107,10,2018,7,3
Group 1,BB,1.5,14,14,108,13,2018,12,1
Group 1,BB,1.5,14,14,109,10,2018,11,-1
Group 1,BB,1.5,14,14,110,14,2018,9,5
Group 1,BB,1.5,14,14,111,12,2018,9,3
Group 1,BB,1.5,14,14,112,9,2018,13,-4
Group 1,BB,1.5,14,14,113,11,2018,10,1
Group 1,BB,1.5,14,14,114,12,2018,10,2
Group 1,BB,1.5,14,14,115,9,2018,12,-3
Group 1,BB,1.5,14,14,116,10,2018,9,1
Group 1,BB,1.5,14,14,117,11,2018,9,2
Group 1,BB,1.5,14,14,118,8,2018,9,-1
Group 1,BB,1.5,14,14,119,8,2018,11,-3
Group 1,BB,1.5,14,14,120,11,2018,11,0
Group 1,BB,1.5,14,14,121,11,2018,11,0
Group 1,BB,1.5,14,14,122,11,2018,7,4
Group 1,BB,1.5,14,14,123,8,2018,8,0
Group 1,BB,1.5,14,14,124,13,2018,10,3
Group 1,BB,1.5,14,14,125,11,2018,12,-1
Group 1,BB,1.5,14,14,126,12,2018,11,1
Group 1,BB,1.5,14,14,127,8,2018,12,-4
Group 1,BB,1.5,14,14,128,8,2018,10,-2
Group 1,BB,1.5,14,14,129,12,2018,14,-2
Group 1,BB,1.5,14,14,130,13,2018,14,-1
Group 1,BB,1.5,14,14,131,13,2018,8,5
Group 1,BB,1.5,14,14,132,7,2018,12,-5
Group 1,BB,1.5,14,14,133,13,2018,9,4
Group 1,BB,1.5,14,14,134,13,2018,11,2
Group 1,BB,1.5,14,14,135,7,2018,10,-3
Group 1,BB,1.5,14,14,136,13,2018,9,4
Group 1,BB,1.5,14,14,137,12,2018,5,7
Group 1,BB,1.5,14,14,138,11,2018,9,2
Group 1,BB,1.5,14,14,139,11,2018,11,0
Group 1,BB,1.5,14,14,140,9,2018,7,2
Group 1,BB,1.5,14,14,141,8,2018,11,-3
Group 1,BB,1.5,14,14,142,9,2018,10,-1
Group 1,BB,1.5,14,14,143,10,2018,8,2
Group 1,BB,1.5,14,14,144,12,2018,10,2
Group 1,BB,1.5,14,14,145,13,2018,12,1
Group 1,BB,1.5,14,14,146,9,2018,10,-1
Group 1,BB,1.5,14,14,147,13,2018,11,2
Group 1,BB,1.5,14,14,148,10,2018,11,-1
Group 1,BB,1.5,14,14,149,11,2018,9,2
Group 1,BB,1.5,14,14,150,10,2018,14,-4
Group 1,BB,1.5,14,14,151,11,2018,11,0
Group 1,BB,1.5,14,14,152,11,2018,10,1
Group 1,BB,1.5,14,14,153,9,2018,11,-2
Group 1,BB,1.5,14,14,154,10,2018,13,-3
Group 1,BB,1.5,14,14,155,8,2018,7,1
Group 1,BB,1.5,14,14,156,14,2018,13,1
Group 1,BB,1.5,14,14,157,11,2018,8,3
Group 1,BB,1.5,14,14,158,9,2018,8,1
Group 1,BB,1.5,14,14,159,11,2018,10,1
Group 1,BB,1.5,14,14,160,10,2018,10,0
Group 1,BB,1.5,14,14,161,10,2018,10,0
Group 1,BB,1.5,14,14,162,14,2018,12,2
Group 1,BB,1.5,14,14,163,12,2018,11,1
Group 1,BB,1.5,14,14,164,9,2018,10,-1
Group 1,BB,1.5,14,14,165,8,2018,9,-1
Group 1,BB,1.5,14,14,166,13,2018,10,3
Group 1,BB,1.5,14,14,167,10,2018,8,2
Group 1,BB,1.5,14,14,168,9,2018,11,-2
Group 1,BB,1.5,14,14,169,10,2018,9,1
Group 1,BB,1.5,14,14,170,14,2018,13,1
Group 1,BB,1.5,14,14,171,12,2018,11,1
Group 1,BB,1.5,14,14,172,12,2018,11,1
Group 1,BB,1.5,14,14,173,10,2018,9,1
Group 1,BB,1.5,14,14,174,10,2018,9,1
Group 1,BB,1.5,14,14,175,10,2018,11,-1
Group 1,BB,1.5,14,14,176,11,2018,12,-1
Group 1,BB,1.5,14,14,177,11,2018,12,-1
Group 1,BB,1.5,14,14,178,12,2018,12,0
Group 1,BB,1.5,14,14,179,11,2018,9,2
Group 1,BB,1.5,14,14,180,10,2018,9,1
Group 1,BB,1.5,14,14,181,13,2018,11,2
Group 1,BB,1.5,14,14,182,12,2018,10,2
Group 1,BB,1.5,14,14,183,12,2018,9,3
Group 1,BB,1.5,14,14,184,11,2018,12,-1
Group 1,BB,1.5,14,14,185,9,2018,11,-2
Group 1,BB,1.5,14,14,186,12,2018,9,3
Group 1,BB,1.5,14,14,187,11,2018,10,1
Group 1,BB,1.5,14,14,188,12,2018,11,1
Group 1,BB,1.5,14,14,189,9,2018,9,0
Group 1,BB,1.5,14,14,190,10,2018,8,2
Group 1,BB,1.5,14,14,191,13,2018,10,3
Group 1,BB,1.5,14,14,192,12,2018,7,5
Group 1,BB,1.5,14,14,193,13,2018,12,1
Group 1,BB,1.5,14,14,194,10,2018,11,-1
Group 1,BB,1.5,14,14,195,12,2018,11,1
Group 1,BB,1.5,14,14,196,11,2018,10,1
Group 1,BB,1.5,14,14,197,12,2018,8,4
Group 1,BB,1.5,14,14,198,12,2018,8,4
Group 1,BB,1.5,14,14,199,9,2018,5,4
Group 1,BB,1.5,14,14,200,12,2018,7,5
Group 1,BB,1.5,14,14,201,12,2018,10,2
Group 1,BB,1.5,14,14,202,10,2018,12,-2
Group 1,BB,1.5,14,14,203,12,2018,10,2
Group 1,BB,1.5,14,14,204,11,2018,5,6
Group 1,BB,1.5,14,14,205,9,2018,10,-1
Group 1,BB,1.5,14,14,206,12,2018,10,2
Group 1,BB,1.5,14,14,207,12,2018,9,3
Group 1,BB,1.5,14,14,208,9,2018,8,1
Group 1,BB,1.5,14,14,209,12,2018,11,1
Group 1,BB,1.5,14,14,210,13,2018,11,2
Group 1,BB,1.5,14,14,211,9,2018,12,-3
Group 1,BB,1.5,14,14,212,11,2018,12,-1
Group 1,BB,1.5,14,14,213,9,2018,7,2
Group 1,BB,1.5,14,14,214,10,2018,11,-1
Group 1,BB,1.5,14,14,215,10,2018,9,1
Group 1,BB,1.5,14,14,216,10,2018,3,7
Group 1,BB,1.5,14,14,217,10,2018,10,0
Group 1,BB,1.5,14,14,218,10,2018,9,1
Group 1,BB,1.5,14,14,219,8,2018,10,-2
Group 1,BB,1.5,14,14,220,12,2018,9,3
Group 1,BB,1.5,14,14,221,12,2018,7,5
Group 1,BB,1.5,14,14,222,12,2018,11,1
Group 1,BB,1.5,14,14,223,11,2018,11,0
Group 1,BB,1.5,14,14,224,12,2018,11,1
Group 1,BB,1.5,14,14,225,11,2018,8,3
Group 1,BB,1.5,14,14,226,9,2018,10,-1
Group 1,BB,1.5,14,14,227,13,2018,9,4
Group 1,BB,1.5,14,14,228,13,2018,9,4
Group 1,BB,1.5,14,14,229,11,2018,8,3
Group 1,BB,1.5,14,14,230,9,2018,9,0
Group 1,BB,1.5,14,14,231,12,2018,13,-1
Group 1,BB,1.5,14,14,232,13,2018,13,0
Group 1,BB,1.5,14,14,233,11,2018,10,1
Group 1,BB,1.5,14,14,234,11,2018,10,1
Group 1,BB,1.5,14,14,235,11,2018,10,1
Group 1,BB,1.5,14,14,236,11,2018,9,2
Group 1,BB,1.5,14,14,237,11,2018,11,0
Group 1,BB,1.5,14,14,238,13,2018,10,3
Group 1,BB,1.5,14,14,239,12,2018,10,2
Group 1,BB,1.5,14,14,240,10,2018,13,-3
Group 1,BB,1.5,14,14,241,11,2018,11,0
Group 1,BB,1.5,14,14,242,13,2018,12,1
Group 1,BB,1.5,14,14,243,13,2018,12,1
Group 1,BB,1.5,14,14,244,14,2018,12,2
Group 1,BB,1.5,14,14,245,10,2018,10,0
Group 1,BB,1.5,14,14,246,11,2018,11,0
Group 1,BB,1.5,14,14,247,10,2018,10,0
Group 1,BB,1.5,14,14,248,10,2018,9,1
Group 1,BB,1.5,14,14,249,13,2018,10,3
Group 1,BB,1.5,14,14,250,12,2018,8,4
Group 1,BB,1.5,14,14,251,11,2018,9,2
Group 1,BB,1.5,14,14,252,10,2018,11,-1
Group 1,BB,1.5,14,14,253,11,2018,12,-1
Group 1,BB,1.5,14,14,254,10,2018,10,0
Group 1,BB,1.5,14,14,255,11,2018,7,4
Group 1,BB,1.5,14,14,256,13,2018,12,1
Group 1,BB,1.5,14,14,257,10,2018,9,1
Group 1,BB,1.5,14,14,258,11,2018,12,-1
Group 1,BB,1.5,14,14,259,9,2018,9,0
Group 1,BB,1.5,14,14,260,14,2018,7,7
Group 1,BB,1.5,14,14,261,9,2018,12,-3
Group 1,BB,1.5,14,14,262,11,2018,12,-1
Group 1,BB,1.5,14,14,263,13,2018,8,5
Group 1,BB,1.5,14,14,264,12,2018,12,0
Group 1,BB,1.5,14,14,265,9,2018,6,3
Group 1,BB,1.5,14,14,266,12,2018,8,4
Group 1,BB,1.5,14,14,267,9,2018,9,0
Group 1,BB,1.5,14,14,268,10,2018,12,-2
Group 1,BB,1.5,14,14,269,12,2018,14,-2
Group 1,BB,1.5,14,14,270,11,2018,11,0
Group 1,BB,1.5,14,14,271,11,2018,10,1
Group 1,BB,1.5,14,14,272,12,2018,8,4
Group 1,BB,1.5,14,14,273,13,2018,12,1
Group 1,BB,1.5,14,14,274,12,2018,10,2
Group 1,BB,1.5,14,14,275,10,2018,9,1
Group 1,BB,1.5,14,14,276,12,2018,9,3
Group 1,BB,1.5,14,14,277,12,2018,10,2
Group 1,BB,1.5,14,14,278,10,2018,14,-4
Group 1,BB,1.5,14,14,279,12,2018,10,2
Group 1,BB,1.5,14,14,280,11,2018,11,0
Group 1,BB,1.5,14,14,281,11,2018,8,3
Group 1,BB,1.5,14,14,282,10,2018,10,0
Group 1,BB,1.5,14,14,283,11,2018,9,2
Group 1,BB,1.5,14,14,284,7,2018,8,-1
Group 1,BB,1.5,14,14,285,11,2018,11,0
Group 1,BB,1.5,14,14,286,11,2018,8,3
Group 1,BB,1.5,14,14,287,12,2018,10,2
Group 1,BB,1.5,14,14,288,10,2018,10,0
Group 1,BB,1.5,14,14,289,10,2018,9,1
Group 1,BB,1.5,14,14,290,11,2018,10,1
Group 1,BB,1.5,14,14,291,12,2018,12,0
Group 1,BB,1.5,14,14,292,7,2018,13,-6
Group 1,BB,1.5,14,14,293,13,2018,10,3
Group 1,BB,1.5,14,14,294,12,2018,10,2
Group 1,BB,1.5,14,14,295,13,2018,10,3
Group 1,BB,1.5,14,14,296,10,2018,7,3
Group 1,BB,1.5,14,14,297,13,2018,8,5
Group 1,BB,1.5,14,14,298,11,2018,12,-1
Group 1,BB,1.5,14,14,299,9,2018,10,-1
Group 1,BB,1.5,14,14,300,9,2018,10,-1
Group 1,BB,1.5,14,14,301,10,2018,11,-1
Group 1,BB,1.5,14,14,302,9,2018,11,-2
Group 1,BB,1.5,14,14,303,7,2018,13,-6
Group 1,BB,1.5,14,14,304,13,2018,10,3
Group 1,BB,1.5,14,14,305,11,2018,9,2
Group 1,BB,1.5,14,14,306,10,2018,10,0
Group 1,BB,1.5,14,14,307,8,2018,11,-3
Group 1,BB,1.5,14,14,308,11,2018,12,-1
Group 1,BB,1.5,14,14,309,9,2018,9,0
Group 1,BB,1.5,14,14,310,10,2018,11,-1
Group 1,BB,1.5,14,14,311,8,2018,5,3
Group 1,BB,1.5,14,14,312,11,2018,9,2
Group 1,BB,1.5,14,14,313,12,2018,10,2
Group 1,BB,1.5,14,14,314,11,2018,12,-1
Group 1,BB,1.5,14,14,315,11,2018,13,-2
Group 1,BB,1.5,14,14,316,12,2018,11,1
Group 1,BB,1.5,14,14,317,10,2018,13,-3
Group 1,BB,1.5,14,14,318,10,2018,11,-1
Group 1,BB,1.5,14,14,319,11,2018,9,2
Group 1,BB,1.5,14,14,320,8,2018,10,-2
Group 1,BB,1.5,14,14,321,13,2018,10,3
Group 1,BB,1.5,14,14,322,9,2018,12,-3
Group 1,BB,1.5,14,14,323,9,2018,11,-2
Group 1,BB,1.5,14,14,324,12,2018,12,0
Group 1,BB,1.5,14,14,325,12,2018,9,3
Group 1,BB,1.5,14,14,326,10,2018,10,0
Group 1,BB,1.5,14,14,327,10,2018,9,1
Group 1,BB,1.5,14,14,328,9,2018,12,-3
Group 1,BB,1.5,14,14,329,10,2018,10,0
Group 1,BB,1.5,14,14,330,10,2018,11,-1
Group 1,BB,1.5,14,14,331,11,2018,14,-3
Group 1,BB,1.5,14,14,332,11,2018,11,0
Group 1,BB,1.5,14,14,333,9,2018,11,-2
Group 1,BB,1.5,14,14,334,11,2018,10,1
Group 1,BB,1.5,14,14,335,12,2018,9,3
Group 1,BB,1.5,14,14,336,11,2018,11,0
Group 1,BB,1.5,14,14,337,9,2018,9,0
Group 1,BB,1.5,14,14,338,11,2018,13,-2
Group 1,BB,1.5,14,14,339,13,2018,7,6
Group 1,BB,1.5,14,14,340,12,2018,12,0
Group 1,BB,1.5,14,14,341,12,2018,13,-1
Group 1,BB,1.5,14,14,342,9,2018,11,-2
Group 1,BB,1.5,14,14,343,10,2018,11,-1
Group 1,BB,1.5,14,14,344,7,2018,12,-5
Group 1,BB,1.5,14,14,345,11,2018,10,1
Group 1,BB,1.5,14,14,346,12,2018,10,2
Group 1,BB,1.5,14,14,347,9,2018,10,-1
Group 1,BB,1.5,14,14,348,11,2018,11,0
Group 1,BB,1.5,14,14,349,10,2018,11,-1
Group 1,BB,1.5,14,14,350,11,2018,9,2
Group 1,BB,1.5,14,14,351,11,2018,10,1
Group 1,BB,1.5,14,14,352,13,2018,12,1
Group 1,BB,1.5,14,14,353,9,2018,8,1
Group 1,BB,1.5,14,14,354,9,2018,7,2
Group 1,BB,1.5,14,14,355,10,2018,13,-3
Group 1,BB,1.5,14,14,356,12,2018,8,4
Group 1,BB,1.5,14,14,357,11,2018,12,-1
Group 1,BB,1.5,14,14,358,12,2018,11,1
Group 1,BB,1.5,14,14,359,12,2018,13,-1
Group 1,BB,1.5,14,14,360,11,2018,8,3
Group 1,BB,1.5,14,14,361,13,2018,9,4
Group 1,BB,1.5,14,14,362,11,2018,7,4
Group 1,BB,1.5,14,14,363,10,2018,8,2
Group 1,BB,1.5,14,14,364,6,2018,10,-4
Group 1,BB,1.5,14,14,365,11,2018,10,1
Group 1,BB,1.5,14,14,366,8,2018,9,-1
Group 1,BB,1.5,14,14,367,13,2018,8,5
Group 1,BB,1.5,14,14,368,11,2018,11,0
Group 1,BB,1.5,14,14,369,11,2018,13,-2
Group 1,BB,1.5,14,14,370,11,2018,10,1
Group 1,BB,1.5,14,14,371,8,2018,9,-1
Group 1,BB,1.5,14,14,372,11,2018,10,1
Group 1,BB,1.5,14,14,373,13,2018,11,2
Group 1,BB,1.5,14,14,374,11,2018,8,3
Group 1,BB,1.5,14,14,375,11,2018,10,1
Group 1,BB,1.5,14,14,376,10,2018,10,0
Group 1,BB,1.5,14,14,377,11,2018,13,-2
Group 1,BB,1.5,14,14,378,12,2018,10,2
Group 1,BB,1.5,14,14,379,9,2018,10,-1
Group 1,BB,1.5,14,14,380,11,2018,8,3
Group 1,BB,1.5,14,14,381,10,2018,11,-1
Group 1,BB,1.5,14,14,382,12,2018,4,8
Group 1,BB,1.5,14,14,383,12,2018,10,2
Group 1,BB,1.5,14,14,384,13,2018,12,1
Group 1,BB,1.5,14,14,385,13,2018,9,4
Group 1,BB,1.5,14,14,386,11,2018,14,-3
Group 1,BB,1.5,14,14,387,8,2018,10,-2
Group 1,BB,1.5,14,14,388,14,2018,12,2
Group 1,BB,1.5,14,14,389,10,2018,12,-2
Group 1,BB,1.5,14,14,390,12,2018,6,6
Group 1,BB,1.5,14,14,391,10,2018,7,3
Group 1,BB,1.5,14,14,392,9,2018,10,-1
Group 1,BB,1.5,14,14,393,11,2018,12,-1
Group 1,BB,1.5,14,14,394,11,2018,12,-1
Group 1,BB,1.5,14,14,395,10,2018,8,2
Group 1,BB,1.5,14,14,396,11,2018,10,1
Group 1,BB,1.5,14,14,397,11,2018,10,1
Group 1,BB,1.5,14,14,398,11,2018,9,2
Group 1,BB,1.5,14,14,399,10,2018,10,0
Group 1,BB,1.5,14,14,400,10,2018,8,2
Group 1,BB,1.5,14,14,401,11,2018,9,2
Group 1,BB,1.5,14,14,402,7,2018,12,-5
Group 1,BB,1.5,14,14,403,13,2018,9,4
Group 1,BB,1.5,14,14,404,13,2018,7,6
Group 1,BB,1.5,14,14,405,9,2018,10,-1
Group 1,BB,1.5,14,14,406,11,2018,9,2
Group 1,BB,1.5,14,14,407,10,2018,12,-2
Group 1,BB,1.5,14,14,408,11,2018,7,4
Group 1,BB,1.5,14,14,409,6,2018,8,-2
Group 1,BB,1.5,14,14,410,13,2018,10,3
Group 1,BB,1.5,14,14,411,12,2018,12,0
Group 1,BB,1.5,14,14,412,11,2018,11,0
Group 1,BB,1.5,14,14,413,10,2018,10,0
Group 1,BB,1.5,14,14,414,11,2018,10,1
Group 1,BB,1.5,14,14,415,11,2018,10,1
Group 1,BB,1.5,14,14,416,12,2018,12,0
Group 1,BB,1.5,14,14,417,12,2018,7,5
Group 1,BB,1.5,14,14,418,9,2018,10,-1
Group 1,BB,1.5,14,14,419,14,2018,13,1
Group 1,BB,1.5,14,14,420,10,2018,7,3
Group 1,BB,1.5,14,14,421,10,2018,11,-1
Group 1,BB,1.5,14,14,422,13,2018,11,2
Group 1,BB,1.5,14,14,423,11,2018,8,3
Group 1,BB,1.5,14,14,424,11,2018,9,2
Group 1,BB,1.5,14,14,425,10,2018,8,2
Group 1,BB,1.5,14,14,426,8,2018,9,-1
Group 1,BB,1.5,14,14,427,10,2018,12,-2
Group 1,BB,1.5,14,14,428,12,2018,10,2
Group 1,BB,1.5,14,14,429,13,2018,8,5
Group 1,BB,1.5,14,14,430,13,2018,10,3
Group 1,BB,1.5,14,14,431,11,2018,11,0
Group 1,BB,1.5,14,14,432,10,2018,12,-2
Group 1,BB,1.5,14,14,433,12,2018,11,1
Group 1,BB,1.5,14,14,434,11,2018,8,3
Group 1,BB,1.5,14,14,435,10,2018,10,0
Group 1,BB,1.5,14,14,436,10,2018,12,-2
Group 1,BB,1.5,14,14,437,13,2018,9,4
Group 1,BB,1.5,14,14,438,13,2018,12,1
Group 1,BB,1.5,14,14,439,12,2018,7,5
Group 1,BB,1.5,14,14,440,13,2018,8,5
Group 1,BB,1.5,14,14,441,12,2018,11,1
Group 1,BB,1.5,14,14,442,9,2018,12,-3
Group 1,BB,1.5,14,14,443,12,2018,12,0
Group 1,BB,1.5,14,14,444,10,2018,11,-1
Group 1,BB,1.5,14,14,445,13,2018,12,1
Group 1,BB,1.5,14,14,446,12,2018,10,2
Group 1,BB,1.5,14,14,447,12,2018,10,2
Group 1,BB,1.5,14,14,448,12,2018,9,3
Group 1,BB,1.5,14,14,449,12,2018,8,4
Group 1,BB,1.5,14,14,450,13,2018,10,3
Group 1,BB,1.5,14,14,451,9,2018,11,-2
Group 1,BB,1.5,14,14,452,14,2018,8,6
Group 1,BB,1.5,14,14,453,10,2018,8,2
Group 1,BB,1.5,14,14,454,11,2018,11,0
Group 1,BB,1.5,14,14,455,10,2018,10,0
Group 1,BB,1.5,14,14,456,12,2018,12,0
Group 1,BB,1.5,14,14,457,11,2018,6,5
Group 1,BB,1.5,14,14,458,9,2018,11,-2
Group 1,BB,1.5,14,14,459,10,2018,10,0
Group 1,BB,1.5,14,14,460,11,2018,10,1
Group 1,BB,1.5,14,14,461,12,2018,11,1
Group 1,BB,1.5,14,14,462,9,2018,11,-2
Group 1,BB,1.5,14,14,463,9,2018,13,-4
Group 1,BB,1.5,14,14,464,11,2018,11,0
Group 1,BB,1.5,14,14,465,12,2018,9,3
Group 1,BB,1.5,14,14,466,11,2018,9,2
Group 1,BB,1.5,14,14,467,7,2018,9,-2
Group 1,BB,1.5,14,14,468,12,2018,9,3
Group 1,BB,1.5,14,14,469,11,2018,12,-1
Group 1,BB,1.5,14,14,470,11,2018,7,4
Group 1,BB,1.5,14,14,471,12,2018,6,6
Group 1,BB,1.5,14,14,472,12,2018,7,5
Group 1,BB,1.5,14,14,473,9,2018,10,-1
Group 1,BB,1.5,14,14,474,11,2018,13,-2
Group 1,BB,1.5,14,14,475,12,2018,11,1
Group 1,BB,1.5,14,14,476,8,2018,13,-5
Group 1,BB,1.5,14,14,477,8,2018,10,-2
Group 1,BB,1.5,14,14,478,9,2018,10,-1
Group 1,BB,1.5,14,14,479,10,2018,10,0
Group 1,BB,1.5,14,14,480,11,2018,12,-1
Group 1,BB,1.5,14,14,481,12,2018,10,2
Group 1,BB,1.5,14,14,482,12,2018,11,1
Group 1,BB,1.5,14,14,483,13,2018,8,5
Group 1,BB,1.5,14,14,484,10,2018,11,-1
Group 1,BB,1.5,14,14,485,8,2018,11,-3
Group 1,BB,1.5,14,14,486,11,2018,10,1
Group 1,BB,1.5,14,14,487,8,2018,12,-4
Group 1,BB,1.5,14,14,488,9,2018,10,-1
Group 1,BB,1.5,14,14,489,11,2018,12,-1
Group 1,BB,1.5,14,14,490,10,2018,10,0
Group 1,BB,1.5,14,14,491,12,2018,10,2
Group 1,BB,1.5,14,14,492,10,2018,10,0
Group 1,BB,1.5,14,14,493,14,2018,7,7
Group 1,BB,1.5,14,14,494,12,2018,8,4
Group 1,BB,1.5,14,14,495,6,2018,9,-3
Group 1,BB,1.5,14,14,496,12,2018,10,2
Group 1,BB,1.5,14,14,497,6,2018,9,-3
Group 1,BB,1.5,14,14,498,10,2018,10,0
Group 1,BB,1.5,14,14,499,11,2018,9,2
Group 1,BB,1.5,14,14,500,12,2018,8,4
Group 1,BB,1.5,14,14,501,12,2018,13,-1
Group 1,BB,1.5,14,14,502,10,2018,6,4
Group 1,BB,1.5,14,14,503,11,2018,12,-1
Group 1,BB,1.5,14,14,504,9,2018,7,2
Group 1,BB,1.5,14,14,505,10,2018,6,4
Group 1,BB,1.5,14,14,506,11,2018,6,5
Group 1,BB,1.5,14,14,507,10,2018,12,-2
Group 1,BB,1.5,14,14,508,13,2018,14,-1
Group 1,BB,1.5,14,14,509,11,2018,10,1
Group 1,BB,1.5,14,14,510,12,2018,12,0
Group 1,BB,1.5,14,14,511,10,2018,9,1
Group 1,BB,1.5,14,14,512,12,2018,8,4
Group 1,BB,1.5,14,14,513,11,2018,8,3
Group 1,BB,1.5,14,14,514,10,2018,9,1
Group 1,BB,1.5,14,14,515,10,2018,12,-2
Group 1,BB,1.5,14,14,516,10,2018,11,-1
Group 1,BB,1.5,14,14,517,9,2018,6,3
Group 1,BB,1.5,14,14,518,9,2018,10,-1
Group 1,BB,1.5,14,14,519,13,2018,10,3
Group 1,BB,1.5,14,14,520,9,2018,7,2
Group 1,BB,1.5,14,14,521,14,2018,9,5
Group 1,BB,1.5,14,14,522,6,2018,11,-5
Group 1,BB,1.5,14,14,523,10,2018,12,-2
Group 1,BB,1.5,14,14,524,12,2018,12,0
Group 1,BB,1.5,14,14,525,12,2018,12,0
Group 1,BB,1.5,14,14,526,13,2018,10,3
Group 1,BB,1.5,14,14,527,10,2018,9,1
Group 1,BB,1.5,14,14,528,11,2018,9,2
Group 1,BB,1.5,14,14,529,8,2018,11,-3
Group 1,BB,1.5,14,14,530,9,2018,11,-2
Group 1,BB,1.5,14,14,531,10,2018,9,1
Group 1,BB,1.5,14,14,532,10,2018,13,-3
Group 1,BB,1.5,14,14,533,7,2018,10,-3
Group 1,BB,1.5,14,14,534,11,2018,10,1
Group 1,BB,1.5,14,14,535,9,2018,10,-1
Group 1,BB,1.5,14,14,536,11,2018,10,1
Group 1,BB,1.5,14,14,537,10,2018,13,-3
Group 1,BB,1.5,14,14,538,12,2018,8,4
Group 1,BB,1.5,14,14,539,12,2018,10,2
Group 1,BB,1.5,14,14,540,8,2018,14,-6
Group 1,BB,1.5,14,14,541,8,2018,7,1
Group 1,BB,1.5,14,14,542,6,2018,12,-6
Group 1,BB,1.5,14,14,543,8,2018,13,-5
Group 1,BB,1.5,14,14,544,10,2018,11,-1
Group 1,BB,1.5,14,14,545,14,2018,9,5
Group 1,BB,1.5,14,14,546,10,2018,11,-1
Group 1,BB,1.5,14,14,547,11,2018,10,1
Group 1,BB,1.5,14,14,548,9,2018,4,5
Group 1,BB,1.5,14,14,549,10,2018,9,1
Group 1,BB,1.5,14,14,550,12,2018,10,2
Group 1,BB,1.5,14,14,551,11,2018,10,1
Group 1,BB,1.5,14,14,552,12,2018,10,2
Group 1,BB,1.5,14,14,553,11,2018,10,1
Group 1,BB,1.5,14,14,554,11,2018,13,-2
Group 1,BB,1.5,14,14,555,12,2018,12,0
Group 1,BB,1.5,14,14,556,12,2018,7,5
Group 1,BB,1.5,14,14,557,10,2018,9,1
Group 1,BB,1.5,14,14,558,11,2018,5,6
Group 1,BB,1.5,14,14,559,11,2018,10,1
Group 1,BB,1.5,14,14,560,12,2018,8,4
Group 1,BB,1.5,14,14,561,9,2018,13,-4
Group 1,BB,1.5,14,14,562,13,2018,12,1
Group 1,BB,1.5,14,14,563,11,2018,9,2
Group 1,BB,1.5,14,14,564,10,2018,12,-2
Group 1,BB,1.5,14,14,565,10,2018,10,0
Group 1,BB,1.5,14,14,566,12,2018,8,4
Group 1,BB,1.5,14,14,567,8,2018,12,-4
Group 1,BB,1.5,14,14,568,11,2018,9,2
Group 1,BB,1.5,14,14,569,9,2018,11,-2
Group 1,BB,1.5,14,14,570,11,2018,13,-2
Group 1,BB,1.5,14,14,571,9,2018,12,-3
Group 1,BB,1.5,14,14,572,8,2018,9,-1
Group 1,BB,1.5,14,14,573,10,2018,13,-3
Group 1,BB,1.5,14,14,574,9,2018,11,-2
Group 1,BB,1.5,14,14,575,10,2018,8,2
Group 1,BB,1.5,14,14,576,13,2018,11,2
Group 1,BB,1.5,14,14,577,13,2018,10,3
Group 1,BB,1.5,14,14,578,8,2018,7,1
Group 1,BB,1.5,14,14,579,10,2018,13,-3
Group 1,BB,1.5,14,14,580,13,2018,10,3
Group 1,BB,1.5,14,14,581,13,2018,11,2
Group 1,BB,1.5,14,14,582,10,2018,10,0
Group 1,BB,1.5,14,14,583,10,2018,10,0
Group 1,BB,1.5,14,14,584,10,2018,11,-1
Group 1,BB,1.5,14,14,585,14,2018,13,1
Group 1,BB,1.5,14,14,586,11,2018,12,-1
Group 1,BB,1.5,14,14,587,10,2018,14,-4
Group 1,BB,1.5,14,14,588,12,2018,10,2
Group 1,BB,1.5,14,14,589,13,2018,11,2
Group 1,BB,1.5,14,14,590,11,2018,12,-1
Group 1,BB,1.5,14,14,591,8,2018,12,-4
Group 1,BB,1.5,14,14,592,11,2018,10,1
Group 1,BB,1.5,14,14,593,11,2018,10,1
Group 1,BB,1.5,14,14,594,10,2018,8,2
Group 1,BB,1.5,14,14,595,11,2018,6,5
Group 1,BB,1.5,14,14,596,8,2018,4,4
Group 1,BB,1.5,14,14,597,12,2018,11,1
Group 1,BB,1.5,14,14,598,12,2018,11,1
Group 1,BB,1.5,14,14,599,10,2018,11,-1
Group 1,BB,1.5,14,14,600,12,2018,9,3
Group 1,BB,1.5,14,14,601,9,2018,12,-3
Group 1,BB,1.5,14,14,602,11,2018,12,-1
Group 1,BB,1.5,14,14,603,11,2018,11,0
Group 1,BB,1.5,14,14,604,13,2018,12,1
Group 1,BB,1.5,14,14,605,8,2018,11,-3
Group 1,BB,1.5,14,14,606,9,2018,10,-1
Group 1,BB,1.5,14,14,607,10,2018,7,3
Group 1,BB,1.5,14,14,608,6,2018,6,0
Group 1,BB,1.5,14,14,609,11,2018,10,1
Group 1,BB,1.5,14,14,610,11,2018,9,2
Group 1,BB,1.5,14,14,611,11,2018,8,3
Group 1,BB,1.5,14,14,612,9,2018,11,-2
Group 1,BB,1.5,14,14,613,5,2018,13,-8
Group 1,BB,1.5,14,14,614,7,2018,8,-1
Group 1,BB,1.5,14,14,615,13,2018,7,6
Group 1,BB,1.5,14,14,616,12,2018,9,3
Group 1,BB,1.5,14,14,617,11,2018,8,3
Group 1,BB,1.5,14,14,618,7,2018,11,-4
Group 1,BB,1.5,14,14,619,10,2018,12,-2
Group 1,BB,1.5,14,14,620,10,2018,10,0
Group 1,BB,1.5,14,14,621,12,2018,9,3
Group 1,BB,1.5,14,14,622,12,2018,11,1
Group 1,BB,1.5,14,14,623,11,2018,11,0
Group 1,BB,1.5,14,14,624,11,2018,9,2
Group 1,BB,1.5,14,14,625,8,2018,12,-4
Group 1,BB,1.5,14,14,626,10,2018,9,1
Group 1,BB,1.5,14,14,627,8,2018,7,1
Group 1,BB,1.5,14,14,628,12,2018,7,5
Group 1,BB,1.5,14,14,629,10,2018,6,4
Group 1,BB,1.5,14,14,630,11,2018,10,1
Group 1,BB,1.5,14,14,631,12,2018,8,4
Group 1,BB,1.5,14,14,632,10,2018,12,-2
Group 1,BB,1.5,14,14,633,11,2018,10,1
Group 1,BB,1.5,14,14,634,11,2018,10,1
Group 1,BB,1.5,14,14,635,7,2018,11,-4
Group 1,BB,1.5,14,14,636,12,2018,10,2
Group 1,BB,1.5,14,14,637,12,2018,12,0
Group 1,BB,1.5,14,14,638,11,2018,7,4
Group 1,BB,1.5,14,14,639,7,2018,9,-2
Group 1,BB,1.5,14,14,640,12,2018,5,7
Group 1,BB,1.5,14,14,641,11,2018,11,0
Group 1,BB,1.5,14,14,642,10,2018,10,0
Group 1,BB,1.5,14,14,643,11,2018,8,3
Group 1,BB,1.5,14,14,644,9,2018,12,-3
Group 1,BB,1.5,14,14,645,10,2018,6,4
Group 1,BB,1.5,14,14,646,10,2018,7,3
Group 1,BB,1.5,14,14,647,13,2018,11,2
Group 1,BB,1.5,14,14,648,10,2018,9,1
Group 1,BB,1.5,14,14,649,11,2018,8,3
Group 1,BB,1.5,14,14,650,11,2018,8,3
Group 1,BB,1.5,14,14,651,6,2018,9,-3
Group 1,BB,1.5,14,14,652,14,2018,10,4
Group 1,BB,1.5,14,14,653,10,2018,7,3
Group 1,BB,1.5,14,14,654,13,2018,12,1
Group 1,BB,1.5,14,14,655,10,2018,12,-2
Group 1,BB,1.5,14,14,656,9,2018,9,0
Group 1,BB,1.5,14,14,657,10,2018,10,0
Group 1,BB,1.5,14,14,658,11,2018,11,0
Group 1,BB,1.5,14,14,659,13,2018,13,0
Group 1,BB,1.5,14,14,660,12,2018,8,4
Group 1,BB,1.5,14,14,661,10,2018,9,1
Group 1,BB,1.5,14,14,662,10,2018,9,1
Group 1,BB,1.5,14,14,663,10,2018,9,1
Group 1,BB,1.5,14,14,664,9,2018,10,-1
Group 1,BB,1.5,14,14,665,11,2018,11,0
Group 1,BB,1.5,14,14,666,9,2018,11,-2
Group 1,BB,1.5,14,14,667,11,2018,11,0
Group 1,BB,1.5,14,14,668,12,2018,7,5
Group 1,BB,1.5,14,14,669,11,2018,7,4
Group 1,BB,1.5,14,14,670,8,2018,11,-3
Group 1,BB,1.5,14,14,671,11,2018,7,4
Group 1,BB,1.5,14,14,672,11,2018,8,3
Group 1,BB,1.5,14,14,673,10,2018,10,0
Group 1,BB,1.5,14,14,674,10,2018,10,0
Group 1,BB,1.5,14,14,675,11,2018,11,0
Group 1,BB,1.5,14,14,676,8,2018,5,3
Group 1,BB,1.5,14,14,677,11,2018,12,-1
Group 1,BB,1.5,14,14,678,11,2018,11,0
Group 1,BB,1.5,14,14,679,12,2018,10,2
Group 1,BB,1.5,14,14,680,10,2018,10,0
Group 1,BB,1.5,14,14,681,13,2018,9,4
Group 1,BB,1.5,14,14,682,10,2018,10,0
Group 1,BB,1.5,14,14,683,10,2018,10,0
Group 1,BB,1.5,14,14,684,12,2018,10,2
Group 1,BB,1.5,14,14,685,11,2018,9,2
Group 1,BB,1.5,14,14,686,13,2018,11,2
Group 1,BB,1.5,14,14,687,11,2018,11,0
Group 1,BB,1.5,14,14,688,13,2018,10,3
Group 1,BB,1.5,14,14,689,12,2018,9,3
Group 1,BB,1.5,14,14,690,6,2018,10,-4
Group 1,BB,1.5,14,14,691,10,2018,11,-1
Group 1,BB,1.5,14,14,692,11,2018,10,1
Group 1,BB,1.5,14,14,693,9,2018,10,-1
Group 1,BB,1.5,14,14,694,11,2018,10,1
Group 1,BB,1.5,14,14,695,11,2018,12,-1
Group 1,BB,1.5,14,14,696,10,2018,12,-2
Group 1,BB,1.5,14,14,697,9,2018,8,1
Group 1,BB,1.5,14,14,698,9,2018,9,0
Group 1,BB,1.5,14,14,699,8,2018,6,2
Group 1,BB,1.5,14,14,700,10,2018,13,-3
Group 1,BB,1.5,14,14,701,9,2018,8,1
Group 1,BB,1.5,14,14,702,8,2018,9,-1
Group 1,BB,1.5,14,14,703,11,2018,12,-1
Group 1,BB,1.5,14,14,704,11,2018,8,3
Group 1,BB,1.5,14,14,705,10,2018,9,1
Group 1,BB,1.5,14,14,706,12,2018,11,1
Group 1,BB,1.5,14,14,707,10,2018,10,0
Group 1,BB,1.5,14,14,708,9,2018,9,0
Group 1,BB,1.5,14,14,709,13,2018,10,3
Group 1,BB,1.5,14,14,710,13,2018,11,2
Group 1,BB,1.5,14,14,711,12,2018,13,-1
Group 1,BB,1.5,14,14,712,11,2018,12,-1
Group 1,BB,1.5,14,14,713,7,2018,12,-5
Group 1,BB,1.5,14,14,714,9,2018,12,-3
Group 1,BB,1.5,14,14,715,11,2018,9,2
Group 1,BB,1.5,14,14,716,11,2018,12,-1
Group 1,BB,1.5,14,14,717,10,2018,12,-2
Group 1,BB,1.5,14,14,718,14,2018,9,5
Group 1,BB,1.5,14,14,719,13,2018,10,3
Group 1,BB,1.5,14,14,720,10,2018,11,-1
Group 1,BB,1.5,14,14,721,10,2018,11,-1
Group 1,BB,1.5,14,14,722,11,2018,10,1
Group 1,BB,1.5,14,14,723,9,2018,8,1
Group 1,BB,1.5,14,14,724,11,2018,9,2
Group 1,BB,1.5,14,14,725,11,2018,8,3
Group 1,BB,1.5,14,14,726,10,2018,8,2
Group 1,BB,1.5,14,14,727,13,2018,6,7
Group 1,BB,1.5,14,14,728,13,2018,12,1
Group 1,BB,1.5,14,14,729,13,2018,9,4
Group 1,BB,1.5,14,14,730,14,2018,10,4
Group 1,BB,1.5,14,14,731,8,2018,7,1
Group 1,BB,1.5,14,14,732,11,2018,6,5
Group 1,BB,1.5,14,14,733,10,2018,11,-1
Group 1,BB,1.5,14,14,734,10,2018,11,-1
Group 1,BB,1.5,14,14,735,13,2018,11,2
Group 1,BB,1.5,14,14,736,11,2018,10,1
Group 1,BB,1.5,14,14,737,9,2018,11,-2
Group 1,BB,1.5,14,14,738,13,2018,12,1
Group 1,BB,1.5,14,14,739,8,2018,9,-1
Group 1,BB,1.5,14,14,740,9,2018,11,-2
Group 1,BB,1.5,14,14,741,11,2018,8,3
Group 1,BB,1.5,14,14,742,11,2018,8,3
Group 1,BB,1.5,14,14,743,13,2018,9,4
Group 1,BB,1.5,14,14,744,8,2018,13,-5
Group 1,BB,1.5,14,14,745,12,2018,9,3
Group 1,BB,1.5,14,14,746,11,2018,9,2
Group 1,BB,1.5,14,14,747,11,2018,10,1
Group 1,BB,1.5,14,14,748,11,2018,10,1
Group 1,BB,1.5,14,14,749,9,2018,7,2
Group 1,BB,1.5,14,14,750,13,2018,6,7
Group 1,BB,1.5,14,14,751,13,2018,12,1
Group 1,BB,1.5,14,14,752,13,2018,7,6
Group 1,BB,1.5,14,14,753,9,2018,9,0
Group 1,BB,1.5,14,14,754,10,2018,9,1
Group 1,BB,1.5,14,14,755,11,2018,12,-1
Group 1,BB,1.5,14,14,756,9,2018,6,3
Group 1,BB,1.5,14,14,757,7,2018,10,-3
Group 1,BB,1.5,14,14,758,10,2018,13,-3
Group 1,BB,1.5,14,14,759,12,2018,11,1
Group 1,BB,1.5,14,14,760,8,2018,7,1
Group 1,BB,1.5,14,14,761,11,2018,12,-1
Group 1,BB,1.5,14,14,762,10,2018,9,1
Group 1,BB,1.5,14,14,763,11,2018,12,-1
Group 1,BB,1.5,14,14,764,8,2018,10,-2
Group 1,BB,1.5,14,14,765,11,2018,11,0
Group 1,BB,1.5,14,14,766,10,2018,8,2
Group 1,BB,1.5,14,14,767,12,2018,10,2
Group 1,BB,1.5,14,14,768,13,2018,12,1
Group 1,BB,1.5,14,14,769,11,2018,9,2
Group 1,BB,1.5,14,14,770,10,2018,9,1
Group 1,BB,1.5,14,14,771,11,2018,11,0
Group 1,BB,1.5,14,14,772,11,2018,9,2
Group 1,BB,1.5,14,14,773,12,2018,10,2
Group 1,BB,1.5,14,14,774,13,2018,11,2
Group 1,BB,1.5,14,14,775,7,2018,9,-2
Group 1,BB,1.5,14,14,776,12,2018,9,3
Group 1,BB,1.5,14,14,777,9,2018,8,1
Group 1,BB,1.5,14,14,778,12,2018,5,7
Group 1,BB,1.5,14,14,779,11,2018,12,-1
Group 1,BB,1.5,14,14,780,10,2018,7,3
Group 1,BB,1.5,14,14,781,8,2018,10,-2
Group 1,BB,1.5,14,14,782,10,2018,12,-2
Group 1,BB,1.5,14,14,783,10,2018,7,3
Group 1,BB,1.5,14,14,784,13,2018,11,2
Group 1,BB,1.5,14,14,785,10,2018,9,1
Group 1,BB,1.5,14,14,786,12,2018,9,3
Group 1,BB,1.5,14,14,787,10,2018,12,-2
Group 1,BB,1.5,14,14,788,6,2018,11,-5
Group 1,BB,1.5,14,14,789,10,2018,11,-1
Group 1,BB,1.5,14,14,790,8,2018,9,-1
Group 1,BB,1.5,14,14,791,12,2018,12,0
Group 1,BB,1.5,14,14,792,8,2018,10,-2
Group 1,BB,1.5,14,14,793,8,2018,12,-4
Group 1,BB,1.5,14,14,794,10,2018,11,-1
Group 1,BB,1.5,14,14,795,8,2018,10,-2
Group 1,BB,1.5,14,14,796,12,2018,12,0
Group 1,BB,1.5,14,14,797,13,2018,10,3
Group 1,BB,1.5,14,14,798,13,2018,9,4
Group 1,BB,1.5,14,14,799,10,2018,11,-1
Group 1,BB,1.5,14,14,800,13,2018,12,1
Group 1,BB,1.5,14,14,801,12,2018,10,2
Group 1,BB,1.5,14,14,802,9,2018,9,0
Group 1,BB,1.5,14,14,803,11,2018,9,2
Group 1,BB,1.5,14,14,804,11,2018,6,5
Group 1,BB,1.5,14,14,805,10,2018,11,-1
Group 1,BB,1.5,14,14,806,10,2018,12,-2
Group 1,BB,1.5,14,14,807,11,2018,10,1
Group 1,BB,1.5,14,14,808,10,2018,7,3
Group 1,BB,1.5,14,14,809,9,2018,10,-1
Group 1,BB,1.5,14,14,810,6,2018,10,-4
Group 1,BB,1.5,14,14,811,11,2018,7,4
Group 1,BB,1.5,14,14,812,11,2018,8,3
Group 1,BB,1.5,14,14,813,9,2018,11,-2
Group 1,BB,1.5,14,14,814,12,2018,9,3
Group 1,BB,1.5,14,14,815,11,2018,11,0
Group 1,BB,1.5,14,14,816,10,2018,11,-1
Group 1,BB,1.5,14,14,817,12,2018,9,3
Group 1,BB,1.5,14,14,818,9,2018,11,-2
Group 1,BB,1.5,14,14,819,10,2018,9,1
Group 1,BB,1.5,14,14,820,11,2018,5,6
Group 1,BB,1.5,14,14,821,12,2018,10,2
Group 1,BB,1.5,14,14,822,11,2018,7,4
Group 1,BB,1.5,14,14,823,12,2018,8,4
Group 1,BB,1.5,14,14,824,11,2018,8,3
Group 1,BB,1.5,14,14,825,14,2018,10,4
Group 1,BB,1.5,14,14,826,14,2018,13,1
Group 1,BB,1.5,14,14,827,11,2018,9,2
Group 1,BB,1.5,14,14,828,13,2018,11,2
Group 1,BB,1.5,14,14,829,9,2018,9,0
Group 1,BB,1.5,14,14,830,9,2018,8,1
Group 1,BB,1.5,14,14,831,10,2018,10,0
Group 1,BB,1.5,14,14,832,11,2018,13,-2
Group 1,BB,1.5,14,14,833,11,2018,5,6
Group 1,BB,1.5,14,14,834,11,2018,11,0
Group 1,BB,1.5,14,14,835,11,2018,10,1
Group 1,BB,1.5,14,14,836,9,2018,8,1
Group 1,BB,1.5,14,14,837,10,2018,8,2
Group 1,BB,1.5,14,14,838,11,2018,10,1
Group 1,BB,1.5,14,14,839,12,2018,12,0
Group 1,BB,1.5,14,14,840,8,2018,7,1
Group 1,BB,1.5,14,14,841,11,2018,9,2
Group 1,BB,1.5,14,14,842,12,2018,11,1
Group 1,BB,1.5,14,14,843,11,2018,9,2
Group 1,BB,1.5,14,14,844,10,2018,10,0
Group 1,BB,1.5,14,14,845,12,2018,9,3
Group 1,BB,1.5,14,14,846,13,2018,10,3
Group 1,BB,1.5,14,14,847,9,2018,10,-1
Group 1,BB,1.5,14,14,848,11,2018,9,2
Group 1,BB,1.5,14,14,849,11,2018,12,-1
Group 1,BB,1.5,14,14,850,12,2018,12,0
Group 1,BB,1.5,14,14,851,9,2018,9,0
Group 1,BB,1.5,14,14,852,13,2018,10,3
Group 1,BB,1.5,14,14,853,14,2018,9,5
Group 1,BB,1.5,14,14,854,13,2018,10,3
Group 1,BB,1.5,14,14,855,12,2018,12,0
Group 1,BB,1.5,14,14,856,8,2018,12,-4
Group 1,BB,1.5,14,14,857,8,2018,11,-3
Group 1,BB,1.5,14,14,858,13,2018,9,4
Group 1,BB,1.5,14,14,859,11,2018,12,-1
Group 1,BB,1.5,14,14,860,12,2018,5,7
Group 1,BB,1.5,14,14,861,12,2018,9,3
Group 1,BB,1.5,14,14,862,9,2018,9,0
Group 1,BB,1.5,14,14,863,11,2018,6,5
Group 1,BB,1.5,14,14,864,11,2018,6,5
Group 1,BB,1.5,14,14,865,7,2018,9,-2
Group 1,BB,1.5,14,14,866,11,2018,10,1
Group 1,BB,1.5,14,14,867,9,2018,12,-3
Group 1,BB,1.5,14,14,868,12,2018,10,2
Group 1,BB,1.5,14,14,869,10,2018,9,1
Group 1,BB,1.5,14,14,870,10,2018,9,1
Group 1,BB,1.5,14,14,871,11,2018,11,0
Group 1,BB,1.5,14,14,872,10,2018,14,-4
Group 1,BB,1.5,14,14,873,9,2018,14,-5
Group 1,BB,1.5,14,14,874,9,2018,10,-1
Group 1,BB,1.5,14,14,875,10,2018,13,-3
Group 1,BB,1.5,14,14,876,8,2018,9,-1
Group 1,BB,1.5,14,14,877,11,2018,11,0
Group 1,BB,1.5,14,14,878,13,2018,13,0
Group 1,BB,1.5,14,14,879,11,2018,8,3
Group 1,BB,1.5,14,14,880,11,2018,9,2
Group 1,BB,1.5,14,14,881,11,2018,9,2
Group 1,BB,1.5,14,14,882,13,2018,10,3
Group 1,BB,1.5,14,14,883,13,2018,9,4
Group 1,BB,1.5,14,14,884,11,2018,8,3
Group 1,BB,1.5,14,14,885,9,2018,11,-2
Group 1,BB,1.5,14,14,886,10,2018,10,0
Group 1,BB,1.5,14,14,887,8,2018,12,-4
Group 1,BB,1.5,14,14,888,11,2018,11,0
Group 1,BB,1.5,14,14,889,10,2018,9,1
Group 1,BB,1.5,14,14,890,12,2018,9,3
Group 1,BB,1.5,14,14,891,10,2018,12,-2
Group 1,BB,1.5,14,14,892,10,2018,13,-3
Group 1,BB,1.5,14,14,893,12,2018,9,3
Group 1,BB,1.5,14,14,894,12,2018,11,1
Group 1,BB,1.5,14,14,895,12,2018,9,3
Group 1,BB,1.5,14,14,896,8,2018,12,-4
Group 1,BB,1.5,14,14,897,7,2018,11,-4
Group 1,BB,1.5,14,14,898,9,2018,7,2
Group 1,BB,1.5,14,14,899,9,2018,7,2
Group 1,BB,1.5,14,14,900,10,2018,9,1
Group 1,BB,1.5,14,14,901,9,2018,9,0
Group 1,BB,1.5,14,14,902,10,2018,11,-1
Group 1,BB,1.5,14,14,903,12,2018,8,4
Group 1,BB,1.5,14,14,904,8,2018,11,-3
Group 1,BB,1.5,14,14,905,11,2018,12,-1
Group 1,BB,1.5,14,14,906,11,2018,8,3
Group 1,BB,1.5,14,14,907,9,2018,9,0
Group 1,BB,1.5,14,14,908,11,2018,13,-2
Group 1,BB,1.5,14,14,909,10,2018,9,1
Group 1,BB,1.5,14,14,910,12,2018,9,3
Group 1,BB,1.5,14,14,911,9,2018,10,-1
Group 1,BB,1.5,14,14,912,12,2018,8,4
Group 1,BB,1.5,14,14,913,11,2018,8,3
Group 1,BB,1.5,14,14,914,12,2018,5,7
Group 1,BB,1.5,14,14,915,9,2018,8,1
Group 1,BB,1.5,14,14,916,11,2018,9,2
Group 1,BB,1.5,14,14,917,12,2018,10,2
Group 1,BB,1.5,14,14,918,11,2018,9,2
Group 1,BB,1.5,14,14,919,12,2018,11,1
Group 1,BB,1.5,14,14,920,13,2018,13,0
Group 1,BB,1.5,14,14,921,9,2018,8,1
Group 1,BB,1.5,14,14,922,11,2018,9,2
Group 1,BB,1.5,14,14,923,11,2018,14,-3
Group 1,BB,1.5,14,14,924,13,2018,12,1
Group 1,BB,1.5,14,14,925,7,2018,10,-3
Group 1,BB,1.5,14,14,926,11,2018,11,0
Group 1,BB,1.5,14,14,927,10,2018,9,1
Group 1,BB,1.5,14,14,928,10,2018,10,0
Group 1,BB,1.5,14,14,929,9,2018,9,0
Group 1,BB,1.5,14,14,930,12,2018,10,2
Group 1,BB,1.5,14,14,931,9,2018,9,0
Group 1,BB,1.5,14,14,932,12,2018,9,3
Group 1,BB,1.5,14,14,933,11,2018,7,4
Group 1,BB,1.5,14,14,934,10,2018,12,-2
Group 1,BB,1.5,14,14,935,10,2018,9,1
Group 1,BB,1.5,14,14,936,13,2018,10,3
Group 1,BB,1.5,14,14,937,9,2018,10,-1
Group 1,BB,1.5,14,14,938,11,2018,9,2
Group 1,BB,1.5,14,14,939,12,2018,11,1
Group 1,BB,1.5,14,14,940,10,2018,10,0
Group 1,BB,1.5,14,14,941,13,2018,6,7
Group 1,BB,1.5,14,14,942,8,2018,8,0
Group 1,BB,1.5,14,14,943,13,2018,9,4
Group 1,BB,1.5,14,14,944,11,2018,14,-3
Group 1,BB,1.5,14,14,945,10,2018,11,-1
Group 1,BB,1.5,14,14,946,8,2018,9,-1
Group 1,BB,1.5,14,14,947,12,2018,10,2
Group 1,BB,1.5,14,14,948,10,2018,10,0
Group 1,BB,1.5,14,14,949,12,2018,11,1
Group 1,BB,1.5,14,14,950,12,2018,12,0
Group 1,BB,1.5,14,14,951,12,2018,7,5
Group 1,BB,1.5,14,14,952,10,2018,10,0
Group 1,BB,1.5,14,14,953,13,2018,11,2
Group 1,BB,1.5,14,14,954,12,2018,9,3
Group 1,BB,1.5,14,14,955,11,2018,7,4
Group 1,BB,1.5,14,14,956,9,2018,14,-5
Group 1,BB,1.5,14,14,957,11,2018,12,-1
Group 1,BB,1.5,14,14,958,10,2018,8,2
Group 1,BB,1.5,14,14,959,11,2018,10,1
Group 1,BB,1.5,14,14,960,12,2018,11,1
Group 1,BB,1.5,14,14,961,10,2018,11,-1
Group 1,BB,1.5,14,14,962,9,2018,12,-3
Group 1,BB,1.5,14,14,963,12,2018,11,1
Group 1,BB,1.5,14,14,964,10,2018,12,-2
Group 1,BB,1.5,14,14,965,9,2018,8,1
Group 1,BB,1.5,14,14,966,10,2018,7,3
Group 1,BB,1.5,14,14,967,11,2018,8,3
Group 1,BB,1.5,14,14,968,9,2018,10,-1
Group 1,BB,1.5,14,14,969,11,2018,8,3
Group 1,BB,1.5,14,14,970,10,2018,10,0
Group 1,BB,1.5,14,14,971,10,2018,10,0
Group 1,BB,1.5,14,14,972,10,2018,11,-1
Group 1,BB,1.5,14,14,973,11,2018,8,3
Group 1,BB,1.5,14,14,974,12,2018,12,0
Group 1,BB,1.5,14,14,975,9,2018,9,0
Group 1,BB,1.5,14,14,976,8,2018,7,1
Group 1,BB,1.5,14,14,977,10,2018,9,1
Group 1,BB,1.5,14,14,978,9,2018,8,1
Group 1,BB,1.5,14,14,979,6,2018,9,-3
Group 1,BB,1.5,14,14,980,14,2018,11,3
Group 1,BB,1.5,14,14,981,12,2018,12,0
Group 1,BB,1.5,14,14,982,11,2018,6,5
Group 1,BB,1.5,14,14,983,8,2018,10,-2
Group 1,BB,1.5,14,14,984,13,2018,7,6
Group 1,BB,1.5,14,14,985,10,2018,12,-2
Group 1,BB,1.5,14,14,986,12,2018,13,-1
Group 1,BB,1.5,14,14,987,11,2018,12,-1
Group 1,BB,1.5,14,14,988,11,2018,12,-1
Group 1,BB,1.5,14,14,989,11,2018,13,-2
Group 1,BB,1.5,14,14,990,10,2018,6,4
Group 1,BB,1.5,14,14,991,11,2018,9,2
Group 1,BB,1.5,14,14,992,13,2018,10,3
Group 1,BB,1.5,14,14,993,9,2018,13,-4
Group 1,BB,1.5,14,14,994,9,2018,12,-3
Group 1,BB,1.5,14,14,995,9,2018,11,-2
Group 1,BB,1.5,14,14,996,11,2018,10,1
Group 1,BB,1.5,14,14,997,12,2018,11,1
Group 1,BB,1.5,14,14,998,9,2018,10,-1
Group 1,BB,1.5,14,14,999,12,2018,7,5
Group 1,BB,1.5,14,14,1000,13,2018,11,2
Group 1,BB,1.5,14,14,1001,9,2018,12,-3
Group 1,BB,1.5,14,14,1002,10,2018,12,-2
Group 1,BB,1.5,14,14,1003,9,2018,10,-1
Group 1,BB,1.5,14,14,1004,10,2018,11,-1
Group 1,BB,1.5,14,14,1005,14,2018,13,1
Group 1,BB,1.5,14,14,1006,11,2018,8,3
Group 1,BB,1.5,14,14,1007,10,2018,8,2
Group 1,BB,1.5,14,14,1008,11,2018,11,0
Group 1,BB,1.5,14,14,1009,11,2018,9,2
Group 1,BB,1.5,14,14,1010,11,2018,9,2
Group 1,BB,1.5,14,14,1011,10,2018,5,5
Group 1,BB,1.5,14,14,1012,12,2018,10,2
Group 1,BB,1.5,14,14,1013,11,2018,9,2
Group 1,BB,1.5,14,14,1014,9,2018,10,-1
Group 1,BB,1.5,14,14,1015,11,2018,12,-1
Group 1,BB,1.5,14,14,1016,11,2018,11,0
Group 1,BB,1.5,14,14,1017,10,2018,9,1
Group 1,BB,1.5,14,14,1018,11,2018,11,0
Group 1,BB,1.5,14,14,1019,9,2018,13,-4
Group 1,BB,1.5,14,14,1020,13,2018,12,1
Group 1,BB,1.5,14,14,1021,9,2018,13,-4
Group 1,BB,1.5,14,14,1022,11,2018,11,0
Group 1,BB,1.5,14,14,1023,9,2018,9,0
Group 1,BB,1.5,14,14,1024,10,2018,6,4
Group 1,BB,1.5,14,14,1025,9,2018,9,0
Group 1,BB,1.5,14,14,1026,9,2018,10,-1
Group 1,BB,1.5,14,14,1027,11,2018,6,5
Group 1,BB,1.5,14,14,1028,11,2018,12,-1
Group 1,BB,1.5,14,14,1029,9,2018,12,-3
Group 1,BB,1.5,14,14,1030,11,2018,11,0
Group 1,BB,1.5,14,14,1031,7,2018,12,-5
Group 1,BB,1.5,14,14,1032,9,2018,8,1
Group 1,BB,1.5,14,14,1033,9,2018,11,-2
Group 1,BB,1.5,14,14,1034,13,2018,9,4
Group 1,BB,1.5,14,14,1035,12,2018,10,2
Group 1,BB,1.5,14,14,1036,10,2018,11,-1
Group 1,BB,1.5,14,14,1037,9,2018,13,-4
Group 1,BB,1.5,14,14,1038,10,2018,11,-1
Group 1,BB,1.5,14,14,1039,12,2018,7,5
Group 1,BB,1.5,14,14,1040,11,2018,7,4
Group 1,BB,1.5,14,14,1041,12,2018,12,0
Group 1,BB,1.5,14,14,1042,12,2018,8,4
Group 1,BB,1.5,14,14,1043,7,2018,8,-1
Group 1,BB,1.5,14,14,1044,11,2018,11,0
Group 1,BB,1.5,14,14,1045,9,2018,10,-1
Group 1,BB,1.5,14,14,1046,10,2018,9,1
Group 1,BB,1.5,14,14,1047,12,2018,7,5
Group 1,BB,1.5,14,14,1048,10,2018,10,0
Group 1,BB,1.5,14,14,1049,12,2018,10,2
Group 1,BB,1.5,14,14,1050,8,2018,10,-2
Group 1,BB,1.5,14,14,1051,10,2018,12,-2
Group 1,BB,1.5,14,14,1052,8,2018,11,-3
Group 1,BB,1.5,14,14,1053,11,2018,11,0
Group 1,BB,1.5,14,14,1054,9,2018,10,-1
Group 1,BB,1.5,14,14,1055,11,2018,14,-3
Group 1,BB,1.5,14,14,1056,11,2018,11,0
Group 1,BB,1.5,14,14,1057,14,2018,10,4
Group 1,BB,1.5,14,14,1058,13,2018,12,1
Group 1,BB,1.5,14,14,1059,10,2018,11,-1
Group 1,BB,1.5,14,14,1060,10,2018,9,1
Group 1,BB,1.5,14,14,1061,9,2018,7,2
Group 1,BB,1.5,14,14,1062,10,2018,11,-1
Group 1,BB,1.5,14,14,1063,6,2018,10,-4
Group 1,BB,1.5,14,14,1064,9,2018,13,-4
Group 1,BB,1.5,14,14,1065,7,2018,8,-1
Group 1,BB,1.5,14,14,1066,11,2018,13,-2
Group 1,BB,1.5,14,14,1067,13,2018,10,3
Group 1,BB,1.5,14,14,1068,13,2018,14,-1
Group 1,BB,1.5,14,14,1069,10,2018,11,-1
Group 1,BB,1.5,14,14,1070,13,2018,13,0
Group 1,BB,1.5,14,14,1071,9,2018,7,2
Group 1,BB,1.5,14,14,1072,12,2018,12,0
Group 1,BB,1.5,14,14,1073,13,2018,9,4
Group 1,BB,1.5,14,14,1074,8,2018,9,-1
Group 1,BB,1.5,14,14,1075,9,2018,10,-1
Group 1,BB,1.5,14,14,1076,10,2018,11,-1
Group 1,BB,1.5,14,14,1077,11,2018,7,4
Group 1,BB,1.5,14,14,1078,9,2018,13,-4
Group 1,BB,1.5,14,14,1079,8,2018,13,-5
Group 1,BB,1.5,14,14,1080,13,2018,10,3
Group 1,BB,1.5,14,14,1081,10,2018,8,2
Group 1,BB,1.5,14,14,1082,11,2018,13,-2
Group 1,BB,1.5,14,14,1083,11,2018,13,-2
Group 1,BB,1.5,14,14,1084,11,2018,9,2
Group 1,BB,1.5,14,14,1085,7,2018,9,-2
Group 1,BB,1.5,14,14,1086,8,2018,9,-1
Group 1,BB,1.5,14,14,1087,9,2018,13,-4
Group 1,BB,1.5,14,14,1088,10,2018,11,-1
Group 1,BB,1.5,14,14,1089,10,2018,8,2
Group 1,BB,1.5,14,14,1090,11,2018,11,0
Group 1,BB,1.5,14,14,1091,11,2018,11,0
Group 1,BB,1.5,14,14,1092,11,2018,10,1
Group 1,BB,1.5,14,14,1093,12,2018,10,2
Group 1,BB,1.5,14,14,1094,12,2018,12,0
Group 1,BB,1.5,14,14,1095,13,2018,11,2
Group 1,BB,1.5,14,14,1096,11,2018,8,3
Group 1,BB,1.5,14,14,1097,10,2018,6,4
Group 1,BB,1.5,14,14,1098,9,2018,11,-2
Group 1,BB,1.5,14,14,1099,8,2018,8,0
Group 1,BB,1.5,14,14,1100,10,2018,12,-2
Group 1,BB,1.5,14,14,1101,9,2018,11,-2
Group 1,BB,1.5,14,14,1102,10,2018,7,3
Group 1,BB,1.5,14,14,1103,11,2018,5,6
Group 1,BB,1.5,14,14,1104,8,2018,11,-3
Group 1,BB,1.5,14,14,1105,12,2018,10,2
Group 1,BB,1.5,14,14,1106,12,2018,10,2
Group 1,BB,1.5,14,14,1107,12,2018,10,2
Group 1,BB,1.5,14,14,1108,12,2018,9,3
Group 1,BB,1.5,14,14,1109,8,2018,7,1
Group 1,BB,1.5,14,14,1110,12,2018,9,3
Group 1,BB,1.5,14,14,1111,12,2018,13,-1
Group 1,BB,1.5,14,14,1112,13,2018,14,-1
Group 1,BB,1.5,14,14,1113,11,2018,10,1
Group 1,BB,1.5,14,14,1114,9,2018,7,2
Group 1,BB,1.5,14,14,1115,8,2018,9,-1
Group 1,BB,1.5,14,14,1116,13,2018,11,2
Group 1,BB,1.5,14,14,1117,7,2018,9,-2
Group 1,BB,1.5,14,14,1118,9,2018,11,-2
Group 1,BB,1.5,14,14,1119,8,2018,13,-5
Group 1,BB,1.5,14,14,1120,6,2018,10,-4
Group 1,BB,1.5,14,14,1121,10,2018,12,-2
Group 1,BB,1.5,14,14,1122,9,2018,12,-3
Group 1,BB,1.5,14,14,1123,12,2018,11,1
Group 1,BB,1.5,14,14,1124,12,2018,9,3
Group 1,BB,1.5,14,14,1125,11,2018,8,3
Group 1,BB,1.5,14,14,1126,10,2018,12,-2
Group 1,BB,1.5,14,14,1127,12,2018,11,1
Group 1,BB,1.5,14,14,1128,10,2018,13,-3
Group 1,BB,1.5,14,14,1129,13,2018,8,5
Group 1,BB,1.5,14,14,1130,8,2018,9,-1
Group 1,BB,1.5,14,14,1131,11,2018,9,2
Group 1,BB,1.5,14,14,1132,14,2018,9,5
Group 1,BB,1.5,14,14,1133,13,2018,10,3
Group 1,BB,1.5,14,14,1134,11,2018,9,2
Group 1,BB,1.5,14,14,1135,13,2018,9,4
Group 1,BB,1.5,14,14,1136,9,2018,8,1
Group 1,BB,1.5,14,14,1137,12,2018,11,1
Group 1,BB,1.5,14,14,1138,9,2018,10,-1
Group 1,BB,1.5,14,14,1139,12,2018,9,3
Group 1,BB,1.5,14,14,1140,11,2018,13,-2
Group 1,BB,1.5,14,14,1141,10,2018,11,-1
Group 1,BB,1.5,14,14,1142,12,2018,11,1
Group 1,BB,1.5,14,14,1143,8,2018,10,-2
Group 1,BB,1.5,14,14,1144,11,2018,7,4
Group 1,BB,1.5,14,14,1145,13,2018,13,0
Group 1,BB,1.5,14,14,1146,13,2018,8,5
Group 1,BB,1.5,14,14,1147,13,2018,6,7
Group 1,BB,1.5,14,14,1148,11,2018,14,-3
Group 1,BB,1.5,14,14,1149,9,2018,9,0
Group 1,BB,1.5,14,14,1150,11,2018,10,1
Group 1,BB,1.5,14,14,1151,13,2018,12,1
Group 1,BB,1.5,14,14,1152,9,2018,12,-3
Group 1,BB,1.5,14,14,1153,11,2018,9,2
Group 1,BB,1.5,14,14,1154,12,2018,7,5
Group 1,BB,1.5,14,14,1155,11,2018,5,6
Group 1,BB,1.5,14,14,1156,11,2018,11,0
Group 1,BB,1.5,14,14,1157,8,2018,12,-4
Group 1,BB,1.5,14,14,1158,11,2018,8,3
Group 1,BB,1.5,14,14,1159,10,2018,10,0
Group 1,BB,1.5,14,14,1160,10,2018,11,-1
Group 1,BB,1.5,14,14,1161,10,2018,7,3
Group 1,BB,1.5,14,14,1162,10,2018,9,1
Group 1,BB,1.5,14,14,1163,10,2018,12,-2
Group 1,BB,1.5,14,14,1164,8,2018,13,-5
Group 1,BB,1.5,14,14,1165,13,2018,12,1
Group 1,BB,1.5,14,14,1166,10,2018,11,-1
Group 1,BB,1.5,14,14,1167,8,2018,10,-2
Group 1,BB,1.5,14,14,1168,12,2018,12,0
Group 1,BB,1.5,14,14,1169,7,2018,8,-1
Group 1,BB,1.5,14,14,1170,12,2018,13,-1
Group 1,BB,1.5,14,14,1171,12,2018,10,2
Group 1,BB,1.5,14,14,1172,10,2018,12,-2
Group 1,BB,1.5,14,14,1173,12,2018,9,3
Group 1,BB,1.5,14,14,1174,13,2018,11,2
Group 1,BB,1.5,14,14,1175,7,2018,8,-1
Group 1,BB,1.5,14,14,1176,10,2018,14,-4
Group 1,BB,1.5,14,14,1177,9,2018,13,-4
Group 1,BB,1.5,14,14,1178,12,2018,11,1
Group 1,BB,1.5,14,14,1179,12,2018,12,0
Group 1,BB,1.5,14,14,1180,13,2018,12,1
Group 1,BB,1.5,14,14,1181,11,2018,9,2
Group 1,BB,1.5,14,14,1182,10,2018,11,-1
Group 1,BB,1.5,14,14,1183,10,2018,9,1
Group 1,BB,1.5,14,14,1184,12,2018,13,-1
Group 1,BB,1.5,14,14,1185,12,2018,12,0
Group 1,BB,1.5,14,14,1186,10,2018,11,-1
Group 1,BB,1.5,14,14,1187,12,2018,9,3
Group 1,BB,1.5,14,14,1188,11,2018,10,1
Group 1,BB,1.5,14,14,1189,12,2018,10,2
Group 1,BB,1.5,14,14,1190,11,2018,9,2
Group 1,BB,1.5,14,14,1191,11,2018,13,-2
Group 1,BB,1.5,14,14,1192,9,2018,9,0
Group 1,BB,1.5,14,14,1193,8,2018,12,-4
Group 1,BB,1.5,14,14,1194,10,2018,13,-3
Group 1,BB,1.5,14,14,1195,7,2018,12,-5
Group 1,BB,1.5,14,14,1196,11,2018,11,0
Group 1,BB,1.5,14,14,1197,12,2018,13,-1
Group 1,BB,1.5,14,14,1198,11,2018,7,4
Group 1,BB,1.5,14,14,1199,9,2018,5,4
Group 1,BB,1.5,14,14,1200,11,2018,9,2
Group 1,BB,1.5,14,14,1201,9,2018,11,-2
Group 1,BB,1.5,14,14,1202,13,2018,8,5
Group 1,BB,1.5,14,14,1203,12,2018,9,3
Group 1,BB,1.5,14,14,1204,10,2018,10,0
Group 1,BB,1.5,14,14,1205,8,2018,10,-2
Group 1,BB,1.5,14,14,1206,10,2018,10,0
Group 1,BB,1.5,14,14,1207,12,2018,10,2
Group 1,BB,1.5,14,14,1208,10,2018,10,0
Group 1,BB,1.5,14,14,1209,13,2018,9,4
Group 1,BB,1.5,14,14,1210,8,2018,10,-2
Group 1,BB,1.5,14,14,1211,9,2018,11,-2
Group 1,BB,1.5,14,14,1212,13,2018,10,3
Group 1,BB,1.5,14,14,1213,8,2018,10,-2
Group 1,BB,1.5,14,14,1214,10,2018,11,-1
Group 1,BB,1.5,14,14,1215,9,2018,12,-3
Group 1,BB,1.5,14,14,1216,10,2018,13,-3
Group 1,BB,1.5,14,14,1217,10,2018,8,2
Group 1,BB,1.5,14,14,1218,12,2018,9,3
Group 1,BB,1.5,14,14,1219,9,2018,11,-2
Group 1,BB,1.5,14,14,1220,9,2018,11,-2
Group 1,BB,1.5,14,14,1221,13,2018,8,5
Group 1,BB,1.5,14,14,1222,13,2018,11,2
Group 1,BB,1.5,14,14,1223,11,2018,10,1
Group 1,BB,1.5,14,14,1224,12,2018,10,2
Group 1,BB,1.5,14,14,1225,14,2018,10,4
Group 1,BB,1.5,14,14,1226,10,2018,10,0
Group 1,BB,1.5,14,14,1227,13,2018,11,2
Group 1,BB,1.5,14,14,1228,9,2018,13,-4
Group 1,BB,1.5,14,14,1229,12,2018,9,3
Group 1,BB,1.5,14,14,1230,13,2018,13,0
Group 1,BB,1.5,14,14,1231,10,2018,9,1
Group 1,BB,1.5,14,14,1232,11,2018,11,0
Group 1,BB,1.5,14,14,1233,9,2018,12,-3
Group 1,BB,1.5,14,14,1234,11,2018,10,1
Group 1,BB,1.5,14,14,1235,8,2018,7,1
Group 1,BB,1.5,14,14,1236,12,2018,10,2
Group 1,BB,1.5,14,14,1237,11,2018,12,-1
Group 1,BB,1.5,14,14,1238,12,2018,9,3
Group 1,BB,1.5,14,14,1239,11,2018,12,-1
Group 1,BB,1.5,14,14,1240,12,2018,9,3
Group 1,BB,1.5,14,14,1241,10,2018,6,4
Group 1,BB,1.5,14,14,1242,11,2018,8,3
Group 1,BB,1.5,14,14,1243,12,2018,7,5
Group 1,BB,1.5,14,14,1244,11,2018,12,-1
Group 1,BB,1.5,14,14,1245,10,2018,13,-3
Group 1,BB,1.5,14,14,1246,8,2018,13,-5
Group 1,BB,1.5,14,14,1247,8,2018,12,-4
Group 1,BB,1.5,14,14,1248,8,2018,13,-5
Group 1,BB,1.5,14,14,1249,12,2018,13,-1
Group 1,BB,1.5,14,14,1250,10,2018,10,0
Group 1,BB,1.5,14,14,1251,14,2018,10,4
Group 1,BB,1.5,14,14,1252,10,2018,13,-3
Group 1,BB,1.5,14,14,1253,8,2018,9,-1
Group 1,BB,1.5,14,14,1254,11,2018,7,4
Group 1,BB,1.5,14,14,1255,9,2018,6,3
Group 1,BB,1.5,14,14,1256,10,2018,7,3
Group 1,BB,1.5,14,14,1257,13,2018,13,0
Group 1,BB,1.5,14,14,1258,7,2018,11,-4
Group 1,BB,1.5,14,14,1259,9,2018,12,-3
Group 1,BB,1.5,14,14,1260,12,2018,11,1
Group 1,BB,1.5,14,14,1261,11,2018,7,4
Group 1,BB,1.5,14,14,1262,10,2018,11,-1
Group 1,BB,1.5,14,14,1263,8,2018,9,-1
Group 1,BB,1.5,14,14,1264,11,2018,10,1
Group 1,BB,1.5,14,14,1265,11,2018,11,0
Group 1,BB,1.5,14,14,1266,11,2018,10,1
Group 1,BB,1.5,14,14,1267,13,2018,12,1
Group 1,BB,1.5,14,14,1268,12,2018,10,2
Group 1,BB,1.5,14,14,1269,9,2018,11,-2
Group 1,BB,1.5,14,14,1270,11,2018,12,-1
Group 1,BB,1.5,14,14,1271,13,2018,12,1
Group 1,BB,1.5,14,14,1272,12,2018,12,0
Group 1,BB,1.5,14,14,1273,10,2018,10,0
Group 1,BB,1.5,14,14,1274,12,2018,12,0
Group 1,BB,1.5,14,14,1275,10,2018,12,-2
Group 1,BB,1.5,14,14,1276,9,2018,10,-1
Group 1,BB,1.5,14,14,1277,10,2018,12,-2
Group 1,BB,1.5,14,14,1278,12,2018,11,1
Group 1,BB,1.5,14,14,1279,8,2018,11,-3
Group 1,BB,1.5,14,14,1280,9,2018,9,0
Group 1,BB,1.5,14,14,1281,12,2018,10,2
Group 1,BB,1.5,14,14,1282,12,2018,10,2
Group 1,BB,1.5,14,14,1283,9,2018,12,-3
Group 1,BB,1.5,14,14,1284,11,2018,10,1
Group 1,BB,1.5,14,14,1285,8,2018,10,-2
Group 1,BB,1.5,14,14,1286,10,2018,11,-1
Group 1,BB,1.5,14,14,1287,11,2018,7,4
Group 1,BB,1.5,14,14,1288,7,2018,11,-4
Group 1,BB,1.5,14,14,1289,11,2018,11,0
Group 1,BB,1.5,14,14,1290,11,2018,9,2
Group 1,BB,1.5,14,14,1291,11,2018,11,0
Group 1,BB,1.5,14,14,1292,7,2018,11,-4
Group 1,BB,1.5,14,14,1293,14,2018,9,5
Group 1,BB,1.5,14,14,1294,13,2018,10,3
Group 1,BB,1.5,14,14,1295,13,2018,9,4
Group 1,BB,1.5,14,14,1296,11,2018,9,2
Group 1,BB,1.5,14,14,1297,11,2018,11,0
Group 1,BB,1.5,14,14,1298,8,2018,10,-2
Group 1,BB,1.5,14,14,1299,12,2018,10,2
Group 1,BB,1.5,14,14,1300,11,2018,9,2
Group 1,BB,1.5,14,14,1301,11,2018,12,-1
Group 1,BB,1.5,14,14,1302,8,2018,5,3
Group 1,BB,1.5,14,14,1303,12,2018,12,0
Group 1,BB,1.5,14,14,1304,7,2018,10,-3
Group 1,BB,1.5,14,14,1305,9,2018,7,2
Group 1,BB,1.5,14,14,1306,13,2018,11,2
Group 1,BB,1.5,14,14,1307,10,2018,10,0
Group 1,BB,1.5,14,14,1308,10,2018,8,2
Group 1,BB,1.5,14,14,1309,11,2018,10,1
Group 1,BB,1.5,14,14,1310,13,2018,9,4
Group 1,BB,1.5,14,14,1311,10,2018,9,1
Group 1,BB,1.5,14,14,1312,11,2018,11,0
Group 1,BB,1.5,14,14,1313,12,2018,10,2
Group 1,BB,1.5,14,14,1314,13,2018,8,5
Group 1,BB,1.5,14,14,1315,11,2018,10,1
Group 1,BB,1.5,14,14,1316,12,2018,10,2
Group 1,BB,1.5,14,14,1317,12,2018,8,4
Group 1,BB,1.5,14,14,1318,12,2018,6,6
Group 1,BB,1.5,14,14,1319,11,2018,13,-2
Group 1,BB,1.5,14,14,1320,10,2018,11,-1
Group 1,BB,1.5,14,14,1321,12,2018,7,5
Group 1,BB,1.5,14,14,1322,11,2018,7,4
Group 1,BB,1.5,14,14,1323,11,2018,7,4
Group 1,BB,1.5,14,14,1324,13,2018,7,6
Group 1,BB,1.5,14,14,1325,13,2018,7,6
Group 1,BB,1.5,14,14,1326,9,2018,9,0
Group 1,BB,1.5,14,14,1327,13,2018,9,4
Group 1,BB,1.5,14,14,1328,10,2018,9,1
Group 1,BB,1.5,14,14,1329,13,2018,6,7
Group 1,BB,1.5,14,14,1330,13,2018,5,8
Group 1,BB,1.5,14,14,1331,12,2018,9,3
Group 1,BB,1.5,14,14,1332,10,2018,6,4
Group 1,BB,1.5,14,14,1333,9,2018,5,4
Group 1,BB,1.5,14,14,1334,9,2018,6,3
Group 1,BB,1.5,14,14,1335,10,2018,9,1
Group 1,BB,1.5,14,14,1336,10,2018,11,-1
Group 1,BB,1.5,14,14,1337,11,2018,9,2
Group 1,BB,1.5,14,14,1338,9,2018,9,0
Group 1,BB,1.5,14,14,1339,12,2018,11,1
Group 1,BB,1.5,14,14,1340,11,2018,10,1
Group 1,BB,1.5,14,14,1341,8,2018,10,-2
Group 1,BB,1.5,14,14,1342,9,2018,8,1
Group 1,BB,1.5,14,14,1343,10,2018,8,2
Group 1,BB,1.5,14,14,1344,13,2018,8,5
Group 1,BB,1.5,14,14,1345,7,2018,12,-5
Group 1,BB,1.5,14,14,1346,13,2018,9,4
Group 1,BB,1.5,14,14,1347,13,2018,14,-1
Group 1,BB,1.5,14,14,1348,13,2018,10,3
Group 1,BB,1.5,14,14,1349,12,2018,11,1
Group 1,BB,1.5,14,14,1350,12,2018,12,0
Group 1,BB,1.5,14,14,1351,7,2018,6,1
Group 1,BB,1.5,14,14,1352,10,2018,9,1
Group 1,BB,1.5,14,14,1353,10,2018,10,0
Group 1,BB,1.5,14,14,1354,12,2018,9,3
Group 1,BB,1.5,14,14,1355,11,2018,12,-1
Group 1,BB,1.5,14,14,1356,13,2018,8,5
Group 1,BB,1.5,14,14,1357,12,2018,10,2
Group 1,BB,1.5,14,14,1358,12,2018,10,2
Group 1,BB,1.5,14,14,1359,12,2018,8,4
Group 1,BB,1.5,14,14,1360,12,2018,12,0
Group 1,BB,1.5,14,14,1361,12,2018,8,4
Group 1,BB,1.5,14,14,1362,10,2018,7,3
Group 1,BB,1.5,14,14,1363,10,2018,11,-1
Group 1,BB,1.5,14,14,1364,13,2018,11,2
Group 1,BB,1.5,14,14,1365,12,2018,9,3
Group 1,BB,1.5,14,14,1366,11,2018,12,-1
Group 1,BB,1.5,14,14,1367,7,2018,9,-2
Group 1,BB,1.5,14,14,1368,10,2018,14,-4
Group 1,BB,1.5,14,14,1369,9,2018,8,1
Group 1,BB,1.5,14,14,1370,10,2018,11,-1
Group 1,BB,1.5,14,14,1371,10,2018,10,0
Group 1,BB,1.5,14,14,1372,9,2018,14,-5
Group 1,BB,1.5,14,14,1373,10,2018,10,0
Group 1,BB,1.5,14,14,1374,11,2018,7,4
Group 1,BB,1.5,14,14,1375,11,2018,10,1
Group 1,BB,1.5,14,14,1376,9,2018,7,2
Group 1,BB,1.5,14,14,1377,13,2018,8,5
Group 1,BB,1.5,14,14,1378,11,2018,9,2
Group 1,BB,1.5,14,14,1379,14,2018,8,6
Group 1,BB,1.5,14,14,1380,11,2018,10,1
Group 1,BB,1.5,14,14,1381,12,2018,12,0
Group 1,BB,1.5,14,14,1382,11,2018,10,1
Group 1,BB,1.5,14,14,1383,10,2018,8,2
Group 1,BB,1.5,14,14,1384,11,2018,13,-2
Group 1,BB,1.5,14,14,1385,9,2018,12,-3
Group 1,BB,1.5,14,14,1386,12,2018,10,2
Group 1,BB,1.5,14,14,1387,11,2018,12,-1
Group 1,BB,1.5,14,14,1388,13,2018,11,2
Group 1,BB,1.5,14,14,1389,9,2018,11,-2
Group 1,BB,1.5,14,14,1390,12,2018,9,3
Group 1,BB,1.5,14,14,1391,11,2018,7,4
Group 1,BB,1.5,14,14,1392,9,2018,11,-2
Group 1,BB,1.5,14,14,1393,9,2018,13,-4
Group 1,BB,1.5,14,14,1394,9,2018,9,0
Group 1,BB,1.5,14,14,1395,12,2018,10,2
Group 1,BB,1.5,14,14,1396,11,2018,12,-1
Group 1,BB,1.5,14,14,1397,8,2018,9,-1
Group 1,BB,1.5,14,14,1398,6,2018,11,-5
Group 1,BB,1.5,14,14,1399,8,2018,10,-2
Group 1,BB,1.5,14,14,1400,12,2018,11,1
Group 1,BB,1.5,14,14,1401,8,2018,7,1
Group 1,BB,1.5,14,14,1402,8,2018,13,-5
Group 1,BB,1.5,14,14,1403,12,2018,9,3
Group 1,BB,1.5,14,14,1404,7,2018,10,-3
Group 1,BB,1.5,14,14,1405,13,2018,10,3
Group 1,BB,1.5,14,14,1406,9,2018,8,1
Group 1,BB,1.5,14,14,1407,11,2018,10,1
Group 1,BB,1.5,14,14,1408,10,2018,8,2
Group 1,BB,1.5,14,14,1409,9,2018,8,1
Group 1,BB,1.5,14,14,1410,8,2018,11,-3
Group 1,BB,1.5,14,14,1411,12,2018,12,0
Group 1,BB,1.5,14,14,1412,11,2018,9,2
Group 1,BB,1.5,14,14,1413,11,2018,12,-1
Group 1,BB,1.5,14,14,1414,12,2018,10,2
Group 1,BB,1.5,14,14,1415,12,2018,10,2
Group 1,BB,1.5,14,14,1416,10,2018,9,1
Group 1,BB,1.5,14,14,1417,12,2018,13,-1
Group 1,BB,1.5,14,14,1418,11,2018,11,0
Group 1,BB,1.5,14,14,1419,12,2018,10,2
Group 1,BB,1.5,14,14,1420,13,2018,10,3
Group 1,BB,1.5,14,14,1421,10,2018,12,-2
Group 1,BB,1.5,14,14,1422,12,2018,11,1
Group 1,BB,1.5,14,14,1423,11,2018,6,5
Group 1,BB,1.5,14,14,1424,10,2018,7,3
Group 1,BB,1.5,14,14,1425,13,2018,12,1
Group 1,BB,1.5,14,14,1426,11,2018,6,5
Group 1,BB,1.5,14,14,1427,8,2018,10,-2
Group 1,BB,1.5,14,14,1428,8,2018,11,-3
Group 1,BB,1.5,14,14,1429,10,2018,11,-1
Group 1,BB,1.5,14,14,1430,11,2018,11,0
Group 1,BB,1.5,14,14,1431,11,2018,8,3
Group 1,BB,1.5,14,14,1432,11,2018,10,1
Group 1,BB,1.5,14,14,1433,11,2018,10,1
Group 1,BB,1.5,14,14,1434,10,2018,11,-1
Group 1,BB,1.5,14,14,1435,12,2018,7,5
Group 1,BB,1.5,14,14,1436,6,2018,11,-5
Group 1,BB,1.5,14,14,1437,11,2018,14,-3
Group 1,BB,1.5,14,14,1438,12,2018,12,0
Group 1,BB,1.5,14,14,1439,10,2018,9,1
Group 1,BB,1.5,14,14,1440,11,2018,12,-1
Group 1,BB,1.5,14,14,1441,13,2018,10,3
Group 1,BB,1.5,14,14,1442,11,2018,7,4
Group 1,BB,1.5,14,14,1443,10,2018,10,0
Group 1,BB,1.5,14,14,1444,11,2018,8,3
Group 1,BB,1.5,14,14,1445,12,2018,12,0
Group 1,BB,1.5,14,14,1446,12,2018,11,1
Group 1,BB,1.5,14,14,1447,10,2018,11,-1
Group 1,BB,1.5,14,14,1448,12,2018,11,1
Group 1,BB,1.5,14,14,1449,11,2018,10,1
Group 1,BB,1.5,14,14,1450,8,2018,13,-5
Group 1,BB,1.5,14,14,1451,13,2018,10,3
Group 1,BB,1.5,14,14,1452,12,2018,11,1
Group 1,BB,1.5,14,14,1453,9,2018,9,0
Group 1,BB,1.5,14,14,1454,11,2018,13,-2
Group 1,BB,1.5,14,14,1455,10,2018,10,0
Group 1,BB,1.5,14,14,1456,10,2018,9,1
Group 1,BB,1.5,14,14,1457,10,2018,10,0
Group 1,BB,1.5,14,14,1458,12,2018,12,0
Group 1,BB,1.5,14,14,1459,12,2018,11,1
Group 1,BB,1.5,14,14,1460,10,2018,6,4
Group 1,BB,1.5,14,14,1461,11,2018,13,-2
Group 1,BB,1.5,14,14,1462,7,2018,10,-3
Group 1,BB,1.5,14,14,1463,10,2018,9,1
Group 1,BB,1.5,14,14,1464,11,2018,13,-2
Group 1,BB,1.5,14,14,1465,13,2018,13,0
Group 1,BB,1.5,14,14,1466,12,2018,12,0
Group 1,BB,1.5,14,14,1467,9,2018,7,2
Group 1,BB,1.5,14,14,1468,9,2018,11,-2
Group 1,BB,1.5,14,14,1469,10,2018,8,2
Group 1,BB,1.5,14,14,1470,9,2018,10,-1
Group 1,BB,1.5,14,14,1471,10,2018,9,1
Group 1,BB,1.5,14,14,1472,10,2018,10,0
Group 1,BB,1.5,14,14,1473,13,2018,11,2
Group 1,BB,1.5,14,14,1474,8,2018,11,-3
Group 1,BB,1.5,14,14,1475,10,2018,12,-2
Group 1,BB,1.5,14,14,1476,13,2018,9,4
Group 1,BB,1.5,14,14,1477,11,2018,5,6
Group 1,BB,1.5,14,14,1478,13,2018,7,6
Group 1,BB,1.5,14,14,1479,11,2018,12,-1
Group 1,BB,1.5,14,14,1480,10,2018,8,2
Group 1,BB,1.5,14,14,1481,9,2018,11,-2
Group 1,BB,1.5,14,14,1482,12,2018,12,0
Group 1,BB,1.5,14,14,1483,10,2018,9,1
Group 1,BB,1.5,14,14,1484,10,2018,8,2
Group 1,BB,1.5,14,14,1485,10,2018,6,4
Group 1,BB,1.5,14,14,1486,10,2018,10,0
Group 1,BB,1.5,14,14,1487,11,2018,10,1
Group 1,BB,1.5,14,14,1488,10,2018,8,2
Group 1,BB,1.5,14,14,1489,11,2018,10,1
Group 1,BB,1.5,14,14,1490,9,2018,9,0
Group 1,BB,1.5,14,14,1491,6,2018,11,-5
Group 1,BB,1.5,14,14,1492,7,2018,7,0
Group 1,BB,1.5,14,14,1493,11,2018,9,2
Group 1,BB,1.5,14,14,1494,9,2018,10,-1
Group 1,BB,1.5,14,14,1495,12,2018,10,2
Group 1,BB,1.5,14,14,1496,10,2018,9,1
Group 1,BB,1.5,14,14,1497,12,2018,8,4
Group 1,BB,1.5,14,14,1498,10,2018,9,1
Group 1,BB,1.5,14,14,1499,12,2018,11,1
Group 1,BB,1.5,14,14,1500,10,2018,7,3
Group 1,BB,1.5,14,14,1501,10,2018,9,1
Group 1,BB,1.5,14,14,1502,9,2018,7,2
Group 1,BB,1.5,14,14,1503,5,2018,12,-7
Group 1,BB,1.5,14,14,1504,10,2018,9,1
Group 1,BB,1.5,14,14,1505,10,2018,11,-1
Group 1,BB,1.5,14,14,1506,13,2018,10,3
Group 1,BB,1.5,14,14,1507,10,2018,8,2
Group 1,BB,1.5,14,14,1508,8,2018,9,-1
Group 1,BB,1.5,14,14,1509,10,2018,7,3
Group 1,BB,1.5,14,14,1510,6,2018,9,-3
Group 1,BB,1.5,14,14,1511,10,2018,13,-3
Group 1,BB,1.5,14,14,1512,10,2018,12,-2
Group 1,BB,1.5,14,14,1513,14,2018,11,3
Group 1,BB,1.5,14,14,1514,11,2018,9,2
Group 1,BB,1.5,14,14,1515,9,2018,12,-3
Group 1,BB,1.5,14,14,1516,8,2018,14,-6
Group 1,BB,1.5,14,14,1517,7,2018,12,-5
Group 1,BB,1.5,14,14,1518,8,2018,8,0
Group 1,BB,1.5,14,14,1519,12,2018,11,1
Group 1,BB,1.5,14,14,1520,8,2018,6,2
Group 1,BB,1.5,14,14,1521,12,2018,9,3
Group 1,BB,1.5,14,14,1522,10,2018,11,-1
Group 1,BB,1.5,14,14,1523,13,2018,8,5
Group 1,BB,1.5,14,14,1524,9,2018,14,-5
Group 1,BB,1.5,14,14,1525,12,2018,13,-1
Group 1,BB,1.5,14,14,1526,10,2018,11,-1
Group 1,BB,1.5,14,14,1527,6,2018,8,-2
Group 1,BB,1.5,14,14,1528,11,2018,7,4
Group 1,BB,1.5,14,14,1529,9,2018,10,-1
Group 1,BB,1.5,14,14,1530,10,2018,11,-1
Group 1,BB,1.5,14,14,1531,12,2018,10,2
Group 1,BB,1.5,14,14,1532,13,2018,8,5
Group 1,BB,1.5,14,14,1533,12,2018,11,1
Group 1,BB,1.5,14,14,1534,13,2018,11,2
Group 1,BB,1.5,14,14,1535,13,2018,12,1
Group 1,BB,1.5,14,14,1536,7,2018,12,-5
Group 1,BB,1.5,14,14,1537,11,2018,12,-1
Group 1,BB,1.5,14,14,1538,10,2018,12,-2
Group 1,BB,1.5,14,14,1539,12,2018,9,3
Group 1,BB,1.5,14,14,1540,11,2018,9,2
Group 1,BB,1.5,14,14,1541,9,2018,10,-1
Group 1,BB,1.5,14,14,1542,12,2018,10,2
Group 1,BB,1.5,14,14,1543,9,2018,8,1
Group 1,BB,1.5,14,14,1544,14,2018,10,4
Group 1,BB,1.5,14,14,1545,12,2018,10,2
Group 1,BB,1.5,14,14,1546,10,2018,9,1
Group 1,BB,1.5,14,14,1547,9,2018,11,-2
Group 1,BB,1.5,14,14,1548,12,2018,10,2
Group 1,BB,1.5,14,14,1549,11,2018,12,-1
Group 1,BB,1.5,14,14,1550,10,2018,10,0
Group 1,BB,1.5,14,14,1551,11,2018,11,0
Group 1,BB,1.5,14,14,1552,14,2018,5,9
Group 1,BB,1.5,14,14,1553,12,2018,11,1
Group 1,BB,1.5,14,14,1554,12,2018,11,1
Group 1,BB,1.5,14,14,1555,11,2018,9,2
Group 1,BB,1.5,14,14,1556,11,2018,10,1
Group 1,BB,1.5,14,14,1557,14,2018,10,4
Group 1,BB,1.5,14,14,1558,11,2018,10,1
Group 1,BB,1.5,14,14,1559,11,2018,10,1
Group 1,BB,1.5,14,14,1560,9,2018,11,-2
Group 1,BB,1.5,14,14,1561,10,2018,6,4
Group 1,BB,1.5,14,14,1562,11,2018,14,-3
Group 1,BB,1.5,14,14,1563,13,2018,8,5
Group 1,BB,1.5,14,14,1564,11,2018,8,3
Group 1,BB,1.5,14,14,1565,12,2018,9,3
Group 1,BB,1.5,14,14,1566,13,2018,11,2
Group 1,BB,1.5,14,14,1567,11,2018,11,0
Group 1,BB,1.5,14,14,1568,9,2018,8,1
Group 1,BB,1.5,14,14,1569,13,2018,9,4
Group 1,BB,1.5,14,14,1570,12,2018,5,7
Group 1,BB,1.5,14,14,1571,12,2018,10,2
Group 1,BB,1.5,14,14,1572,10,2018,11,-1
Group 1,BB,1.5,14,14,1573,12,2018,10,2
Group 1,BB,1.5,14,14,1574,11,2018,9,2
Group 1,BB,1.5,14,14,1575,13,2018,12,1
Group 1,BB,1.5,14,14,1576,11,2018,9,2
Group 1,BB,1.5,14,14,1577,10,2018,10,0
Group 1,BB,1.5,14,14,1578,12,2018,9,3
Group 1,BB,1.5,14,14,1579,13,2018,12,1
Group 1,BB,1.5,14,14,1580,7,2018,10,-3
Group 1,BB,1.5,14,14,1581,10,2018,10,0
Group 1,BB,1.5,14,14,1582,10,2018,10,0
Group 1,BB,1.5,14,14,1583,9,2018,9,0
Group 1,BB,1.5,14,14,1584,11,2018,14,-3
Group 1,BB,1.5,14,14,1585,11,2018,14,-3
Group 1,BB,1.5,14,14,1586,13,2018,7,6
Group 1,BB,1.5,14,14,1587,10,2018,10,0
Group 1,BB,1.5,14,14,1588,8,2018,10,-2
Group 1,BB,1.5,14,14,1589,11,2018,7,4
Group 1,BB,1.5,14,14,1590,12,2018,12,0
Group 1,BB,1.5,14,14,1591,11,2018,10,1
Group 1,BB,1.5,14,14,1592,12,2018,10,2
Group 1,BB,1.5,14,14,1593,12,2018,8,4
Group 1,BB,1.5,14,14,1594,11,2018,8,3
Group 1,BB,1.5,14,14,1595,12,2018,7,5
Group 1,BB,1.5,14,14,1596,8,2018,8,0
Group 1,BB,1.5,14,14,1597,11,2018,7,4
Group 1,BB,1.5,14,14,1598,10,2018,7,3
Group 1,BB,1.5,14,14,1599,12,2018,10,2
Group 1,BB,1.5,14,14,1600,11,2018,8,3
Group 1,BB,1.5,14,14,1601,12,2018,11,1
Group 1,BB,1.5,14,14,1602,6,2018,8,-2
Group 1,BB,1.5,14,14,1603,6,2018,10,-4
Group 1,BB,1.5,14,14,1604,10,2018,10,0
Group 1,BB,1.5,14,14,1605,9,2018,10,-1
Group 1,BB,1.5,14,14,1606,9,2018,10,-1
Group 1,BB,1.5,14,14,1607,12,2018,10,2
Group 1,BB,1.5,14,14,1608,13,2018,13,0
Group 1,BB,1.5,14,14,1609,12,2018,11,1
Group 1,BB,1.5,14,14,1610,10,2018,11,-1
Group 1,BB,1.5,14,14,1611,8,2018,10,-2
Group 1,BB,1.5,14,14,1612,11,2018,11,0
Group 1,BB,1.5,14,14,1613,12,2018,10,2
Group 1,BB,1.5,14,14,1614,11,2018,9,2
Group 1,BB,1.5,14,14,1615,13,2018,10,3
Group 1,BB,1.5,14,14,1616,8,2018,8,0
Group 1,BB,1.5,14,14,1617,10,2018,13,-3
Group 1,BB,1.5,14,14,1618,10,2018,10,0
Group 1,BB,1.5,14,14,1619,9,2018,9,0
Group 1,BB,1.5,14,14,1620,8,2018,10,-2
Group 1,BB,1.5,14,14,1621,13,2018,7,6
Group 1,BB,1.5,14,14,1622,7,2018,10,-3
Group 1,BB,1.5,14,14,1623,8,2018,8,0
Group 1,BB,1.5,14,14,1624,12,2018,9,3
Group 1,BB,1.5,14,14,1625,10,2018,13,-3
Group 1,BB,1.5,14,14,1626,13,2018,9,4
Group 1,BB,1.5,14,14,1627,12,2018,11,1
Group 1,BB,1.5,14,14,1628,11,2018,9,2
Group 1,BB,1.5,14,14,1629,10,2018,13,-3
Group 1,BB,1.5,14,14,1630,12,2018,10,2
Group 1,BB,1.5,14,14,1631,14,2018,11,3
Group 1,BB,1.5,14,14,1632,11,2018,11,0
Group 1,BB,1.5,14,14,1633,9,2018,14,-5
Group 1,BB,1.5,14,14,1634,9,2018,12,-3
Group 1,BB,1.5,14,14,1635,7,2018,9,-2
Group 1,BB,1.5,14,14,1636,8,2018,10,-2
Group 1,BB,1.5,14,14,1637,11,2018,10,1
Group 1,BB,1.5,14,14,1638,11,2018,10,1
Group 1,BB,1.5,14,14,1639,11,2018,11,0
Group 1,BB,1.5,14,14,1640,11,2018,10,1
Group 1,BB,1.5,14,14,1641,10,2018,11,-1
Group 1,BB,1.5,14,14,1642,11,2018,7,4
Group 1,BB,1.5,14,14,1643,10,2018,11,-1
Group 1,BB,1.5,14,14,1644,13,2018,11,2
Group 1,BB,1.5,14,14,1645,11,2018,10,1
Group 1,BB,1.5,14,14,1646,13,2018,11,2
Group 1,BB,1.5,14,14,1647,11,2018,9,2
Group 1,BB,1.5,14,14,1648,12,2018,11,1
Group 1,BB,1.5,14,14,1649,10,2018,9,1
Group 1,BB,1.5,14,14,1650,14,2018,12,2
Group 1,BB,1.5,14,14,1651,11,2018,13,-2
Group 1,BB,1.5,14,14,1652,10,2018,9,1
Group 1,BB,1.5,14,14,1653,10,2018,12,-2
Group 1,BB,1.5,14,14,1654,13,2018,8,5
Group 1,BB,1.5,14,14,1655,10,2018,12,-2
Group 1,BB,1.5,14,14,1656,12,2018,11,1
Group 1,BB,1.5,14,14,1657,13,2018,10,3
Group 1,BB,1.5,14,14,1658,10,2018,13,-3
Group 1,BB,1.5,14,14,1659,10,2018,11,-1
Group 1,BB,1.5,14,14,1660,8,2018,13,-5
Group 1,BB,1.5,14,14,1661,11,2018,11,0
Group 1,BB,1.5,14,14,1662,12,2018,8,4
Group 1,BB,1.5,14,14,1663,12,2018,12,0
Group 1,BB,1.5,14,14,1664,12,2018,10,2
Group 1,BB,1.5,14,14,1665,12,2018,6,6
Group 1,BB,1.5,14,14,1666,10,2018,5,5
Group 1,BB,1.5,14,14,1667,10,2018,8,2
Group 1,BB,1.5,14,14,1668,9,2018,8,1
Group 1,BB,1.5,14,14,1669,11,2018,9,2
Group 1,BB,1.5,14,14,1670,7,2018,13,-6
Group 1,BB,1.5,14,14,1671,14,2018,12,2
Group 1,BB,1.5,14,14,1672,10,2018,11,-1
Group 1,BB,1.5,14,14,1673,8,2018,12,-4
Group 1,BB,1.5,14,14,1674,12,2018,9,3
Group 1,BB,1.5,14,14,1675,9,2018,8,1
Group 1,BB,1.5,14,14,1676,11,2018,9,2
Group 1,BB,1.5,14,14,1677,11,2018,9,2
Group 1,BB,1.5,14,14,1678,12,2018,11,1
Group 1,BB,1.5,14,14,1679,10,2018,12,-2
Group 1,BB,1.5,14,14,1680,8,2018,12,-4
Group 1,BB,1.5,14,14,1681,11,2018,9,2
Group 1,BB,1.5,14,14,1682,12,2018,12,0
Group 1,BB,1.5,14,14,1683,6,2018,12,-6
Group 1,BB,1.5,14,14,1684,9,2018,13,-4
Group 1,BB,1.5,14,14,1685,9,2018,12,-3
Group 1,BB,1.5,14,14,1686,9,2018,13,-4
Group 1,BB,1.5,14,14,1687,11,2018,10,1
Group 1,BB,1.5,14,14,1688,12,2018,13,-1
Group 1,BB,1.5,14,14,1689,11,2018,10,1
Group 1,BB,1.5,14,14,1690,11,2018,12,-1
Group 1,BB,1.5,14,14,1691,10,2018,11,-1
Group 1,BB,1.5,14,14,1692,11,2018,11,0
Group 1,BB,1.5,14,14,1693,12,2018,10,2
Group 1,BB,1.5,14,14,1694,13,2018,12,1
Group 1,BB,1.5,14,14,1695,8,2018,10,-2
Group 1,BB,1.5,14,14,1696,13,2018,10,3
Group 1,BB,1.5,14,14,1697,7,2018,9,-2
Group 1,BB,1.5,14,14,1698,7,2018,7,0
Group 1,BB,1.5,14,14,1699,9,2018,10,-1
Group 1,BB,1.5,14,14,1700,11,2018,10,1
Group 1,BB,1.5,14,14,1701,11,2018,11,0
Group 1,BB,1.5,14,14,1702,11,2018,8,3
Group 1,BB,1.5,14,14,1703,9,2018,11,-2
Group 1,BB,1.5,14,14,1704,11,2018,12,-1
Group 1,BB,1.5,14,14,1705,11,2018,10,1
Group 1,BB,1.5,14,14,1706,13,2018,9,4
Group 1,BB,1.5,14,14,1707,13,2018,11,2
Group 1,BB,1.5,14,14,1708,12,2018,11,1
Group 1,BB,1.5,14,14,1709,12,2018,9,3
Group 1,BB,1.5,14,14,1710,11,2018,9,2
Group 1,BB,1.5,14,14,1711,8,2018,9,-1
Group 1,BB,1.5,14,14,1712,7,2018,11,-4
Group 1,BB,1.5,14,14,1713,11,2018,12,-1
Group 1,BB,1.5,14,14,1714,12,2018,9,3
Group 1,BB,1.5,14,14,1715,11,2018,11,0
Group 1,BB,1.5,14,14,1716,13,2018,12,1
Group 1,BB,1.5,14,14,1717,9,2018,12,-3
Group 1,BB,1.5,14,14,1718,10,2018,10,0
Group 1,BB,1.5,14,14,1719,10,2018,12,-2
Group 1,BB,1.5,14,14,1720,13,2018,7,6
Group 1,BB,1.5,14,14,1721,12,2018,10,2
Group 1,BB,1.5,14,14,1722,10,2018,9,1
Group 1,BB,1.5,14,14,1723,12,2018,11,1
Group 1,BB,1.5,14,14,1724,13,2018,11,2
Group 1,BB,1.5,14,14,1725,7,2018,11,-4
Group 1,BB,1.5,14,14,1726,11,2018,9,2
Group 1,BB,1.5,14,14,1727,11,2018,9,2
Group 1,BB,1.5,14,14,1728,9,2018,12,-3
Group 1,BB,1.5,14,14,1729,10,2018,8,2
Group 1,BB,1.5,14,14,1730,9,2018,12,-3
Group 1,BB,1.5,14,14,1731,11,2018,6,5
Group 1,BB,1.5,14,14,1732,10,2018,12,-2
Group 1,BB,1.5,14,14,1733,13,2018,12,1
Group 1,BB,1.5,14,14,1734,8,2018,13,-5
Group 1,BB,1.5,14,14,1735,10,2018,7,3
Group 1,BB,1.5,14,14,1736,8,2018,8,0
Group 1,BB,1.5,14,14,1737,9,2018,11,-2
Group 1,BB,1.5,14,14,1738,6,2018,11,-5
Group 1,BB,1.5,14,14,1739,11,2018,10,1
Group 1,BB,1.5,14,14,1740,8,2018,11,-3
Group 1,BB,1.5,14,14,1741,8,2018,12,-4
Group 1,BB,1.5,14,14,1742,10,2018,9,1
Group 1,BB,1.5,14,14,1743,11,2018,9,2
Group 1,BB,1.5,14,14,1744,9,2018,10,-1
Group 1,BB,1.5,14,14,1745,11,2018,10,1
Group 1,BB,1.5,14,14,1746,13,2018,12,1
Group 1,BB,1.5,14,14,1747,11,2018,11,0
Group 1,BB,1.5,14,14,1748,10,2018,10,0
Group 1,BB,1.5,14,14,1749,13,2018,11,2
Group 1,BB,1.5,14,14,1750,12,2018,13,-1
Group 1,BB,1.5,14,14,1751,11,2018,10,1
Group 1,BB,1.5,14,14,1752,10,2018,11,-1
Group 1,BB,1.5,14,14,1753,13,2018,12,1
Group 1,BB,1.5,14,14,1754,12,2018,11,1
Group 1,BB,1.5,14,14,1755,10,2018,10,0
Group 1,BB,1.5,14,14,1756,11,2018,12,-1
Group 1,BB,1.5,14,14,1757,10,2018,12,-2
Group 1,BB,1.5,14,14,1758,8,2018,8,0
Group 1,BB,1.5,14,14,1759,13,2018,9,4
Group 1,BB,1.5,14,14,1760,13,2018,11,2
Group 1,BB,1.5,14,14,1761,10,2018,10,0
Group 1,BB,1.5,14,14,1762,12,2018,12,0
Group 1,BB,1.5,14,14,1763,13,2018,13,0
Group 1,BB,1.5,14,14,1764,14,2018,12,2
Group 1,BB,1.5,14,14,1765,10,2018,10,0
Group 1,BB,1.5,14,14,1766,11,2018,9,2
Group 1,BB,1.5,14,14,1767,11,2018,8,3
Group 1,BB,1.5,14,14,1768,12,2018,10,2
Group 1,BB,1.5,14,14,1769,9,2018,7,2
Group 1,BB,1.5,14,14,1770,11,2018,12,-1
Group 1,BB,1.5,14,14,1771,9,2018,9,0
Group 1,BB,1.5,14,14,1772,12,2018,14,-2
Group 1,BB,1.5,14,14,1773,13,2018,14,-1
Group 1,BB,1.5,14,14,1774,13,2018,10,3
Group 1,BB,1.5,14,14,1775,13,2018,10,3
Group 1,BB,1.5,14,14,1776,11,2018,8,3
Group 1,BB,1.5,14,14,1777,12,2018,11,1
Group 1,BB,1.5,14,14,1778,7,2018,7,0
Group 1,BB,1.5,14,14,1779,11,2018,10,1
Group 1,BB,1.5,14,14,1780,12,2018,9,3
Group 1,BB,1.5,14,14,1781,9,2018,11,-2
Group 1,BB,1.5,14,14,1782,11,2018,9,2
Group 1,BB,1.5,14,14,1783,12,2018,8,4
Group 1,BB,1.5,14,14,1784,14,2018,11,3
Group 1,BB,1.5,14,14,1785,11,2018,10,1
Group 1,BB,1.5,14,14,1786,9,2018,10,-1
Group 1,BB,1.5,14,14,1787,11,2018,10,1
Group 1,BB,1.5,14,14,1788,12,2018,9,3
Group 1,BB,1.5,14,14,1789,13,2018,12,1
Group 1,BB,1.5,14,14,1790,10,2018,11,-1
Group 1,BB,1.5,14,14,1791,11,2018,7,4
Group 1,BB,1.5,14,14,1792,11,2018,9,2
Group 1,BB,1.5,14,14,1793,12,2018,8,4
Group 1,BB,1.5,14,14,1794,8,2018,12,-4
Group 1,BB,1.5,14,14,1795,10,2018,10,0
Group 1,BB,1.5,14,14,1796,12,2018,9,3
Group 1,BB,1.5,14,14,1797,10,2018,8,2
Group 1,BB,1.5,14,14,1798,13,2018,9,4
Group 1,BB,1.5,14,14,1799,10,2018,12,-2
Group 1,BB,1.5,14,14,1800,12,2018,13,-1
Group 1,BB,1.5,14,14,1801,11,2018,10,1
Group 1,BB,1.5,14,14,1802,11,2018,13,-2
Group 1,BB,1.5,14,14,1803,8,2018,10,-2
Group 1,BB,1.5,14,14,1804,9,2018,11,-2
Group 1,BB,1.5,14,14,1805,8,2018,9,-1
Group 1,BB,1.5,14,14,1806,12,2018,11,1
Group 1,BB,1.5,14,14,1807,11,2018,12,-1
Group 1,BB,1.5,14,14,1808,11,2018,6,5
Group 1,BB,1.5,14,14,1809,10,2018,9,1
Group 1,BB,1.5,14,14,1810,12,2018,10,2
Group 1,BB,1.5,14,14,1811,11,2018,10,1
Group 1,BB,1.5,14,14,1812,10,2018,11,-1
Group 1,BB,1.5,14,14,1813,8,2018,11,-3
Group 1,BB,1.5,14,14,1814,12,2018,10,2
Group 1,BB,1.5,14,14,1815,10,2018,13,-3
Group 1,BB,1.5,14,14,1816,13,2018,12,1
Group 1,BB,1.5,14,14,1817,10,2018,9,1
Group 1,BB,1.5,14,14,1818,13,2018,13,0
Group 1,BB,1.5,14,14,1819,11,2018,10,1
Group 1,BB,1.5,14,14,1820,6,2018,8,-2
Group 1,BB,1.5,14,14,1821,13,2018,9,4
Group 1,BB,1.5,14,14,1822,11,2018,11,0
Group 1,BB,1.5,14,14,1823,12,2018,7,5
Group 1,BB,1.5,14,14,1824,6,2018,11,-5
Group 1,BB,1.5,14,14,1825,11,2018,6,5
Group 1,BB,1.5,14,14,1826,10,2018,11,-1
Group 1,BB,1.5,14,14,1827,11,2018,7,4
Group 1,BB,1.5,14,14,1828,11,2018,9,2
Group 1,BB,1.5,14,14,1829,13,2018,13,0
Group 1,BB,1.5,14,14,1830,12,2018,8,4
Group 1,BB,1.5,14,14,1831,12,2018,10,2
Group 1,BB,1.5,14,14,1832,9,2018,11,-2
Group 1,BB,1.5,14,14,1833,8,2018,11,-3
Group 1,BB,1.5,14,14,1834,11,2018,11,0
Group 1,BB,1.5,14,14,1835,13,2018,8,5
Group 1,BB,1.5,14,14,1836,13,2018,12,1
Group 1,BB,1.5,14,14,1837,10,2018,10,0
Group 1,BB,1.5,14,14,1838,8,2018,12,-4
Group 1,BB,1.5,14,14,1839,10,2018,6,4
Group 1,BB,1.5,14,14,1840,9,2018,9,0
Group 1,BB,1.5,14,14,1841,11,2018,9,2
Group 1,BB,1.5,14,14,1842,11,2018,12,-1
Group 1,BB,1.5,14,14,1843,9,2018,8,1
Group 1,BB,1.5,14,14,1844,11,2018,11,0
Group 1,BB,1.5,14,14,1845,13,2018,10,3
Group 1,BB,1.5,14,14,1846,11,2018,12,-1
Group 1,BB,1.5,14,14,1847,13,2018,7,6
Group 1,BB,1.5,14,14,1848,12,2018,6,6
Group 1,BB,1.5,14,14,1849,13,2018,8,5
Group 1,BB,1.5,14,14,1850,12,2018,11,1
Group 1,BB,1.5,14,14,1851,11,2018,10,1
Group 1,BB,1.5,14,14,1852,11,2018,10,1
Group 1,BB,1.5,14,14,1853,9,2018,10,-1
Group 1,BB,1.5,14,14,1854,13,2018,14,-1
Group 1,BB,1.5,14,14,1855,10,2018,8,2
Group 1,BB,1.5,14,14,1856,11,2018,12,-1
Group 1,BB,1.5,14,14,1857,10,2018,7,3
Group 1,BB,1.5,14,14,1858,12,2018,8,4
Group 1,BB,1.5,14,14,1859,14,2018,7,7
Group 1,BB,1.5,14,14,1860,10,2018,11,-1
Group 1,BB,1.5,14,14,1861,10,2018,9,1
Group 1,BB,1.5,14,14,1862,9,2018,11,-2
Group 1,BB,1.5,14,14,1863,10,2018,10,0
Group 1,BB,1.5,14,14,1864,12,2018,14,-2
Group 1,BB,1.5,14,14,1865,13,2018,14,-1
Group 1,BB,1.5,14,14,1866,8,2018,7,1
Group 1,BB,1.5,14,14,1867,11,2018,11,0
Group 1,BB,1.5,14,14,1868,10,2018,10,0
Group 1,BB,1.5,14,14,1869,11,2018,11,0
Group 1,BB,1.5,14,14,1870,9,2018,11,-2
Group 1,BB,1.5,14,14,1871,13,2018,8,5
Group 1,BB,1.5,14,14,1872,7,2018,7,0
Group 1,BB,1.5,14,14,1873,13,2018,11,2
Group 1,BB,1.5,14,14,1874,12,2018,10,2
Group 1,BB,1.5,14,14,1875,11,2018,10,1
Group 1,BB,1.5,14,14,1876,9,2018,10,-1
Group 1,BB,1.5,14,14,1877,12,2018,10,2
Group 1,BB,1.5,14,14,1878,11,2018,10,1
Group 1,BB,1.5,14,14,1879,13,2018,12,1
Group 1,BB,1.5,14,14,1880,13,2018,10,3
Group 1,BB,1.5,14,14,1881,6,2018,11,-5
Group 1,BB,1.5,14,14,1882,8,2018,8,0
Group 1,BB,1.5,14,14,1883,10,2018,11,-1
Group 1,BB,1.5,14,14,1884,8,2018,10,-2
Group 1,BB,1.5,14,14,1885,10,2018,11,-1
Group 1,BB,1.5,14,14,1886,10,2018,12,-2
Group 1,BB,1.5,14,14,1887,13,2018,6,7
Group 1,BB,1.5,14,14,1888,10,2018,9,1
Group 1,BB,1.5,14,14,1889,10,2018,11,-1
Group 1,BB,1.5,14,14,1890,12,2018,6,6
Group 1,BB,1.5,14,14,1891,12,2018,6,6
Group 1,BB,1.5,14,14,1892,11,2018,11,0
Group 1,BB,1.5,14,14,1893,10,2018,11,-1
Group 1,BB,1.5,14,14,1894,13,2018,9,4
Group 1,BB,1.5,14,14,1895,7,2018,12,-5
Group 1,BB,1.5,14,14,1896,8,2018,11,-3
Group 1,BB,1.5,14,14,1897,13,2018,9,4
Group 1,BB,1.5,14,14,1898,12,2018,10,2
Group 1,BB,1.5,14,14,1899,11,2018,11,0
Group 1,BB,1.5,14,14,1900,11,2018,11,0
Group 1,BB,1.5,14,14,1901,13,2018,9,4
Group 1,BB,1.5,14,14,1902,11,2018,13,-2
Group 1,BB,1.5,14,14,1903,10,2018,10,0
Group 1,BB,1.5,14,14,1904,11,2018,11,0
Group 1,BB,1.5,14,14,1905,12,2018,10,2
Group 1,BB,1.5,14,14,1906,12,2018,11,1
Group 1,BB,1.5,14,14,1907,10,2018,10,0
Group 1,BB,1.5,14,14,1908,10,2018,12,-2
Group 1,BB,1.5,14,14,1909,13,2018,7,6
Group 1,BB,1.5,14,14,1910,10,2018,11,-1
Group 1,BB,1.5,14,14,1911,11,2018,5,6
Group 1,BB,1.5,14,14,1912,10,2018,8,2
Group 1,BB,1.5,14,14,1913,11,2018,10,1
Group 1,BB,1.5,14,14,1914,12,2018,7,5
Group 1,BB,1.5,14,14,1915,11,2018,13,-2
Group 1,BB,1.5,14,14,1916,13,2018,11,2
Group 1,BB,1.5,14,14,1917,9,2018,13,-4
Group 1,BB,1.5,14,14,1918,13,2018,11,2
Group 1,BB,1.5,14,14,1919,11,2018,9,2
Group 1,BB,1.5,14,14,1920,12,2018,11,1
Group 1,BB,1.5,14,14,1921,8,2018,7,1
Group 1,BB,1.5,14,14,1922,11,2018,10,1
Group 1,BB,1.5,14,14,1923,14,2018,10,4
Group 1,BB,1.5,14,14,1924,12,2018,10,2
Group 1,BB,1.5,14,14,1925,12,2018,7,5
Group 1,BB,1.5,14,14,1926,8,2018,12,-4
Group 1,BB,1.5,14,14,1927,10,2018,11,-1
Group 1,BB,1.5,14,14,1928,11,2018,13,-2
Group 1,BB,1.5,14,14,1929,10,2018,13,-3
Group 1,BB,1.5,14,14,1930,11,2018,9,2
Group 1,BB,1.5,14,14,1931,10,2018,14,-4
Group 1,BB,1.5,14,14,1932,13,2018,7,6
Group 1,BB,1.5,14,14,1933,9,2018,12,-3
Group 1,BB,1.5,14,14,1934,11,2018,12,-1
Group 1,BB,1.5,14,14,1935,13,2018,11,2
Group 1,BB,1.5,14,14,1936,11,2018,11,0
Group 1,BB,1.5,14,14,1937,9,2018,9,0
Group 1,BB,1.5,14,14,1938,9,2018,9,0
Group 1,BB,1.5,14,14,1939,11,2018,9,2
Group 1,BB,1.5,14,14,1940,12,2018,11,1
Group 1,BB,1.5,14,14,1941,8,2018,11,-3
Group 1,BB,1.5,14,14,1942,11,2018,11,0
Group 1,BB,1.5,14,14,1943,11,2018,10,1
Group 1,BB,1.5,14,14,1944,11,2018,11,0
Group 1,BB,1.5,14,14,1945,10,2018,11,-1
Group 1,BB,1.5,14,14,1946,11,2018,6,5
Group 1,BB,1.5,14,14,1947,10,2018,12,-2
Group 1,BB,1.5,14,14,1948,9,2018,13,-4
Group 1,BB,1.5,14,14,1949,12,2018,11,1
Group 1,BB,1.5,14,14,1950,11,2018,13,-2
Group 1,BB,1.5,14,14,1951,11,2018,12,-1
Group 1,BB,1.5,14,14,1952,9,2018,10,-1
Group 1,BB,1.5,14,14,1953,14,2018,12,2
Group 1,BB,1.5,14,14,1954,11,2018,11,0
Group 1,BB,1.5,14,14,1955,14,2018,11,3
Group 1,BB,1.5,14,14,1956,11,2018,9,2
Group 1,BB,1.5,14,14,1957,8,2018,8,0
Group 1,BB,1.5,14,14,1958,10,2018,9,1
Group 1,BB,1.5,14,14,1959,10,2018,7,3
Group 1,BB,1.5,14,14,1960,10,2018,9,1
Group 1,BB,1.5,14,14,1961,13,2018,11,2
Group 1,BB,1.5,14,14,1962,11,2018,9,2
Group 1,BB,1.5,14,14,1963,13,2018,8,5
Group 1,BB,1.5,14,14,1964,11,2018,5,6
Group 1,BB,1.5,14,14,1965,12,2018,6,6
Group 1,BB,1.5,14,14,1966,10,2018,9,1
Group 1,BB,1.5,14,14,1967,14,2018,10,4
Group 1,BB,1.5,14,14,1968,11,2018,12,-1
Group 1,BB,1.5,14,14,1969,13,2018,13,0
Group 1,BB,1.5,14,14,1970,10,2018,12,-2
Group 1,BB,1.5,14,14,1971,12,2018,7,5
Group 1,BB,1.5,14,14,1972,11,2018,10,1
Group 1,BB,1.5,14,14,1973,12,2018,6,6
Group 1,BB,1.5,14,14,1974,12,2018,6,6
Group 1,BB,1.5,14,14,1975,12,2018,9,3
Group 1,BB,1.5,14,14,1976,8,2018,5,3
Group 1,BB,1.5,14,14,1977,11,2018,6,5
Group 1,BB,1.5,14,14,1978,12,2018,12,0
Group 1,BB,1.5,14,14,1979,11,2018,12,-1
Group 1,BB,1.5,14,14,1980,7,2018,9,-2
Group 1,BB,1.5,14,14,1981,8,2018,8,0
Group 1,BB,1.5,14,14,1982,12,2018,12,0
Group 1,BB,1.5,14,14,1983,12,2018,12,0
Group 1,BB,1.5,14,14,1984,10,2018,7,3
Group 1,BB,1.5,14,14,1985,10,2018,11,-1
Group 1,BB,1.5,14,14,1986,14,2018,8,6
Group 1,BB,1.5,14,14,1987,12,2018,13,-1
Group 1,BB,1.5,14,14,1988,11,2018,11,0
Group 1,BB,1.5,14,14,1989,14,2018,6,8
Group 1,BB,1.5,14,14,1990,12,2018,11,1
Group 1,BB,1.5,14,14,1991,11,2018,12,-1
Group 1,BB,1.5,14,14,1992,10,2018,8,2
Group 1,BB,1.5,14,14,1993,7,2018,11,-4
Group 1,BB,1.5,14,14,1994,9,2018,9,0
Group 1,BB,1.5,14,14,1995,9,2018,10,-1
Group 1,BB,1.5,14,14,1996,11,2018,12,-1
Group 1,BB,1.5,14,14,1997,10,2018,9,1
Group 1,BB,1.5,14,14,1998,7,2018,6,1
Group 1,BB,1.5,14,14,1999,9,2018,12,-3
Group 1,BB,1.5,14,14,2000,11,2018,11,0
Group 1,BB,1.5,14,14,2001,11,2018,7,4
Group 1,BB,1.5,14,14,2002,12,2018,6,6
Group 1,BB,1.5,14,14,2003,11,2018,11,0
Group 1,BB,1.5,14,14,2004,11,2018,10,1
Group 1,BB,1.5,14,14,2005,12,2018,10,2
Group 1,BB,1.5,14,14,2006,10,2018,10,0
Group 1,BB,1.5,14,14,2007,9,2018,10,-1
Group 1,BB,1.5,14,14,2008,10,2018,12,-2
Group 1,BB,1.5,14,14,2009,10,2018,8,2
Group 1,BB,1.5,14,14,2010,10,2018,11,-1
Group 1,BB,1.5,14,14,2011,10,2018,11,-1
Group 1,BB,1.5,14,14,2012,11,2018,12,-1
Group 1,BB,1.5,14,14,2013,11,2018,13,-2
Group 1,BB,1.5,14,14,2014,9,2018,8,1
Group 1,BB,1.5,14,14,2015,10,2018,11,-1
Group 1,BB,1.5,14,14,2016,9,2018,12,-3
Group 1,BB,1.5,14,14,2017,9,2018,8,1
Group 1,BB,1.5,14,14,2018,13,2018,9,4
Group 1,BB,1.5,14,14,2019,9,2018,11,-2
Group 1,BB,1.5,14,14,2020,12,2018,11,1
Group 1,BB,1.5,14,14,2021,10,2018,10,0
Group 1,BB,1.5,14,14,2022,10,2018,8,2
Group 1,BB,1.5,14,14,2023,10,2018,10,0
Group 1,BB,1.5,14,14,2024,14,2018,9,5
Group 1,BB,1.5,14,14,2025,12,2018,13,-1
Group 1,BB,1.5,14,14,2026,11,2018,10,1
Group 1,BB,1.5,14,14,2027,11,2018,7,4
Group 1,BB,1.5,14,14,2028,12,2018,9,3
Group 1,BB,1.5,14,14,2029,9,2018,12,-3
Group 1,BB,1.5,14,14,2030,9,2018,14,-5
Group 1,BB,1.5,14,14,2031,10,2018,3,7
Group 1,BB,1.5,14,14,2032,9,2018,11,-2
Group 1,BB,1.5,14,14,2033,6,2018,12,-6
Group 1,BB,1.5,14,14,2034,9,2018,9,0
Group 1,BB,1.5,14,14,2035,13,2018,6,7
Group 1,BB,1.5,14,14,2036,12,2018,11,1
Group 1,BB,1.5,14,14,2037,9,2018,12,-3
Group 1,BB,1.5,14,14,2038,8,2018,11,-3
Group 1,BB,1.5,14,14,2039,11,2018,10,1
Group 1,BB,1.5,14,14,2040,10,2018,9,1
Group 1,BB,1.5,14,14,2041,11,2018,8,3
Group 1,BB,1.5,14,14,2042,12,2018,8,4
Group 1,BB,1.5,14,14,2043,12,2018,8,4
Group 1,BB,1.5,14,14,2044,12,2018,10,2
Group 1,BB,1.5,14,14,2045,10,2018,12,-2
Group 1,BB,1.5,14,14,2046,7,2018,10,-3
Group 1,BB,1.5,14,14,2047,11,2018,9,2
Group 1,BB,1.5,14,14,2048,10,2018,8,2
Group 1,BB,1.5,14,14,2049,11,2018,11,0
Group 1,BB,1.5,14,14,2050,7,2018,10,-3
Group 1,BB,1.5,14,14,2051,10,2018,8,2
Group 1,BB,1.5,14,14,2052,14,2018,11,3
Group 1,BB,1.5,14,14,2053,10,2018,9,1
Group 1,BB,1.5,14,14,2054,12,2018,13,-1
Group 1,BB,1.5,14,14,2055,13,2018,14,-1
Group 1,BB,1.5,14,14,2056,10,2018,8,2
Group 1,BB,1.5,14,14,2057,11,2018,7,4
Group 1,BB,1.5,14,14,2058,11,2018,7,4
Group 1,BB,1.5,14,14,2059,10,2018,12,-2
Group 1,BB,1.5,14,14,2060,10,2018,11,-1
Group 1,BB,1.5,14,14,2061,11,2018,11,0
Group 1,BB,1.5,14,14,2062,9,2018,8,1
Group 1,BB,1.5,14,14,2063,11,2018,13,-2
Group 1,BB,1.5,14,14,2064,12,2018,5,7
Group 1,BB,1.5,14,14,2065,12,2018,8,4
Group 1,BB,1.5,14,14,2066,12,2018,9,3
Group 1,BB,1.5,14,14,2067,9,2018,14,-5
Group 1,BB,1.5,14,14,2068,10,2018,9,1
Group 1,BB,1.5,14,14,2069,11,2018,9,2
Group 1,BB,1.5,14,14,2070,9,2018,9,0
Group 1,BB,1.5,14,14,2071,11,2018,11,0
Group 1,BB,1.5,14,14,2072,8,2018,9,-1
Group 1,BB,1.5,14,14,2073,11,2018,8,3
Group 1,BB,1.5,14,14,2074,11,2018,11,0
Group 1,BB,1.5,14,14,2075,10,2018,8,2
Group 1,BB,1.5,14,14,2076,9,2018,11,-2
Group 1,BB,1.5,14,14,2077,12,2018,11,1
Group 1,BB,1.5,14,14,2078,11,2018,11,0
Group 1,BB,1.5,14,14,2079,12,2018,13,-1
Group 1,BB,1.5,14,14,2080,9,2018,8,1
Group 1,BB,1.5,14,14,2081,11,2018,8,3
Group 1,BB,1.5,14,14,2082,13,2018,10,3
Group 1,BB,1.5,14,14,2083,10,2018,11,-1
Group 1,BB,1.5,14,14,2084,11,2018,12,-1
Group 1,BB,1.5,14,14,2085,8,2018,7,1
Group 1,BB,1.5,14,14,2086,9,2018,11,-2
Group 1,BB,1.5,14,14,2087,11,2018,8,3
Group 1,BB,1.5,14,14,2088,10,2018,10,0
Group 1,BB,1.5,14,14,2089,11,2018,11,0
Group 1,BB,1.5,14,14,2090,10,2018,8,2
Group 1,BB,1.5,14,14,2091,12,2018,12,0
Group 1,BB,1.5,14,14,2092,10,2018,11,-1
Group 1,BB,1.5,14,14,2093,11,2018,12,-1
Group 1,BB,1.5,14,14,2094,13,2018,11,2
Group 1,BB,1.5,14,14,2095,8,2018,11,-3
Group 1,BB,1.5,14,14,2096,12,2018,10,2
Group 1,BB,1.5,14,14,2097,12,2018,8,4
Group 1,BB,1.5,14,14,2098,11,2018,11,0
Group 1,BB,1.5,14,14,2099,11,2018,6,5
Group 1,BB,1.5,14,14,2100,10,2018,11,-1
Group 1,BB,1.5,14,14,2101,10,2018,13,-3
Group 1,BB,1.5,14,14,2102,10,2018,10,0
Group 1,BB,1.5,14,14,2103,10,2018,11,-1
Group 1,BB,1.5,14,14,2104,9,2018,10,-1
Group 1,BB,1.5,14,14,2105,11,2018,8,3
Group 1,BB,1.5,14,14,2106,7,2018,14,-7
Group 1,BB,1.5,14,14,2107,11,2018,7,4
Group 1,BB,1.5,14,14,2108,11,2018,11,0
Group 1,BB,1.5,14,14,2109,12,2018,11,1
Group 1,BB,1.5,14,14,2110,12,2018,11,1
Group 1,BB,1.5,14,14,2111,12,2018,10,2
Group 1,BB,1.5,14,14,2112,10,2018,11,-1
Group 1,BB,1.5,14,14,2113,12,2018,13,-1
Group 1,BB,1.5,14,14,2114,12,2018,9,3
Group 1,BB,1.5,14,14,2115,8,2018,10,-2
Group 1,BB,1.5,14,14,2116,11,2018,8,3
Group 1,BB,1.5,14,14,2117,12,2018,8,4
Group 1,BB,1.5,14,14,2118,9,2018,12,-3
Group 1,BB,1.5,14,14,2119,10,2018,13,-3
Group 1,BB,1.5,14,14,2120,10,2018,11,-1
Group 1,BB,1.5,14,14,2121,10,2018,11,-1
Group 1,BB,1.5,14,14,2122,12,2018,11,1
Group 1,BB,1.5,14,14,2123,9,2018,12,-3
Group 1,BB,1.5,14,14,2124,13,2018,7,6
Group 1,BB,1.5,14,14,2125,12,2018,11,1
Group 1,BB,1.5,14,14,2126,10,2018,9,1
Group 1,BB,1.5,14,14,2127,11,2018,8,3
Group 1,BB,1.5,14,14,2128,11,2018,10,1
Group 1,BB,1.5,14,14,2129,12,2018,7,5
Group 1,BB,1.5,14,14,2130,12,2018,9,3
Group 1,BB,1.5,14,14,2131,12,2018,8,4
Group 1,BB,1.5,14,14,2132,11,2018,4,7
Group 1,BB,1.5,14,14,2133,13,2018,8,5
Group 1,BB,1.5,14,14,2134,14,2018,6,8
Group 1,BB,1.5,14,14,2135,11,2018,10,1
Group 1,BB,1.5,14,14,2136,12,2018,11,1
Group 1,BB,1.5,14,14,2137,13,2018,7,6
Group 1,BB,1.5,14,14,2138,12,2018,11,1
Group 1,BB,1.5,14,14,2139,11,2018,8,3
Group 1,BB,1.5,14,14,2140,10,2018,10,0
Group 1,BB,1.5,14,14,2141,12,2018,12,0
Group 1,BB,1.5,14,14,2142,8,2018,11,-3
Group 1,BB,1.5,14,14,2143,11,2018,8,3
Group 1,BB,1.5,14,14,2144,8,2018,11,-3
Group 1,BB,1.5,14,14,2145,10,2018,9,1
Group 1,BB,1.5,14,14,2146,12,2018,10,2
Group 1,BB,1.5,14,14,2147,12,2018,8,4
Group 1,BB,1.5,14,14,2148,9,2018,12,-3
Group 1,BB,1.5,14,14,2149,12,2018,8,4
Group 1,BB,1.5,14,14,2150,9,2018,9,0
Group 1,BB,1.5,14,14,2151,12,2018,9,3
Group 1,BB,1.5,14,14,2152,10,2018,11,-1
Group 1,BB,1.5,14,14,2153,11,2018,12,-1
Group 1,BB,1.5,14,14,2154,9,2018,12,-3
Group 1,BB,1.5,14,14,2155,12,2018,9,3
Group 1,BB,1.5,14,14,2156,10,2018,11,-1
Group 1,BB,1.5,14,14,2157,9,2018,10,-1
Group 1,BB,1.5,14,14,2158,10,2018,11,-1
Group 1,BB,1.5,14,14,2159,11,2018,10,1
Group 1,BB,1.5,14,14,2160,9,2018,10,-1
Group 1,BB,1.5,14,14,2161,8,2018,9,-1
Group 1,BB,1.5,14,14,2162,14,2018,10,4
Group 1,BB,1.5,14,14,2163,12,2018,13,-1
Group 1,BB,1.5,14,14,2164,10,2018,9,1
Group 1,BB,1.5,14,14,2165,11,2018,10,1
Group 1,BB,1.5,14,14,2166,12,2018,11,1
Group 1,BB,1.5,14,14,2167,11,2018,7,4
Group 1,BB,1.5,14,14,2168,11,2018,9,2
Group 1,BB,1.5,14,14,2169,11,2018,6,5
Group 1,BB,1.5,14,14,2170,11,2018,3,8
Group 1,BB,1.5,14,14,2171,12,2018,11,1
Group 1,BB,1.5,14,14,2172,12,2018,9,3
Group 1,BB,1.5,14,14,2173,9,2018,12,-3
Group 1,BB,1.5,14,14,2174,12,2018,10,2
Group 1,BB,1.5,14,14,2175,8,2018,12,-4
Group 1,BB,1.5,14,14,2176,12,2018,11,1
Group 1,BB,1.5,14,14,2177,14,2018,12,2
Group 1,BB,1.5,14,14,2178,12,2018,12,0
Group 1,BB,1.5,14,14,2179,12,2018,9,3
Group 1,BB,1.5,14,14,2180,10,2018,7,3
Group 1,BB,1.5,14,14,2181,11,2018,8,3
Group 1,BB,1.5,14,14,2182,7,2018,10,-3
Group 1,BB,1.5,14,14,2183,10,2018,10,0
Group 1,BB,1.5,14,14,2184,12,2018,6,6
Group 1,BB,1.5,14,14,2185,9,2018,8,1
Group 1,BB,1.5,14,14,2186,9,2018,12,-3
Group 1,BB,1.5,14,14,2187,13,2018,13,0
Group 1,BB,1.5,14,14,2188,12,2018,12,0
Group 1,BB,1.5,14,14,2189,11,2018,12,-1
Group 1,BB,1.5,14,14,2190,10,2018,11,-1
Group 1,BB,1.5,14,14,2191,11,2018,10,1
Group 1,BB,1.5,14,14,2192,12,2018,12,0
Group 1,BB,1.5,14,14,2193,13,2018,9,4
Group 1,BB,1.5,14,14,2194,12,2018,8,4
Group 1,BB,1.5,14,14,2195,11,2018,8,3
Group 1,BB,1.5,14,14,2196,9,2018,11,-2
Group 1,BB,1.5,14,14,2197,10,2018,9,1
Group 1,BB,1.5,14,14,2198,11,2018,9,2
Group 1,BB,1.5,14,14,2199,12,2018,13,-1
Group 1,BB,1.5,14,14,2200,7,2018,11,-4
Group 1,BB,1.5,14,14,2201,12,2018,6,6
Group 1,BB,1.5,14,14,2202,11,2018,13,-2
Group 1,BB,1.5,14,14,2203,8,2018,12,-4
Group 1,BB,1.5,14,14,2204,13,2018,8,5
Group 1,BB,1.5,14,14,2205,12,2018,11,1
Group 1,BB,1.5,14,14,2206,13,2018,10,3
Group 1,BB,1.5,14,14,2207,10,2018,9,1
Group 1,BB,1.5,14,14,2208,12,2018,8,4
Group 1,BB,1.5,14,14,2209,10,2018,8,2
Group 1,BB,1.5,14,14,2210,12,2018,12,0
Group 1,BB,1.5,14,14,2211,11,2018,13,-2
Group 1,BB,1.5,14,14,2212,10,2018,12,-2
Group 1,BB,1.5,14,14,2213,13,2018,9,4
Group 1,BB,1.5,14,14,2214,10,2018,7,3
Group 1,BB,1.5,14,14,2215,9,2018,11,-2
Group 1,BB,1.5,14,14,2216,9,2018,10,-1
Group 1,BB,1.5,14,14,2217,10,2018,12,-2
Group 1,BB,1.5,14,14,2218,9,2018,10,-1
Group 1,BB,1.5,14,14,2219,10,2018,10,0
Group 1,BB,1.5,14,14,2220,12,2018,11,1
Group 1,BB,1.5,14,14,2221,10,2018,13,-3
Group 1,BB,1.5,14,14,2222,11,2018,10,1
Group 1,BB,1.5,14,14,2223,10,2018,6,4
Group 1,BB,1.5,14,14,2224,13,2018,14,-1
Group 1,BB,1.5,14,14,2225,10,2018,10,0
Group 1,BB,1.5,14,14,2226,11,2018,12,-1
Group 1,BB,1.5,14,14,2227,11,2018,13,-2
Group 1,BB,1.5,14,14,2228,11,2018,11,0
Group 1,BB,1.5,14,14,2229,12,2018,12,0
Group 1,BB,1.5,14,14,2230,10,2018,12,-2
Group 1,BB,1.5,14,14,2231,13,2018,10,3
Group 1,BB,1.5,14,14,2232,12,2018,8,4
Group 1,BB,1.5,14,14,2233,10,2018,8,2
Group 1,BB,1.5,14,14,2234,9,2018,10,-1
Group 1,BB,1.5,14,14,2235,8,2018,9,-1
Group 1,BB,1.5,14,14,2236,10,2018,8,2
Group 1,BB,1.5,14,14,2237,13,2018,12,1
Group 1,BB,1.5,14,14,2238,12,2018,12,0
Group 1,BB,1.5,14,14,2239,13,2018,10,3
Group 1,BB,1.5,14,14,2240,13,2018,11,2
Group 1,BB,1.5,14,14,2241,9,2018,7,2
Group 1,BB,1.5,14,14,2242,10,2018,6,4
Group 1,BB,1.5,14,14,2243,10,2018,8,2
Group 1,BB,1.5,14,14,2244,10,2018,10,0
Group 1,BB,1.5,14,14,2245,12,2018,12,0
Group 1,BB,1.5,14,14,2246,10,2018,7,3
Group 1,BB,1.5,14,14,2247,11,2018,10,1
Group 1,BB,1.5,14,14,2248,11,2018,9,2
Group 1,BB,1.5,14,14,2249,8,2018,7,1
Group 1,BB,1.5,14,14,2250,13,2018,12,1
Group 1,BB,1.5,14,14,2251,9,2018,11,-2
Group 1,BB,1.5,14,14,2252,10,2018,9,1
Group 1,BB,1.5,14,14,2253,10,2018,10,0
Group 1,BB,1.5,14,14,2254,10,2018,10,0
Group 1,BB,1.5,14,14,2255,7,2018,12,-5
Group 1,BB,1.5,14,14,2256,11,2018,11,0
Group 1,BB,1.5,14,14,2257,12,2018,11,1
Group 1,BB,1.5,14,14,2258,8,2018,11,-3
Group 1,BB,1.5,14,14,2259,9,2018,11,-2
Group 1,BB,1.5,14,14,2260,9,2018,9,0
Group 1,BB,1.5,14,14,2261,10,2018,11,-1
Group 1,BB,1.5,14,14,2262,11,2018,10,1
Group 1,BB,1.5,14,14,2263,12,2018,12,0
Group 1,BB,1.5,14,14,2264,14,2018,9,5
Group 1,BB,1.5,14,14,2265,12,2018,10,2
Group 1,BB,1.5,14,14,2266,11,2018,10,1
Group 1,BB,1.5,14,14,2267,10,2018,11,-1
Group 1,BB,1.5,14,14,2268,11,2018,10,1
Group 1,BB,1.5,14,14,2269,12,2018,8,4
Group 1,BB,1.5,14,14,2270,12,2018,11,1
Group 1,BB,1.5,14,14,2271,8,2018,12,-4
Group 1,BB,1.5,14,14,2272,11,2018,11,0
Group 1,BB,1.5,14,14,2273,6,2018,7,-1
Group 1,BB,1.5,14,14,2274,13,2018,8,5
Group 1,BB,1.5,14,14,2275,7,2018,12,-5
Group 1,BB,1.5,14,14,2276,9,2018,7,2
Group 1,BB,1.5,14,14,2277,11,2018,9,2
Group 1,BB,1.5,14,14,2278,12,2018,11,1
Group 1,BB,1.5,14,14,2279,11,2018,9,2
Group 1,BB,1.5,14,14,2280,11,2018,12,-1
Group 1,BB,1.5,14,14,2281,8,2018,12,-4
Group 1,BB,1.5,14,14,2282,12,2018,12,0
Group 1,BB,1.5,14,14,2283,11,2018,9,2
Group 1,BB,1.5,14,14,2284,11,2018,11,0
Group 1,BB,1.5,14,14,2285,9,2018,11,-2
Group 1,BB,1.5,14,14,2286,12,2018,9,3
Group 1,BB,1.5,14,14,2287,12,2018,9,3
Group 1,BB,1.5,14,14,2288,9,2018,8,1
Group 1,BB,1.5,14,14,2289,11,2018,10,1
Group 1,BB,1.5,14,14,2290,8,2018,7,1
Group 1,BB,1.5,14,14,2291,9,2018,11,-2
Group 1,BB,1.5,14,14,2292,10,2018,10,0
Group 1,BB,1.5,14,14,2293,11,2018,12,-1
Group 1,BB,1.5,14,14,2294,8,2018,11,-3
Group 1,BB,1.5,14,14,2295,11,2018,9,2
Group 1,BB,1.5,14,14,2296,10,2018,10,0
Group 1,BB,1.5,14,14,2297,11,2018,9,2
Group 1,BB,1.5,14,14,2298,11,2018,8,3
Group 1,BB,1.5,14,14,2299,12,2018,8,4
Group 1,BB,1.5,14,14,2300,12,2018,8,4
Group 1,BB,1.5,14,14,2301,8,2018,12,-4
Group 1,BB,1.5,14,14,2302,9,2018,8,1
Group 1,BB,1.5,14,14,2303,12,2018,5,7
Group 1,BB,1.5,14,14,2304,12,2018,12,0
Group 1,BB,1.5,14,14,2305,13,2018,9,4
Group 1,BB,1.5,14,14,2306,13,2018,12,1
Group 1,BB,1.5,14,14,2307,10,2018,12,-2
Group 1,BB,1.5,14,14,2308,11,2018,12,-1
Group 1,BB,1.5,14,14,2309,10,2018,12,-2
Group 1,BB,1.5,14,14,2310,13,2018,14,-1
Group 1,BB,1.5,14,14,2311,10,2018,12,-2
Group 1,BB,1.5,14,14,2312,9,2018,12,-3
Group 1,BB,1.5,14,14,2313,12,2018,9,3
Group 1,BB,1.5,14,14,2314,10,2018,9,1
Group 1,BB,1.5,14,14,2315,11,2018,8,3
Group 1,BB,1.5,14,14,2316,6,2018,6,0
Group 1,BB,1.5,14,14,2317,10,2018,11,-1
Group 1,BB,1.5,14,14,2318,11,2018,11,0
Group 1,BB,1.5,14,14,2319,14,2018,11,3
Group 1,BB,1.5,14,14,2320,12,2018,7,5
Group 1,BB,1.5,14,14,2321,12,2018,12,0
Group 1,BB,1.5,14,14,2322,9,2018,11,-2
Group 1,BB,1.5,14,14,2323,9,2018,11,-2
Group 1,BB,1.5,14,14,2324,12,2018,11,1
Group 1,BB,1.5,14,14,2325,11,2018,10,1
Group 1,BB,1.5,14,14,2326,10,2018,10,0
Group 1,BB,1.5,14,14,2327,6,2018,11,-5
Group 1,BB,1.5,14,14,2328,12,2018,10,2
Group 1,BB,1.5,14,14,2329,10,2018,9,1
Group 1,BB,1.5,14,14,2330,12,2018,8,4
Group 1,BB,1.5,14,14,2331,13,2018,9,4
Group 1,BB,1.5,14,14,2332,8,2018,7,1
Group 1,BB,1.5,14,14,2333,10,2018,10,0
Group 1,BB,1.5,14,14,2334,12,2018,9,3
Group 1,BB,1.5,14,14,2335,12,2018,12,0
Group 1,BB,1.5,14,14,2336,12,2018,10,2
Group 1,BB,1.5,14,14,2337,9,2018,12,-3
Group 1,BB,1.5,14,14,2338,9,2018,10,-1
Group 1,BB,1.5,14,14,2339,13,2018,10,3
Group 1,BB,1.5,14,14,2340,10,2018,8,2
Group 1,BB,1.5,14,14,2341,12,2018,12,0
Group 1,BB,1.5,14,14,2342,9,2018,10,-1
Group 1,BB,1.5,14,14,2343,12,2018,12,0
Group 1,BB,1.5,14,14,2344,9,2018,8,1
Group 1,BB,1.5,14,14,2345,12,2018,10,2
Group 1,BB,1.5,14,14,2346,12,2018,10,2
Group 1,BB,1.5,14,14,2347,13,2018,11,2
Group 1,BB,1.5,14,14,2348,10,2018,9,1
Group 1,BB,1.5,14,14,2349,8,2018,7,1
Group 1,BB,1.5,14,14,2350,10,2018,13,-3
Group 1,BB,1.5,14,14,2351,12,2018,8,4
Group 1,BB,1.5,14,14,2352,13,2018,9,4
Group 1,BB,1.5,14,14,2353,6,2018,8,-2
Group 1,BB,1.5,14,14,2354,10,2018,8,2
Group 1,BB,1.5,14,14,2355,7,2018,10,-3
Group 1,BB,1.5,14,14,2356,11,2018,11,0
Group 1,BB,1.5,14,14,2357,11,2018,10,1
Group 1,BB,1.5,14,14,2358,9,2018,10,-1
Group 1,BB,1.5,14,14,2359,8,2018,12,-4
Group 1,BB,1.5,14,14,2360,11,2018,10,1
Group 1,BB,1.5,14,14,2361,12,2018,11,1
Group 1,BB,1.5,14,14,2362,10,2018,11,-1
Group 1,BB,1.5,14,14,2363,13,2018,11,2
Group 1,BB,1.5,14,14,2364,11,2018,8,3
Group 1,BB,1.5,14,14,2365,11,2018,12,-1
Group 1,BB,1.5,14,14,2366,10,2018,12,-2
Group 1,BB,1.5,14,14,2367,8,2018,12,-4
Group 1,BB,1.5,14,14,2368,12,2018,12,0
Group 1,BB,1.5,14,14,2369,11,2018,13,-2
Group 1,BB,1.5,14,14,2370,11,2018,12,-1
Group 1,BB,1.5,14,14,2371,7,2018,9,-2
Group 1,BB,1.5,14,14,2372,7,2018,10,-3
Group 1,BB,1.5,14,14,2373,10,2018,9,1
Group 1,BB,1.5,14,14,2374,13,2018,9,4
Group 1,BB,1.5,14,14,2375,11,2018,8,3
Group 1,BB,1.5,14,14,2376,13,2018,8,5
Group 1,BB,1.5,14,14,2377,12,2018,13,-1
Group 1,BB,1.5,14,14,2378,10,2018,9,1
Group 1,BB,1.5,14,14,2379,9,2018,10,-1
Group 1,BB,1.5,14,14,2380,13,2018,12,1
Group 1,BB,1.5,14,14,2381,11,2018,12,-1
Group 1,BB,1.5,14,14,2382,9,2018,11,-2
Group 1,BB,1.5,14,14,2383,11,2018,8,3
Group 1,BB,1.5,14,14,2384,9,2018,9,0
Group 1,BB,1.5,14,14,2385,9,2018,8,1
Group 1,BB,1.5,14,14,2386,11,2018,8,3
Group 1,BB,1.5,14,14,2387,9,2018,13,-4
Group 1,BB,1.5,14,14,2388,10,2018,12,-2
Group 1,BB,1.5,14,14,2389,10,2018,11,-1
Group 1,BB,1.5,14,14,2390,7,2018,14,-7
Group 1,BB,1.5,14,14,2391,8,2018,11,-3
Group 1,BB,1.5,14,14,2392,9,2018,10,-1
Group 1,BB,1.5,14,14,2393,11,2018,11,0
Group 1,BB,1.5,14,14,2394,12,2018,5,7
Group 1,BB,1.5,14,14,2395,10,2018,9,1
Group 1,BB,1.5,14,14,2396,14,2018,11,3
Group 1,BB,1.5,14,14,2397,12,2018,8,4
Group 1,BB,1.5,14,14,2398,9,2018,11,-2
Group 1,BB,1.5,14,14,2399,9,2018,11,-2
Group 1,BB,1.5,14,14,2400,12,2018,12,0
Group 1,BB,1.5,14,14,2401,12,2018,10,2
Group 1,BB,1.5,14,14,2402,10,2018,11,-1
Group 1,BB,1.5,14,14,2403,8,2018,11,-3
Group 1,BB,1.5,14,14,2404,11,2018,11,0
Group 1,BB,1.5,14,14,2405,8,2018,6,2
Group 1,BB,1.5,14,14,2406,10,2018,9,1
Group 1,BB,1.5,14,14,2407,10,2018,13,-3
Group 1,BB,1.5,14,14,2408,8,2018,11,-3
Group 1,BB,1.5,14,14,2409,10,2018,11,-1
Group 1,BB,1.5,14,14,2410,11,2018,10,1
Group 1,BB,1.5,14,14,2411,10,2018,9,1
Group 1,BB,1.5,14,14,2412,11,2018,10,1
Group 1,BB,1.5,14,14,2413,14,2018,8,6
Group 1,BB,1.5,14,14,2414,10,2018,10,0
Group 1,BB,1.5,14,14,2415,8,2018,8,0
Group 1,BB,1.5,14,14,2416,9,2018,14,-5
Group 1,BB,1.5,14,14,2417,10,2018,12,-2
Group 1,BB,1.5,14,14,2418,11,2018,9,2
Group 1,BB,1.5,14,14,2419,13,2018,11,2
Group 1,BB,1.5,14,14,2420,10,2018,8,2
Group 1,BB,1.5,14,14,2421,10,2018,10,0
Group 1,BB,1.5,14,14,2422,11,2018,13,-2
Group 1,BB,1.5,14,14,2423,12,2018,9,3
Group 1,BB,1.5,14,14,2424,8,2018,5,3
Group 1,BB,1.5,14,14,2425,8,2018,8,0
Group 1,BB,1.5,14,14,2426,8,2018,10,-2
Group 1,BB,1.5,14,14,2427,9,2018,9,0
Group 1,BB,1.5,14,14,2428,10,2018,11,-1
Group 1,BB,1.5,14,14,2429,12,2018,10,2
Group 1,BB,1.5,14,14,2430,10,2018,8,2
Group 1,BB,1.5,14,14,2431,10,2018,10,0
Group 1,BB,1.5,14,14,2432,8,2018,13,-5
Group 1,BB,1.5,14,14,2433,11,2018,12,-1
Group 1,BB,1.5,14,14,2434,10,2018,11,-1
Group 1,BB,1.5,14,14,2435,8,2018,10,-2
Group 1,BB,1.5,14,14,2436,14,2018,10,4
Group 1,BB,1.5,14,14,2437,12,2018,11,1
Group 1,BB,1.5,14,14,2438,7,2018,9,-2
Group 1,BB,1.5,14,14,2439,13,2018,12,1
Group 1,BB,1.5,14,14,2440,13,2018,11,2
Group 1,BB,1.5,14,14,2441,9,2018,11,-2
Group 1,BB,1.5,14,14,2442,11,2018,11,0
Group 1,BB,1.5,14,14,2443,9,2018,11,-2
Group 1,BB,1.5,14,14,2444,12,2018,11,1
Group 1,BB,1.5,14,14,2445,10,2018,12,-2
Group 1,BB,1.5,14,14,2446,11,2018,8,3
Group 1,BB,1.5,14,14,2447,13,2018,11,2
Group 1,BB,1.5,14,14,2448,12,2018,12,0
Group 1,BB,1.5,14,14,2449,12,2018,9,3
Group 1,BB,1.5,14,14,2450,10,2018,9,1
Group 1,BB,1.5,14,14,2451,12,2018,9,3
Group 1,BB,1.5,14,14,2452,11,2018,10,1
Group 1,BB,1.5,14,14,2453,9,2018,9,0
Group 1,BB,1.5,14,14,2454,8,2018,12,-4
Group 1,BB,1.5,14,14,2455,12,2018,13,-1
Group 1,BB,1.5,14,14,2456,11,2018,11,0
Group 1,BB,1.5,14,14,2457,11,2018,10,1
Group 1,BB,1.5,14,14,2458,12,2018,12,0
Group 1,BB,1.5,14,14,2459,8,2018,9,-1
Group 1,BB,1.5,14,14,2460,11,2018,9,2
Group 1,BB,1.5,14,14,2461,11,2018,10,1
Group 1,BB,1.5,14,14,2462,11,2018,11,0
Group 1,BB,1.5,14,14,2463,9,2018,12,-3
Group 1,BB,1.5,14,14,2464,11,2018,13,-2
Group 1,BB,1.5,14,14,2465,10,2018,12,-2
Group 1,BB,1.5,14,14,2466,11,2018,9,2
Group 1,BB,1.5,14,14,2467,12,2018,12,0
Group 1,BB,1.5,14,14,2468,10,2018,10,0
Group 1,BB,1.5,14,14,2469,12,2018,12,0
Group 1,BB,1.5,14,14,2470,12,2018,8,4
Group 1,BB,1.5,14,14,2471,12,2018,6,6
Group 1,BB,1.5,14,14,2472,11,2018,10,1
Group 1,BB,1.5,14,14,2473,11,2018,8,3
Group 1,BB,1.5,14,14,2474,12,2018,10,2
Group 1,BB,1.5,14,14,2475,12,2018,13,-1
Group 1,BB,1.5,14,14,2476,11,2018,12,-1
Group 1,BB,1.5,14,14,2477,8,2018,13,-5
Group 1,BB,1.5,14,14,2478,13,2018,9,4
Group 1,BB,1.5,14,14,2479,10,2018,10,0
Group 1,BB,1.5,14,14,2480,9,2018,11,-2
Group 1,BB,1.5,14,14,2481,9,2018,8,1
Group 1,BB,1.5,14,14,2482,11,2018,9,2
Group 1,BB,1.5,14,14,2483,9,2018,11,-2
Group 1,BB,1.5,14,14,2484,11,2018,12,-1
Group 1,BB,1.5,14,14,2485,12,2018,8,4
Group 1,BB,1.5,14,14,2486,12,2018,11,1
Group 1,BB,1.5,14,14,2487,10,2018,9,1
Group 1,BB,1.5,14,14,2488,10,2018,11,-1
Group 1,BB,1.5,14,14,2489,11,2018,12,-1
Group 1,BB,1.5,14,14,2490,10,2018,13,-3
Group 1,BB,1.5,14,14,2491,10,2018,11,-1
Group 1,BB,1.5,14,14,2492,13,2018,8,5
Group 1,BB,1.5,14,14,2493,8,2018,12,-4
Group 1,BB,1.5,14,14,2494,10,2018,13,-3
Group 1,BB,1.5,14,14,2495,12,2018,10,2
Group 1,BB,1.5,14,14,2496,9,2018,9,0
Group 1,BB,1.5,14,14,2497,10,2018,9,1
Group 1,BB,1.5,14,14,2498,8,2018,8,0
Group 1,BB,1.5,14,14,2499,10,2018,14,-4
Group 1,BB,1.5,14,14,2500,12,2018,8,4
Group 1,BB,1.5,14,14,2501,11,2018,9,2
Group 1,BB,1.5,14,14,2502,10,2018,12,-2
Group 1,BB,1.5,14,14,2503,12,2018,8,4
Group 1,BB,1.5,14,14,2504,11,2018,13,-2
Group 1,BB,1.5,14,14,2505,9,2018,9,0
Group 1,BB,1.5,14,14,2506,12,2018,9,3
Group 1,BB,1.5,14,14,2507,8,2018,8,0
Group 1,BB,1.5,14,14,2508,10,2018,11,-1
Group 1,BB,1.5,14,14,2509,11,2018,10,1
Group 1,BB,1.5,14,14,2510,11,2018,11,0
Group 1,BB,1.5,14,14,2511,11,2018,11,0
Group 1,BB,1.5,14,14,2512,12,2018,12,0
Group 1,BB,1.5,14,14,2513,9,2018,10,-1
Group 1,BB,1.5,14,14,2514,7,2018,12,-5
Group 1,BB,1.5,14,14,2515,10,2018,10,0
Group 1,BB,1.5,14,14,2516,13,2018,10,3
Group 1,BB,1.5,14,14,2517,10,2018,11,-1
Group 1,BB,1.5,14,14,2518,10,2018,9,1
Group 1,BB,1.5,14,14,2519,9,2018,6,3
Group 1,BB,1.5,14,14,2520,12,2018,11,1
Group 1,BB,1.5,14,14,2521,11,2018,10,1
Group 1,BB,1.5,14,14,2522,10,2018,9,1
Group 1,BB,1.5,14,14,2523,13,2018,6,7
Group 1,BB,1.5,14,14,2524,10,2018,13,-3
Group 1,BB,1.5,14,14,2525,10,2018,13,-3
Group 1,BB,1.5,14,14,2526,13,2018,14,-1
Group 1,BB,1.5,14,14,2527,10,2018,9,1
Group 1,BB,1.5,14,14,2528,11,2018,9,2
Group 1,BB,1.5,14,14,2529,12,2018,9,3
Group 1,BB,1.5,14,14,2530,13,2018,7,6
Group 1,BB,1.5,14,14,2531,10,2018,11,-1
Group 1,BB,1.5,14,14,2532,11,2018,10,1
Group 1,BB,1.5,14,14,2533,11,2018,10,1
Group 1,BB,1.5,14,14,2534,9,2018,11,-2
Group 1,BB,1.5,14,14,2535,11,2018,11,0
Group 1,BB,1.5,14,14,2536,10,2018,7,3
Group 1,BB,1.5,14,14,2537,11,2018,10,1
Group 1,BB,1.5,14,14,2538,13,2018,8,5
Group 1,BB,1.5,14,14,2539,11,2018,12,-1
Group 1,BB,1.5,14,14,2540,13,2018,10,3
Group 1,BB,1.5,14,14,2541,12,2018,11,1
Group 1,BB,1.5,14,14,2542,9,2018,10,-1
Group 1,BB,1.5,14,14,2543,13,2018,7,6
Group 1,BB,1.5,14,14,2544,12,2018,12,0
Group 1,BB,1.5,14,14,2545,11,2018,11,0
Group 1,BB,1.5,14,14,2546,10,2018,8,2
Group 1,BB,1.5,14,14,2547,12,2018,10,2
Group 1,BB,1.5,14,14,2548,10,2018,11,-1
Group 1,BB,1.5,14,14,2549,11,2018,10,1
Group 1,BB,1.5,14,14,2550,14,2018,8,6
Group 1,BB,1.5,14,14,2551,12,2018,11,1
Group 1,BB,1.5,14,14,2552,12,2018,13,-1
Group 1,BB,1.5,14,14,2553,11,2018,10,1
Group 1,BB,1.5,14,14,2554,13,2018,12,1
Group 1,BB,1.5,14,14,2555,11,2018,8,3
Group 1,BB,1.5,14,14,2556,12,2018,10,2
Group 1,BB,1.5,14,14,2557,10,2018,10,0
Group 1,BB,1.5,14,14,2558,12,2018,7,5
Group 1,BB,1.5,14,14,2559,12,2018,14,-2
Group 1,BB,1.5,14,14,2560,13,2018,11,2
Group 1,BB,1.5,14,14,2561,10,2018,9,1
Group 1,BB,1.5,14,14,2562,12,2018,9,3
Group 1,BB,1.5,14,14,2563,9,2018,8,1
Group 1,BB,1.5,14,14,2564,12,2018,13,-1
Group 1,BB,1.5,14,14,2565,10,2018,11,-1
Group 1,BB,1.5,14,14,2566,12,2018,11,1
Group 1,BB,1.5,14,14,2567,11,2018,14,-3
Group 1,BB,1.5,14,14,2568,13,2018,5,8
Group 1,BB,1.5,14,14,2569,12,2018,8,4
Group 1,BB,1.5,14,14,2570,10,2018,10,0
Group 1,BB,1.5,14,14,2571,11,2018,10,1
Group 1,BB,1.5,14,14,2572,8,2018,8,0
Group 1,BB,1.5,14,14,2573,8,2018,11,-3
Group 1,BB,1.5,14,14,2574,8,2018,12,-4
Group 1,BB,1.5,14,14,2575,11,2018,5,6
Group 1,BB,1.5,14,14,2576,10,2018,12,-2
Group 1,BB,1.5,14,14,2577,10,2018,9,1
Group 1,BB,1.5,14,14,2578,10,2018,11,-1
Group 1,BB,1.5,14,14,2579,5,2018,8,-3
Group 1,BB,1.5,14,14,2580,8,2018,12,-4
Group 1,BB,1.5,14,14,2581,11,2018,12,-1
Group 1,BB,1.5,14,14,2582,12,2018,11,1
Group 1,BB,1.5,14,14,2583,10,2018,8,2
Group 1,BB,1.5,14,14,2584,11,2018,10,1
Group 1,BB,1.5,14,14,2585,12,2018,10,2
Group 1,BB,1.5,14,14,2586,13,2018,6,7
Group 1,BB,1.5,14,14,2587,9,2018,12,-3
Group 1,BB,1.5,14,14,2588,9,2018,11,-2
Group 1,BB,1.5,14,14,2589,12,2018,10,2
Group 1,BB,1.5,14,14,2590,13,2018,10,3
Group 1,BB,1.5,14,14,2591,14,2018,11,3
Group 1,BB,1.5,14,14,2592,12,2018,14,-2
Group 1,BB,1.5,14,14,2593,13,2018,10,3
Group 1,BB,1.5,14,14,2594,10,2018,14,-4
Group 1,BB,1.5,14,14,2595,12,2018,12,0
Group 1,BB,1.5,14,14,2596,6,2018,11,-5
Group 1,BB,1.5,14,14,2597,12,2018,13,-1
Group 1,BB,1.5,14,14,2598,12,2018,12,0
Group 1,BB,1.5,14,14,2599,10,2018,10,0
Group 1,BB,1.5,14,14,2600,9,2018,8,1
Group 1,BB,1.5,14,14,2601,13,2018,9,4
Group 1,BB,1.5,14,14,2602,9,2018,12,-3
Group 1,BB,1.5,14,14,2603,10,2018,14,-4
Group 1,BB,1.5,14,14,2604,13,2018,6,7
Group 1,BB,1.5,14,14,2605,9,2018,9,0
Group 1,BB,1.5,14,14,2606,9,2018,9,0
Group 1,BB,1.5,14,14,2607,11,2018,9,2
Group 1,BB,1.5,14,14,2608,11,2018,11,0
Group 1,BB,1.5,14,14,2609,13,2018,11,2
Group 1,BB,1.5,14,14,2610,12,2018,5,7
Group 1,BB,1.5,14,14,2611,13,2018,9,4
Group 1,BB,1.5,14,14,2612,11,2018,9,2
Group 1,BB,1.5,14,14,2613,9,2018,9,0
Group 1,BB,1.5,14,14,2614,7,2018,12,-5
Group 1,BB,1.5,14,14,2615,11,2018,8,3
Group 1,BB,1.5,14,14,2616,10,2018,12,-2
Group 1,BB,1.5,14,14,2617,9,2018,8,1
Group 1,BB,1.5,14,14,2618,12,2018,12,0
Group 1,BB,1.5,14,14,2619,12,2018,11,1
Group 1,BB,1.5,14,14,2620,13,2018,10,3
Group 1,BB,1.5,14,14,2621,11,2018,12,-1
Group 1,BB,1.5,14,14,2622,13,2018,13,0
Group 1,BB,1.5,14,14,2623,10,2018,11,-1
Group 1,BB,1.5,14,14,2624,9,2018,9,0
Group 1,BB,1.5,14,14,2625,12,2018,11,1
Group 1,BB,1.5,14,14,2626,12,2018,11,1
Group 1,BB,1.5,14,14,2627,11,2018,12,-1
Group 1,BB,1.5,14,14,2628,8,2018,10,-2
Group 1,BB,1.5,14,14,2629,11,2018,10,1
Group 1,BB,1.5,14,14,2630,12,2018,9,3
Group 1,BB,1.5,14,14,2631,11,2018,9,2
Group 1,BB,1.5,14,14,2632,9,2018,10,-1
Group 1,BB,1.5,14,14,2633,9,2018,7,2
Group 1,BB,1.5,14,14,2634,10,2018,10,0
Group 1,BB,1.5,14,14,2635,9,2018,10,-1
Group 1,BB,1.5,14,14,2636,11,2018,8,3
Group 1,BB,1.5,14,14,2637,9,2018,9,0
Group 1,BB,1.5,14,14,2638,7,2018,10,-3
Group 1,BB,1.5,14,14,2639,8,2018,7,1
Group 1,BB,1.5,14,14,2640,6,2018,11,-5
Group 1,BB,1.5,14,14,2641,11,2018,11,0
Group 1,BB,1.5,14,14,2642,12,2018,12,0
Group 1,BB,1.5,14,14,2643,10,2018,8,2
Group 1,BB,1.5,14,14,2644,9,2018,12,-3
Group 1,BB,1.5,14,14,2645,8,2018,8,0
Group 1,BB,1.5,14,14,2646,13,2018,10,3
Group 1,BB,1.5,14,14,2647,10,2018,11,-1
Group 1,BB,1.5,14,14,2648,12,2018,8,4
Group 1,BB,1.5,14,14,2649,9,2018,11,-2
Group 1,BB,1.5,14,14,2650,12,2018,11,1
Group 1,BB,1.5,14,14,2651,10,2018,11,-1
Group 1,BB,1.5,14,14,2652,8,2018,11,-3
Group 1,BB,1.5,14,14,2653,10,2018,5,5
Group 1,BB,1.5,14,14,2654,12,2018,8,4
Group 1,BB,1.5,14,14,2655,10,2018,12,-2
Group 1,BB,1.5,14,14,2656,12,2018,8,4
Group 1,BB,1.5,14,14,2657,12,2018,11,1
Group 1,BB,1.5,14,14,2658,12,2018,8,4
Group 1,BB,1.5,14,14,2659,9,2018,11,-2
Group 1,BB,1.5,14,14,2660,10,2018,8,2
Group 1,BB,1.5,14,14,2661,10,2018,12,-2
Group 1,BB,1.5,14,14,2662,14,2018,11,3
Group 1,BB,1.5,14,14,2663,10,2018,11,-1
Group 1,BB,1.5,14,14,2664,11,2018,13,-2
Group 1,BB,1.5,14,14,2665,11,2018,12,-1
Group 1,BB,1.5,14,14,2666,11,2018,9,2
Group 1,BB,1.5,14,14,2667,8,2018,11,-3
Group 1,BB,1.5,14,14,2668,12,2018,9,3
Group 1,BB,1.5,14,14,2669,8,2018,11,-3
Group 1,BB,1.5,14,14,2670,9,2018,12,-3
Group 1,BB,1.5,14,14,2671,10,2018,10,0
Group 1,BB,1.5,14,14,2672,12,2018,10,2
Group 1,BB,1.5,14,14,2673,10,2018,7,3
Group 1,BB,1.5,14,14,2674,12,2018,10,2
Group 1,BB,1.5,14,14,2675,11,2018,10,1
Group 1,BB,1.5,14,14,2676,12,2018,9,3
Group 1,BB,1.5,14,14,2677,8,2018,8,0
Group 1,BB,1.5,14,14,2678,11,2018,13,-2
Group 1,BB,1.5,14,14,2679,11,2018,11,0
Group 1,BB,1.5,14,14,2680,12,2018,10,2
Group 1,BB,1.5,14,14,2681,11,2018,11,0
Group 1,BB,1.5,14,14,2682,11,2018,13,-2
Group 1,BB,1.5,14,14,2683,13,2018,12,1
Group 1,BB,1.5,14,14,2684,9,2018,11,-2
Group 1,BB,1.5,14,14,2685,11,2018,11,0
Group 1,BB,1.5,14,14,2686,13,2018,8,5
Group 1,BB,1.5,14,14,2687,12,2018,9,3
Group 1,BB,1.5,14,14,2688,9,2018,11,-2
Group 1,BB,1.5,14,14,2689,10,2018,11,-1
Group 1,BB,1.5,14,14,2690,10,2018,12,-2
Group 1,BB,1.5,14,14,2691,10,2018,11,-1
Group 1,BB,1.5,14,14,2692,8,2018,7,1
Group 1,BB,1.5,14,14,2693,10,2018,12,-2
Group 1,BB,1.5,14,14,2694,10,2018,11,-1
Group 1,BB,1.5,14,14,2695,10,2018,5,5
Group 1,BB,1.5,14,14,2696,6,2018,9,-3
Group 1,BB,1.5,14,14,2697,13,2018,10,3
Group 1,BB,1.5,14,14,2698,12,2018,10,2
Group 1,BB,1.5,14,14,2699,10,2018,9,1
Group 1,BB,1.5,14,14,2700,13,2018,11,2
Group 1,BB,1.5,14,14,2701,6,2018,10,-4
Group 1,BB,1.5,14,14,2702,12,2018,6,6
Group 1,BB,1.5,14,14,2703,12,2018,11,1
Group 1,BB,1.5,14,14,2704,10,2018,8,2
Group 1,BB,1.5,14,14,2705,7,2018,10,-3
Group 1,BB,1.5,14,14,2706,11,2018,8,3
Group 1,BB,1.5,14,14,2707,11,2018,9,2
Group 1,BB,1.5,14,14,2708,10,2018,12,-2
Group 1,BB,1.5,14,14,2709,13,2018,13,0
Group 1,BB,1.5,14,14,2710,10,2018,11,-1
Group 1,BB,1.5,14,14,2711,10,2018,7,3
Group 1,BB,1.5,14,14,2712,12,2018,12,0
Group 1,BB,1.5,14,14,2713,10,2018,11,-1
Group 1,BB,1.5,14,14,2714,10,2018,10,0
Group 1,BB,1.5,14,14,2715,14,2018,11,3
Group 1,BB,1.5,14,14,2716,11,2018,5,6
Group 1,BB,1.5,14,14,2717,13,2018,8,5
Group 1,BB,1.5,14,14,2718,14,2018,9,5
Group 1,BB,1.5,14,14,2719,12,2018,9,3
Group 1,BB,1.5,14,14,2720,11,2018,13,-2
Group 1,BB,1.5,14,14,2721,12,2018,11,1
Group 1,BB,1.5,14,14,2722,8,2018,12,-4
Group 1,BB,1.5,14,14,2723,11,2018,9,2
Group 1,BB,1.5,14,14,2724,8,2018,8,0
Group 1,BB,1.5,14,14,2725,12,2018,11,1
Group 1,BB,1.5,14,14,2726,11,2018,11,0
Group 1,BB,1.5,14,14,2727,12,2018,10,2
Group 1,BB,1.5,14,14,2728,13,2018,9,4
Group 1,BB,1.5,14,14,2729,12,2018,12,0
Group 1,BB,1.5,14,14,2730,12,2018,9,3
Group 1,BB,1.5,14,14,2731,9,2018,12,-3
Group 1,BB,1.5,14,14,2732,9,2018,8,1
Group 1,BB,1.5,14,14,2733,12,2018,7,5
Group 1,BB,1.5,14,14,2734,12,2018,12,0
Group 1,BB,1.5,14,14,2735,10,2018,10,0
Group 1,BB,1.5,14,14,2736,11,2018,9,2
Group 1,BB,1.5,14,14,2737,11,2018,8,3
Group 1,BB,1.5,14,14,2738,9,2018,8,1
Group 1,BB,1.5,14,14,2739,11,2018,11,0
Group 1,BB,1.5,14,14,2740,11,2018,11,0
Group 1,BB,1.5,14,14,2741,10,2018,5,5
Group 1,BB,1.5,14,14,2742,11,2018,7,4
Group 1,BB,1.5,14,14,2743,6,2018,8,-2
Group 1,BB,1.5,14,14,2744,13,2018,7,6
Group 1,BB,1.5,14,14,2745,13,2018,12,1
Group 1,BB,1.5,14,14,2746,11,2018,11,0
Group 1,BB,1.5,14,14,2747,12,2018,13,-1
Group 1,BB,1.5,14,14,2748,11,2018,10,1
Group 1,BB,1.5,14,14,2749,9,2018,11,-2
Group 1,BB,1.5,14,14,2750,10,2018,10,0
Group 1,BB,1.5,14,14,2751,9,2018,11,-2
Group 1,BB,1.5,14,14,2752,14,2018,10,4
Group 1,BB,1.5,14,14,2753,12,2018,13,-1
Group 1,BB,1.5,14,14,2754,13,2018,10,3
Group 1,BB,1.5,14,14,2755,9,2018,10,-1
Group 1,BB,1.5,14,14,2756,12,2018,9,3
Group 1,BB,1.5,14,14,2757,8,2018,9,-1
Group 1,BB,1.5,14,14,2758,9,2018,14,-5
Group 1,BB,1.5,14,14,2759,11,2018,12,-1
Group 1,BB,1.5,14,14,2760,10,2018,10,0
Group 1,BB,1.5,14,14,2761,11,2018,11,0
Group 1,BB,1.5,14,14,2762,12,2018,10,2
Group 1,BB,1.5,14,14,2763,11,2018,11,0
Group 1,BB,1.5,14,14,2764,11,2018,8,3
Group 1,BB,1.5,14,14,2765,10,2018,8,2
Group 1,BB,1.5,14,14,2766,12,2018,11,1
Group 1,BB,1.5,14,14,2767,8,2018,7,1
Group 1,BB,1.5,14,14,2768,9,2018,10,-1
Group 1,BB,1.5,14,14,2769,12,2018,10,2
Group 1,BB,1.5,14,14,2770,12,2018,10,2
Group 1,BB,1.5,14,14,2771,8,2018,11,-3
Group 1,BB,1.5,14,14,2772,9,2018,9,0
Group 1,BB,1.5,14,14,2773,9,2018,11,-2
Group 1,BB,1.5,14,14,2774,12,2018,10,2
Group 1,BB,1.5,14,14,2775,11,2018,11,0
Group 1,BB,1.5,14,14,2776,12,2018,10,2
Group 1,BB,1.5,14,14,2777,12,2018,12,0
Group 1,BB,1.5,14,14,2778,7,2018,10,-3
Group 1,BB,1.5,14,14,2779,11,2018,10,1
Group 1,BB,1.5,14,14,2780,9,2018,9,0
Group 1,BB,1.5,14,14,2781,11,2018,11,0
Group 1,BB,1.5,14,14,2782,14,2018,9,5
Group 1,BB,1.5,14,14,2783,12,2018,8,4
Group 1,BB,1.5,14,14,2784,11,2018,9,2
Group 1,BB,1.5,14,14,2785,10,2018,12,-2
Group 1,BB,1.5,14,14,2786,10,2018,7,3
Group 1,BB,1.5,14,14,2787,11,2018,12,-1
Group 1,BB,1.5,14,14,2788,9,2018,12,-3
Group 1,BB,1.5,14,14,2789,10,2018,11,-1
Group 1,BB,1.5,14,14,2790,12,2018,9,3
Group 1,BB,1.5,14,14,2791,10,2018,9,1
Group 1,BB,1.5,14,14,2792,8,2018,12,-4
Group 1,BB,1.5,14,14,2793,9,2018,13,-4
Group 1,BB,1.5,14,14,2794,12,2018,9,3
Group 1,BB,1.5,14,14,2795,13,2018,12,1
Group 1,BB,1.5,14,14,2796,12,2018,9,3
Group 1,BB,1.5,14,14,2797,12,2018,11,1
Group 1,BB,1.5,14,14,2798,13,2018,11,2
Group 1,BB,1.5,14,14,2799,13,2018,11,2
Group 1,BB,1.5,14,14,2800,11,2018,10,1
Group 1,BB,1.5,14,14,2801,9,2018,11,-2
Group 1,BB,1.5,14,14,2802,12,2018,9,3
Group 1,BB,1.5,14,14,2803,10,2018,12,-2
Group 1,BB,1.5,14,14,2804,8,2018,13,-5
Group 1,BB,1.5,14,14,2805,9,2018,11,-2
Group 1,BB,1.5,14,14,2806,12,2018,7,5
Group 1,BB,1.5,14,14,2807,12,2018,12,0
Group 1,BB,1.5,14,14,2808,10,2018,9,1
Group 1,BB,1.5,14,14,2809,11,2018,14,-3
Group 1,BB,1.5,14,14,2810,13,2018,11,2
Group 1,BB,1.5,14,14,2811,11,2018,12,-1
Group 1,BB,1.5,14,14,2812,10,2018,10,0
Group 1,BB,1.5,14,14,2813,13,2018,10,3
Group 1,BB,1.5,14,14,2814,12,2018,8,4
Group 1,BB,1.5,14,14,2815,11,2018,10,1
Group 1,BB,1.5,14,14,2816,13,2018,8,5
Group 1,BB,1.5,14,14,2817,9,2018,9,0
Group 1,BB,1.5,14,14,2818,8,2018,12,-4
Group 1,BB,1.5,14,14,2819,11,2018,9,2
Group 1,BB,1.5,14,14,2820,10,2018,12,-2
Group 1,BB,1.5,14,14,2821,12,2018,7,5
Group 1,BB,1.5,14,14,2822,13,2018,8,5
Group 1,BB,1.5,14,14,2823,11,2018,7,4
Group 1,BB,1.5,14,14,2824,12,2018,9,3
Group 1,BB,1.5,14,14,2825,11,2018,11,0
Group 1,BB,1.5,14,14,2826,8,2018,12,-4
Group 1,BB,1.5,14,14,2827,10,2018,11,-1
Group 1,BB,1.5,14,14,2828,11,2018,7,4
Group 1,BB,1.5,14,14,2829,11,2018,10,1
Group 1,BB,1.5,14,14,2830,10,2018,10,0
Group 1,BB,1.5,14,14,2831,11,2018,3,8
Group 1,BB,1.5,14,14,2832,10,2018,9,1
Group 1,BB,1.5,14,14,2833,8,2018,7,1
Group 1,BB,1.5,14,14,2834,10,2018,13,-3
Group 1,BB,1.5,14,14,2835,13,2018,7,6
Group 1,BB,1.5,14,14,2836,8,2018,10,-2
Group 1,BB,1.5,14,14,2837,12,2018,8,4
Group 1,BB,1.5,14,14,2838,10,2018,11,-1
Group 1,BB,1.5,14,14,2839,12,2018,11,1
Group 1,BB,1.5,14,14,2840,11,2018,8,3
Group 1,BB,1.5,14,14,2841,8,2018,12,-4
Group 1,BB,1.5,14,14,2842,11,2018,9,2
Group 1,BB,1.5,14,14,2843,14,2018,14,0
Group 1,BB,1.5,14,14,2844,11,2018,10,1
Group 1,BB,1.5,14,14,2845,12,2018,6,6
Group 1,BB,1.5,14,14,2846,10,2018,8,2
Group 1,BB,1.5,14,14,2847,10,2018,8,2
Group 1,BB,1.5,14,14,2848,13,2018,9,4
Group 1,BB,1.5,14,14,2849,10,2018,11,-1
Group 1,BB,1.5,14,14,2850,12,2018,7,5
Group 1,BB,1.5,14,14,2851,11,2018,9,2
Group 1,BB,1.5,14,14,2852,13,2018,11,2
Group 1,BB,1.5,14,14,2853,10,2018,10,0
Group 1,BB,1.5,14,14,2854,13,2018,8,5
Group 1,BB,1.5,14,14,2855,14,2018,13,1
Group 1,BB,1.5,14,14,2856,9,2018,9,0
Group 1,BB,1.5,14,14,2857,10,2018,9,1
Group 1,BB,1.5,14,14,2858,8,2018,9,-1
Group 1,BB,1.5,14,14,2859,10,2018,12,-2
Group 1,BB,1.5,14,14,2860,13,2018,9,4
Group 1,BB,1.5,14,14,2861,9,2018,10,-1
Group 1,BB,1.5,14,14,2862,14,2018,11,3
Group 1,BB,1.5,14,14,2863,10,2018,8,2
Group 1,BB,1.5,14,14,2864,9,2018,10,-1
Group 1,BB,1.5,14,14,2865,11,2018,10,1
Group 1,BB,1.5,14,14,2866,14,2018,8,6
Group 1,BB,1.5,14,14,2867,10,2018,11,-1
Group 1,BB,1.5,14,14,2868,12,2018,12,0
Group 1,BB,1.5,14,14,2869,12,2018,8,4
Group 1,BB,1.5,14,14,2870,9,2018,13,-4
Group 1,BB,1.5,14,14,2871,12,2018,11,1
Group 1,BB,1.5,14,14,2872,12,2018,13,-1
Group 1,BB,1.5,14,14,2873,7,2018,13,-6
Group 1,BB,1.5,14,14,2874,14,2018,14,0
Group 1,BB,1.5,14,14,2875,10,2018,9,1
Group 1,BB,1.5,14,14,2876,12,2018,8,4
Group 1,BB,1.5,14,14,2877,13,2018,10,3
Group 1,BB,1.5,14,14,2878,13,2018,10,3
Group 1,BB,1.5,14,14,2879,12,2018,7,5
Group 1,BB,1.5,14,14,2880,14,2018,10,4
Group 1,BB,1.5,14,14,2881,12,2018,9,3
Group 1,BB,1.5,14,14,2882,12,2018,9,3
Group 1,BB,1.5,14,14,2883,11,2018,10,1
Group 1,BB,1.5,14,14,2884,11,2018,9,2
Group 1,BB,1.5,14,14,2885,13,2018,11,2
Group 1,BB,1.5,14,14,2886,12,2018,12,0
Group 1,BB,1.5,14,14,2887,12,2018,13,-1
Group 1,BB,1.5,14,14,2888,13,2018,13,0
Group 1,BB,1.5,14,14,2889,12,2018,8,4
Group 1,BB,1.5,14,14,2890,11,2018,10,1
Group 1,BB,1.5,14,14,2891,7,2018,11,-4
Group 1,BB,1.5,14,14,2892,10,2018,13,-3
Group 1,BB,1.5,14,14,2893,11,2018,10,1
Group 1,BB,1.5,14,14,2894,10,2018,10,0
Group 1,BB,1.5,14,14,2895,8,2018,10,-2
Group 1,BB,1.5,14,14,2896,14,2018,9,5
Group 1,BB,1.5,14,14,2897,12,2018,9,3
Group 1,BB,1.5,14,14,2898,11,2018,10,1
Group 1,BB,1.5,14,14,2899,10,2018,12,-2
Group 1,BB,1.5,14,14,2900,11,2018,9,2
Group 1,BB,1.5,14,14,2901,13,2018,10,3
Group 1,BB,1.5,14,14,2902,10,2018,10,0
Group 1,BB,1.5,14,14,2903,11,2018,8,3
Group 1,BB,1.5,14,14,2904,10,2018,10,0
Group 1,BB,1.5,14,14,2905,8,2018,9,-1
Group 1,BB,1.5,14,14,2906,12,2018,8,4
Group 1,BB,1.5,14,14,2907,10,2018,9,1
Group 1,BB,1.5,14,14,2908,10,2018,8,2
Group 1,BB,1.5,14,14,2909,12,2018,11,1
Group 1,BB,1.5,14,14,2910,11,2018,11,0
Group 1,BB,1.5,14,14,2911,12,2018,13,-1
Group 1,BB,1.5,14,14,2912,9,2018,6,3
Group 1,BB,1.5,14,14,2913,8,2018,7,1
Group 1,BB,1.5,14,14,2914,10,2018,12,-2
Group 1,BB,1.5,14,14,2915,12,2018,12,0
Group 1,BB,1.5,14,14,2916,12,2018,8,4
Group 1,BB,1.5,14,14,2917,11,2018,12,-1
Group 1,BB,1.5,14,14,2918,11,2018,10,1
Group 1,BB,1.5,14,14,2919,11,2018,8,3
Group 1,BB,1.5,14,14,2920,13,2018,11,2
Group 1,BB,1.5,14,14,2921,10,2018,7,3
Group 1,BB,1.5,14,14,2922,9,2018,9,0
Group 1,BB,1.5,14,14,2923,11,2018,11,0
Group 1,BB,1.5,14,14,2924,12,2018,6,6
Group 1,BB,1.5,14,14,2925,9,2018,9,0
Group 1,BB,1.5,14,14,2926,6,2018,11,-5
Group 1,BB,1.5,14,14,2927,10,2018,11,-1
Group 1,BB,1.5,14,14,2928,6,2018,9,-3
Group 1,BB,1.5,14,14,2929,12,2018,8,4
Group 1,BB,1.5,14,14,2930,12,2018,9,3
Group 1,BB,1.5,14,14,2931,13,2018,11,2
Group 1,BB,1.5,14,14,2932,10,2018,12,-2
Group 1,BB,1.5,14,14,2933,12,2018,11,1
Group 1,BB,1.5,14,14,2934,8,2018,10,-2
Group 1,BB,1.5,14,14,2935,9,2018,11,-2
Group 1,BB,1.5,14,14,2936,11,2018,11,0
Group 1,BB,1.5,14,14,2937,9,2018,10,-1
Group 1,BB,1.5,14,14,2938,12,2018,12,0
Group 1,BB,1.5,14,14,2939,9,2018,10,-1
Group 1,BB,1.5,14,14,2940,6,2018,11,-5
Group 1,BB,1.5,14,14,2941,10,2018,11,-1
Group 1,BB,1.5,14,14,2942,10,2018,10,0
Group 1,BB,1.5,14,14,2943,11,2018,11,0
Group 1,BB,1.5,14,14,2944,11,2018,9,2
Group 1,BB,1.5,14,14,2945,13,2018,13,0
Group 1,BB,1.5,14,14,2946,12,2018,10,2
Group 1,BB,1.5,14,14,2947,11,2018,9,2
Group 1,BB,1.5,14,14,2948,11,2018,11,0
Group 1,BB,1.5,14,14,2949,12,2018,10,2
Group 1,BB,1.5,14,14,2950,11,2018,10,1
Group 1,BB,1.5,14,14,2951,9,2018,8,1
Group 1,BB,1.5,14,14,2952,9,2018,10,-1
Group 1,BB,1.5,14,14,2953,10,2018,10,0
Group 1,BB,1.5,14,14,2954,7,2018,11,-4
Group 1,BB,1.5,14,14,2955,11,2018,8,3
Group 1,BB,1.5,14,14,2956,9,2018,11,-2
Group 1,BB,1.5,14,14,2957,10,2018,14,-4
Group 1,BB,1.5,14,14,2958,8,2018,13,-5
Group 1,BB,1.5,14,14,2959,13,2018,12,1
Group 1,BB,1.5,14,14,2960,13,2018,10,3
Group 1,BB,1.5,14,14,2961,12,2018,9,3
Group 1,BB,1.5,14,14,2962,12,2018,9,3
Group 1,BB,1.5,14,14,2963,12,2018,8,4
Group 1,BB,1.5,14,14,2964,8,2018,10,-2
Group 1,BB,1.5,14,14,2965,9,2018,7,2
Group 1,BB,1.5,14,14,2966,11,2018,8,3
Group 1,BB,1.5,14,14,2967,12,2018,9,3
Group 1,BB,1.5,14,14,2968,10,2018,11,-1
Group 1,BB,1.5,14,14,2969,10,2018,8,2
Group 1,BB,1.5,14,14,2970,10,2018,7,3
Group 1,BB,1.5,14,14,2971,10,2018,12,-2
Group 1,BB,1.5,14,14,2972,11,2018,9,2
Group 1,BB,1.5,14,14,2973,10,2018,9,1
Group 1,BB,1.5,14,14,2974,10,2018,7,3
Group 1,BB,1.5,14,14,2975,14,2018,11,3
Group 1,BB,1.5,14,14,2976,12,2018,10,2
Group 1,BB,1.5,14,14,2977,11,2018,12,-1
Group 1,BB,1.5,14,14,2978,11,2018,8,3
Group 1,BB,1.5,14,14,2979,7,2018,6,1
Group 1,BB,1.5,14,14,2980,9,2018,9,0
Group 1,BB,1.5,14,14,2981,11,2018,8,3
Group 1,BB,1.5,14,14,2982,12,2018,7,5
Group 1,BB,1.5,14,14,2983,11,2018,8,3
Group 1,BB,1.5,14,14,2984,11,2018,12,-1
Group 1,BB,1.5,14,14,2985,14,2018,11,3
Group 1,BB,1.5,14,14,2986,11,2018,11,0
Group 1,BB,1.5,14,14,2987,12,2018,12,0
Group 1,BB,1.5,14,14,2988,14,2018,12,2
Group 1,BB,1.5,14,14,2989,13,2018,9,4
Group 1,BB,1.5,14,14,2990,8,2018,9,-1
Group 1,BB,1.5,14,14,2991,13,2018,10,3
Group 1,BB,1.5,14,14,2992,12,2018,9,3
Group 1,BB,1.5,14,14,2993,11,2018,10,1
Group 1,BB,1.5,14,14,2994,10,2018,7,3
Group 1,BB,1.5,14,14,2995,12,2018,11,1
Group 1,BB,1.5,14,14,2996,8,2018,9,-1
Group 1,BB,1.5,14,14,2997,12,2018,9,3
Group 1,BB,1.5,14,14,2998,11,2018,10,1
Group 1,BB,1.5,14,14,2999,11,2018,11,0
Group 1,BB,1.5,14,14,3000,6,2018,13,-7
Group 1,BB,1.5,14,14,3001,12,2018,11,1
Group 1,BB,1.5,14,14,3002,12,2018,9,3
Group 1,BB,1.5,14,14,3003,12,2018,12,0
Group 1,BB,1.5,14,14,3004,12,2018,7,5
Group 1,BB,1.5,14,14,3005,11,2018,10,1
Group 1,BB,1.5,14,14,3006,10,2018,11,-1
Group 1,BB,1.5,14,14,3007,11,2018,11,0
Group 1,BB,1.5,14,14,3008,13,2018,12,1
Group 1,BB,1.5,14,14,3009,11,2018,11,0
Group 1,BB,1.5,14,14,3010,11,2018,7,4
Group 1,BB,1.5,14,14,3011,13,2018,9,4
Group 1,BB,1.5,14,14,3012,10,2018,10,0
Group 1,BB,1.5,14,14,3013,9,2018,8,1
Group 1,BB,1.5,14,14,3014,12,2018,9,3
Group 1,BB,1.5,14,14,3015,10,2018,9,1
Group 1,BB,1.5,14,14,3016,9,2018,11,-2
Group 1,BB,1.5,14,14,3017,11,2018,12,-1
Group 1,BB,1.5,14,14,3018,12,2018,9,3
Group 1,BB,1.5,14,14,3019,10,2018,11,-1
Group 1,BB,1.5,14,14,3020,13,2018,9,4
Group 1,BB,1.5,14,14,3021,8,2018,12,-4
Group 1,BB,1.5,14,14,3022,8,2018,6,2
Group 1,BB,1.5,14,14,3023,9,2018,5,4
Group 1,BB,1.5,14,14,3024,13,2018,13,0
Group 1,BB,1.5,14,14,3025,12,2018,12,0
Group 1,BB,1.5,14,14,3026,9,2018,10,-1
Group 1,BB,1.5,14,14,3027,13,2018,10,3
Group 1,BB,1.5,14,14,3028,10,2018,12,-2
Group 1,BB,1.5,14,14,3029,10,2018,11,-1
Group 1,BB,1.5,14,14,3030,12,2018,11,1
Group 1,BB,1.5,14,14,3031,13,2018,9,4
Group 1,BB,1.5,14,14,3032,12,2018,9,3
Group 1,BB,1.5,14,14,3033,12,2018,11,1
Group 1,BB,1.5,14,14,3034,11,2018,10,1
Group 1,BB,1.5,14,14,3035,11,2018,12,-1
Group 1,BB,1.5,14,14,3036,12,2018,6,6
Group 1,BB,1.5,14,14,3037,11,2018,11,0
Group 1,BB,1.5,14,14,3038,11,2018,10,1
Group 1,BB,1.5,14,14,3039,10,2018,12,-2
Group 1,BB,1.5,14,14,3040,10,2018,10,0
Group 1,BB,1.5,14,14,3041,12,2018,9,3
Group 1,BB,1.5,14,14,3042,12,2018,12,0
Group 1,BB,1.5,14,14,3043,14,2018,11,3
Group 1,BB,1.5,14,14,3044,13,2018,5,8
Group 1,BB,1.5,14,14,3045,12,2018,9,3
Group 1,BB,1.5,14,14,3046,11,2018,12,-1
Group 1,BB,1.5,14,14,3047,13,2018,10,3
Group 1,BB,1.5,14,14,3048,10,2018,11,-1
Group 1,BB,1.5,14,14,3049,12,2018,12,0
Group 1,BB,1.5,14,14,3050,10,2018,12,-2
Group 1,BB,1.5,14,14,3051,12,2018,13,-1
Group 1,BB,1.5,14,14,3052,12,2018,11,1
Group 1,BB,1.5,14,14,3053,12,2018,12,0
Group 1,BB,1.5,14,14,3054,9,2018,8,1
Group 1,BB,1.5,14,14,3055,13,2018,7,6
Group 1,BB,1.5,14,14,3056,10,2018,11,-1
Group 1,BB,1.5,14,14,3057,12,2018,10,2
Group 1,BB,1.5,14,14,3058,10,2018,11,-1
Group 1,BB,1.5,14,14,3059,11,2018,10,1
Group 1,BB,1.5,14,14,3060,13,2018,11,2
Group 1,BB,1.5,14,14,3061,13,2018,10,3
Group 1,BB,1.5,14,14,3062,12,2018,8,4
Group 1,BB,1.5,14,14,3063,11,2018,9,2
Group 1,BB,1.5,14,14,3064,14,2018,11,3
Group 1,BB,1.5,14,14,3065,11,2018,10,1
Group 1,BB,1.5,14,14,3066,11,2018,13,-2
Group 1,BB,1.5,14,14,3067,10,2018,10,0
Group 1,BB,1.5,14,14,3068,11,2018,11,0
Group 1,BB,1.5,14,14,3069,12,2018,10,2
Group 1,BB,1.5,14,14,3070,10,2018,11,-1
Group 1,BB,1.5,14,14,3071,12,2018,11,1
Group 1,BB,1.5,14,14,3072,10,2018,11,-1
Group 1,BB,1.5,14,14,3073,11,2018,11,0
Group 1,BB,1.5,14,14,3074,10,2018,10,0
Group 1,BB,1.5,14,14,3075,12,2018,11,1
Group 1,BB,1.5,14,14,3076,13,2018,10,3
Group 1,BB,1.5,14,14,3077,9,2018,8,1
Group 1,BB,1.5,14,14,3078,8,2018,13,-5
Group 1,BB,1.5,14,14,3079,12,2018,8,4
Group 1,BB,1.5,14,14,3080,12,2018,10,2
Group 1,BB,1.5,14,14,3081,11,2018,11,0
Group 1,BB,1.5,14,14,3082,13,2018,10,3
Group 1,BB,1.5,14,14,3083,10,2018,13,-3
Group 1,BB,1.5,14,14,3084,12,2018,11,1
Group 1,BB,1.5,14,14,3085,11,2018,11,0
Group 1,BB,1.5,14,14,3086,10,2018,11,-1
Group 1,BB,1.5,14,14,3087,12,2018,9,3
Group 1,BB,1.5,14,14,3088,11,2018,8,3
Group 1,BB,1.5,14,14,3089,11,2018,11,0
Group 1,BB,1.5,14,14,3090,11,2018,12,-1
Group 1,BB,1.5,14,14,3091,11,2018,12,-1
Group 1,BB,1.5,14,14,3092,5,2018,13,-8
Group 1,BB,1.5,14,14,3093,10,2018,9,1
Group 1,BB,1.5,14,14,3094,12,2018,10,2
Group 1,BB,1.5,14,14,3095,12,2018,11,1
Group 1,BB,1.5,14,14,3096,10,2018,11,-1
Group 1,BB,1.5,14,14,3097,8,2018,9,-1
Group 1,BB,1.5,14,14,3098,11,2018,7,4
Group 1,BB,1.5,14,14,3099,11,2018,11,0
Group 1,BB,1.5,14,14,3100,10,2018,10,0
Group 1,BB,1.5,14,14,3101,10,2018,11,-1
Group 1,BB,1.5,14,14,3102,12,2018,8,4
Group 1,BB,1.5,14,14,3103,10,2018,8,2
Group 1,BB,1.5,14,14,3104,11,2018,12,-1
Group 1,BB,1.5,14,14,3105,12,2018,12,0
Group 1,BB,1.5,14,14,3106,11,2018,12,-1
Group 1,BB,1.5,14,14,3107,12,2018,12,0
Group 1,BB,1.5,14,14,3108,12,2018,7,5
Group 1,BB,1.5,14,14,3109,10,2018,9,1
Group 1,BB,1.5,14,14,3110,11,2018,12,-1
Group 1,BB,1.5,14,14,3111,13,2018,11,2
Group 1,BB,1.5,14,14,3112,11,2018,10,1
Group 1,BB,1.5,14,14,3113,13,2018,10,3
Group 1,BB,1.5,14,14,3114,10,2018,9,1
Group 1,BB,1.5,14,14,3115,13,2018,13,0
Group 1,BB,1.5,14,14,3116,11,2018,8,3
Group 1,BB,1.5,14,14,3117,12,2018,10,2
Group 1,BB,1.5,14,14,3118,7,2018,7,0
Group 1,BB,1.5,14,14,3119,11,2018,13,-2
Group 1,BB,1.5,14,14,3120,10,2018,7,3
Group 1,BB,1.5,14,14,3121,11,2018,9,2
Group 1,BB,1.5,14,14,3122,12,2018,9,3
Group 1,BB,1.5,14,14,3123,12,2018,10,2
Group 1,BB,1.5,14,14,3124,12,2018,14,-2
Group 1,BB,1.5,14,14,3125,10,2018,13,-3
Group 1,BB,1.5,14,14,3126,10,2018,12,-2
Group 1,BB,1.5,14,14,3127,10,2018,12,-2
Group 1,BB,1.5,14,14,3128,11,2018,12,-1
Group 1,BB,1.5,14,14,3129,11,2018,8,3
Group 1,BB,1.5,14,14,3130,12,2018,12,0
Group 1,BB,1.5,14,14,3131,12,2018,10,2
Group 1,BB,1.5,14,14,3132,9,2018,11,-2
Group 1,BB,1.5,14,14,3133,11,2018,9,2
Group 1,BB,1.5,14,14,3134,11,2018,12,-1
Group 1,BB,1.5,14,14,3135,11,2018,12,-1
Group 1,BB,1.5,14,14,3136,9,2018,13,-4
Group 1,BB,1.5,14,14,3137,10,2018,11,-1
Group 1,BB,1.5,14,14,3138,12,2018,12,0
Group 1,BB,1.5,14,14,3139,11,2018,10,1
Group 1,BB,1.5,14,14,3140,9,2018,13,-4
Group 1,BB,1.5,14,14,3141,10,2018,11,-1
Group 1,BB,1.5,14,14,3142,13,2018,9,4
Group 1,BB,1.5,14,14,3143,12,2018,13,-1
Group 1,BB,1.5,14,14,3144,7,2018,8,-1
Group 1,BB,1.5,14,14,3145,8,2018,4,4
Group 1,BB,1.5,14,14,3146,11,2018,5,6
Group 1,BB,1.5,14,14,3147,14,2018,13,1
Group 1,BB,1.5,14,14,3148,10,2018,7,3
Group 1,BB,1.5,14,14,3149,10,2018,10,0
Group 1,BB,1.5,14,14,3150,10,2018,9,1
Group 1,BB,1.5,14,14,3151,12,2018,8,4
Group 1,BB,1.5,14,14,3152,10,2018,10,0
Group 1,BB,1.5,14,14,3153,7,2018,10,-3
Group 1,BB,1.5,14,14,3154,12,2018,9,3
Group 1,BB,1.5,14,14,3155,13,2018,7,6
Group 1,BB,1.5,14,14,3156,11,2018,10,1
Group 1,BB,1.5,14,14,3157,12,2018,13,-1
Group 1,BB,1.5,14,14,3158,11,2018,13,-2
Group 1,BB,1.5,14,14,3159,14,2018,12,2
Group 1,BB,1.5,14,14,3160,10,2018,11,-1
Group 1,BB,1.5,14,14,3161,12,2018,11,1
Group 1,BB,1.5,14,14,3162,8,2018,8,0
Group 1,BB,1.5,14,14,3163,11,2018,10,1
Group 1,BB,1.5,14,14,3164,13,2018,11,2
Group 1,BB,1.5,14,14,3165,9,2018,9,0
Group 1,BB,1.5,14,14,3166,9,2018,10,-1
Group 1,BB,1.5,14,14,3167,10,2018,11,-1
Group 1,BB,1.5,14,14,3168,11,2018,12,-1
Group 1,BB,1.5,14,14,3169,10,2018,7,3
Group 1,BB,1.5,14,14,3170,9,2018,12,-3
Group 1,BB,1.5,14,14,3171,12,2018,10,2
Group 1,BB,1.5,14,14,3172,10,2018,8,2
Group 1,BB,1.5,14,14,3173,9,2018,13,-4
Group 1,BB,1.5,14,14,3174,9,2018,13,-4
Group 1,BB,1.5,14,14,3175,10,2018,10,0
Group 1,BB,1.5,14,14,3176,9,2018,11,-2
Group 1,BB,1.5,14,14,3177,12,2018,11,1
Group 1,BB,1.5,14,14,3178,12,2018,11,1
Group 1,BB,1.5,14,14,3179,8,2018,12,-4
Group 1,BB,1.5,14,14,3180,10,2018,10,0
Group 1,BB,1.5,14,14,3181,9,2018,11,-2
Group 1,BB,1.5,14,14,3182,11,2018,10,1
Group 1,BB,1.5,14,14,3183,10,2018,9,1
Group 1,BB,1.5,14,14,3184,13,2018,7,6
Group 1,BB,1.5,14,14,3185,12,2018,12,0
Group 1,BB,1.5,14,14,3186,9,2018,13,-4
Group 1,BB,1.5,14,14,3187,10,2018,10,0
Group 1,BB,1.5,14,14,3188,11,2018,10,1
Group 1,BB,1.5,14,14,3189,12,2018,5,7
Group 1,BB,1.5,14,14,3190,10,2018,9,1
Group 1,BB,1.5,14,14,3191,13,2018,6,7
Group 1,BB,1.5,14,14,3192,14,2018,6,8
Group 1,BB,1.5,14,14,3193,8,2018,12,-4
Group 1,BB,1.5,14,14,3194,9,2018,8,1
Group 1,BB,1.5,14,14,3195,9,2018,10,-1
Group 1,BB,1.5,14,14,3196,12,2018,9,3
Group 1,BB,1.5,14,14,3197,11,2018,9,2
Group 1,BB,1.5,14,14,3198,9,2018,10,-1
Group 1,BB,1.5,14,14,3199,8,2018,13,-5
Group 1,BB,1.5,14,14,3200,8,2018,10,-2
Group 1,BB,1.5,14,14,3201,8,2018,12,-4
Group 1,BB,1.5,14,14,3202,8,2018,11,-3
Group 1,BB,1.5,14,14,3203,9,2018,12,-3
Group 1,BB,1.5,14,14,3204,10,2018,8,2
Group 1,BB,1.5,14,14,3205,8,2018,9,-1
Group 1,BB,1.5,14,14,3206,12,2018,9,3
Group 1,BB,1.5,14,14,3207,7,2018,11,-4
Group 1,BB,1.5,14,14,3208,10,2018,9,1
Group 1,BB,1.5,14,14,3209,10,2018,10,0
Group 1,BB,1.5,14,14,3210,9,2018,10,-1
Group 1,BB,1.5,14,14,3211,13,2018,7,6
Group 1,BB,1.5,14,14,3212,11,2018,10,1
Group 1,BB,1.5,14,14,3213,9,2018,9,0
Group 1,BB,1.5,14,14,3214,8,2018,7,1
Group 1,BB,1.5,14,14,3215,12,2018,13,-1
Group 1,BB,1.5,14,14,3216,11,2018,11,0
Group 1,BB,1.5,14,14,3217,10,2018,8,2
Group 1,BB,1.5,14,14,3218,14,2018,12,2
Group 1,BB,1.5,14,14,3219,13,2018,11,2
Group 1,BB,1.5,14,14,3220,10,2018,9,1
Group 1,BB,1.5,14,14,3221,10,2018,9,1
Group 1,BB,1.5,14,14,3222,10,2018,12,-2
Group 1,BB,1.5,14,14,3223,12,2018,10,2
Group 1,BB,1.5,14,14,3224,13,2018,12,1
Group 1,BB,1.5,14,14,3225,9,2018,13,-4
Group 1,BB,1.5,14,14,3226,9,2018,12,-3
Group 1,BB,1.5,14,14,3227,10,2018,11,-1
Group 1,BB,1.5,14,14,3228,11,2018,9,2
Group 1,BB,1.5,14,14,3229,9,2018,12,-3
Group 1,BB,1.5,14,14,3230,12,2018,10,2
Group 1,BB,1.5,14,14,3231,13,2018,6,7
Group 1,BB,1.5,14,14,3232,10,2018,11,-1
Group 1,BB,1.5,14,14,3233,13,2018,12,1
Group 1,BB,1.5,14,14,3234,10,2018,11,-1
Group 1,BB,1.5,14,14,3235,11,2018,13,-2
Group 1,BB,1.5,14,14,3236,8,2018,10,-2
Group 1,BB,1.5,14,14,3237,11,2018,8,3
Group 1,BB,1.5,14,14,3238,11,2018,12,-1
Group 1,BB,1.5,14,14,3239,11,2018,10,1
Group 1,BB,1.5,14,14,3240,12,2018,8,4
Group 1,BB,1.5,14,14,3241,9,2018,14,-5
Group 1,BB,1.5,14,14,3242,10,2018,7,3
Group 1,BB,1.5,14,14,3243,10,2018,8,2
Group 1,BB,1.5,14,14,3244,12,2018,11,1
Group 1,BB,1.5,14,14,3245,11,2018,10,1
Group 1,BB,1.5,14,14,3246,12,2018,10,2
Group 1,BB,1.5,14,14,3247,11,2018,11,0
Group 1,BB,1.5,14,14,3248,11,2018,8,3
Group 1,BB,1.5,14,14,3249,11,2018,9,2
Group 1,BB,1.5,14,14,3250,12,2018,10,2
Group 1,BB,1.5,14,14,3251,9,2018,9,0
Group 1,BB,1.5,14,14,3252,10,2018,10,0
Group 1,BB,1.5,14,14,3253,11,2018,8,3
Group 1,BB,1.5,14,14,3254,11,2018,6,5
Group 1,BB,1.5,14,14,3255,9,2018,10,-1
Group 1,BB,1.5,14,14,3256,10,2018,8,2
Group 1,BB,1.5,14,14,3257,9,2018,11,-2
Group 1,BB,1.5,14,14,3258,9,2018,11,-2
Group 1,BB,1.5,14,14,3259,11,2018,9,2
Group 1,BB,1.5,14,14,3260,9,2018,10,-1
Group 1,BB,1.5,14,14,3261,14,2018,11,3
Group 1,BB,1.5,14,14,3262,10,2018,9,1
Group 1,BB,1.5,14,14,3263,11,2018,10,1
Group 1,BB,1.5,14,14,3264,5,2018,6,-1
Group 1,BB,1.5,14,14,3265,12,2018,5,7
Group 1,BB,1.5,14,14,3266,10,2018,4,6
Group 1,BB,1.5,14,14,3267,7,2018,11,-4
Group 1,BB,1.5,14,14,3268,12,2018,7,5
Group 1,BB,1.5,14,14,3269,10,2018,9,1
Group 1,BB,1.5,14,14,3270,12,2018,8,4
Group 1,BB,1.5,14,14,3271,11,2018,10,1
Group 1,BB,1.5,14,14,3272,13,2018,12,1
Group 1,BB,1.5,14,14,3273,10,2018,9,1
Group 1,BB,1.5,14,14,3274,11,2018,10,1
Group 1,BB,1.5,14,14,3275,12,2018,12,0
Group 1,BB,1.5,14,14,3276,12,2018,11,1
Group 1,BB,1.5,14,14,3277,11,2018,9,2
Group 1,BB,1.5,14,14,3278,9,2018,9,0
Group 1,BB,1.5,14,14,3279,12,2018,11,1
Group 1,BB,1.5,14,14,3280,9,2018,9,0
Group 1,BB,1.5,14,14,3281,10,2018,12,-2
Group 1,BB,1.5,14,14,3282,12,2018,10,2
Group 1,BB,1.5,14,14,3283,11,2018,12,-1
Group 1,BB,1.5,14,14,3284,13,2018,14,-1
Group 1,BB,1.5,14,14,3285,13,2018,11,2
Group 1,BB,1.5,14,14,3286,10,2018,10,0
Group 1,BB,1.5,14,14,3287,10,2018,12,-2
Group 1,BB,1.5,14,14,3288,11,2018,10,1
Group 1,BB,1.5,14,14,3289,7,2018,11,-4
Group 1,BB,1.5,14,14,3290,11,2018,13,-2
Group 1,BB,1.5,14,14,3291,11,2018,9,2
Group 1,BB,1.5,14,14,3292,13,2018,10,3
Group 1,BB,1.5,14,14,3293,10,2018,8,2
Group 1,BB,1.5,14,14,3294,12,2018,10,2
Group 1,BB,1.5,14,14,3295,9,2018,9,0
Group 1,BB,1.5,14,14,3296,9,2018,10,-1
Group 1,BB,1.5,14,14,3297,10,2018,10,0
Group 1,BB,1.5,14,14,3298,9,2018,12,-3
Group 1,BB,1.5,14,14,3299,12,2018,10,2
Group 1,BB,1.5,14,14,3300,9,2018,12,-3
Group 1,BB,1.5,14,14,3301,13,2018,12,1
Group 1,BB,1.5,14,14,3302,8,2018,13,-5
Group 1,BB,1.5,14,14,3303,12,2018,11,1
Group 1,BB,1.5,14,14,3304,10,2018,12,-2
Group 1,BB,1.5,14,14,3305,9,2018,10,-1
Group 1,BB,1.5,14,14,3306,10,2018,10,0
Group 1,BB,1.5,14,14,3307,11,2018,9,2
Group 1,BB,1.5,14,14,3308,14,2018,10,4
Group 1,BB,1.5,14,14,3309,13,2018,8,5
Group 1,BB,1.5,14,14,3310,11,2018,9,2
Group 1,BB,1.5,14,14,3311,8,2018,12,-4
Group 1,BB,1.5,14,14,3312,13,2018,7,6
Group 1,BB,1.5,14,14,3313,13,2018,8,5
Group 1,BB,1.5,14,14,3314,8,2018,10,-2
Group 1,BB,1.5,14,14,3315,10,2018,10,0
Group 1,BB,1.5,14,14,3316,12,2018,11,1
Group 1,BB,1.5,14,14,3317,11,2018,10,1
Group 1,BB,1.5,14,14,3318,7,2018,12,-5
Group 1,BB,1.5,14,14,3319,12,2018,6,6
Group 1,BB,1.5,14,14,3320,11,2018,12,-1
Group 1,BB,1.5,14,14,3321,12,2018,11,1
Group 1,BB,1.5,14,14,3322,9,2018,8,1
Group 1,BB,1.5,14,14,3323,8,2018,8,0
Group 1,BB,1.5,14,14,3324,7,2018,12,-5
Group 1,BB,1.5,14,14,3325,11,2018,12,-1
Group 1,BB,1.5,14,14,3326,12,2018,6,6
Group 1,BB,1.5,14,14,3327,12,2018,11,1
Group 1,BB,1.5,14,14,3328,12,2018,9,3
Group 1,BB,1.5,14,14,3329,9,2018,12,-3
Group 1,BB,1.5,14,14,3330,11,2018,9,2
Group 1,BB,1.5,14,14,3331,12,2018,8,4
Group 1,BB,1.5,14,14,3332,12,2018,7,5
Group 1,BB,1.5,14,14,3333,12,2018,8,4
Group 1,BB,1.5,14,14,3334,8,2018,8,0
Group 1,BB,1.5,14,14,3335,9,2018,12,-3
Group 1,BB,1.5,14,14,3336,9,2018,9,0
Group 1,BB,1.5,14,14,3337,13,2018,13,0
Group 1,BB,1.5,14,14,3338,9,2018,11,-2
Group 1,BB,1.5,14,14,3339,10,2018,11,-1
Group 1,BB,1.5,14,14,3340,12,2018,10,2
Group 1,BB,1.5,14,14,3341,12,2018,8,4
Group 1,BB,1.5,14,14,3342,9,2018,10,-1
Group 1,BB,1.5,14,14,3343,12,2018,8,4
Group 1,BB,1.5,14,14,3344,10,2018,13,-3
Group 1,BB,1.5,14,14,3345,12,2018,11,1
Group 1,BB,1.5,14,14,3346,12,2018,10,2
Group 1,BB,1.5,14,14,3347,11,2018,13,-2
Group 1,BB,1.5,14,14,3348,10,2018,8,2
Group 1,BB,1.5,14,14,3349,9,2018,12,-3
Group 1,BB,1.5,14,14,3350,13,2018,10,3
Group 1,BB,1.5,14,14,3351,11,2018,9,2
Group 1,BB,1.5,14,14,3352,10,2018,11,-1
Group 1,BB,1.5,14,14,3353,12,2018,8,4
Group 1,BB,1.5,14,14,3354,11,2018,10,1
Group 1,BB,1.5,14,14,3355,11,2018,12,-1
Group 1,BB,1.5,14,14,3356,13,2018,12,1
Group 1,BB,1.5,14,14,3357,12,2018,11,1
Group 1,BB,1.5,14,14,3358,11,2018,8,3
Group 1,BB,1.5,14,14,3359,11,2018,9,2
Group 1,BB,1.5,14,14,3360,9,2018,11,-2
Group 1,BB,1.5,14,14,3361,9,2018,9,0
Group 1,BB,1.5,14,14,3362,11,2018,12,-1
Group 1,BB,1.5,14,14,3363,12,2018,10,2
Group 1,BB,1.5,14,14,3364,11,2018,8,3
Group 1,BB,1.5,14,14,3365,10,2018,13,-3
Group 1,BB,1.5,14,14,3366,13,2018,9,4
Group 1,BB,1.5,14,14,3367,11,2018,8,3
Group 1,BB,1.5,14,14,3368,11,2018,10,1
Group 1,BB,1.5,14,14,3369,11,2018,7,4
Group 1,BB,1.5,14,14,3370,8,2018,12,-4
Group 1,BB,1.5,14,14,3371,11,2018,11,0
Group 1,BB,1.5,14,14,3372,12,2018,9,3
Group 1,BB,1.5,14,14,3373,8,2018,10,-2
Group 1,BB,1.5,14,14,3374,9,2018,7,2
Group 1,BB,1.5,14,14,3375,13,2018,8,5
Group 1,BB,1.5,14,14,3376,13,2018,8,5
Group 1,BB,1.5,14,14,3377,7,2018,8,-1
Group 1,BB,1.5,14,14,3378,12,2018,11,1
Group 1,BB,1.5,14,14,3379,12,2018,9,3
Group 1,BB,1.5,14,14,3380,11,2018,8,3
Group 1,BB,1.5,14,14,3381,10,2018,11,-1
Group 1,BB,1.5,14,14,3382,11,2018,10,1
Group 1,BB,1.5,14,14,3383,11,2018,8,3
Group 1,BB,1.5,14,14,3384,12,2018,8,4
Group 1,BB,1.5,14,14,3385,12,2018,10,2
Group 1,BB,1.5,14,14,3386,11,2018,7,4
Group 1,BB,1.5,14,14,3387,10,2018,8,2
Group 1,BB,1.5,14,14,3388,11,2018,7,4
Group 1,BB,1.5,14,14,3389,9,2018,10,-1
Group 1,BB,1.5,14,14,3390,12,2018,11,1
Group 1,BB,1.5,14,14,3391,8,2018,10,-2
Group 1,BB,1.5,14,14,3392,13,2018,10,3
Group 1,BB,1.5,14,14,3393,13,2018,11,2
Group 1,BB,1.5,14,14,3394,10,2018,9,1
Group 1,BB,1.5,14,14,3395,12,2018,10,2
Group 1,BB,1.5,14,14,3396,8,2018,10,-2
Group 1,BB,1.5,14,14,3397,10,2018,11,-1
Group 1,BB,1.5,14,14,3398,12,2018,5,7
Group 1,BB,1.5,14,14,3399,11,2018,14,-3
Group 1,BB,1.5,14,14,3400,13,2018,10,3
Group 1,BB,1.5,14,14,3401,8,2018,13,-5
Group 1,BB,1.5,14,14,3402,12,2018,8,4
Group 1,BB,1.5,14,14,3403,10,2018,8,2
Group 1,BB,1.5,14,14,3404,11,2018,11,0
Group 1,BB,1.5,14,14,3405,12,2018,10,2
Group 1,BB,1.5,14,14,3406,10,2018,8,2
Group 1,BB,1.5,14,14,3407,12,2018,12,0
Group 1,BB,1.5,14,14,3408,9,2018,12,-3
Group 1,BB,1.5,14,14,3409,13,2018,13,0
Group 1,BB,1.5,14,14,3410,12,2018,11,1
Group 1,BB,1.5,14,14,3411,8,2018,11,-3
Group 1,BB,1.5,14,14,3412,9,2018,12,-3
Group 1,BB,1.5,14,14,3413,9,2018,13,-4
Group 1,BB,1.5,14,14,3414,11,2018,11,0
Group 1,BB,1.5,14,14,3415,11,2018,9,2
Group 1,BB,1.5,14,14,3416,8,2018,11,-3
Group 1,BB,1.5,14,14,3417,11,2018,8,3
Group 1,BB,1.5,14,14,3418,12,2018,9,3
Group 1,BB,1.5,14,14,3419,11,2018,8,3
Group 1,BB,1.5,14,14,3420,14,2018,8,6
Group 1,BB,1.5,14,14,3421,10,2018,12,-2
Group 1,BB,1.5,14,14,3422,12,2018,9,3
Group 1,BB,1.5,14,14,3423,8,2018,9,-1
Group 1,BB,1.5,14,14,3424,10,2018,7,3
Group 1,BB,1.5,14,14,3425,12,2018,11,1
Group 1,BB,1.5,14,14,3426,10,2018,11,-1
Group 1,BB,1.5,14,14,3427,10,2018,9,1
Group 1,BB,1.5,14,14,3428,11,2018,6,5
Group 1,BB,1.5,14,14,3429,8,2018,10,-2
Group 1,BB,1.5,14,14,3430,12,2018,9,3
Group 1,BB,1.5,14,14,3431,12,2018,9,3
Group 1,BB,1.5,14,14,3432,9,2018,11,-2
Group 1,BB,1.5,14,14,3433,8,2018,9,-1
Group 1,BB,1.5,14,14,3434,12,2018,10,2
Group 1,BB,1.5,14,14,3435,11,2018,10,1
Group 1,BB,1.5,14,14,3436,8,2018,11,-3
Group 1,BB,1.5,14,14,3437,10,2018,9,1
Group 1,BB,1.5,14,14,3438,8,2018,9,-1
Group 1,BB,1.5,14,14,3439,13,2018,8,5
Group 1,BB,1.5,14,14,3440,10,2018,10,0
Group 1,BB,1.5,14,14,3441,14,2018,8,6
Group 1,BB,1.5,14,14,3442,12,2018,8,4
Group 1,BB,1.5,14,14,3443,10,2018,13,-3
Group 1,BB,1.5,14,14,3444,10,2018,10,0
Group 1,BB,1.5,14,14,3445,12,2018,9,3
Group 1,BB,1.5,14,14,3446,11,2018,14,-3
Group 1,BB,1.5,14,14,3447,13,2018,9,4
Group 1,BB,1.5,14,14,3448,7,2018,11,-4
Group 1,BB,1.5,14,14,3449,10,2018,12,-2
Group 1,BB,1.5,14,14,3450,10,2018,12,-2
Group 1,BB,1.5,14,14,3451,12,2018,6,6
Group 1,BB,1.5,14,14,3452,9,2018,8,1
Group 1,BB,1.5,14,14,3453,9,2018,11,-2
Group 1,BB,1.5,14,14,3454,8,2018,11,-3
Group 1,BB,1.5,14,14,3455,9,2018,8,1
Group 1,BB,1.5,14,14,3456,11,2018,10,1
Group 1,BB,1.5,14,14,3457,11,2018,12,-1
Group 1,BB,1.5,14,14,3458,12,2018,8,4
Group 1,BB,1.5,14,14,3459,12,2018,11,1
Group 1,BB,1.5,14,14,3460,11,2018,10,1
Group 1,BB,1.5,14,14,3461,10,2018,8,2
Group 1,BB,1.5,14,14,3462,12,2018,10,2
Group 1,BB,1.5,14,14,3463,12,2018,7,5
Group 1,BB,1.5,14,14,3464,12,2018,11,1
Group 1,BB,1.5,14,14,3465,14,2018,14,0
Group 1,BB,1.5,14,14,3466,13,2018,12,1
Group 1,BB,1.5,14,14,3467,12,2018,12,0
Group 1,BB,1.5,14,14,3468,10,2018,10,0
Group 1,BB,1.5,14,14,3469,11,2018,10,1
Group 1,BB,1.5,14,14,3470,13,2018,10,3
Group 1,BB,1.5,14,14,3471,12,2018,8,4
Group 1,BB,1.5,14,14,3472,9,2018,11,-2
Group 1,BB,1.5,14,14,3473,11,2018,6,5
Group 1,BB,1.5,14,14,3474,11,2018,9,2
Group 1,BB,1.5,14,14,3475,13,2018,11,2
Group 1,BB,1.5,14,14,3476,10,2018,7,3
Group 1,BB,1.5,14,14,3477,9,2018,12,-3
Group 1,BB,1.5,14,14,3478,9,2018,9,0
Group 1,BB,1.5,14,14,3479,14,2018,13,1
Group 1,BB,1.5,14,14,3480,13,2018,13,0
Group 1,BB,1.5,14,14,3481,11,2018,10,1
Group 1,BB,1.5,14,14,3482,13,2018,13,0
Group 1,BB,1.5,14,14,3483,11,2018,9,2
Group 1,BB,1.5,14,14,3484,12,2018,11,1
Group 1,BB,1.5,14,14,3485,11,2018,12,-1
Group 1,BB,1.5,14,14,3486,9,2018,6,3
Group 1,BB,1.5,14,14,3487,10,2018,11,-1
Group 1,BB,1.5,14,14,3488,13,2018,10,3
Group 1,BB,1.5,14,14,3489,10,2018,11,-1
Group 1,BB,1.5,14,14,3490,10,2018,13,-3
Group 1,BB,1.5,14,14,3491,12,2018,11,1
Group 1,BB,1.5,14,14,3492,8,2018,8,0
Group 1,BB,1.5,14,14,3493,9,2018,8,1
Group 1,BB,1.5,14,14,3494,13,2018,11,2
Group 1,BB,1.5,14,14,3495,14,2018,12,2
Group 1,BB,1.5,14,14,3496,12,2018,10,2
Group 1,BB,1.5,14,14,3497,11,2018,7,4
Group 1,BB,1.5,14,14,3498,11,2018,10,1
Group 1,BB,1.5,14,14,3499,10,2018,13,-3
Group 1,BB,1.5,14,14,3500,10,2018,12,-2
Group 1,BB,1.5,14,14,3501,10,2018,6,4
Group 1,BB,1.5,14,14,3502,12,2018,10,2
Group 1,BB,1.5,14,14,3503,7,2018,11,-4
Group 1,BB,1.5,14,14,3504,13,2018,10,3
Group 1,BB,1.5,14,14,3505,11,2018,11,0
Group 1,BB,1.5,14,14,3506,12,2018,10,2
Group 1,BB,1.5,14,14,3507,8,2018,9,-1
Group 1,BB,1.5,14,14,3508,9,2018,10,-1
Group 1,BB,1.5,14,14,3509,6,2018,9,-3
Group 1,BB,1.5,14,14,3510,11,2018,12,-1
Group 1,BB,1.5,14,14,3511,9,2018,14,-5
Group 1,BB,1.5,14,14,3512,10,2018,9,1
Group 1,BB,1.5,14,14,3513,10,2018,12,-2
Group 1,BB,1.5,14,14,3514,12,2018,12,0
Group 1,BB,1.5,14,14,3515,12,2018,9,3
Group 1,BB,1.5,14,14,3516,9,2018,8,1
Group 1,BB,1.5,14,14,3517,9,2018,12,-3
Group 1,BB,1.5,14,14,3518,11,2018,7,4
Group 1,BB,1.5,14,14,3519,10,2018,10,0
Group 1,BB,1.5,14,14,3520,11,2018,9,2
Group 1,BB,1.5,14,14,3521,11,2018,10,1
Group 1,BB,1.5,14,14,3522,8,2018,11,-3
Group 1,BB,1.5,14,14,3523,6,2018,10,-4
Group 1,BB,1.5,14,14,3524,13,2018,10,3
Group 1,BB,1.5,14,14,3525,12,2018,12,0
Group 1,BB,1.5,14,14,3526,14,2018,10,4
Group 1,BB,1.5,14,14,3527,10,2018,8,2
Group 1,BB,1.5,14,14,3528,8,2018,9,-1
Group 1,BB,1.5,14,14,3529,8,2018,5,3
Group 1,BB,1.5,14,14,3530,11,2018,8,3
Group 1,BB,1.5,14,14,3531,10,2018,11,-1
Group 1,BB,1.5,14,14,3532,10,2018,9,1
Group 1,BB,1.5,14,14,3533,11,2018,9,2
Group 1,BB,1.5,14,14,3534,14,2018,10,4
Group 1,BB,1.5,14,14,3535,11,2018,11,0
Group 1,BB,1.5,14,14,3536,13,2018,13,0
Group 1,BB,1.5,14,14,3537,11,2018,11,0
Group 1,BB,1.5,14,14,3538,9,2018,13,-4
Group 1,BB,1.5,14,14,3539,9,2018,12,-3
Group 1,BB,1.5,14,14,3540,13,2018,11,2
Group 1,BB,1.5,14,14,3541,9,2018,11,-2
Group 1,BB,1.5,14,14,3542,11,2018,9,2
Group 1,BB,1.5,14,14,3543,12,2018,11,1
Group 1,BB,1.5,14,14,3544,9,2018,11,-2
Group 1,BB,1.5,14,14,3545,10,2018,10,0
Group 1,BB,1.5,14,14,3546,10,2018,13,-3
Group 1,BB,1.5,14,14,3547,10,2018,11,-1
Group 1,BB,1.5,14,14,3548,10,2018,7,3
Group 1,BB,1.5,14,14,3549,12,2018,10,2
Group 1,BB,1.5,14,14,3550,10,2018,9,1
Group 1,BB,1.5,14,14,3551,13,2018,12,1
Group 1,BB,1.5,14,14,3552,11,2018,10,1
Group 1,BB,1.5,14,14,3553,13,2018,4,9
Group 1,BB,1.5,14,14,3554,13,2018,10,3
Group 1,BB,1.5,14,14,3555,9,2018,7,2
Group 1,BB,1.5,14,14,3556,9,2018,14,-5
Group 1,BB,1.5,14,14,3557,10,2018,11,-1
Group 1,BB,1.5,14,14,3558,11,2018,13,-2
Group 1,BB,1.5,14,14,3559,13,2018,11,2
Group 1,BB,1.5,14,14,3560,8,2018,12,-4
Group 1,BB,1.5,14,14,3561,8,2018,9,-1
Group 1,BB,1.5,14,14,3562,12,2018,12,0
Group 1,BB,1.5,14,14,3563,11,2018,8,3
Group 1,BB,1.5,14,14,3564,13,2018,9,4
Group 1,BB,1.5,14,14,3565,13,2018,8,5
Group 1,BB,1.5,14,14,3566,14,2018,10,4
Group 1,BB,1.5,14,14,3567,7,2018,9,-2
Group 1,BB,1.5,14,14,3568,7,2018,12,-5
Group 1,BB,1.5,14,14,3569,11,2018,11,0
Group 1,BB,1.5,14,14,3570,10,2018,11,-1
Group 1,BB,1.5,14,14,3571,12,2018,8,4
Group 1,BB,1.5,14,14,3572,10,2018,9,1
Group 1,BB,1.5,14,14,3573,12,2018,7,5
Group 1,BB,1.5,14,14,3574,10,2018,6,4
Group 1,BB,1.5,14,14,3575,11,2018,10,1
Group 1,BB,1.5,14,14,3576,7,2018,10,-3
Group 1,BB,1.5,14,14,3577,12,2018,8,4
Group 1,BB,1.5,14,14,3578,12,2018,12,0
Group 1,BB,1.5,14,14,3579,10,2018,11,-1
Group 1,BB,1.5,14,14,3580,10,2018,9,1
Group 1,BB,1.5,14,14,3581,10,2018,8,2
Group 1,BB,1.5,14,14,3582,12,2018,10,2
Group 1,BB,1.5,14,14,3583,10,2018,8,2
Group 1,BB,1.5,14,14,3584,11,2018,13,-2
Group 1,BB,1.5,14,14,3585,10,2018,12,-2
Group 1,BB,1.5,14,14,3586,11,2018,7,4
Group 1,BB,1.5,14,14,3587,10,2018,10,0
Group 1,BB,1.5,14,14,3588,11,2018,8,3
Group 1,BB,1.5,14,14,3589,9,2018,6,3
Group 1,BB,1.5,14,14,3590,8,2018,14,-6
Group 1,BB,1.5,14,14,3591,8,2018,14,-6
Group 1,BB,1.5,14,14,3592,10,2018,7,3
Group 1,BB,1.5,14,14,3593,11,2018,10,1
Group 1,BB,1.5,14,14,3594,13,2018,7,6
Group 1,BB,1.5,14,14,3595,11,2018,12,-1
Group 1,BB,1.5,14,14,3596,11,2018,10,1
Group 1,BB,1.5,14,14,3597,10,2018,9,1
Group 1,BB,1.5,14,14,3598,12,2018,11,1
Group 1,BB,1.5,14,14,3599,10,2018,11,-1
Group 1,BB,1.5,14,14,3600,9,2018,8,1
Group 1,BB,1.5,14,14,3601,9,2018,9,0
Group 1,BB,1.5,14,14,3602,13,2018,8,5
Group 1,BB,1.5,14,14,3603,12,2018,11,1
Group 1,BB,1.5,14,14,3604,5,2018,9,-4
Group 1,BB,1.5,14,14,3605,10,2018,9,1
Group 1,BB,1.5,14,14,3606,9,2018,11,-2
Group 1,BB,1.5,14,14,3607,9,2018,9,0
Group 1,BB,1.5,14,14,3608,10,2018,11,-1
Group 1,BB,1.5,14,14,3609,8,2018,12,-4
Group 1,BB,1.5,14,14,3610,8,2018,9,-1
Group 1,BB,1.5,14,14,3611,12,2018,11,1
Group 1,BB,1.5,14,14,3612,11,2018,9,2
Group 1,BB,1.5,14,14,3613,11,2018,10,1
Group 1,BB,1.5,14,14,3614,11,2018,11,0
Group 1,BB,1.5,14,14,3615,7,2018,10,-3
Group 1,BB,1.5,14,14,3616,12,2018,11,1
Group 1,BB,1.5,14,14,3617,7,2018,10,-3
Group 1,BB,1.5,14,14,3618,12,2018,11,1
Group 1,BB,1.5,14,14,3619,9,2018,8,1
Group 1,BB,1.5,14,14,3620,8,2018,9,-1
Group 1,BB,1.5,14,14,3621,14,2018,11,3
Group 1,BB,1.5,14,14,3622,13,2018,9,4
Group 1,BB,1.5,14,14,3623,10,2018,7,3
Group 1,BB,1.5,14,14,3624,13,2018,12,1
Group 1,BB,1.5,14,14,3625,13,2018,13,0
Group 1,BB,1.5,14,14,3626,11,2018,12,-1
Group 1,BB,1.5,14,14,3627,13,2018,11,2
Group 1,BB,1.5,14,14,3628,11,2018,11,0
Group 1,BB,1.5,14,14,3629,10,2018,11,-1
Group 1,BB,1.5,14,14,3630,11,2018,9,2
Group 1,BB,1.5,14,14,3631,10,2018,12,-2
Group 1,BB,1.5,14,14,3632,9,2018,9,0
Group 1,BB,1.5,14,14,3633,10,2018,11,-1
Group 1,BB,1.5,14,14,3634,11,2018,10,1
Group 1,BB,1.5,14,14,3635,11,2018,9,2
Group 1,BB,1.5,14,14,3636,9,2018,10,-1
Group 1,BB,1.5,14,14,3637,11,2018,12,-1
Group 1,BB,1.5,14,14,3638,13,2018,11,2
Group 1,BB,1.5,14,14,3639,11,2018,12,-1
Group 1,BB,1.5,14,14,3640,14,2018,10,4
Group 1,BB,1.5,14,14,3641,13,2018,11,2
Group 1,BB,1.5,14,14,3642,10,2018,10,0
Group 1,BB,1.5,14,14,3643,9,2018,11,-2
Group 1,BB,1.5,14,14,3644,11,2018,11,0
Group 1,BB,1.5,14,14,3645,9,2018,8,1
Group 1,BB,1.5,14,14,3646,6,2018,6,0
Group 1,BB,1.5,14,14,3647,10,2018,13,-3
Group 1,BB,1.5,14,14,3648,13,2018,10,3
Group 1,BB,1.5,14,14,3649,11,2018,8,3
Group 1,BB,1.5,14,14,3650,10,2018,13,-3
Group 1,BB,1.5,14,14,3651,5,2018,12,-7
Group 1,BB,1.5,14,14,3652,10,2018,11,-1
Group 1,BB,1.5,14,14,3653,12,2018,10,2
Group 1,BB,1.5,14,14,3654,10,2018,10,0
Group 1,BB,1.5,14,14,3655,13,2018,10,3
Group 1,BB,1.5,14,14,3656,7,2018,12,-5
Group 1,BB,1.5,14,14,3657,11,2018,12,-1
Group 1,BB,1.5,14,14,3658,10,2018,11,-1
Group 1,BB,1.5,14,14,3659,13,2018,9,4
Group 1,BB,1.5,14,14,3660,11,2018,12,-1
Group 1,BB,1.5,14,14,3661,12,2018,9,3
Group 1,BB,1.5,14,14,3662,13,2018,12,1
Group 1,BB,1.5,14,14,3663,10,2018,9,1
Group 1,BB,1.5,14,14,3664,10,2018,12,-2
Group 1,BB,1.5,14,14,3665,12,2018,12,0
Group 1,BB,1.5,14,14,3666,11,2018,13,-2
Group 1,BB,1.5,14,14,3667,10,2018,10,0
Group 1,BB,1.5,14,14,3668,8,2018,9,-1
Group 1,BB,1.5,14,14,3669,12,2018,12,0
Group 1,BB,1.5,14,14,3670,9,2018,10,-1
Group 1,BB,1.5,14,14,3671,7,2018,9,-2
Group 1,BB,1.5,14,14,3672,10,2018,10,0
Group 1,BB,1.5,14,14,3673,12,2018,12,0
Group 1,BB,1.5,14,14,3674,13,2018,13,0
Group 1,BB,1.5,14,14,3675,13,2018,8,5
Group 1,BB,1.5,14,14,3676,10,2018,13,-3
Group 1,BB,1.5,14,14,3677,12,2018,12,0
Group 1,BB,1.5,14,14,3678,9,2018,9,0
Group 1,BB,1.5,14,14,3679,11,2018,9,2
Group 1,BB,1.5,14,14,3680,10,2018,10,0
Group 1,BB,1.5,14,14,3681,11,2018,10,1
Group 1,BB,1.5,14,14,3682,10,2018,12,-2
Group 1,BB,1.5,14,14,3683,9,2018,8,1
Group 1,BB,1.5,14,14,3684,10,2018,7,3
Group 1,BB,1.5,14,14,3685,11,2018,13,-2
Group 1,BB,1.5,14,14,3686,10,2018,9,1
Group 1,BB,1.5,14,14,3687,10,2018,7,3
Group 1,BB,1.5,14,14,3688,11,2018,8,3
Group 1,BB,1.5,14,14,3689,10,2018,9,1
Group 1,BB,1.5,14,14,3690,3,2018,8,-5
Group 1,BB,1.5,14,14,3691,10,2018,8,2
Group 1,BB,1.5,14,14,3692,9,2018,13,-4
Group 1,BB,1.5,14,14,3693,13,2018,12,1
Group 1,BB,1.5,14,14,3694,10,2018,8,2
Group 1,BB,1.5,14,14,3695,10,2018,9,1
Group 1,BB,1.5,14,14,3696,10,2018,11,-1
Group 1,BB,1.5,14,14,3697,14,2018,7,7
Group 1,BB,1.5,14,14,3698,9,2018,12,-3
Group 1,BB,1.5,14,14,3699,12,2018,9,3
Group 1,BB,1.5,14,14,3700,12,2018,7,5
Group 1,BB,1.5,14,14,3701,13,2018,13,0
Group 1,BB,1.5,14,14,3702,11,2018,7,4
Group 1,BB,1.5,14,14,3703,12,2018,11,1
Group 1,BB,1.5,14,14,3704,10,2018,9,1
Group 1,BB,1.5,14,14,3705,11,2018,10,1
Group 1,BB,1.5,14,14,3706,11,2018,10,1
Group 1,BB,1.5,14,14,3707,12,2018,11,1
Group 1,BB,1.5,14,14,3708,14,2018,12,2
Group 1,BB,1.5,14,14,3709,11,2018,9,2
Group 1,BB,1.5,14,14,3710,10,2018,9,1
Group 1,BB,1.5,14,14,3711,12,2018,9,3
Group 1,BB,1.5,14,14,3712,9,2018,11,-2
Group 1,BB,1.5,14,14,3713,10,2018,11,-1
Group 1,BB,1.5,14,14,3714,10,2018,10,0
Group 1,BB,1.5,14,14,3715,10,2018,12,-2
Group 1,BB,1.5,14,14,3716,11,2018,12,-1
Group 1,BB,1.5,14,14,3717,12,2018,11,1
Group 1,BB,1.5,14,14,3718,13,2018,11,2
Group 1,BB,1.5,14,14,3719,12,2018,10,2
Group 1,BB,1.5,14,14,3720,12,2018,9,3
Group 1,BB,1.5,14,14,3721,14,2018,7,7
Group 1,BB,1.5,14,14,3722,10,2018,12,-2
Group 1,BB,1.5,14,14,3723,13,2018,9,4
Group 1,BB,1.5,14,14,3724,10,2018,12,-2
Group 1,BB,1.5,14,14,3725,12,2018,6,6
Group 1,BB,1.5,14,14,3726,13,2018,12,1
Group 1,BB,1.5,14,14,3727,13,2018,12,1
Group 1,BB,1.5,14,14,3728,12,2018,10,2
Group 1,BB,1.5,14,14,3729,13,2018,9,4
Group 1,BB,1.5,14,14,3730,11,2018,7,4
Group 1,BB,1.5,14,14,3731,7,2018,6,1
Group 1,BB,1.5,14,14,3732,13,2018,7,6
Group 1,BB,1.5,14,14,3733,11,2018,11,0
Group 1,BB,1.5,14,14,3734,8,2018,13,-5
Group 1,BB,1.5,14,14,3735,8,2018,13,-5
Group 1,BB,1.5,14,14,3736,12,2018,7,5
Group 1,BB,1.5,14,14,3737,12,2018,12,0
Group 1,BB,1.5,14,14,3738,8,2018,5,3
Group 1,BB,1.5,14,14,3739,9,2018,9,0
Group 1,BB,1.5,14,14,3740,10,2018,12,-2
Group 1,BB,1.5,14,14,3741,10,2018,10,0
Group 1,BB,1.5,14,14,3742,13,2018,13,0
Group 1,BB,1.5,14,14,3743,12,2018,10,2
Group 1,BB,1.5,14,14,3744,11,2018,9,2
Group 1,BB,1.5,14,14,3745,6,2018,8,-2
Group 1,BB,1.5,14,14,3746,12,2018,11,1
Group 1,BB,1.5,14,14,3747,7,2018,11,-4
Group 1,BB,1.5,14,14,3748,11,2018,6,5
Group 1,BB,1.5,14,14,3749,11,2018,10,1
Group 1,BB,1.5,14,14,3750,11,2018,12,-1
Group 1,BB,1.5,14,14,3751,11,2018,11,0
Group 1,BB,1.5,14,14,3752,11,2018,12,-1
Group 1,BB,1.5,14,14,3753,9,2018,14,-5
Group 1,BB,1.5,14,14,3754,10,2018,10,0
Group 1,BB,1.5,14,14,3755,11,2018,11,0
Group 1,BB,1.5,14,14,3756,9,2018,8,1
Group 1,BB,1.5,14,14,3757,10,2018,9,1
Group 1,BB,1.5,14,14,3758,11,2018,11,0
Group 1,BB,1.5,14,14,3759,12,2018,6,6
Group 1,BB,1.5,14,14,3760,9,2018,7,2
Group 1,BB,1.5,14,14,3761,14,2018,12,2
Group 1,BB,1.5,14,14,3762,9,2018,6,3
Group 1,BB,1.5,14,14,3763,11,2018,12,-1
Group 1,BB,1.5,14,14,3764,11,2018,12,-1
Group 1,BB,1.5,14,14,3765,10,2018,12,-2
Group 1,BB,1.5,14,14,3766,12,2018,11,1
Group 1,BB,1.5,14,14,3767,10,2018,12,-2
Group 1,BB,1.5,14,14,3768,12,2018,13,-1
Group 1,BB,1.5,14,14,3769,11,2018,11,0
Group 1,BB,1.5,14,14,3770,12,2018,12,0
Group 1,BB,1.5,14,14,3771,12,2018,13,-1
Group 1,BB,1.5,14,14,3772,14,2018,10,4
Group 1,BB,1.5,14,14,3773,9,2018,10,-1
Group 1,BB,1.5,14,14,3774,9,2018,11,-2
Group 1,BB,1.5,14,14,3775,8,2018,8,0
Group 1,BB,1.5,14,14,3776,10,2018,11,-1
Group 1,BB,1.5,14,14,3777,9,2018,13,-4
Group 1,BB,1.5,14,14,3778,11,2018,6,5
Group 1,BB,1.5,14,14,3779,13,2018,9,4
Group 1,BB,1.5,14,14,3780,11,2018,10,1
Group 1,BB,1.5,14,14,3781,7,2018,10,-3
Group 1,BB,1.5,14,14,3782,11,2018,10,1
Group 1,BB,1.5,14,14,3783,13,2018,7,6
Group 1,BB,1.5,14,14,3784,13,2018,12,1
Group 1,BB,1.5,14,14,3785,12,2018,9,3
Group 1,BB,1.5,14,14,3786,11,2018,11,0
Group 1,BB,1.5,14,14,3787,10,2018,10,0
Group 1,BB,1.5,14,14,3788,9,2018,9,0
Group 1,BB,1.5,14,14,3789,13,2018,10,3
Group 1,BB,1.5,14,14,3790,11,2018,11,0
Group 1,BB,1.5,14,14,3791,11,2018,10,1
Group 1,BB,1.5,14,14,3792,12,2018,12,0
Group 1,BB,1.5,14,14,3793,11,2018,11,0
Group 1,BB,1.5,14,14,3794,11,2018,8,3
Group 1,BB,1.5,14,14,3795,7,2018,10,-3
Group 1,BB,1.5,14,14,3796,12,2018,10,2
Group 1,BB,1.5,14,14,3797,12,2018,9,3
Group 1,BB,1.5,14,14,3798,11,2018,12,-1
Group 1,BB,1.5,14,14,3799,9,2018,9,0
Group 1,BB,1.5,14,14,3800,13,2018,14,-1
Group 1,BB,1.5,14,14,3801,13,2018,8,5
Group 1,BB,1.5,14,14,3802,11,2018,11,0
Group 1,BB,1.5,14,14,3803,8,2018,11,-3
Group 1,BB,1.5,14,14,3804,8,2018,7,1
Group 1,BB,1.5,14,14,3805,9,2018,8,1
Group 1,BB,1.5,14,14,3806,11,2018,11,0
Group 1,BB,1.5,14,14,3807,8,2018,10,-2
Group 1,BB,1.5,14,14,3808,10,2018,10,0
Group 1,BB,1.5,14,14,3809,14,2018,11,3
Group 1,BB,1.5,14,14,3810,9,2018,11,-2
Group 1,BB,1.5,14,14,3811,12,2018,11,1
Group 1,BB,1.5,14,14,3812,8,2018,10,-2
Group 1,BB,1.5,14,14,3813,8,2018,12,-4
Group 1,BB,1.5,14,14,3814,10,2018,9,1
Group 1,BB,1.5,14,14,3815,10,2018,9,1
Group 1,BB,1.5,14,14,3816,11,2018,10,1
Group 1,BB,1.5,14,14,3817,11,2018,12,-1
Group 1,BB,1.5,14,14,3818,12,2018,12,0
Group 1,BB,1.5,14,14,3819,9,2018,10,-1
Group 1,BB,1.5,14,14,3820,8,2018,9,-1
Group 1,BB,1.5,14,14,3821,11,2018,11,0
Group 1,BB,1.5,14,14,3822,9,2018,11,-2
Group 1,BB,1.5,14,14,3823,9,2018,11,-2
Group 1,BB,1.5,14,14,3824,12,2018,10,2
Group 1,BB,1.5,14,14,3825,10,2018,12,-2
Group 1,BB,1.5,14,14,3826,10,2018,14,-4
Group 1,BB,1.5,14,14,3827,9,2018,7,2
Group 1,BB,1.5,14,14,3828,8,2018,6,2
Group 1,BB,1.5,14,14,3829,11,2018,6,5
Group 1,BB,1.5,14,14,3830,11,2018,12,-1
Group 1,BB,1.5,14,14,3831,11,2018,12,-1
Group 1,BB,1.5,14,14,3832,9,2018,9,0
Group 1,BB,1.5,14,14,3833,6,2018,11,-5
Group 1,BB,1.5,14,14,3834,8,2018,10,-2
Group 1,BB,1.5,14,14,3835,9,2018,11,-2
Group 1,BB,1.5,14,14,3836,11,2018,10,1
Group 1,BB,1.5,14,14,3837,11,2018,8,3
Group 1,BB,1.5,14,14,3838,13,2018,12,1
Group 1,BB,1.5,14,14,3839,11,2018,11,0
Group 1,BB,1.5,14,14,3840,11,2018,11,0
Group 1,BB,1.5,14,14,3841,11,2018,8,3
Group 1,BB,1.5,14,14,3842,11,2018,10,1
Group 1,BB,1.5,14,14,3843,9,2018,12,-3
Group 1,BB,1.5,14,14,3844,12,2018,13,-1
Group 1,BB,1.5,14,14,3845,10,2018,11,-1
Group 1,BB,1.5,14,14,3846,12,2018,10,2
Group 1,BB,1.5,14,14,3847,13,2018,9,4
Group 1,BB,1.5,14,14,3848,10,2018,9,1
Group 1,BB,1.5,14,14,3849,13,2018,8,5
Group 1,BB,1.5,14,14,3850,10,2018,10,0
Group 1,BB,1.5,14,14,3851,9,2018,7,2
Group 1,BB,1.5,14,14,3852,9,2018,10,-1
Group 1,BB,1.5,14,14,3853,10,2018,9,1
Group 1,BB,1.5,14,14,3854,9,2018,11,-2
Group 1,BB,1.5,14,14,3855,11,2018,9,2
Group 1,BB,1.5,14,14,3856,13,2018,11,2
Group 1,BB,1.5,14,14,3857,14,2018,8,6
Group 1,BB,1.5,14,14,3858,14,2018,12,2
Group 1,BB,1.5,14,14,3859,7,2018,11,-4
Group 1,BB,1.5,14,14,3860,10,2018,9,1
Group 1,BB,1.5,14,14,3861,12,2018,11,1
Group 1,BB,1.5,14,14,3862,12,2018,13,-1
Group 1,BB,1.5,14,14,3863,10,2018,13,-3
Group 1,BB,1.5,14,14,3864,13,2018,11,2
Group 1,BB,1.5,14,14,3865,8,2018,9,-1
Group 1,BB,1.5,14,14,3866,12,2018,10,2
Group 1,BB,1.5,14,14,3867,12,2018,10,2
Group 1,BB,1.5,14,14,3868,11,2018,12,-1
Group 1,BB,1.5,14,14,3869,12,2018,12,0
Group 1,BB,1.5,14,14,3870,12,2018,8,4
Group 1,BB,1.5,14,14,3871,12,2018,10,2
Group 1,BB,1.5,14,14,3872,12,2018,11,1
Group 1,BB,1.5,14,14,3873,13,2018,14,-1
Group 1,BB,1.5,14,14,3874,10,2018,10,0
Group 1,BB,1.5,14,14,3875,10,2018,9,1
Group 1,BB,1.5,14,14,3876,11,2018,12,-1
Group 1,BB,1.5,14,14,3877,10,2018,11,-1
Group 1,BB,1.5,14,14,3878,7,2018,13,-6
Group 1,BB,1.5,14,14,3879,11,2018,13,-2
Group 1,BB,1.5,14,14,3880,9,2018,9,0
Group 1,BB,1.5,14,14,3881,9,2018,9,0
Group 1,BB,1.5,14,14,3882,9,2018,10,-1
Group 1,BB,1.5,14,14,3883,11,2018,8,3
Group 1,BB,1.5,14,14,3884,9,2018,10,-1
Group 1,BB,1.5,14,14,3885,10,2018,10,0
Group 1,BB,1.5,14,14,3886,12,2018,11,1
Group 1,BB,1.5,14,14,3887,12,2018,10,2
Group 1,BB,1.5,14,14,3888,11,2018,12,-1
Group 1,BB,1.5,14,14,3889,10,2018,10,0
Group 1,BB,1.5,14,14,3890,10,2018,9,1
Group 1,BB,1.5,14,14,3891,9,2018,12,-3
Group 1,BB,1.5,14,14,3892,11,2018,10,1
Group 1,BB,1.5,14,14,3893,9,2018,10,-1
Group 1,BB,1.5,14,14,3894,11,2018,10,1
Group 1,BB,1.5,14,14,3895,9,2018,11,-2
Group 1,BB,1.5,14,14,3896,11,2018,8,3
Group 1,BB,1.5,14,14,3897,11,2018,10,1
Group 1,BB,1.5,14,14,3898,13,2018,12,1
Group 1,BB,1.5,14,14,3899,9,2018,11,-2
Group 1,BB,1.5,14,14,3900,13,2018,5,8
Group 1,BB,1.5,14,14,3901,9,2018,11,-2
Group 1,BB,1.5,14,14,3902,9,2018,12,-3
Group 1,BB,1.5,14,14,3903,10,2018,10,0
Group 1,BB,1.5,14,14,3904,9,2018,10,-1
Group 1,BB,1.5,14,14,3905,6,2018,9,-3
Group 1,BB,1.5,14,14,3906,9,2018,11,-2
Group 1,BB,1.5,14,14,3907,11,2018,11,0
Group 1,BB,1.5,14,14,3908,12,2018,11,1
Group 1,BB,1.5,14,14,3909,10,2018,12,-2
Group 1,BB,1.5,14,14,3910,8,2018,8,0
Group 1,BB,1.5,14,14,3911,12,2018,10,2
Group 1,BB,1.5,14,14,3912,10,2018,10,0
Group 1,BB,1.5,14,14,3913,11,2018,11,0
Group 1,BB,1.5,14,14,3914,13,2018,10,3
Group 1,BB,1.5,14,14,3915,10,2018,5,5
Group 1,BB,1.5,14,14,3916,10,2018,10,0
Group 1,BB,1.5,14,14,3917,12,2018,13,-1
Group 1,BB,1.5,14,14,3918,13,2018,8,5
Group 1,BB,1.5,14,14,3919,12,2018,11,1
Group 1,BB,1.5,14,14,3920,10,2018,5,5
Group 1,BB,1.5,14,14,3921,11,2018,7,4
Group 1,BB,1.5,14,14,3922,12,2018,11,1
Group 1,BB,1.5,14,14,3923,9,2018,9,0
Group 1,BB,1.5,14,14,3924,12,2018,8,4
Group 1,BB,1.5,14,14,3925,11,2018,8,3
Group 1,BB,1.5,14,14,3926,12,2018,10,2
Group 1,BB,1.5,14,14,3927,10,2018,12,-2
Group 1,BB,1.5,14,14,3928,12,2018,10,2
Group 1,BB,1.5,14,14,3929,9,2018,12,-3
Group 1,BB,1.5,14,14,3930,9,2018,12,-3
Group 1,BB,1.5,14,14,3931,11,2018,7,4
Group 1,BB,1.5,14,14,3932,10,2018,9,1
Group 1,BB,1.5,14,14,3933,11,2018,11,0
Group 1,BB,1.5,14,14,3934,8,2018,9,-1
Group 1,BB,1.5,14,14,3935,8,2018,12,-4
Group 1,BB,1.5,14,14,3936,9,2018,10,-1
Group 1,BB,1.5,14,14,3937,11,2018,8,3
Group 1,BB,1.5,14,14,3938,11,2018,11,0
Group 1,BB,1.5,14,14,3939,10,2018,8,2
Group 1,BB,1.5,14,14,3940,13,2018,9,4
Group 1,BB,1.5,14,14,3941,9,2018,10,-1
Group 1,BB,1.5,14,14,3942,8,2018,10,-2
Group 1,BB,1.5,14,14,3943,12,2018,8,4
Group 1,BB,1.5,14,14,3944,10,2018,8,2
Group 1,BB,1.5,14,14,3945,9,2018,6,3
Group 1,BB,1.5,14,14,3946,11,2018,9,2
Group 1,BB,1.5,14,14,3947,12,2018,7,5
Group 1,BB,1.5,14,14,3948,11,2018,7,4
Group 1,BB,1.5,14,14,3949,13,2018,9,4
Group 1,BB,1.5,14,14,3950,14,2018,11,3
Group 1,BB,1.5,14,14,3951,12,2018,7,5
Group 1,BB,1.5,14,14,3952,6,2018,11,-5
Group 1,BB,1.5,14,14,3953,9,2018,10,-1
Group 1,BB,1.5,14,14,3954,10,2018,10,0
Group 1,BB,1.5,14,14,3955,8,2018,12,-4
Group 1,BB,1.5,14,14,3956,12,2018,12,0
Group 1,BB,1.5,14,14,3957,11,2018,11,0
Group 1,BB,1.5,14,14,3958,11,2018,7,4
Group 1,BB,1.5,14,14,3959,10,2018,5,5
Group 1,BB,1.5,14,14,3960,9,2018,5,4
Group 1,BB,1.5,14,14,3961,13,2018,7,6
Group 1,BB,1.5,14,14,3962,12,2018,14,-2
Group 1,BB,1.5,14,14,3963,12,2018,11,1
Group 1,BB,1.5,14,14,3964,10,2018,6,4
Group 1,BB,1.5,14,14,3965,12,2018,7,5
Group 1,BB,1.5,14,14,3966,12,2018,5,7
Group 1,BB,1.5,14,14,3967,9,2018,11,-2
Group 1,BB,1.5,14,14,3968,11,2018,11,0
Group 1,BB,1.5,14,14,3969,14,2018,7,7
Group 1,BB,1.5,14,14,3970,13,2018,11,2
Group 1,BB,1.5,14,14,3971,12,2018,12,0
Group 1,BB,1.5,14,14,3972,11,2018,10,1
Group 1,BB,1.5,14,14,3973,11,2018,12,-1
Group 1,BB,1.5,14,14,3974,12,2018,10,2
Group 1,BB,1.5,14,14,3975,11,2018,13,-2
Group 1,BB,1.5,14,14,3976,12,2018,10,2
Group 1,BB,1.5,14,14,3977,12,2018,10,2
Group 1,BB,1.5,14,14,3978,12,2018,12,0
Group 1,BB,1.5,14,14,3979,13,2018,10,3
Group 1,BB,1.5,14,14,3980,10,2018,11,-1
Group 1,BB,1.5,14,14,3981,9,2018,12,-3
Group 1,BB,1.5,14,14,3982,11,2018,10,1
Group 1,BB,1.5,14,14,3983,9,2018,11,-2
Group 1,BB,1.5,14,14,3984,10,2018,10,0
Group 1,BB,1.5,14,14,3985,10,2018,12,-2
Group 1,BB,1.5,14,14,3986,10,2018,11,-1
Group 1,BB,1.5,14,14,3987,9,2018,7,2
Group 1,BB,1.5,14,14,3988,12,2018,11,1
Group 1,BB,1.5,14,14,3989,13,2018,11,2
Group 1,BB,1.5,14,14,3990,13,2018,11,2
Group 1,BB,1.5,14,14,3991,8,2018,11,-3
Group 1,BB,1.5,14,14,3992,9,2018,11,-2
Group 1,BB,1.5,14,14,3993,11,2018,13,-2
Group 1,BB,1.5,14,14,3994,13,2018,13,0
Group 1,BB,1.5,14,14,3995,12,2018,11,1
Group 1,BB,1.5,14,14,3996,11,2018,11,0
Group 1,BB,1.5,14,14,3997,7,2018,12,-5
Group 1,BB,1.5,14,14,3998,12,2018,14,-2
Group 1,BB,1.5,14,14,3999,13,2018,10,3
Group 1,BB,1.5,14,14,4000,13,2018,9,4
Group 3,BB,1.5,15,14,1,10,2018,11,-1
Group 3,BB,1.5,15,14,2,11,2018,8,3
Group 3,BB,1.5,15,14,3,11,2018,12,-1
Group 3,BB,1.5,15,14,4,12,2018,11,1
Group 3,BB,1.5,15,14,5,13,2018,13,0
Group 3,BB,1.5,15,14,6,10,2018,12,-2
Group 3,BB,1.5,15,14,7,12,2018,8,4
Group 3,BB,1.5,15,14,8,12,2018,12,0
Group 3,BB,1.5,15,14,9,12,2018,10,2
Group 3,BB,1.5,15,14,10,8,2018,11,-3
Group 3,BB,1.5,15,14,11,10,2018,12,-2
Group 3,BB,1.5,15,14,12,11,2018,12,-1
Group 3,BB,1.5,15,14,13,11,2018,11,0
Group 3,BB,1.5,15,14,14,11,2018,9,2
Group 3,BB,1.5,15,14,15,11,2018,8,3
Group 3,BB,1.5,15,14,16,14,2018,9,5
Group 3,BB,1.5,15,14,17,14,2018,9,5
Group 3,BB,1.5,15,14,18,14,2018,12,2
Group 3,BB,1.5,15,14,19,8,2018,11,-3
Group 3,BB,1.5,15,14,20,8,2018,9,-1
Group 3,BB,1.5,15,14,21,12,2018,11,1
Group 3,BB,1.5,15,14,22,10,2018,8,2
Group 3,BB,1.5,15,14,23,9,2018,9,0
Group 3,BB,1.5,15,14,24,9,2018,11,-2
Group 3,BB,1.5,15,14,25,6,2018,12,-6
Group 3,BB,1.5,15,14,26,6,2018,11,-5
Group 3,BB,1.5,15,14,27,12,2018,10,2
Group 3,BB,1.5,15,14,28,9,2018,10,-1
Group 3,BB,1.5,15,14,29,8,2018,10,-2
Group 3,BB,1.5,15,14,30,10,2018,8,2
Group 3,BB,1.5,15,14,31,12,2018,8,4
Group 3,BB,1.5,15,14,32,11,2018,11,0
Group 3,BB,1.5,15,14,33,11,2018,12,-1
Group 3,BB,1.5,15,14,34,13,2018,10,3
Group 3,BB,1.5,15,14,35,14,2018,9,5
Group 3,BB,1.5,15,14,36,12,2018,11,1
Group 3,BB,1.5,15,14,37,10,2018,10,0
Group 3,BB,1.5,15,14,38,10,2018,8,2
Group 3,BB,1.5,15,14,39,13,2018,11,2
Group 3,BB,1.5,15,14,40,9,2018,8,1
Group 3,BB,1.5,15,14,41,8,2018,11,-3
Group 3,BB,1.5,15,14,42,8,2018,9,-1
Group 3,BB,1.5,15,14,43,9,2018,12,-3
Group 3,BB,1.5,15,14,44,13,2018,11,2
Group 3,BB,1.5,15,14,45,13,2018,12,1
Group 3,BB,1.5,15,14,46,6,2018,9,-3
Group 3,BB,1.5,15,14,47,13,2018,10,3
Group 3,BB,1.5,15,14,48,8,2018,8,0
Group 3,BB,1.5,15,14,49,10,2018,11,-1
Group 3,BB,1.5,15,14,50,10,2018,10,0
Group 3,BB,1.5,15,14,51,10,2018,11,-1
Group 3,BB,1.5,15,14,52,12,2018,9,3
Group 3,BB,1.5,15,14,53,9,2018,10,-1
Group 3,BB,1.5,15,14,54,14,2018,9,5
Group 3,BB,1.5,15,14,55,10,2018,8,2
Group 3,BB,1.5,15,14,56,13,2018,7,6
Group 3,BB,1.5,15,14,57,13,2018,13,0
Group 3,BB,1.5,15,14,58,9,2018,10,-1
Group 3,BB,1.5,15,14,59,9,2018,14,-5
Group 3,BB,1.5,15,14,60,10,2018,10,0
Group 3,BB,1.5,15,14,61,14,2018,10,4
Group 3,BB,1.5,15,14,62,13,2018,12,1
Group 3,BB,1.5,15,14,63,14,2018,10,4
Group 3,BB,1.5,15,14,64,12,2018,7,5
Group 3,BB,1.5,15,14,65,8,2018,7,1
Group 3,BB,1.5,15,14,66,8,2018,13,-5
Group 3,BB,1.5,15,14,67,12,2018,8,4
Group 3,BB,1.5,15,14,68,10,2018,6,4
Group 3,BB,1.5,15,14,69,12,2018,10,2
Group 3,BB,1.5,15,14,70,12,2018,12,0
Group 3,BB,1.5,15,14,71,12,2018,13,-1
Group 3,BB,1.5,15,14,72,12,2018,6,6
Group 3,BB,1.5,15,14,73,13,2018,10,3
Group 3,BB,1.5,15,14,74,13,2018,8,5
Group 3,BB,1.5,15,14,75,8,2018,11,-3
Group 3,BB,1.5,15,14,76,11,2018,11,0
Group 3,BB,1.5,15,14,77,6,2018,12,-6
Group 3,BB,1.5,15,14,78,9,2018,10,-1
Group 3,BB,1.5,15,14,79,9,2018,10,-1
Group 3,BB,1.5,15,14,80,6,2018,9,-3
Group 3,BB,1.5,15,14,81,5,2018,10,-5
Group 3,BB,1.5,15,14,82,11,2018,10,1
Group 3,BB,1.5,15,14,83,10,2018,8,2
Group 3,BB,1.5,15,14,84,11,2018,10,1
Group 3,BB,1.5,15,14,85,10,2018,10,0
Group 3,BB,1.5,15,14,86,11,2018,8,3
Group 3,BB,1.5,15,14,87,11,2018,10,1
Group 3,BB,1.5,15,14,88,11,2018,11,0
Group 3,BB,1.5,15,14,89,11,2018,11,0
Group 3,BB,1.5,15,14,90,13,2018,8,5
Group 3,BB,1.5,15,14,91,14,2018,8,6
Group 3,BB,1.5,15,14,92,12,2018,9,3
Group 3,BB,1.5,15,14,93,10,2018,11,-1
Group 3,BB,1.5,15,14,94,13,2018,9,4
Group 3,BB,1.5,15,14,95,12,2018,9,3
Group 3,BB,1.5,15,14,96,10,2018,11,-1
Group 3,BB,1.5,15,14,97,11,2018,12,-1
Group 3,BB,1.5,15,14,98,12,2018,11,1
Group 3,BB,1.5,15,14,99,10,2018,8,2
Group 3,BB,1.5,15,14,100,8,2018,14,-6
Group 3,BB,1.5,15,14,101,10,2018,13,-3
Group 3,BB,1.5,15,14,102,13,2018,8,5
Group 3,BB,1.5,15,14,103,10,2018,8,2
Group 3,BB,1.5,15,14,104,11,2018,13,-2
Group 3,BB,1.5,15,14,105,11,2018,6,5
Group 3,BB,1.5,15,14,106,10,2018,10,0
Group 3,BB,1.5,15,14,107,9,2018,7,2
Group 3,BB,1.5,15,14,108,11,2018,12,-1
Group 3,BB,1.5,15,14,109,9,2018,11,-2
Group 3,BB,1.5,15,14,110,13,2018,9,4
Group 3,BB,1.5,15,14,111,8,2018,9,-1
Group 3,BB,1.5,15,14,112,12,2018,13,-1
Group 3,BB,1.5,15,14,113,10,2018,10,0
Group 3,BB,1.5,15,14,114,11,2018,10,1
Group 3,BB,1.5,15,14,115,10,2018,12,-2
Group 3,BB,1.5,15,14,116,9,2018,9,0
Group 3,BB,1.5,15,14,117,12,2018,9,3
Group 3,BB,1.5,15,14,118,8,2018,9,-1
Group 3,BB,1.5,15,14,119,11,2018,11,0
Group 3,BB,1.5,15,14,120,9,2018,11,-2
Group 3,BB,1.5,15,14,121,6,2018,11,-5
Group 3,BB,1.5,15,14,122,13,2018,7,6
Group 3,BB,1.5,15,14,123,13,2018,8,5
Group 3,BB,1.5,15,14,124,10,2018,10,0
Group 3,BB,1.5,15,14,125,10,2018,12,-2
Group 3,BB,1.5,15,14,126,9,2018,11,-2
Group 3,BB,1.5,15,14,127,12,2018,12,0
Group 3,BB,1.5,15,14,128,11,2018,10,1
Group 3,BB,1.5,15,14,129,9,2018,14,-5
Group 3,BB,1.5,15,14,130,11,2018,14,-3
Group 3,BB,1.5,15,14,131,11,2018,8,3
Group 3,BB,1.5,15,14,132,12,2018,12,0
Group 3,BB,1.5,15,14,133,8,2018,9,-1
Group 3,BB,1.5,15,14,134,9,2018,11,-2
Group 3,BB,1.5,15,14,135,10,2018,10,0
Group 3,BB,1.5,15,14,136,11,2018,9,2
Group 3,BB,1.5,15,14,137,10,2018,5,5
Group 3,BB,1.5,15,14,138,10,2018,9,1
Group 3,BB,1.5,15,14,139,9,2018,11,-2
Group 3,BB,1.5,15,14,140,14,2018,7,7
Group 3,BB,1.5,15,14,141,12,2018,11,1
Group 3,BB,1.5,15,14,142,8,2018,10,-2
Group 3,BB,1.5,15,14,143,11,2018,8,3
Group 3,BB,1.5,15,14,144,11,2018,10,1
Group 3,BB,1.5,15,14,145,10,2018,12,-2
Group 3,BB,1.5,15,14,146,10,2018,10,0
Group 3,BB,1.5,15,14,147,12,2018,11,1
Group 3,BB,1.5,15,14,148,9,2018,11,-2
Group 3,BB,1.5,15,14,149,10,2018,9,1
Group 3,BB,1.5,15,14,150,11,2018,14,-3
Group 3,BB,1.5,15,14,151,8,2018,11,-3
Group 3,BB,1.5,15,14,152,11,2018,10,1
Group 3,BB,1.5,15,14,153,11,2018,11,0
Group 3,BB,1.5,15,14,154,8,2018,13,-5
Group 3,BB,1.5,15,14,155,8,2018,7,1
Group 3,BB,1.5,15,14,156,14,2018,13,1
Group 3,BB,1.5,15,14,157,9,2018,8,1
Group 3,BB,1.5,15,14,158,12,2018,8,4
Group 3,BB,1.5,15,14,159,8,2018,10,-2
Group 3,BB,1.5,15,14,160,10,2018,10,0
Group 3,BB,1.5,15,14,161,14,2018,10,4
Group 3,BB,1.5,15,14,162,6,2018,12,-6
Group 3,BB,1.5,15,14,163,8,2018,11,-3
Group 3,BB,1.5,15,14,164,8,2018,10,-2
Group 3,BB,1.5,15,14,165,8,2018,9,-1
Group 3,BB,1.5,15,14,166,10,2018,10,0
Group 3,BB,1.5,15,14,167,12,2018,8,4
Group 3,BB,1.5,15,14,168,12,2018,11,1
Group 3,BB,1.5,15,14,169,10,2018,9,1
Group 3,BB,1.5,15,14,170,11,2018,13,-2
Group 3,BB,1.5,15,14,171,13,2018,11,2
Group 3,BB,1.5,15,14,172,11,2018,11,0
Group 3,BB,1.5,15,14,173,8,2018,9,-1
Group 3,BB,1.5,15,14,174,9,2018,9,0
Group 3,BB,1.5,15,14,175,10,2018,11,-1
Group 3,BB,1.5,15,14,176,11,2018,12,-1
Group 3,BB,1.5,15,14,177,12,2018,12,0
Group 3,BB,1.5,15,14,178,12,2018,12,0
Group 3,BB,1.5,15,14,179,13,2018,9,4
Group 3,BB,1.5,15,14,180,10,2018,9,1
Group 3,BB,1.5,15,14,181,9,2018,11,-2
Group 3,BB,1.5,15,14,182,11,2018,10,1
Group 3,BB,1.5,15,14,183,9,2018,9,0
Group 3,BB,1.5,15,14,184,5,2018,12,-7
Group 3,BB,1.5,15,14,185,12,2018,11,1
Group 3,BB,1.5,15,14,186,11,2018,9,2
Group 3,BB,1.5,15,14,187,8,2018,10,-2
Group 3,BB,1.5,15,14,188,9,2018,11,-2
Group 3,BB,1.5,15,14,189,10,2018,9,1
Group 3,BB,1.5,15,14,190,11,2018,8,3
Group 3,BB,1.5,15,14,191,10,2018,10,0
Group 3,BB,1.5,15,14,192,13,2018,7,6
Group 3,BB,1.5,15,14,193,7,2018,12,-5
Group 3,BB,1.5,15,14,194,13,2018,11,2
Group 3,BB,1.5,15,14,195,8,2018,11,-3
Group 3,BB,1.5,15,14,196,9,2018,10,-1
Group 3,BB,1.5,15,14,197,13,2018,8,5
Group 3,BB,1.5,15,14,198,10,2018,8,2
Group 3,BB,1.5,15,14,199,8,2018,5,3
Group 3,BB,1.5,15,14,200,10,2018,7,3
Group 3,BB,1.5,15,14,201,8,2018,10,-2
Group 3,BB,1.5,15,14,202,7,2018,12,-5
Group 3,BB,1.5,15,14,203,12,2018,10,2
Group 3,BB,1.5,15,14,204,10,2018,5,5
Group 3,BB,1.5,15,14,205,9,2018,10,-1
Group 3,BB,1.5,15,14,206,9,2018,10,-1
Group 3,BB,1.5,15,14,207,11,2018,9,2
Group 3,BB,1.5,15,14,208,10,2018,8,2
Group 3,BB,1.5,15,14,209,12,2018,11,1
Group 3,BB,1.5,15,14,210,10,2018,11,-1
Group 3,BB,1.5,15,14,211,11,2018,12,-1
Group 3,BB,1.5,15,14,212,11,2018,12,-1
Group 3,BB,1.5,15,14,213,9,2018,7,2
Group 3,BB,1.5,15,14,214,10,2018,11,-1
Group 3,BB,1.5,15,14,215,9,2018,9,0
Group 3,BB,1.5,15,14,216,13,2018,3,10
Group 3,BB,1.5,15,14,217,9,2018,10,-1
Group 3,BB,1.5,15,14,218,12,2018,9,3
Group 3,BB,1.5,15,14,219,13,2018,10,3
Group 3,BB,1.5,15,14,220,11,2018,9,2
Group 3,BB,1.5,15,14,221,12,2018,7,5
Group 3,BB,1.5,15,14,222,13,2018,11,2
Group 3,BB,1.5,15,14,223,12,2018,11,1
Group 3,BB,1.5,15,14,224,9,2018,11,-2
Group 3,BB,1.5,15,14,225,9,2018,8,1
Group 3,BB,1.5,15,14,226,11,2018,10,1
Group 3,BB,1.5,15,14,227,10,2018,9,1
Group 3,BB,1.5,15,14,228,12,2018,9,3
Group 3,BB,1.5,15,14,229,7,2018,8,-1
Group 3,BB,1.5,15,14,230,8,2018,9,-1
Group 3,BB,1.5,15,14,231,6,2018,13,-7
Group 3,BB,1.5,15,14,232,12,2018,13,-1
Group 3,BB,1.5,15,14,233,9,2018,10,-1
Group 3,BB,1.5,15,14,234,9,2018,10,-1
Group 3,BB,1.5,15,14,235,10,2018,10,0
Group 3,BB,1.5,15,14,236,11,2018,9,2
Group 3,BB,1.5,15,14,237,11,2018,11,0
Group 3,BB,1.5,15,14,238,7,2018,10,-3
Group 3,BB,1.5,15,14,239,9,2018,10,-1
Group 3,BB,1.5,15,14,240,10,2018,13,-3
Group 3,BB,1.5,15,14,241,11,2018,11,0
Group 3,BB,1.5,15,14,242,8,2018,12,-4
Group 3,BB,1.5,15,14,243,9,2018,12,-3
Group 3,BB,1.5,15,14,244,11,2018,12,-1
Group 3,BB,1.5,15,14,245,11,2018,10,1
Group 3,BB,1.5,15,14,246,12,2018,11,1
Group 3,BB,1.5,15,14,247,12,2018,10,2
Group 3,BB,1.5,15,14,248,11,2018,9,2
Group 3,BB,1.5,15,14,249,10,2018,10,0
Group 3,BB,1.5,15,14,250,12,2018,8,4
Group 3,BB,1.5,15,14,251,11,2018,9,2
Group 3,BB,1.5,15,14,252,9,2018,11,-2
Group 3,BB,1.5,15,14,253,10,2018,12,-2
Group 3,BB,1.5,15,14,254,12,2018,10,2
Group 3,BB,1.5,15,14,255,10,2018,7,3
Group 3,BB,1.5,15,14,256,12,2018,12,0
Group 3,BB,1.5,15,14,257,11,2018,9,2
Group 3,BB,1.5,15,14,258,9,2018,12,-3
Group 3,BB,1.5,15,14,259,8,2018,9,-1
Group 3,BB,1.5,15,14,260,12,2018,7,5
Group 3,BB,1.5,15,14,261,11,2018,12,-1
Group 3,BB,1.5,15,14,262,11,2018,12,-1
Group 3,BB,1.5,15,14,263,8,2018,8,0
Group 3,BB,1.5,15,14,264,11,2018,12,-1
Group 3,BB,1.5,15,14,265,5,2018,6,-1
Group 3,BB,1.5,15,14,266,11,2018,8,3
Group 3,BB,1.5,15,14,267,8,2018,9,-1
Group 3,BB,1.5,15,14,268,11,2018,12,-1
Group 3,BB,1.5,15,14,269,12,2018,14,-2
Group 3,BB,1.5,15,14,270,11,2018,11,0
Group 3,BB,1.5,15,14,271,11,2018,10,1
Group 3,BB,1.5,15,14,272,12,2018,8,4
Group 3,BB,1.5,15,14,273,14,2018,12,2
Group 3,BB,1.5,15,14,274,14,2018,10,4
Group 3,BB,1.5,15,14,275,11,2018,9,2
Group 3,BB,1.5,15,14,276,8,2018,9,-1
Group 3,BB,1.5,15,14,277,10,2018,10,0
Group 3,BB,1.5,15,14,278,12,2018,14,-2
Group 3,BB,1.5,15,14,279,12,2018,10,2
Group 3,BB,1.5,15,14,280,8,2018,11,-3
Group 3,BB,1.5,15,14,281,12,2018,8,4
Group 3,BB,1.5,15,14,282,8,2018,10,-2
Group 3,BB,1.5,15,14,283,8,2018,9,-1
Group 3,BB,1.5,15,14,284,12,2018,8,4
Group 3,BB,1.5,15,14,285,12,2018,11,1
Group 3,BB,1.5,15,14,286,12,2018,8,4
Group 3,BB,1.5,15,14,287,9,2018,10,-1
Group 3,BB,1.5,15,14,288,12,2018,10,2
Group 3,BB,1.5,15,14,289,10,2018,9,1
Group 3,BB,1.5,15,14,290,8,2018,10,-2
Group 3,BB,1.5,15,14,291,13,2018,12,1
Group 3,BB,1.5,15,14,292,10,2018,13,-3
Group 3,BB,1.5,15,14,293,11,2018,10,1
Group 3,BB,1.5,15,14,294,12,2018,10,2
Group 3,BB,1.5,15,14,295,9,2018,10,-1
Group 3,BB,1.5,15,14,296,13,2018,7,6
Group 3,BB,1.5,15,14,297,12,2018,8,4
Group 3,BB,1.5,15,14,298,9,2018,12,-3
Group 3,BB,1.5,15,14,299,11,2018,10,1
Group 3,BB,1.5,15,14,300,11,2018,10,1
Group 3,BB,1.5,15,14,301,13,2018,11,2
Group 3,BB,1.5,15,14,302,12,2018,11,1
Group 3,BB,1.5,15,14,303,14,2018,13,1
Group 3,BB,1.5,15,14,304,11,2018,10,1
Group 3,BB,1.5,15,14,305,8,2018,9,-1
Group 3,BB,1.5,15,14,306,11,2018,10,1
Group 3,BB,1.5,15,14,307,9,2018,11,-2
Group 3,BB,1.5,15,14,308,10,2018,12,-2
Group 3,BB,1.5,15,14,309,7,2018,9,-2
Group 3,BB,1.5,15,14,310,11,2018,11,0
Group 3,BB,1.5,15,14,311,11,2018,5,6
Group 3,BB,1.5,15,14,312,12,2018,9,3
Group 3,BB,1.5,15,14,313,12,2018,10,2
Group 3,BB,1.5,15,14,314,12,2018,12,0
Group 3,BB,1.5,15,14,315,12,2018,13,-1
Group 3,BB,1.5,15,14,316,7,2018,11,-4
Group 3,BB,1.5,15,14,317,11,2018,13,-2
Group 3,BB,1.5,15,14,318,11,2018,11,0
Group 3,BB,1.5,15,14,319,7,2018,9,-2
Group 3,BB,1.5,15,14,320,9,2018,10,-1
Group 3,BB,1.5,15,14,321,11,2018,10,1
Group 3,BB,1.5,15,14,322,11,2018,12,-1
Group 3,BB,1.5,15,14,323,11,2018,11,0
Group 3,BB,1.5,15,14,324,11,2018,12,-1
Group 3,BB,1.5,15,14,325,8,2018,9,-1
Group 3,BB,1.5,15,14,326,12,2018,10,2
Group 3,BB,1.5,15,14,327,10,2018,9,1
Group 3,BB,1.5,15,14,328,7,2018,12,-5
Group 3,BB,1.5,15,14,329,12,2018,10,2
Group 3,BB,1.5,15,14,330,14,2018,11,3
Group 3,BB,1.5,15,14,331,12,2018,14,-2
Group 3,BB,1.5,15,14,332,8,2018,11,-3
Group 3,BB,1.5,15,14,333,14,2018,11,3
Group 3,BB,1.5,15,14,334,10,2018,10,0
Group 3,BB,1.5,15,14,335,12,2018,9,3
Group 3,BB,1.5,15,14,336,12,2018,11,1
Group 3,BB,1.5,15,14,337,13,2018,9,4
Group 3,BB,1.5,15,14,338,9,2018,13,-4
Group 3,BB,1.5,15,14,339,12,2018,7,5
Group 3,BB,1.5,15,14,340,13,2018,12,1
Group 3,BB,1.5,15,14,341,8,2018,13,-5
Group 3,BB,1.5,15,14,342,7,2018,11,-4
Group 3,BB,1.5,15,14,343,6,2018,11,-5
Group 3,BB,1.5,15,14,344,13,2018,12,1
Group 3,BB,1.5,15,14,345,6,2018,10,-4
Group 3,BB,1.5,15,14,346,7,2018,10,-3
Group 3,BB,1.5,15,14,347,12,2018,10,2
Group 3,BB,1.5,15,14,348,11,2018,11,0
Group 3,BB,1.5,15,14,349,9,2018,11,-2
Group 3,BB,1.5,15,14,350,12,2018,9,3
Group 3,BB,1.5,15,14,351,13,2018,10,3
Group 3,BB,1.5,15,14,352,11,2018,12,-1
Group 3,BB,1.5,15,14,353,9,2018,8,1
Group 3,BB,1.5,15,14,354,12,2018,7,5
Group 3,BB,1.5,15,14,355,13,2018,13,0
Group 3,BB,1.5,15,14,356,8,2018,8,0
Group 3,BB,1.5,15,14,357,12,2018,12,0
Group 3,BB,1.5,15,14,358,12,2018,11,1
Group 3,BB,1.5,15,14,359,10,2018,13,-3
Group 3,BB,1.5,15,14,360,13,2018,8,5
Group 3,BB,1.5,15,14,361,13,2018,9,4
Group 3,BB,1.5,15,14,362,10,2018,7,3
Group 3,BB,1.5,15,14,363,11,2018,8,3
Group 3,BB,1.5,15,14,364,8,2018,10,-2
Group 3,BB,1.5,15,14,365,11,2018,10,1
Group 3,BB,1.5,15,14,366,10,2018,9,1
Group 3,BB,1.5,15,14,367,12,2018,8,4
Group 3,BB,1.5,15,14,368,12,2018,11,1
Group 3,BB,1.5,15,14,369,13,2018,13,0
Group 3,BB,1.5,15,14,370,13,2018,10,3
Group 3,BB,1.5,15,14,371,8,2018,9,-1
Group 3,BB,1.5,15,14,372,13,2018,10,3
Group 3,BB,1.5,15,14,373,12,2018,11,1
Group 3,BB,1.5,15,14,374,4,2018,8,-4
Group 3,BB,1.5,15,14,375,12,2018,10,2
Group 3,BB,1.5,15,14,376,12,2018,10,2
Group 3,BB,1.5,15,14,377,12,2018,13,-1
Group 3,BB,1.5,15,14,378,10,2018,10,0
Group 3,BB,1.5,15,14,379,12,2018,10,2
Group 3,BB,1.5,15,14,380,10,2018,8,2
Group 3,BB,1.5,15,14,381,10,2018,11,-1
Group 3,BB,1.5,15,14,382,11,2018,4,7
Group 3,BB,1.5,15,14,383,11,2018,10,1
Group 3,BB,1.5,15,14,384,11,2018,12,-1
Group 3,BB,1.5,15,14,385,9,2018,9,0
Group 3,BB,1.5,15,14,386,10,2018,14,-4
Group 3,BB,1.5,15,14,387,12,2018,10,2
Group 3,BB,1.5,15,14,388,9,2018,12,-3
Group 3,BB,1.5,15,14,389,11,2018,12,-1
Group 3,BB,1.5,15,14,390,10,2018,6,4
Group 3,BB,1.5,15,14,391,10,2018,7,3
Group 3,BB,1.5,15,14,392,8,2018,10,-2
Group 3,BB,1.5,15,14,393,10,2018,12,-2
Group 3,BB,1.5,15,14,394,13,2018,12,1
Group 3,BB,1.5,15,14,395,14,2018,8,6
Group 3,BB,1.5,15,14,396,13,2018,10,3
Group 3,BB,1.5,15,14,397,9,2018,10,-1
Group 3,BB,1.5,15,14,398,9,2018,9,0
Group 3,BB,1.5,15,14,399,10,2018,10,0
Group 3,BB,1.5,15,14,400,11,2018,8,3
Group 3,BB,1.5,15,14,401,10,2018,9,1
Group 3,BB,1.5,15,14,402,10,2018,12,-2
Group 3,BB,1.5,15,14,403,7,2018,9,-2
Group 3,BB,1.5,15,14,404,11,2018,7,4
Group 3,BB,1.5,15,14,405,13,2018,10,3
Group 3,BB,1.5,15,14,406,11,2018,9,2
Group 3,BB,1.5,15,14,407,12,2018,12,0
Group 3,BB,1.5,15,14,408,11,2018,7,4
Group 3,BB,1.5,15,14,409,10,2018,8,2
Group 3,BB,1.5,15,14,410,6,2018,10,-4
Group 3,BB,1.5,15,14,411,12,2018,12,0
Group 3,BB,1.5,15,14,412,6,2018,11,-5
Group 3,BB,1.5,15,14,413,5,2018,10,-5
Group 3,BB,1.5,15,14,414,12,2018,10,2
Group 3,BB,1.5,15,14,415,10,2018,10,0
Group 3,BB,1.5,15,14,416,10,2018,12,-2
Group 3,BB,1.5,15,14,417,7,2018,7,0
Group 3,BB,1.5,15,14,418,10,2018,10,0
Group 3,BB,1.5,15,14,419,9,2018,13,-4
Group 3,BB,1.5,15,14,420,12,2018,7,5
Group 3,BB,1.5,15,14,421,6,2018,11,-5
Group 3,BB,1.5,15,14,422,10,2018,11,-1
Group 3,BB,1.5,15,14,423,7,2018,8,-1
Group 3,BB,1.5,15,14,424,12,2018,9,3
Group 3,BB,1.5,15,14,425,12,2018,8,4
Group 3,BB,1.5,15,14,426,13,2018,9,4
Group 3,BB,1.5,15,14,427,12,2018,12,0
Group 3,BB,1.5,15,14,428,11,2018,10,1
Group 3,BB,1.5,15,14,429,12,2018,8,4
Group 3,BB,1.5,15,14,430,6,2018,10,-4
Group 3,BB,1.5,15,14,431,11,2018,11,0
Group 3,BB,1.5,15,14,432,13,2018,12,1
Group 3,BB,1.5,15,14,433,10,2018,11,-1
Group 3,BB,1.5,15,14,434,12,2018,8,4
Group 3,BB,1.5,15,14,435,10,2018,10,0
Group 3,BB,1.5,15,14,436,12,2018,12,0
Group 3,BB,1.5,15,14,437,11,2018,9,2
Group 3,BB,1.5,15,14,438,13,2018,12,1
Group 3,BB,1.5,15,14,439,10,2018,7,3
Group 3,BB,1.5,15,14,440,8,2018,8,0
Group 3,BB,1.5,15,14,441,11,2018,11,0
Group 3,BB,1.5,15,14,442,12,2018,12,0
Group 3,BB,1.5,15,14,443,9,2018,12,-3
Group 3,BB,1.5,15,14,444,12,2018,11,1
Group 3,BB,1.5,15,14,445,12,2018,12,0
Group 3,BB,1.5,15,14,446,9,2018,10,-1
Group 3,BB,1.5,15,14,447,10,2018,10,0
Group 3,BB,1.5,15,14,448,10,2018,9,1
Group 3,BB,1.5,15,14,449,9,2018,8,1
Group 3,BB,1.5,15,14,450,11,2018,10,1
Group 3,BB,1.5,15,14,451,10,2018,11,-1
Group 3,BB,1.5,15,14,452,7,2018,8,-1
Group 3,BB,1.5,15,14,453,10,2018,8,2
Group 3,BB,1.5,15,14,454,9,2018,11,-2
Group 3,BB,1.5,15,14,455,8,2018,10,-2
Group 3,BB,1.5,15,14,456,13,2018,12,1
Group 3,BB,1.5,15,14,457,9,2018,6,3
Group 3,BB,1.5,15,14,458,10,2018,11,-1
Group 3,BB,1.5,15,14,459,11,2018,10,1
Group 3,BB,1.5,15,14,460,8,2018,10,-2
Group 3,BB,1.5,15,14,461,8,2018,11,-3
Group 3,BB,1.5,15,14,462,10,2018,11,-1
Group 3,BB,1.5,15,14,463,9,2018,13,-4
Group 3,BB,1.5,15,14,464,8,2018,11,-3
Group 3,BB,1.5,15,14,465,9,2018,9,0
Group 3,BB,1.5,15,14,466,14,2018,9,5
Group 3,BB,1.5,15,14,467,12,2018,9,3
Group 3,BB,1.5,15,14,468,12,2018,9,3
Group 3,BB,1.5,15,14,469,8,2018,12,-4
Group 3,BB,1.5,15,14,470,12,2018,7,5
Group 3,BB,1.5,15,14,471,12,2018,6,6
Group 3,BB,1.5,15,14,472,12,2018,7,5
Group 3,BB,1.5,15,14,473,8,2018,10,-2
Group 3,BB,1.5,15,14,474,7,2018,13,-6
Group 3,BB,1.5,15,14,475,9,2018,11,-2
Group 3,BB,1.5,15,14,476,12,2018,13,-1
Group 3,BB,1.5,15,14,477,11,2018,10,1
Group 3,BB,1.5,15,14,478,10,2018,10,0
Group 3,BB,1.5,15,14,479,9,2018,10,-1
Group 3,BB,1.5,15,14,480,11,2018,12,-1
Group 3,BB,1.5,15,14,481,10,2018,10,0
Group 3,BB,1.5,15,14,482,10,2018,11,-1
Group 3,BB,1.5,15,14,483,13,2018,8,5
Group 3,BB,1.5,15,14,484,9,2018,11,-2
Group 3,BB,1.5,15,14,485,6,2018,11,-5
Group 3,BB,1.5,15,14,486,11,2018,10,1
Group 3,BB,1.5,15,14,487,9,2018,12,-3
Group 3,BB,1.5,15,14,488,13,2018,10,3
Group 3,BB,1.5,15,14,489,11,2018,12,-1
Group 3,BB,1.5,15,14,490,11,2018,10,1
Group 3,BB,1.5,15,14,491,13,2018,10,3
Group 3,BB,1.5,15,14,492,7,2018,10,-3
Group 3,BB,1.5,15,14,493,12,2018,7,5
Group 3,BB,1.5,15,14,494,10,2018,8,2
Group 3,BB,1.5,15,14,495,10,2018,9,1
Group 3,BB,1.5,15,14,496,11,2018,10,1
Group 3,BB,1.5,15,14,497,2,2018,9,-7
Group 3,BB,1.5,15,14,498,11,2018,10,1
Group 3,BB,1.5,15,14,499,13,2018,9,4
Group 3,BB,1.5,15,14,500,10,2018,8,2
Group 3,BB,1.5,15,14,501,14,2018,13,1
Group 3,BB,1.5,15,14,502,10,2018,6,4
Group 3,BB,1.5,15,14,503,14,2018,12,2
Group 3,BB,1.5,15,14,504,8,2018,7,1
Group 3,BB,1.5,15,14,505,12,2018,6,6
Group 3,BB,1.5,15,14,506,7,2018,6,1
Group 3,BB,1.5,15,14,507,12,2018,12,0
Group 3,BB,1.5,15,14,508,9,2018,14,-5
Group 3,BB,1.5,15,14,509,13,2018,10,3
Group 3,BB,1.5,15,14,510,11,2018,12,-1
Group 3,BB,1.5,15,14,511,7,2018,9,-2
Group 3,BB,1.5,15,14,512,6,2018,8,-2
Group 3,BB,1.5,15,14,513,10,2018,8,2
Group 3,BB,1.5,15,14,514,9,2018,9,0
Group 3,BB,1.5,15,14,515,13,2018,12,1
Group 3,BB,1.5,15,14,516,8,2018,11,-3
Group 3,BB,1.5,15,14,517,7,2018,6,1
Group 3,BB,1.5,15,14,518,13,2018,10,3
Group 3,BB,1.5,15,14,519,13,2018,10,3
Group 3,BB,1.5,15,14,520,11,2018,7,4
Group 3,BB,1.5,15,14,521,9,2018,9,0
Group 3,BB,1.5,15,14,522,10,2018,11,-1
Group 3,BB,1.5,15,14,523,7,2018,12,-5
Group 3,BB,1.5,15,14,524,11,2018,12,-1
Group 3,BB,1.5,15,14,525,13,2018,12,1
Group 3,BB,1.5,15,14,526,11,2018,10,1
Group 3,BB,1.5,15,14,527,11,2018,9,2
Group 3,BB,1.5,15,14,528,8,2018,9,-1
Group 3,BB,1.5,15,14,529,11,2018,11,0
Group 3,BB,1.5,15,14,530,11,2018,11,0
Group 3,BB,1.5,15,14,531,11,2018,9,2
Group 3,BB,1.5,15,14,532,8,2018,13,-5
Group 3,BB,1.5,15,14,533,13,2018,10,3
Group 3,BB,1.5,15,14,534,6,2018,10,-4
Group 3,BB,1.5,15,14,535,8,2018,10,-2
Group 3,BB,1.5,15,14,536,9,2018,10,-1
Group 3,BB,1.5,15,14,537,11,2018,13,-2
Group 3,BB,1.5,15,14,538,11,2018,8,3
Group 3,BB,1.5,15,14,539,12,2018,10,2
Group 3,BB,1.5,15,14,540,13,2018,14,-1
Group 3,BB,1.5,15,14,541,8,2018,7,1
Group 3,BB,1.5,15,14,542,7,2018,12,-5
Group 3,BB,1.5,15,14,543,7,2018,13,-6
Group 3,BB,1.5,15,14,544,11,2018,11,0
Group 3,BB,1.5,15,14,545,8,2018,9,-1
Group 3,BB,1.5,15,14,546,9,2018,11,-2
Group 3,BB,1.5,15,14,547,12,2018,10,2
Group 3,BB,1.5,15,14,548,9,2018,4,5
Group 3,BB,1.5,15,14,549,12,2018,9,3
Group 3,BB,1.5,15,14,550,11,2018,10,1
Group 3,BB,1.5,15,14,551,12,2018,10,2
Group 3,BB,1.5,15,14,552,7,2018,10,-3
Group 3,BB,1.5,15,14,553,8,2018,10,-2
Group 3,BB,1.5,15,14,554,8,2018,13,-5
Group 3,BB,1.5,15,14,555,7,2018,12,-5
Group 3,BB,1.5,15,14,556,9,2018,7,2
Group 3,BB,1.5,15,14,557,11,2018,9,2
Group 3,BB,1.5,15,14,558,5,2018,5,0
Group 3,BB,1.5,15,14,559,12,2018,10,2
Group 3,BB,1.5,15,14,560,9,2018,8,1
Group 3,BB,1.5,15,14,561,10,2018,13,-3
Group 3,BB,1.5,15,14,562,13,2018,12,1
Group 3,BB,1.5,15,14,563,11,2018,9,2
Group 3,BB,1.5,15,14,564,11,2018,12,-1
Group 3,BB,1.5,15,14,565,12,2018,10,2
Group 3,BB,1.5,15,14,566,11,2018,8,3
Group 3,BB,1.5,15,14,567,10,2018,12,-2
Group 3,BB,1.5,15,14,568,11,2018,9,2
Group 3,BB,1.5,15,14,569,14,2018,11,3
Group 3,BB,1.5,15,14,570,11,2018,13,-2
Group 3,BB,1.5,15,14,571,10,2018,12,-2
Group 3,BB,1.5,15,14,572,10,2018,9,1
Group 3,BB,1.5,15,14,573,11,2018,13,-2
Group 3,BB,1.5,15,14,574,10,2018,11,-1
Group 3,BB,1.5,15,14,575,11,2018,8,3
Group 3,BB,1.5,15,14,576,6,2018,11,-5
Group 3,BB,1.5,15,14,577,8,2018,10,-2
Group 3,BB,1.5,15,14,578,12,2018,7,5
Group 3,BB,1.5,15,14,579,11,2018,13,-2
Group 3,BB,1.5,15,14,580,9,2018,10,-1
Group 3,BB,1.5,15,14,581,9,2018,11,-2
Group 3,BB,1.5,15,14,582,11,2018,10,1
Group 3,BB,1.5,15,14,583,11,2018,10,1
Group 3,BB,1.5,15,14,584,10,2018,11,-1
Group 3,BB,1.5,15,14,585,10,2018,13,-3
Group 3,BB,1.5,15,14,586,7,2018,12,-5
Group 3,BB,1.5,15,14,587,9,2018,14,-5
Group 3,BB,1.5,15,14,588,13,2018,10,3
Group 3,BB,1.5,15,14,589,9,2018,11,-2
Group 3,BB,1.5,15,14,590,8,2018,12,-4
Group 3,BB,1.5,15,14,591,13,2018,12,1
Group 3,BB,1.5,15,14,592,11,2018,10,1
Group 3,BB,1.5,15,14,593,9,2018,10,-1
Group 3,BB,1.5,15,14,594,8,2018,8,0
Group 3,BB,1.5,15,14,595,9,2018,6,3
Group 3,BB,1.5,15,14,596,10,2018,4,6
Group 3,BB,1.5,15,14,597,8,2018,11,-3
Group 3,BB,1.5,15,14,598,13,2018,11,2
Group 3,BB,1.5,15,14,599,9,2018,11,-2
Group 3,BB,1.5,15,14,600,13,2018,9,4
Group 3,BB,1.5,15,14,601,11,2018,12,-1
Group 3,BB,1.5,15,14,602,8,2018,12,-4
Group 3,BB,1.5,15,14,603,11,2018,11,0
Group 3,BB,1.5,15,14,604,6,2018,12,-6
Group 3,BB,1.5,15,14,605,9,2018,11,-2
Group 3,BB,1.5,15,14,606,11,2018,10,1
Group 3,BB,1.5,15,14,607,10,2018,7,3
Group 3,BB,1.5,15,14,608,8,2018,6,2
Group 3,BB,1.5,15,14,609,12,2018,10,2
Group 3,BB,1.5,15,14,610,9,2018,9,0
Group 3,BB,1.5,15,14,611,12,2018,8,4
Group 3,BB,1.5,15,14,612,11,2018,11,0
Group 3,BB,1.5,15,14,613,11,2018,13,-2
Group 3,BB,1.5,15,14,614,7,2018,8,-1
Group 3,BB,1.5,15,14,615,6,2018,7,-1
Group 3,BB,1.5,15,14,616,11,2018,9,2
Group 3,BB,1.5,15,14,617,6,2018,8,-2
Group 3,BB,1.5,15,14,618,9,2018,11,-2
Group 3,BB,1.5,15,14,619,13,2018,12,1
Group 3,BB,1.5,15,14,620,10,2018,10,0
Group 3,BB,1.5,15,14,621,8,2018,9,-1
Group 3,BB,1.5,15,14,622,9,2018,11,-2
Group 3,BB,1.5,15,14,623,8,2018,11,-3
Group 3,BB,1.5,15,14,624,10,2018,9,1
Group 3,BB,1.5,15,14,625,12,2018,12,0
Group 3,BB,1.5,15,14,626,10,2018,9,1
Group 3,BB,1.5,15,14,627,9,2018,7,2
Group 3,BB,1.5,15,14,628,13,2018,7,6
Group 3,BB,1.5,15,14,629,10,2018,6,4
Group 3,BB,1.5,15,14,630,13,2018,10,3
Group 3,BB,1.5,15,14,631,12,2018,8,4
Group 3,BB,1.5,15,14,632,11,2018,12,-1
Group 3,BB,1.5,15,14,633,9,2018,10,-1
Group 3,BB,1.5,15,14,634,9,2018,10,-1
Group 3,BB,1.5,15,14,635,11,2018,11,0
Group 3,BB,1.5,15,14,636,10,2018,10,0
Group 3,BB,1.5,15,14,637,6,2018,12,-6
Group 3,BB,1.5,15,14,638,8,2018,7,1
Group 3,BB,1.5,15,14,639,11,2018,9,2
Group 3,BB,1.5,15,14,640,11,2018,5,6
Group 3,BB,1.5,15,14,641,10,2018,11,-1
Group 3,BB,1.5,15,14,642,11,2018,10,1
Group 3,BB,1.5,15,14,643,8,2018,8,0
Group 3,BB,1.5,15,14,644,9,2018,12,-3
Group 3,BB,1.5,15,14,645,9,2018,6,3
Group 3,BB,1.5,15,14,646,10,2018,7,3
Group 3,BB,1.5,15,14,647,10,2018,11,-1
Group 3,BB,1.5,15,14,648,11,2018,9,2
Group 3,BB,1.5,15,14,649,11,2018,8,3
Group 3,BB,1.5,15,14,650,8,2018,8,0
Group 3,BB,1.5,15,14,651,8,2018,9,-1
Group 3,BB,1.5,15,14,652,11,2018,10,1
Group 3,BB,1.5,15,14,653,9,2018,7,2
Group 3,BB,1.5,15,14,654,9,2018,12,-3
Group 3,BB,1.5,15,14,655,12,2018,12,0
Group 3,BB,1.5,15,14,656,12,2018,9,3
Group 3,BB,1.5,15,14,657,11,2018,10,1
Group 3,BB,1.5,15,14,658,8,2018,11,-3
Group 3,BB,1.5,15,14,659,9,2018,13,-4
Group 3,BB,1.5,15,14,660,13,2018,8,5
Group 3,BB,1.5,15,14,661,10,2018,9,1
Group 3,BB,1.5,15,14,662,12,2018,9,3
Group 3,BB,1.5,15,14,663,10,2018,9,1
Group 3,BB,1.5,15,14,664,13,2018,10,3
Group 3,BB,1.5,15,14,665,9,2018,11,-2
Group 3,BB,1.5,15,14,666,14,2018,11,3
Group 3,BB,1.5,15,14,667,12,2018,11,1
Group 3,BB,1.5,15,14,668,9,2018,7,2
Group 3,BB,1.5,15,14,669,12,2018,7,5
Group 3,BB,1.5,15,14,670,10,2018,11,-1
Group 3,BB,1.5,15,14,671,8,2018,7,1
Group 3,BB,1.5,15,14,672,9,2018,8,1
Group 3,BB,1.5,15,14,673,13,2018,10,3
Group 3,BB,1.5,15,14,674,7,2018,10,-3
Group 3,BB,1.5,15,14,675,10,2018,11,-1
Group 3,BB,1.5,15,14,676,10,2018,5,5
Group 3,BB,1.5,15,14,677,12,2018,12,0
Group 3,BB,1.5,15,14,678,12,2018,11,1
Group 3,BB,1.5,15,14,679,10,2018,10,0
Group 3,BB,1.5,15,14,680,10,2018,10,0
Group 3,BB,1.5,15,14,681,11,2018,9,2
Group 3,BB,1.5,15,14,682,11,2018,10,1
Group 3,BB,1.5,15,14,683,13,2018,10,3
Group 3,BB,1.5,15,14,684,12,2018,10,2
Group 3,BB,1.5,15,14,685,11,2018,9,2
Group 3,BB,1.5,15,14,686,13,2018,11,2
Group 3,BB,1.5,15,14,687,9,2018,11,-2
Group 3,BB,1.5,15,14,688,11,2018,10,1
Group 3,BB,1.5,15,14,689,13,2018,9,4
Group 3,BB,1.5,15,14,690,12,2018,10,2
Group 3,BB,1.5,15,14,691,11,2018,11,0
Group 3,BB,1.5,15,14,692,9,2018,10,-1
Group 3,BB,1.5,15,14,693,11,2018,10,1
Group 3,BB,1.5,15,14,694,11,2018,10,1
Group 3,BB,1.5,15,14,695,11,2018,12,-1
Group 3,BB,1.5,15,14,696,11,2018,12,-1
Group 3,BB,1.5,15,14,697,11,2018,8,3
Group 3,BB,1.5,15,14,698,11,2018,9,2
Group 3,BB,1.5,15,14,699,9,2018,6,3
Group 3,BB,1.5,15,14,700,11,2018,13,-2
Group 3,BB,1.5,15,14,701,10,2018,8,2
Group 3,BB,1.5,15,14,702,8,2018,9,-1
Group 3,BB,1.5,15,14,703,9,2018,12,-3
Group 3,BB,1.5,15,14,704,10,2018,8,2
Group 3,BB,1.5,15,14,705,12,2018,9,3
Group 3,BB,1.5,15,14,706,7,2018,11,-4
Group 3,BB,1.5,15,14,707,8,2018,10,-2
Group 3,BB,1.5,15,14,708,11,2018,9,2
Group 3,BB,1.5,15,14,709,10,2018,10,0
Group 3,BB,1.5,15,14,710,8,2018,11,-3
Group 3,BB,1.5,15,14,711,12,2018,13,-1
Group 3,BB,1.5,15,14,712,8,2018,12,-4
Group 3,BB,1.5,15,14,713,9,2018,12,-3
Group 3,BB,1.5,15,14,714,12,2018,12,0
Group 3,BB,1.5,15,14,715,9,2018,9,0
Group 3,BB,1.5,15,14,716,10,2018,12,-2
Group 3,BB,1.5,15,14,717,12,2018,12,0
Group 3,BB,1.5,15,14,718,9,2018,9,0
Group 3,BB,1.5,15,14,719,11,2018,10,1
Group 3,BB,1.5,15,14,720,8,2018,11,-3
Group 3,BB,1.5,15,14,721,13,2018,11,2
Group 3,BB,1.5,15,14,722,13,2018,10,3
Group 3,BB,1.5,15,14,723,10,2018,8,2
Group 3,BB,1.5,15,14,724,13,2018,9,4
Group 3,BB,1.5,15,14,725,11,2018,8,3
Group 3,BB,1.5,15,14,726,11,2018,8,3
Group 3,BB,1.5,15,14,727,12,2018,6,6
Group 3,BB,1.5,15,14,728,14,2018,12,2
Group 3,BB,1.5,15,14,729,12,2018,9,3
Group 3,BB,1.5,15,14,730,9,2018,10,-1
Group 3,BB,1.5,15,14,731,13,2018,7,6
Group 3,BB,1.5,15,14,732,13,2018,6,7
Group 3,BB,1.5,15,14,733,12,2018,11,1
Group 3,BB,1.5,15,14,734,13,2018,11,2
Group 3,BB,1.5,15,14,735,11,2018,11,0
Group 3,BB,1.5,15,14,736,12,2018,10,2
Group 3,BB,1.5,15,14,737,10,2018,11,-1
Group 3,BB,1.5,15,14,738,10,2018,12,-2
Group 3,BB,1.5,15,14,739,12,2018,9,3
Group 3,BB,1.5,15,14,740,10,2018,11,-1
Group 3,BB,1.5,15,14,741,11,2018,8,3
Group 3,BB,1.5,15,14,742,12,2018,8,4
Group 3,BB,1.5,15,14,743,10,2018,9,1
Group 3,BB,1.5,15,14,744,12,2018,13,-1
Group 3,BB,1.5,15,14,745,11,2018,9,2
Group 3,BB,1.5,15,14,746,13,2018,9,4
Group 3,BB,1.5,15,14,747,10,2018,10,0
Group 3,BB,1.5,15,14,748,6,2018,10,-4
Group 3,BB,1.5,15,14,749,9,2018,7,2
Group 3,BB,1.5,15,14,750,10,2018,6,4
Group 3,BB,1.5,15,14,751,12,2018,12,0
Group 3,BB,1.5,15,14,752,10,2018,7,3
Group 3,BB,1.5,15,14,753,10,2018,9,1
Group 3,BB,1.5,15,14,754,10,2018,9,1
Group 3,BB,1.5,15,14,755,12,2018,12,0
Group 3,BB,1.5,15,14,756,10,2018,6,4
Group 3,BB,1.5,15,14,757,8,2018,10,-2
Group 3,BB,1.5,15,14,758,8,2018,13,-5
Group 3,BB,1.5,15,14,759,9,2018,11,-2
Group 3,BB,1.5,15,14,760,11,2018,7,4
Group 3,BB,1.5,15,14,761,8,2018,12,-4
Group 3,BB,1.5,15,14,762,11,2018,9,2
Group 3,BB,1.5,15,14,763,11,2018,12,-1
Group 3,BB,1.5,15,14,764,8,2018,10,-2
Group 3,BB,1.5,15,14,765,8,2018,11,-3
Group 3,BB,1.5,15,14,766,10,2018,8,2
Group 3,BB,1.5,15,14,767,14,2018,10,4
Group 3,BB,1.5,15,14,768,9,2018,12,-3
Group 3,BB,1.5,15,14,769,11,2018,9,2
Group 3,BB,1.5,15,14,770,9,2018,9,0
Group 3,BB,1.5,15,14,771,8,2018,11,-3
Group 3,BB,1.5,15,14,772,11,2018,9,2
Group 3,BB,1.5,15,14,773,11,2018,10,1
Group 3,BB,1.5,15,14,774,11,2018,11,0
Group 3,BB,1.5,15,14,775,7,2018,9,-2
Group 3,BB,1.5,15,14,776,13,2018,9,4
Group 3,BB,1.5,15,14,777,11,2018,8,3
Group 3,BB,1.5,15,14,778,11,2018,5,6
Group 3,BB,1.5,15,14,779,10,2018,12,-2
Group 3,BB,1.5,15,14,780,9,2018,7,2
Group 3,BB,1.5,15,14,781,8,2018,10,-2
Group 3,BB,1.5,15,14,782,9,2018,12,-3
Group 3,BB,1.5,15,14,783,11,2018,7,4
Group 3,BB,1.5,15,14,784,7,2018,11,-4
Group 3,BB,1.5,15,14,785,9,2018,9,0
Group 3,BB,1.5,15,14,786,8,2018,9,-1
Group 3,BB,1.5,15,14,787,13,2018,12,1
Group 3,BB,1.5,15,14,788,13,2018,11,2
Group 3,BB,1.5,15,14,789,12,2018,11,1
Group 3,BB,1.5,15,14,790,12,2018,9,3
Group 3,BB,1.5,15,14,791,10,2018,12,-2
Group 3,BB,1.5,15,14,792,12,2018,10,2
Group 3,BB,1.5,15,14,793,11,2018,12,-1
Group 3,BB,1.5,15,14,794,11,2018,11,0
Group 3,BB,1.5,15,14,795,9,2018,10,-1
Group 3,BB,1.5,15,14,796,13,2018,12,1
Group 3,BB,1.5,15,14,797,11,2018,10,1
Group 3,BB,1.5,15,14,798,11,2018,9,2
Group 3,BB,1.5,15,14,799,11,2018,11,0
Group 3,BB,1.5,15,14,800,11,2018,12,-1
Group 3,BB,1.5,15,14,801,10,2018,10,0
Group 3,BB,1.5,15,14,802,11,2018,9,2
Group 3,BB,1.5,15,14,803,11,2018,9,2
Group 3,BB,1.5,15,14,804,12,2018,6,6
Group 3,BB,1.5,15,14,805,12,2018,11,1
Group 3,BB,1.5,15,14,806,12,2018,12,0
Group 3,BB,1.5,15,14,807,12,2018,10,2
Group 3,BB,1.5,15,14,808,12,2018,7,5
Group 3,BB,1.5,15,14,809,10,2018,10,0
Group 3,BB,1.5,15,14,810,13,2018,10,3
Group 3,BB,1.5,15,14,811,7,2018,7,0
Group 3,BB,1.5,15,14,812,10,2018,8,2
Group 3,BB,1.5,15,14,813,9,2018,11,-2
Group 3,BB,1.5,15,14,814,9,2018,9,0
Group 3,BB,1.5,15,14,815,9,2018,11,-2
Group 3,BB,1.5,15,14,816,9,2018,11,-2
Group 3,BB,1.5,15,14,817,9,2018,9,0
Group 3,BB,1.5,15,14,818,11,2018,11,0
Group 3,BB,1.5,15,14,819,8,2018,9,-1
Group 3,BB,1.5,15,14,820,11,2018,5,6
Group 3,BB,1.5,15,14,821,8,2018,10,-2
Group 3,BB,1.5,15,14,822,11,2018,7,4
Group 3,BB,1.5,15,14,823,12,2018,8,4
Group 3,BB,1.5,15,14,824,12,2018,8,4
Group 3,BB,1.5,15,14,825,10,2018,10,0
Group 3,BB,1.5,15,14,826,9,2018,13,-4
Group 3,BB,1.5,15,14,827,6,2018,9,-3
Group 3,BB,1.5,15,14,828,11,2018,11,0
Group 3,BB,1.5,15,14,829,13,2018,9,4
Group 3,BB,1.5,15,14,830,11,2018,8,3
Group 3,BB,1.5,15,14,831,9,2018,10,-1
Group 3,BB,1.5,15,14,832,10,2018,13,-3
Group 3,BB,1.5,15,14,833,14,2018,5,9
Group 3,BB,1.5,15,14,834,13,2018,11,2
Group 3,BB,1.5,15,14,835,9,2018,10,-1
Group 3,BB,1.5,15,14,836,10,2018,8,2
Group 3,BB,1.5,15,14,837,12,2018,8,4
Group 3,BB,1.5,15,14,838,10,2018,10,0
Group 3,BB,1.5,15,14,839,10,2018,12,-2
Group 3,BB,1.5,15,14,840,7,2018,7,0
Group 3,BB,1.5,15,14,841,12,2018,9,3
Group 3,BB,1.5,15,14,842,11,2018,11,0
Group 3,BB,1.5,15,14,843,11,2018,9,2
Group 3,BB,1.5,15,14,844,10,2018,10,0
Group 3,BB,1.5,15,14,845,10,2018,9,1
Group 3,BB,1.5,15,14,846,11,2018,10,1
Group 3,BB,1.5,15,14,847,9,2018,10,-1
Group 3,BB,1.5,15,14,848,13,2018,9,4
Group 3,BB,1.5,15,14,849,11,2018,12,-1
Group 3,BB,1.5,15,14,850,10,2018,12,-2
Group 3,BB,1.5,15,14,851,11,2018,9,2
Group 3,BB,1.5,15,14,852,12,2018,10,2
Group 3,BB,1.5,15,14,853,9,2018,9,0
Group 3,BB,1.5,15,14,854,10,2018,10,0
Group 3,BB,1.5,15,14,855,10,2018,12,-2
Group 3,BB,1.5,15,14,856,10,2018,12,-2
Group 3,BB,1.5,15,14,857,12,2018,11,1
Group 3,BB,1.5,15,14,858,12,2018,9,3
Group 3,BB,1.5,15,14,859,14,2018,12,2
Group 3,BB,1.5,15,14,860,12,2018,5,7
Group 3,BB,1.5,15,14,861,11,2018,9,2
Group 3,BB,1.5,15,14,862,13,2018,9,4
Group 3,BB,1.5,15,14,863,10,2018,6,4
Group 3,BB,1.5,15,14,864,12,2018,6,6
Group 3,BB,1.5,15,14,865,9,2018,9,0
Group 3,BB,1.5,15,14,866,9,2018,10,-1
Group 3,BB,1.5,15,14,867,13,2018,12,1
Group 3,BB,1.5,15,14,868,8,2018,10,-2
Group 3,BB,1.5,15,14,869,12,2018,9,3
Group 3,BB,1.5,15,14,870,11,2018,9,2
Group 3,BB,1.5,15,14,871,11,2018,11,0
Group 3,BB,1.5,15,14,872,10,2018,14,-4
Group 3,BB,1.5,15,14,873,10,2018,14,-4
Group 3,BB,1.5,15,14,874,8,2018,10,-2
Group 3,BB,1.5,15,14,875,11,2018,13,-2
Group 3,BB,1.5,15,14,876,12,2018,9,3
Group 3,BB,1.5,15,14,877,11,2018,11,0
Group 3,BB,1.5,15,14,878,11,2018,13,-2
Group 3,BB,1.5,15,14,879,14,2018,8,6
Group 3,BB,1.5,15,14,880,11,2018,9,2
Group 3,BB,1.5,15,14,881,10,2018,9,1
Group 3,BB,1.5,15,14,882,12,2018,10,2
Group 3,BB,1.5,15,14,883,11,2018,9,2
Group 3,BB,1.5,15,14,884,10,2018,8,2
Group 3,BB,1.5,15,14,885,11,2018,11,0
Group 3,BB,1.5,15,14,886,9,2018,10,-1
Group 3,BB,1.5,15,14,887,10,2018,12,-2
Group 3,BB,1.5,15,14,888,11,2018,11,0
Group 3,BB,1.5,15,14,889,8,2018,9,-1
Group 3,BB,1.5,15,14,890,10,2018,9,1
Group 3,BB,1.5,15,14,891,9,2018,12,-3
Group 3,BB,1.5,15,14,892,12,2018,13,-1
Group 3,BB,1.5,15,14,893,12,2018,9,3
Group 3,BB,1.5,15,14,894,12,2018,11,1
Group 3,BB,1.5,15,14,895,13,2018,9,4
Group 3,BB,1.5,15,14,896,10,2018,12,-2
Group 3,BB,1.5,15,14,897,8,2018,11,-3
Group 3,BB,1.5,15,14,898,7,2018,7,0
Group 3,BB,1.5,15,14,899,11,2018,7,4
Group 3,BB,1.5,15,14,900,10,2018,9,1
Group 3,BB,1.5,15,14,901,13,2018,9,4
Group 3,BB,1.5,15,14,902,11,2018,11,0
Group 3,BB,1.5,15,14,903,11,2018,8,3
Group 3,BB,1.5,15,14,904,12,2018,11,1
Group 3,BB,1.5,15,14,905,11,2018,12,-1
Group 3,BB,1.5,15,14,906,9,2018,8,1
Group 3,BB,1.5,15,14,907,11,2018,9,2
Group 3,BB,1.5,15,14,908,11,2018,13,-2
Group 3,BB,1.5,15,14,909,6,2018,9,-3
Group 3,BB,1.5,15,14,910,11,2018,9,2
Group 3,BB,1.5,15,14,911,12,2018,10,2
Group 3,BB,1.5,15,14,912,11,2018,8,3
Group 3,BB,1.5,15,14,913,5,2018,8,-3
Group 3,BB,1.5,15,14,914,11,2018,5,6
Group 3,BB,1.5,15,14,915,11,2018,8,3
Group 3,BB,1.5,15,14,916,7,2018,9,-2
Group 3,BB,1.5,15,14,917,12,2018,10,2
Group 3,BB,1.5,15,14,918,10,2018,9,1
Group 3,BB,1.5,15,14,919,12,2018,11,1
Group 3,BB,1.5,15,14,920,9,2018,13,-4
Group 3,BB,1.5,15,14,921,14,2018,8,6
Group 3,BB,1.5,15,14,922,13,2018,9,4
Group 3,BB,1.5,15,14,923,14,2018,14,0
Group 3,BB,1.5,15,14,924,11,2018,12,-1
Group 3,BB,1.5,15,14,925,9,2018,10,-1
Group 3,BB,1.5,15,14,926,12,2018,11,1
Group 3,BB,1.5,15,14,927,12,2018,9,3
Group 3,BB,1.5,15,14,928,11,2018,10,1
Group 3,BB,1.5,15,14,929,11,2018,9,2
Group 3,BB,1.5,15,14,930,10,2018,10,0
Group 3,BB,1.5,15,14,931,12,2018,9,3
Group 3,BB,1.5,15,14,932,12,2018,9,3
Group 3,BB,1.5,15,14,933,8,2018,7,1
Group 3,BB,1.5,15,14,934,9,2018,12,-3
Group 3,BB,1.5,15,14,935,12,2018,9,3
Group 3,BB,1.5,15,14,936,9,2018,10,-1
Group 3,BB,1.5,15,14,937,12,2018,10,2
Group 3,BB,1.5,15,14,938,9,2018,9,0
Group 3,BB,1.5,15,14,939,13,2018,11,2
Group 3,BB,1.5,15,14,940,9,2018,10,-1
Group 3,BB,1.5,15,14,941,11,2018,6,5
Group 3,BB,1.5,15,14,942,11,2018,8,3
Group 3,BB,1.5,15,14,943,7,2018,9,-2
Group 3,BB,1.5,15,14,944,7,2018,14,-7
Group 3,BB,1.5,15,14,945,10,2018,11,-1
Group 3,BB,1.5,15,14,946,11,2018,9,2
Group 3,BB,1.5,15,14,947,11,2018,10,1
Group 3,BB,1.5,15,14,948,12,2018,10,2
Group 3,BB,1.5,15,14,949,10,2018,11,-1
Group 3,BB,1.5,15,14,950,6,2018,12,-6
Group 3,BB,1.5,15,14,951,13,2018,7,6
Group 3,BB,1.5,15,14,952,9,2018,10,-1
Group 3,BB,1.5,15,14,953,11,2018,11,0
Group 3,BB,1.5,15,14,954,12,2018,9,3
Group 3,BB,1.5,15,14,955,9,2018,7,2
Group 3,BB,1.5,15,14,956,12,2018,14,-2
Group 3,BB,1.5,15,14,957,8,2018,12,-4
Group 3,BB,1.5,15,14,958,10,2018,8,2
Group 3,BB,1.5,15,14,959,11,2018,10,1
Group 3,BB,1.5,15,14,960,10,2018,11,-1
Group 3,BB,1.5,15,14,961,11,2018,11,0
Group 3,BB,1.5,15,14,962,11,2018,12,-1
Group 3,BB,1.5,15,14,963,9,2018,11,-2
Group 3,BB,1.5,15,14,964,12,2018,12,0
Group 3,BB,1.5,15,14,965,11,2018,8,3
Group 3,BB,1.5,15,14,966,11,2018,7,4
Group 3,BB,1.5,15,14,967,11,2018,8,3
Group 3,BB,1.5,15,14,968,12,2018,10,2
Group 3,BB,1.5,15,14,969,11,2018,8,3
Group 3,BB,1.5,15,14,970,9,2018,10,-1
Group 3,BB,1.5,15,14,971,11,2018,10,1
Group 3,BB,1.5,15,14,972,11,2018,11,0
Group 3,BB,1.5,15,14,973,8,2018,8,0
Group 3,BB,1.5,15,14,974,12,2018,12,0
Group 3,BB,1.5,15,14,975,12,2018,9,3
Group 3,BB,1.5,15,14,976,12,2018,7,5
Group 3,BB,1.5,15,14,977,9,2018,9,0
Group 3,BB,1.5,15,14,978,11,2018,8,3
Group 3,BB,1.5,15,14,979,11,2018,9,2
Group 3,BB,1.5,15,14,980,12,2018,11,1
Group 3,BB,1.5,15,14,981,13,2018,12,1
Group 3,BB,1.5,15,14,982,8,2018,6,2
Group 3,BB,1.5,15,14,983,13,2018,10,3
Group 3,BB,1.5,15,14,984,11,2018,7,4
Group 3,BB,1.5,15,14,985,7,2018,12,-5
Group 3,BB,1.5,15,14,986,11,2018,13,-2
Group 3,BB,1.5,15,14,987,8,2018,12,-4
Group 3,BB,1.5,15,14,988,12,2018,12,0
Group 3,BB,1.5,15,14,989,12,2018,13,-1
Group 3,BB,1.5,15,14,990,9,2018,6,3
Group 3,BB,1.5,15,14,991,11,2018,9,2
Group 3,BB,1.5,15,14,992,5,2018,10,-5
Group 3,BB,1.5,15,14,993,12,2018,13,-1
Group 3,BB,1.5,15,14,994,12,2018,12,0
Group 3,BB,1.5,15,14,995,11,2018,11,0
Group 3,BB,1.5,15,14,996,12,2018,10,2
Group 3,BB,1.5,15,14,997,11,2018,11,0
Group 3,BB,1.5,15,14,998,6,2018,10,-4
Group 3,BB,1.5,15,14,999,11,2018,7,4
Group 3,BB,1.5,15,14,1000,10,2018,11,-1
Group 3,BB,1.5,15,14,1001,14,2018,12,2
Group 3,BB,1.5,15,14,1002,8,2018,12,-4
Group 3,BB,1.5,15,14,1003,10,2018,10,0
Group 3,BB,1.5,15,14,1004,13,2018,11,2
Group 3,BB,1.5,15,14,1005,10,2018,13,-3
Group 3,BB,1.5,15,14,1006,12,2018,8,4
Group 3,BB,1.5,15,14,1007,12,2018,8,4
Group 3,BB,1.5,15,14,1008,11,2018,11,0
Group 3,BB,1.5,15,14,1009,9,2018,9,0
Group 3,BB,1.5,15,14,1010,12,2018,9,3
Group 3,BB,1.5,15,14,1011,11,2018,5,6
Group 3,BB,1.5,15,14,1012,6,2018,10,-4
Group 3,BB,1.5,15,14,1013,10,2018,9,1
Group 3,BB,1.5,15,14,1014,12,2018,10,2
Group 3,BB,1.5,15,14,1015,12,2018,12,0
Group 3,BB,1.5,15,14,1016,13,2018,11,2
Group 3,BB,1.5,15,14,1017,12,2018,9,3
Group 3,BB,1.5,15,14,1018,8,2018,11,-3
Group 3,BB,1.5,15,14,1019,12,2018,13,-1
Group 3,BB,1.5,15,14,1020,10,2018,12,-2
Group 3,BB,1.5,15,14,1021,10,2018,13,-3
Group 3,BB,1.5,15,14,1022,11,2018,11,0
Group 3,BB,1.5,15,14,1023,8,2018,9,-1
Group 3,BB,1.5,15,14,1024,12,2018,6,6
Group 3,BB,1.5,15,14,1025,7,2018,9,-2
Group 3,BB,1.5,15,14,1026,12,2018,10,2
Group 3,BB,1.5,15,14,1027,12,2018,6,6
Group 3,BB,1.5,15,14,1028,11,2018,12,-1
Group 3,BB,1.5,15,14,1029,8,2018,12,-4
Group 3,BB,1.5,15,14,1030,10,2018,11,-1
Group 3,BB,1.5,15,14,1031,9,2018,12,-3
Group 3,BB,1.5,15,14,1032,11,2018,8,3
Group 3,BB,1.5,15,14,1033,10,2018,11,-1
Group 3,BB,1.5,15,14,1034,13,2018,9,4
Group 3,BB,1.5,15,14,1035,10,2018,10,0
Group 3,BB,1.5,15,14,1036,10,2018,11,-1
Group 3,BB,1.5,15,14,1037,14,2018,13,1
Group 3,BB,1.5,15,14,1038,9,2018,11,-2
Group 3,BB,1.5,15,14,1039,8,2018,7,1
Group 3,BB,1.5,15,14,1040,13,2018,7,6
Group 3,BB,1.5,15,14,1041,11,2018,12,-1
Group 3,BB,1.5,15,14,1042,14,2018,8,6
Group 3,BB,1.5,15,14,1043,10,2018,8,2
Group 3,BB,1.5,15,14,1044,11,2018,11,0
Group 3,BB,1.5,15,14,1045,10,2018,10,0
Group 3,BB,1.5,15,14,1046,8,2018,9,-1
Group 3,BB,1.5,15,14,1047,11,2018,7,4
Group 3,BB,1.5,15,14,1048,12,2018,10,2
Group 3,BB,1.5,15,14,1049,11,2018,10,1
Group 3,BB,1.5,15,14,1050,12,2018,10,2
Group 3,BB,1.5,15,14,1051,13,2018,12,1
Group 3,BB,1.5,15,14,1052,12,2018,11,1
Group 3,BB,1.5,15,14,1053,9,2018,11,-2
Group 3,BB,1.5,15,14,1054,13,2018,10,3
Group 3,BB,1.5,15,14,1055,10,2018,14,-4
Group 3,BB,1.5,15,14,1056,12,2018,11,1
Group 3,BB,1.5,15,14,1057,11,2018,10,1
Group 3,BB,1.5,15,14,1058,12,2018,12,0
Group 3,BB,1.5,15,14,1059,12,2018,11,1
Group 3,BB,1.5,15,14,1060,10,2018,9,1
Group 3,BB,1.5,15,14,1061,10,2018,7,3
Group 3,BB,1.5,15,14,1062,8,2018,11,-3
Group 3,BB,1.5,15,14,1063,10,2018,10,0
Group 3,BB,1.5,15,14,1064,11,2018,13,-2
Group 3,BB,1.5,15,14,1065,12,2018,8,4
Group 3,BB,1.5,15,14,1066,10,2018,13,-3
Group 3,BB,1.5,15,14,1067,8,2018,10,-2
Group 3,BB,1.5,15,14,1068,10,2018,14,-4
Group 3,BB,1.5,15,14,1069,10,2018,11,-1
Group 3,BB,1.5,15,14,1070,9,2018,13,-4
Group 3,BB,1.5,15,14,1071,4,2018,7,-3
Group 3,BB,1.5,15,14,1072,11,2018,12,-1
Group 3,BB,1.5,15,14,1073,12,2018,9,3
Group 3,BB,1.5,15,14,1074,13,2018,9,4
Group 3,BB,1.5,15,14,1075,13,2018,10,3
Group 3,BB,1.5,15,14,1076,9,2018,11,-2
Group 3,BB,1.5,15,14,1077,10,2018,7,3
Group 3,BB,1.5,15,14,1078,10,2018,13,-3
Group 3,BB,1.5,15,14,1079,11,2018,13,-2
Group 3,BB,1.5,15,14,1080,12,2018,10,2
Group 3,BB,1.5,15,14,1081,8,2018,8,0
Group 3,BB,1.5,15,14,1082,10,2018,13,-3
Group 3,BB,1.5,15,14,1083,12,2018,13,-1
Group 3,BB,1.5,15,14,1084,11,2018,9,2
Group 3,BB,1.5,15,14,1085,7,2018,9,-2
Group 3,BB,1.5,15,14,1086,7,2018,9,-2
Group 3,BB,1.5,15,14,1087,9,2018,13,-4
Group 3,BB,1.5,15,14,1088,12,2018,11,1
Group 3,BB,1.5,15,14,1089,12,2018,8,4
Group 3,BB,1.5,15,14,1090,10,2018,11,-1
Group 3,BB,1.5,15,14,1091,14,2018,11,3
Group 3,BB,1.5,15,14,1092,8,2018,10,-2
Group 3,BB,1.5,15,14,1093,12,2018,10,2
Group 3,BB,1.5,15,14,1094,12,2018,12,0
Group 3,BB,1.5,15,14,1095,10,2018,11,-1
Group 3,BB,1.5,15,14,1096,10,2018,8,2
Group 3,BB,1.5,15,14,1097,9,2018,6,3
Group 3,BB,1.5,15,14,1098,13,2018,11,2
Group 3,BB,1.5,15,14,1099,8,2018,8,0
Group 3,BB,1.5,15,14,1100,10,2018,12,-2
Group 3,BB,1.5,15,14,1101,7,2018,11,-4
Group 3,BB,1.5,15,14,1102,12,2018,7,5
Group 3,BB,1.5,15,14,1103,10,2018,5,5
Group 3,BB,1.5,15,14,1104,11,2018,11,0
Group 3,BB,1.5,15,14,1105,10,2018,10,0
Group 3,BB,1.5,15,14,1106,11,2018,10,1
Group 3,BB,1.5,15,14,1107,10,2018,10,0
Group 3,BB,1.5,15,14,1108,13,2018,9,4
Group 3,BB,1.5,15,14,1109,9,2018,7,2
Group 3,BB,1.5,15,14,1110,10,2018,9,1
Group 3,BB,1.5,15,14,1111,8,2018,13,-5
Group 3,BB,1.5,15,14,1112,12,2018,14,-2
Group 3,BB,1.5,15,14,1113,11,2018,10,1
Group 3,BB,1.5,15,14,1114,10,2018,7,3
Group 3,BB,1.5,15,14,1115,12,2018,9,3
Group 3,BB,1.5,15,14,1116,10,2018,11,-1
Group 3,BB,1.5,15,14,1117,11,2018,9,2
Group 3,BB,1.5,15,14,1118,9,2018,11,-2
Group 3,BB,1.5,15,14,1119,9,2018,13,-4
Group 3,BB,1.5,15,14,1120,11,2018,10,1
Group 3,BB,1.5,15,14,1121,8,2018,12,-4
Group 3,BB,1.5,15,14,1122,11,2018,12,-1
Group 3,BB,1.5,15,14,1123,12,2018,11,1
Group 3,BB,1.5,15,14,1124,10,2018,9,1
Group 3,BB,1.5,15,14,1125,12,2018,8,4
Group 3,BB,1.5,15,14,1126,11,2018,12,-1
Group 3,BB,1.5,15,14,1127,11,2018,11,0
Group 3,BB,1.5,15,14,1128,9,2018,13,-4
Group 3,BB,1.5,15,14,1129,10,2018,8,2
Group 3,BB,1.5,15,14,1130,10,2018,9,1
Group 3,BB,1.5,15,14,1131,6,2018,9,-3
Group 3,BB,1.5,15,14,1132,10,2018,9,1
Group 3,BB,1.5,15,14,1133,7,2018,10,-3
Group 3,BB,1.5,15,14,1134,12,2018,9,3
Group 3,BB,1.5,15,14,1135,12,2018,9,3
Group 3,BB,1.5,15,14,1136,7,2018,8,-1
Group 3,BB,1.5,15,14,1137,8,2018,11,-3
Group 3,BB,1.5,15,14,1138,7,2018,10,-3
Group 3,BB,1.5,15,14,1139,8,2018,9,-1
Group 3,BB,1.5,15,14,1140,12,2018,13,-1
Group 3,BB,1.5,15,14,1141,5,2018,11,-6
Group 3,BB,1.5,15,14,1142,10,2018,11,-1
Group 3,BB,1.5,15,14,1143,13,2018,10,3
Group 3,BB,1.5,15,14,1144,11,2018,7,4
Group 3,BB,1.5,15,14,1145,10,2018,13,-3
Group 3,BB,1.5,15,14,1146,11,2018,8,3
Group 3,BB,1.5,15,14,1147,13,2018,6,7
Group 3,BB,1.5,15,14,1148,6,2018,14,-8
Group 3,BB,1.5,15,14,1149,11,2018,9,2
Group 3,BB,1.5,15,14,1150,10,2018,10,0
Group 3,BB,1.5,15,14,1151,10,2018,12,-2
Group 3,BB,1.5,15,14,1152,7,2018,12,-5
Group 3,BB,1.5,15,14,1153,12,2018,9,3
Group 3,BB,1.5,15,14,1154,12,2018,7,5
Group 3,BB,1.5,15,14,1155,12,2018,5,7
Group 3,BB,1.5,15,14,1156,9,2018,11,-2
Group 3,BB,1.5,15,14,1157,11,2018,12,-1
Group 3,BB,1.5,15,14,1158,5,2018,8,-3
Group 3,BB,1.5,15,14,1159,12,2018,10,2
Group 3,BB,1.5,15,14,1160,11,2018,11,0
Group 3,BB,1.5,15,14,1161,8,2018,7,1
Group 3,BB,1.5,15,14,1162,10,2018,9,1
Group 3,BB,1.5,15,14,1163,12,2018,12,0
Group 3,BB,1.5,15,14,1164,10,2018,13,-3
Group 3,BB,1.5,15,14,1165,12,2018,12,0
Group 3,BB,1.5,15,14,1166,14,2018,11,3
Group 3,BB,1.5,15,14,1167,12,2018,10,2
Group 3,BB,1.5,15,14,1168,10,2018,12,-2
Group 3,BB,1.5,15,14,1169,11,2018,8,3
Group 3,BB,1.5,15,14,1170,12,2018,13,-1
Group 3,BB,1.5,15,14,1171,11,2018,10,1
Group 3,BB,1.5,15,14,1172,7,2018,12,-5
Group 3,BB,1.5,15,14,1173,11,2018,9,2
Group 3,BB,1.5,15,14,1174,11,2018,11,0
Group 3,BB,1.5,15,14,1175,12,2018,8,4
Group 3,BB,1.5,15,14,1176,11,2018,14,-3
Group 3,BB,1.5,15,14,1177,11,2018,13,-2
Group 3,BB,1.5,15,14,1178,13,2018,11,2
Group 3,BB,1.5,15,14,1179,10,2018,12,-2
Group 3,BB,1.5,15,14,1180,13,2018,12,1
Group 3,BB,1.5,15,14,1181,10,2018,9,1
Group 3,BB,1.5,15,14,1182,10,2018,11,-1
Group 3,BB,1.5,15,14,1183,11,2018,9,2
Group 3,BB,1.5,15,14,1184,12,2018,13,-1
Group 3,BB,1.5,15,14,1185,11,2018,12,-1
Group 3,BB,1.5,15,14,1186,8,2018,11,-3
Group 3,BB,1.5,15,14,1187,11,2018,9,2
Group 3,BB,1.5,15,14,1188,9,2018,10,-1
Group 3,BB,1.5,15,14,1189,11,2018,10,1
Group 3,BB,1.5,15,14,1190,11,2018,9,2
Group 3,BB,1.5,15,14,1191,10,2018,13,-3
Group 3,BB,1.5,15,14,1192,10,2018,9,1
Group 3,BB,1.5,15,14,1193,12,2018,12,0
Group 3,BB,1.5,15,14,1194,12,2018,13,-1
Group 3,BB,1.5,15,14,1195,14,2018,12,2
Group 3,BB,1.5,15,14,1196,10,2018,11,-1
Group 3,BB,1.5,15,14,1197,12,2018,13,-1
Group 3,BB,1.5,15,14,1198,6,2018,7,-1
Group 3,BB,1.5,15,14,1199,9,2018,5,4
Group 3,BB,1.5,15,14,1200,10,2018,9,1
Group 3,BB,1.5,15,14,1201,9,2018,11,-2
Group 3,BB,1.5,15,14,1202,9,2018,8,1
Group 3,BB,1.5,15,14,1203,11,2018,9,2
Group 3,BB,1.5,15,14,1204,9,2018,10,-1
Group 3,BB,1.5,15,14,1205,9,2018,10,-1
Group 3,BB,1.5,15,14,1206,12,2018,10,2
Group 3,BB,1.5,15,14,1207,13,2018,10,3
Group 3,BB,1.5,15,14,1208,11,2018,10,1
Group 3,BB,1.5,15,14,1209,10,2018,9,1
Group 3,BB,1.5,15,14,1210,12,2018,10,2
Group 3,BB,1.5,15,14,1211,13,2018,11,2
Group 3,BB,1.5,15,14,1212,12,2018,10,2
Group 3,BB,1.5,15,14,1213,13,2018,10,3
Group 3,BB,1.5,15,14,1214,14,2018,11,3
Group 3,BB,1.5,15,14,1215,9,2018,12,-3
Group 3,BB,1.5,15,14,1216,11,2018,13,-2
Group 3,BB,1.5,15,14,1217,11,2018,8,3
Group 3,BB,1.5,15,14,1218,13,2018,9,4
Group 3,BB,1.5,15,14,1219,10,2018,11,-1
Group 3,BB,1.5,15,14,1220,10,2018,11,-1
Group 3,BB,1.5,15,14,1221,11,2018,8,3
Group 3,BB,1.5,15,14,1222,12,2018,11,1
Group 3,BB,1.5,15,14,1223,8,2018,10,-2
Group 3,BB,1.5,15,14,1224,11,2018,10,1
Group 3,BB,1.5,15,14,1225,8,2018,10,-2
Group 3,BB,1.5,15,14,1226,10,2018,10,0
Group 3,BB,1.5,15,14,1227,14,2018,11,3
Group 3,BB,1.5,15,14,1228,13,2018,13,0
Group 3,BB,1.5,15,14,1229,10,2018,9,1
Group 3,BB,1.5,15,14,1230,13,2018,13,0
Group 3,BB,1.5,15,14,1231,9,2018,9,0
Group 3,BB,1.5,15,14,1232,13,2018,11,2
Group 3,BB,1.5,15,14,1233,12,2018,12,0
Group 3,BB,1.5,15,14,1234,12,2018,10,2
Group 3,BB,1.5,15,14,1235,13,2018,7,6
Group 3,BB,1.5,15,14,1236,14,2018,10,4
Group 3,BB,1.5,15,14,1237,11,2018,12,-1
Group 3,BB,1.5,15,14,1238,12,2018,9,3
Group 3,BB,1.5,15,14,1239,10,2018,12,-2
Group 3,BB,1.5,15,14,1240,10,2018,9,1
Group 3,BB,1.5,15,14,1241,11,2018,6,5
Group 3,BB,1.5,15,14,1242,9,2018,8,1
Group 3,BB,1.5,15,14,1243,6,2018,7,-1
Group 3,BB,1.5,15,14,1244,14,2018,12,2
Group 3,BB,1.5,15,14,1245,13,2018,13,0
Group 3,BB,1.5,15,14,1246,11,2018,13,-2
Group 3,BB,1.5,15,14,1247,11,2018,12,-1
Group 3,BB,1.5,15,14,1248,10,2018,13,-3
Group 3,BB,1.5,15,14,1249,11,2018,13,-2
Group 3,BB,1.5,15,14,1250,9,2018,10,-1
Group 3,BB,1.5,15,14,1251,10,2018,10,0
Group 3,BB,1.5,15,14,1252,8,2018,13,-5
Group 3,BB,1.5,15,14,1253,12,2018,9,3
Group 3,BB,1.5,15,14,1254,10,2018,7,3
Group 3,BB,1.5,15,14,1255,10,2018,6,4
Group 3,BB,1.5,15,14,1256,11,2018,7,4
Group 3,BB,1.5,15,14,1257,12,2018,13,-1
Group 3,BB,1.5,15,14,1258,8,2018,11,-3
Group 3,BB,1.5,15,14,1259,12,2018,12,0
Group 3,BB,1.5,15,14,1260,12,2018,11,1
Group 3,BB,1.5,15,14,1261,14,2018,7,7
Group 3,BB,1.5,15,14,1262,11,2018,11,0
Group 3,BB,1.5,15,14,1263,9,2018,9,0
Group 3,BB,1.5,15,14,1264,8,2018,10,-2
Group 3,BB,1.5,15,14,1265,7,2018,11,-4
Group 3,BB,1.5,15,14,1266,12,2018,10,2
Group 3,BB,1.5,15,14,1267,9,2018,12,-3
Group 3,BB,1.5,15,14,1268,8,2018,10,-2
Group 3,BB,1.5,15,14,1269,11,2018,11,0
Group 3,BB,1.5,15,14,1270,10,2018,12,-2
Group 3,BB,1.5,15,14,1271,10,2018,12,-2
Group 3,BB,1.5,15,14,1272,13,2018,12,1
Group 3,BB,1.5,15,14,1273,12,2018,10,2
Group 3,BB,1.5,15,14,1274,8,2018,12,-4
Group 3,BB,1.5,15,14,1275,10,2018,12,-2
Group 3,BB,1.5,15,14,1276,10,2018,10,0
Group 3,BB,1.5,15,14,1277,11,2018,12,-1
Group 3,BB,1.5,15,14,1278,7,2018,11,-4
Group 3,BB,1.5,15,14,1279,13,2018,11,2
Group 3,BB,1.5,15,14,1280,6,2018,9,-3
Group 3,BB,1.5,15,14,1281,10,2018,10,0
Group 3,BB,1.5,15,14,1282,11,2018,10,1
Group 3,BB,1.5,15,14,1283,9,2018,12,-3
Group 3,BB,1.5,15,14,1284,11,2018,10,1
Group 3,BB,1.5,15,14,1285,9,2018,10,-1
Group 3,BB,1.5,15,14,1286,10,2018,11,-1
Group 3,BB,1.5,15,14,1287,12,2018,7,5
Group 3,BB,1.5,15,14,1288,14,2018,11,3
Group 3,BB,1.5,15,14,1289,11,2018,11,0
Group 3,BB,1.5,15,14,1290,12,2018,9,3
Group 3,BB,1.5,15,14,1291,10,2018,11,-1
Group 3,BB,1.5,15,14,1292,11,2018,11,0
Group 3,BB,1.5,15,14,1293,12,2018,9,3
Group 3,BB,1.5,15,14,1294,12,2018,10,2
Group 3,BB,1.5,15,14,1295,9,2018,9,0
Group 3,BB,1.5,15,14,1296,10,2018,9,1
Group 3,BB,1.5,15,14,1297,9,2018,11,-2
Group 3,BB,1.5,15,14,1298,9,2018,10,-1
Group 3,BB,1.5,15,14,1299,8,2018,10,-2
Group 3,BB,1.5,15,14,1300,10,2018,9,1
Group 3,BB,1.5,15,14,1301,12,2018,12,0
Group 3,BB,1.5,15,14,1302,10,2018,5,5
Group 3,BB,1.5,15,14,1303,7,2018,12,-5
Group 3,BB,1.5,15,14,1304,6,2018,10,-4
Group 3,BB,1.5,15,14,1305,12,2018,7,5
Group 3,BB,1.5,15,14,1306,7,2018,11,-4
Group 3,BB,1.5,15,14,1307,8,2018,10,-2
Group 3,BB,1.5,15,14,1308,12,2018,8,4
Group 3,BB,1.5,15,14,1309,11,2018,10,1
Group 3,BB,1.5,15,14,1310,8,2018,9,-1
Group 3,BB,1.5,15,14,1311,13,2018,9,4
Group 3,BB,1.5,15,14,1312,9,2018,11,-2
Group 3,BB,1.5,15,14,1313,14,2018,10,4
Group 3,BB,1.5,15,14,1314,10,2018,8,2
Group 3,BB,1.5,15,14,1315,7,2018,10,-3
Group 3,BB,1.5,15,14,1316,8,2018,10,-2
Group 3,BB,1.5,15,14,1317,9,2018,8,1
Group 3,BB,1.5,15,14,1318,11,2018,6,5
Group 3,BB,1.5,15,14,1319,10,2018,13,-3
Group 3,BB,1.5,15,14,1320,7,2018,11,-4
Group 3,BB,1.5,15,14,1321,9,2018,7,2
Group 3,BB,1.5,15,14,1322,12,2018,7,5
Group 3,BB,1.5,15,14,1323,13,2018,7,6
Group 3,BB,1.5,15,14,1324,12,2018,7,5
Group 3,BB,1.5,15,14,1325,7,2018,7,0
Group 3,BB,1.5,15,14,1326,11,2018,9,2
Group 3,BB,1.5,15,14,1327,9,2018,9,0
Group 3,BB,1.5,15,14,1328,13,2018,9,4
Group 3,BB,1.5,15,14,1329,9,2018,6,3
Group 3,BB,1.5,15,14,1330,9,2018,5,4
Group 3,BB,1.5,15,14,1331,9,2018,9,0
Group 3,BB,1.5,15,14,1332,14,2018,6,8
Group 3,BB,1.5,15,14,1333,11,2018,5,6
Group 3,BB,1.5,15,14,1334,11,2018,6,5
Group 3,BB,1.5,15,14,1335,8,2018,9,-1
Group 3,BB,1.5,15,14,1336,11,2018,11,0
Group 3,BB,1.5,15,14,1337,13,2018,9,4
Group 3,BB,1.5,15,14,1338,10,2018,9,1
Group 3,BB,1.5,15,14,1339,13,2018,11,2
Group 3,BB,1.5,15,14,1340,13,2018,10,3
Group 3,BB,1.5,15,14,1341,11,2018,10,1
Group 3,BB,1.5,15,14,1342,7,2018,8,-1
Group 3,BB,1.5,15,14,1343,12,2018,8,4
Group 3,BB,1.5,15,14,1344,8,2018,8,0
Group 3,BB,1.5,15,14,1345,6,2018,12,-6
Group 3,BB,1.5,15,14,1346,10,2018,9,1
Group 3,BB,1.5,15,14,1347,8,2018,14,-6
Group 3,BB,1.5,15,14,1348,13,2018,10,3
Group 3,BB,1.5,15,14,1349,12,2018,11,1
Group 3,BB,1.5,15,14,1350,11,2018,12,-1
Group 3,BB,1.5,15,14,1351,11,2018,6,5
Group 3,BB,1.5,15,14,1352,11,2018,9,2
Group 3,BB,1.5,15,14,1353,9,2018,10,-1
Group 3,BB,1.5,15,14,1354,11,2018,9,2
Group 3,BB,1.5,15,14,1355,12,2018,12,0
Group 3,BB,1.5,15,14,1356,8,2018,8,0
Group 3,BB,1.5,15,14,1357,11,2018,10,1
Group 3,BB,1.5,15,14,1358,11,2018,10,1
Group 3,BB,1.5,15,14,1359,10,2018,8,2
Group 3,BB,1.5,15,14,1360,11,2018,12,-1
Group 3,BB,1.5,15,14,1361,8,2018,8,0
Group 3,BB,1.5,15,14,1362,9,2018,7,2
Group 3,BB,1.5,15,14,1363,8,2018,11,-3
Group 3,BB,1.5,15,14,1364,9,2018,11,-2
Group 3,BB,1.5,15,14,1365,9,2018,9,0
Group 3,BB,1.5,15,14,1366,12,2018,12,0
Group 3,BB,1.5,15,14,1367,11,2018,9,2
Group 3,BB,1.5,15,14,1368,13,2018,14,-1
Group 3,BB,1.5,15,14,1369,11,2018,8,3
Group 3,BB,1.5,15,14,1370,12,2018,11,1
Group 3,BB,1.5,15,14,1371,11,2018,10,1
Group 3,BB,1.5,15,14,1372,11,2018,14,-3
Group 3,BB,1.5,15,14,1373,10,2018,10,0
Group 3,BB,1.5,15,14,1374,10,2018,7,3
Group 3,BB,1.5,15,14,1375,13,2018,10,3
Group 3,BB,1.5,15,14,1376,11,2018,7,4
Group 3,BB,1.5,15,14,1377,12,2018,8,4
Group 3,BB,1.5,15,14,1378,13,2018,9,4
Group 3,BB,1.5,15,14,1379,8,2018,8,0
Group 3,BB,1.5,15,14,1380,11,2018,10,1
Group 3,BB,1.5,15,14,1381,11,2018,12,-1
Group 3,BB,1.5,15,14,1382,12,2018,10,2
Group 3,BB,1.5,15,14,1383,14,2018,8,6
Group 3,BB,1.5,15,14,1384,9,2018,13,-4
Group 3,BB,1.5,15,14,1385,10,2018,12,-2
Group 3,BB,1.5,15,14,1386,9,2018,10,-1
Group 3,BB,1.5,15,14,1387,12,2018,12,0
Group 3,BB,1.5,15,14,1388,10,2018,11,-1
Group 3,BB,1.5,15,14,1389,8,2018,11,-3
Group 3,BB,1.5,15,14,1390,11,2018,9,2
Group 3,BB,1.5,15,14,1391,12,2018,7,5
Group 3,BB,1.5,15,14,1392,11,2018,11,0
Group 3,BB,1.5,15,14,1393,12,2018,13,-1
Group 3,BB,1.5,15,14,1394,14,2018,9,5
Group 3,BB,1.5,15,14,1395,10,2018,10,0
Group 3,BB,1.5,15,14,1396,7,2018,12,-5
Group 3,BB,1.5,15,14,1397,9,2018,9,0
Group 3,BB,1.5,15,14,1398,9,2018,11,-2
Group 3,BB,1.5,15,14,1399,10,2018,10,0
Group 3,BB,1.5,15,14,1400,9,2018,11,-2
Group 3,BB,1.5,15,14,1401,9,2018,7,2
Group 3,BB,1.5,15,14,1402,13,2018,13,0
Group 3,BB,1.5,15,14,1403,9,2018,9,0
Group 3,BB,1.5,15,14,1404,10,2018,10,0
Group 3,BB,1.5,15,14,1405,13,2018,10,3
Group 3,BB,1.5,15,14,1406,11,2018,8,3
Group 3,BB,1.5,15,14,1407,11,2018,10,1
Group 3,BB,1.5,15,14,1408,9,2018,8,1
Group 3,BB,1.5,15,14,1409,11,2018,8,3
Group 3,BB,1.5,15,14,1410,8,2018,11,-3
Group 3,BB,1.5,15,14,1411,12,2018,12,0
Group 3,BB,1.5,15,14,1412,12,2018,9,3
Group 3,BB,1.5,15,14,1413,12,2018,12,0
Group 3,BB,1.5,15,14,1414,11,2018,10,1
Group 3,BB,1.5,15,14,1415,12,2018,10,2
Group 3,BB,1.5,15,14,1416,9,2018,9,0
Group 3,BB,1.5,15,14,1417,13,2018,13,0
Group 3,BB,1.5,15,14,1418,12,2018,11,1
Group 3,BB,1.5,15,14,1419,12,2018,10,2
Group 3,BB,1.5,15,14,1420,12,2018,10,2
Group 3,BB,1.5,15,14,1421,10,2018,12,-2
Group 3,BB,1.5,15,14,1422,10,2018,11,-1
Group 3,BB,1.5,15,14,1423,9,2018,6,3
Group 3,BB,1.5,15,14,1424,10,2018,7,3
Group 3,BB,1.5,15,14,1425,9,2018,12,-3
Group 3,BB,1.5,15,14,1426,11,2018,6,5
Group 3,BB,1.5,15,14,1427,8,2018,10,-2
Group 3,BB,1.5,15,14,1428,13,2018,11,2
Group 3,BB,1.5,15,14,1429,9,2018,11,-2
Group 3,BB,1.5,15,14,1430,11,2018,11,0
Group 3,BB,1.5,15,14,1431,12,2018,8,4
Group 3,BB,1.5,15,14,1432,11,2018,10,1
Group 3,BB,1.5,15,14,1433,8,2018,10,-2
Group 3,BB,1.5,15,14,1434,11,2018,11,0
Group 3,BB,1.5,15,14,1435,8,2018,7,1
Group 3,BB,1.5,15,14,1436,11,2018,11,0
Group 3,BB,1.5,15,14,1437,8,2018,14,-6
Group 3,BB,1.5,15,14,1438,11,2018,12,-1
Group 3,BB,1.5,15,14,1439,5,2018,9,-4
Group 3,BB,1.5,15,14,1440,13,2018,12,1
Group 3,BB,1.5,15,14,1441,14,2018,10,4
Group 3,BB,1.5,15,14,1442,12,2018,7,5
Group 3,BB,1.5,15,14,1443,12,2018,10,2
Group 3,BB,1.5,15,14,1444,11,2018,8,3
Group 3,BB,1.5,15,14,1445,11,2018,12,-1
Group 3,BB,1.5,15,14,1446,12,2018,11,1
Group 3,BB,1.5,15,14,1447,12,2018,11,1
Group 3,BB,1.5,15,14,1448,11,2018,11,0
Group 3,BB,1.5,15,14,1449,12,2018,10,2
Group 3,BB,1.5,15,14,1450,11,2018,13,-2
Group 3,BB,1.5,15,14,1451,8,2018,10,-2
Group 3,BB,1.5,15,14,1452,10,2018,11,-1
Group 3,BB,1.5,15,14,1453,7,2018,9,-2
Group 3,BB,1.5,15,14,1454,6,2018,13,-7
Group 3,BB,1.5,15,14,1455,13,2018,10,3
Group 3,BB,1.5,15,14,1456,12,2018,9,3
Group 3,BB,1.5,15,14,1457,8,2018,10,-2
Group 3,BB,1.5,15,14,1458,11,2018,12,-1
Group 3,BB,1.5,15,14,1459,6,2018,11,-5
Group 3,BB,1.5,15,14,1460,12,2018,6,6
Group 3,BB,1.5,15,14,1461,10,2018,13,-3
Group 3,BB,1.5,15,14,1462,11,2018,10,1
Group 3,BB,1.5,15,14,1463,11,2018,9,2
Group 3,BB,1.5,15,14,1464,13,2018,13,0
Group 3,BB,1.5,15,14,1465,14,2018,13,1
Group 3,BB,1.5,15,14,1466,8,2018,12,-4
Group 3,BB,1.5,15,14,1467,13,2018,7,6
Group 3,BB,1.5,15,14,1468,11,2018,11,0
Group 3,BB,1.5,15,14,1469,10,2018,8,2
Group 3,BB,1.5,15,14,1470,9,2018,10,-1
Group 3,BB,1.5,15,14,1471,11,2018,9,2
Group 3,BB,1.5,15,14,1472,12,2018,10,2
Group 3,BB,1.5,15,14,1473,14,2018,11,3
Group 3,BB,1.5,15,14,1474,12,2018,11,1
Group 3,BB,1.5,15,14,1475,10,2018,12,-2
Group 3,BB,1.5,15,14,1476,10,2018,9,1
Group 3,BB,1.5,15,14,1477,12,2018,5,7
Group 3,BB,1.5,15,14,1478,13,2018,7,6
Group 3,BB,1.5,15,14,1479,8,2018,12,-4
Group 3,BB,1.5,15,14,1480,10,2018,8,2
Group 3,BB,1.5,15,14,1481,13,2018,11,2
Group 3,BB,1.5,15,14,1482,12,2018,12,0
Group 3,BB,1.5,15,14,1483,13,2018,9,4
Group 3,BB,1.5,15,14,1484,10,2018,8,2
Group 3,BB,1.5,15,14,1485,12,2018,6,6
Group 3,BB,1.5,15,14,1486,13,2018,10,3
Group 3,BB,1.5,15,14,1487,9,2018,10,-1
Group 3,BB,1.5,15,14,1488,11,2018,8,3
Group 3,BB,1.5,15,14,1489,11,2018,10,1
Group 3,BB,1.5,15,14,1490,13,2018,9,4
Group 3,BB,1.5,15,14,1491,12,2018,11,1
Group 3,BB,1.5,15,14,1492,8,2018,7,1
Group 3,BB,1.5,15,14,1493,12,2018,9,3
Group 3,BB,1.5,15,14,1494,8,2018,10,-2
Group 3,BB,1.5,15,14,1495,11,2018,10,1
Group 3,BB,1.5,15,14,1496,11,2018,9,2
Group 3,BB,1.5,15,14,1497,9,2018,8,1
Group 3,BB,1.5,15,14,1498,8,2018,9,-1
Group 3,BB,1.5,15,14,1499,8,2018,11,-3
Group 3,BB,1.5,15,14,1500,11,2018,7,4
Group 3,BB,1.5,15,14,1501,12,2018,9,3
Group 3,BB,1.5,15,14,1502,10,2018,7,3
Group 3,BB,1.5,15,14,1503,10,2018,12,-2
Group 3,BB,1.5,15,14,1504,7,2018,9,-2
Group 3,BB,1.5,15,14,1505,12,2018,11,1
Group 3,BB,1.5,15,14,1506,8,2018,10,-2
Group 3,BB,1.5,15,14,1507,12,2018,8,4
Group 3,BB,1.5,15,14,1508,11,2018,9,2
Group 3,BB,1.5,15,14,1509,10,2018,7,3
Group 3,BB,1.5,15,14,1510,11,2018,9,2
Group 3,BB,1.5,15,14,1511,12,2018,13,-1
Group 3,BB,1.5,15,14,1512,12,2018,12,0
Group 3,BB,1.5,15,14,1513,6,2018,11,-5
Group 3,BB,1.5,15,14,1514,13,2018,9,4
Group 3,BB,1.5,15,14,1515,14,2018,12,2
Group 3,BB,1.5,15,14,1516,14,2018,14,0
Group 3,BB,1.5,15,14,1517,9,2018,12,-3
Group 3,BB,1.5,15,14,1518,9,2018,8,1
Group 3,BB,1.5,15,14,1519,9,2018,11,-2
Group 3,BB,1.5,15,14,1520,10,2018,6,4
Group 3,BB,1.5,15,14,1521,7,2018,9,-2
Group 3,BB,1.5,15,14,1522,7,2018,11,-4
Group 3,BB,1.5,15,14,1523,9,2018,8,1
Group 3,BB,1.5,15,14,1524,12,2018,14,-2
Group 3,BB,1.5,15,14,1525,11,2018,13,-2
Group 3,BB,1.5,15,14,1526,9,2018,11,-2
Group 3,BB,1.5,15,14,1527,3,2018,8,-5
Group 3,BB,1.5,15,14,1528,10,2018,7,3
Group 3,BB,1.5,15,14,1529,12,2018,10,2
Group 3,BB,1.5,15,14,1530,8,2018,11,-3
Group 3,BB,1.5,15,14,1531,10,2018,10,0
Group 3,BB,1.5,15,14,1532,13,2018,8,5
Group 3,BB,1.5,15,14,1533,10,2018,11,-1
Group 3,BB,1.5,15,14,1534,14,2018,11,3
Group 3,BB,1.5,15,14,1535,12,2018,12,0
Group 3,BB,1.5,15,14,1536,8,2018,12,-4
Group 3,BB,1.5,15,14,1537,9,2018,12,-3
Group 3,BB,1.5,15,14,1538,10,2018,12,-2
Group 3,BB,1.5,15,14,1539,11,2018,9,2
Group 3,BB,1.5,15,14,1540,11,2018,9,2
Group 3,BB,1.5,15,14,1541,8,2018,10,-2
Group 3,BB,1.5,15,14,1542,10,2018,10,0
Group 3,BB,1.5,15,14,1543,10,2018,8,2
Group 3,BB,1.5,15,14,1544,10,2018,10,0
Group 3,BB,1.5,15,14,1545,11,2018,10,1
Group 3,BB,1.5,15,14,1546,8,2018,9,-1
Group 3,BB,1.5,15,14,1547,7,2018,11,-4
Group 3,BB,1.5,15,14,1548,13,2018,10,3
Group 3,BB,1.5,15,14,1549,10,2018,12,-2
Group 3,BB,1.5,15,14,1550,11,2018,10,1
Group 3,BB,1.5,15,14,1551,11,2018,11,0
Group 3,BB,1.5,15,14,1552,13,2018,5,8
Group 3,BB,1.5,15,14,1553,10,2018,11,-1
Group 3,BB,1.5,15,14,1554,10,2018,11,-1
Group 3,BB,1.5,15,14,1555,11,2018,9,2
Group 3,BB,1.5,15,14,1556,13,2018,10,3
Group 3,BB,1.5,15,14,1557,13,2018,10,3
Group 3,BB,1.5,15,14,1558,11,2018,10,1
Group 3,BB,1.5,15,14,1559,11,2018,10,1
Group 3,BB,1.5,15,14,1560,11,2018,11,0
Group 3,BB,1.5,15,14,1561,10,2018,6,4
Group 3,BB,1.5,15,14,1562,12,2018,14,-2
Group 3,BB,1.5,15,14,1563,10,2018,8,2
Group 3,BB,1.5,15,14,1564,11,2018,8,3
Group 3,BB,1.5,15,14,1565,11,2018,9,2
Group 3,BB,1.5,15,14,1566,9,2018,11,-2
Group 3,BB,1.5,15,14,1567,11,2018,11,0
Group 3,BB,1.5,15,14,1568,10,2018,8,2
Group 3,BB,1.5,15,14,1569,10,2018,9,1
Group 3,BB,1.5,15,14,1570,11,2018,5,6
Group 3,BB,1.5,15,14,1571,8,2018,10,-2
Group 3,BB,1.5,15,14,1572,7,2018,11,-4
Group 3,BB,1.5,15,14,1573,12,2018,10,2
Group 3,BB,1.5,15,14,1574,12,2018,9,3
Group 3,BB,1.5,15,14,1575,11,2018,12,-1
Group 3,BB,1.5,15,14,1576,6,2018,9,-3
Group 3,BB,1.5,15,14,1577,10,2018,10,0
Group 3,BB,1.5,15,14,1578,11,2018,9,2
Group 3,BB,1.5,15,14,1579,9,2018,12,-3
Group 3,BB,1.5,15,14,1580,11,2018,10,1
Group 3,BB,1.5,15,14,1581,13,2018,10,3
Group 3,BB,1.5,15,14,1582,12,2018,10,2
Group 3,BB,1.5,15,14,1583,11,2018,9,2
Group 3,BB,1.5,15,14,1584,12,2018,14,-2
Group 3,BB,1.5,15,14,1585,11,2018,14,-3
Group 3,BB,1.5,15,14,1586,13,2018,7,6
Group 3,BB,1.5,15,14,1587,11,2018,10,1
Group 3,BB,1.5,15,14,1588,11,2018,10,1
Group 3,BB,1.5,15,14,1589,11,2018,7,4
Group 3,BB,1.5,15,14,1590,8,2018,12,-4
Group 3,BB,1.5,15,14,1591,13,2018,10,3
Group 3,BB,1.5,15,14,1592,9,2018,10,-1
Group 3,BB,1.5,15,14,1593,10,2018,8,2
Group 3,BB,1.5,15,14,1594,9,2018,8,1
Group 3,BB,1.5,15,14,1595,11,2018,7,4
Group 3,BB,1.5,15,14,1596,11,2018,8,3
Group 3,BB,1.5,15,14,1597,11,2018,7,4
Group 3,BB,1.5,15,14,1598,13,2018,7,6
Group 3,BB,1.5,15,14,1599,11,2018,10,1
Group 3,BB,1.5,15,14,1600,13,2018,8,5
Group 3,BB,1.5,15,14,1601,11,2018,11,0
Group 3,BB,1.5,15,14,1602,12,2018,8,4
Group 3,BB,1.5,15,14,1603,10,2018,10,0
Group 3,BB,1.5,15,14,1604,13,2018,10,3
Group 3,BB,1.5,15,14,1605,11,2018,10,1
Group 3,BB,1.5,15,14,1606,9,2018,10,-1
Group 3,BB,1.5,15,14,1607,11,2018,10,1
Group 3,BB,1.5,15,14,1608,8,2018,13,-5
Group 3,BB,1.5,15,14,1609,12,2018,11,1
Group 3,BB,1.5,15,14,1610,11,2018,11,0
Group 3,BB,1.5,15,14,1611,11,2018,10,1
Group 3,BB,1.5,15,14,1612,8,2018,11,-3
Group 3,BB,1.5,15,14,1613,12,2018,10,2
Group 3,BB,1.5,15,14,1614,10,2018,9,1
Group 3,BB,1.5,15,14,1615,9,2018,10,-1
Group 3,BB,1.5,15,14,1616,9,2018,8,1
Group 3,BB,1.5,15,14,1617,10,2018,13,-3
Group 3,BB,1.5,15,14,1618,8,2018,10,-2
Group 3,BB,1.5,15,14,1619,12,2018,9,3
Group 3,BB,1.5,15,14,1620,11,2018,10,1
Group 3,BB,1.5,15,14,1621,10,2018,7,3
Group 3,BB,1.5,15,14,1622,14,2018,10,4
Group 3,BB,1.5,15,14,1623,9,2018,8,1
Group 3,BB,1.5,15,14,1624,10,2018,9,1
Group 3,BB,1.5,15,14,1625,10,2018,13,-3
Group 3,BB,1.5,15,14,1626,12,2018,9,3
Group 3,BB,1.5,15,14,1627,8,2018,11,-3
Group 3,BB,1.5,15,14,1628,11,2018,9,2
Group 3,BB,1.5,15,14,1629,12,2018,13,-1
Group 3,BB,1.5,15,14,1630,10,2018,10,0
Group 3,BB,1.5,15,14,1631,9,2018,11,-2
Group 3,BB,1.5,15,14,1632,5,2018,11,-6
Group 3,BB,1.5,15,14,1633,7,2018,14,-7
Group 3,BB,1.5,15,14,1634,12,2018,12,0
Group 3,BB,1.5,15,14,1635,13,2018,9,4
Group 3,BB,1.5,15,14,1636,11,2018,10,1
Group 3,BB,1.5,15,14,1637,12,2018,10,2
Group 3,BB,1.5,15,14,1638,10,2018,10,0
Group 3,BB,1.5,15,14,1639,12,2018,11,1
Group 3,BB,1.5,15,14,1640,11,2018,10,1
Group 3,BB,1.5,15,14,1641,11,2018,11,0
Group 3,BB,1.5,15,14,1642,10,2018,7,3
Group 3,BB,1.5,15,14,1643,13,2018,11,2
Group 3,BB,1.5,15,14,1644,10,2018,11,-1
Group 3,BB,1.5,15,14,1645,13,2018,10,3
Group 3,BB,1.5,15,14,1646,12,2018,11,1
Group 3,BB,1.5,15,14,1647,10,2018,9,1
Group 3,BB,1.5,15,14,1648,12,2018,11,1
Group 3,BB,1.5,15,14,1649,7,2018,9,-2
Group 3,BB,1.5,15,14,1650,11,2018,12,-1
Group 3,BB,1.5,15,14,1651,12,2018,13,-1
Group 3,BB,1.5,15,14,1652,9,2018,9,0
Group 3,BB,1.5,15,14,1653,12,2018,12,0
Group 3,BB,1.5,15,14,1654,9,2018,8,1
Group 3,BB,1.5,15,14,1655,8,2018,12,-4
Group 3,BB,1.5,15,14,1656,8,2018,11,-3
Group 3,BB,1.5,15,14,1657,14,2018,10,4
Group 3,BB,1.5,15,14,1658,13,2018,13,0
Group 3,BB,1.5,15,14,1659,13,2018,11,2
Group 3,BB,1.5,15,14,1660,10,2018,13,-3
Group 3,BB,1.5,15,14,1661,12,2018,11,1
Group 3,BB,1.5,15,14,1662,12,2018,8,4
Group 3,BB,1.5,15,14,1663,11,2018,12,-1
Group 3,BB,1.5,15,14,1664,12,2018,10,2
Group 3,BB,1.5,15,14,1665,13,2018,6,7
Group 3,BB,1.5,15,14,1666,10,2018,5,5
Group 3,BB,1.5,15,14,1667,10,2018,8,2
Group 3,BB,1.5,15,14,1668,12,2018,8,4
Group 3,BB,1.5,15,14,1669,10,2018,9,1
Group 3,BB,1.5,15,14,1670,12,2018,13,-1
Group 3,BB,1.5,15,14,1671,11,2018,12,-1
Group 3,BB,1.5,15,14,1672,11,2018,11,0
Group 3,BB,1.5,15,14,1673,12,2018,12,0
Group 3,BB,1.5,15,14,1674,12,2018,9,3
Group 3,BB,1.5,15,14,1675,13,2018,8,5
Group 3,BB,1.5,15,14,1676,13,2018,9,4
Group 3,BB,1.5,15,14,1677,9,2018,9,0
Group 3,BB,1.5,15,14,1678,14,2018,11,3
Group 3,BB,1.5,15,14,1679,11,2018,12,-1
Group 3,BB,1.5,15,14,1680,11,2018,12,-1
Group 3,BB,1.5,15,14,1681,7,2018,9,-2
Group 3,BB,1.5,15,14,1682,13,2018,12,1
Group 3,BB,1.5,15,14,1683,13,2018,12,1
Group 3,BB,1.5,15,14,1684,14,2018,13,1
Group 3,BB,1.5,15,14,1685,10,2018,12,-2
Group 3,BB,1.5,15,14,1686,14,2018,13,1
Group 3,BB,1.5,15,14,1687,13,2018,10,3
Group 3,BB,1.5,15,14,1688,11,2018,13,-2
Group 3,BB,1.5,15,14,1689,10,2018,10,0
Group 3,BB,1.5,15,14,1690,9,2018,12,-3
Group 3,BB,1.5,15,14,1691,13,2018,11,2
Group 3,BB,1.5,15,14,1692,9,2018,11,-2
Group 3,BB,1.5,15,14,1693,11,2018,10,1
Group 3,BB,1.5,15,14,1694,10,2018,12,-2
Group 3,BB,1.5,15,14,1695,9,2018,10,-1
Group 3,BB,1.5,15,14,1696,8,2018,10,-2
Group 3,BB,1.5,15,14,1697,12,2018,9,3
Group 3,BB,1.5,15,14,1698,12,2018,7,5
Group 3,BB,1.5,15,14,1699,12,2018,10,2
Group 3,BB,1.5,15,14,1700,13,2018,10,3
Group 3,BB,1.5,15,14,1701,10,2018,11,-1
Group 3,BB,1.5,15,14,1702,11,2018,8,3
Group 3,BB,1.5,15,14,1703,11,2018,11,0
Group 3,BB,1.5,15,14,1704,11,2018,12,-1
Group 3,BB,1.5,15,14,1705,10,2018,10,0
Group 3,BB,1.5,15,14,1706,11,2018,9,2
Group 3,BB,1.5,15,14,1707,11,2018,11,0
Group 3,BB,1.5,15,14,1708,7,2018,11,-4
Group 3,BB,1.5,15,14,1709,13,2018,9,4
Group 3,BB,1.5,15,14,1710,8,2018,9,-1
Group 3,BB,1.5,15,14,1711,12,2018,9,3
Group 3,BB,1.5,15,14,1712,12,2018,11,1
Group 3,BB,1.5,15,14,1713,10,2018,12,-2
Group 3,BB,1.5,15,14,1714,5,2018,9,-4
Group 3,BB,1.5,15,14,1715,12,2018,11,1
Group 3,BB,1.5,15,14,1716,8,2018,12,-4
Group 3,BB,1.5,15,14,1717,8,2018,12,-4
Group 3,BB,1.5,15,14,1718,11,2018,10,1
Group 3,BB,1.5,15,14,1719,11,2018,12,-1
Group 3,BB,1.5,15,14,1720,10,2018,7,3
Group 3,BB,1.5,15,14,1721,9,2018,10,-1
Group 3,BB,1.5,15,14,1722,11,2018,9,2
Group 3,BB,1.5,15,14,1723,12,2018,11,1
Group 3,BB,1.5,15,14,1724,12,2018,11,1
Group 3,BB,1.5,15,14,1725,11,2018,11,0
Group 3,BB,1.5,15,14,1726,10,2018,9,1
Group 3,BB,1.5,15,14,1727,11,2018,9,2
Group 3,BB,1.5,15,14,1728,9,2018,12,-3
Group 3,BB,1.5,15,14,1729,8,2018,8,0
Group 3,BB,1.5,15,14,1730,12,2018,12,0
Group 3,BB,1.5,15,14,1731,11,2018,6,5
Group 3,BB,1.5,15,14,1732,7,2018,12,-5
Group 3,BB,1.5,15,14,1733,13,2018,12,1
Group 3,BB,1.5,15,14,1734,7,2018,13,-6
Group 3,BB,1.5,15,14,1735,14,2018,7,7
Group 3,BB,1.5,15,14,1736,7,2018,8,-1
Group 3,BB,1.5,15,14,1737,13,2018,11,2
Group 3,BB,1.5,15,14,1738,9,2018,11,-2
Group 3,BB,1.5,15,14,1739,9,2018,10,-1
Group 3,BB,1.5,15,14,1740,12,2018,11,1
Group 3,BB,1.5,15,14,1741,13,2018,12,1
Group 3,BB,1.5,15,14,1742,12,2018,9,3
Group 3,BB,1.5,15,14,1743,11,2018,9,2
Group 3,BB,1.5,15,14,1744,10,2018,10,0
Group 3,BB,1.5,15,14,1745,12,2018,10,2
Group 3,BB,1.5,15,14,1746,12,2018,12,0
Group 3,BB,1.5,15,14,1747,10,2018,11,-1
Group 3,BB,1.5,15,14,1748,8,2018,10,-2
Group 3,BB,1.5,15,14,1749,10,2018,11,-1
Group 3,BB,1.5,15,14,1750,13,2018,13,0
Group 3,BB,1.5,15,14,1751,10,2018,10,0
Group 3,BB,1.5,15,14,1752,9,2018,11,-2
Group 3,BB,1.5,15,14,1753,7,2018,12,-5
Group 3,BB,1.5,15,14,1754,11,2018,11,0
Group 3,BB,1.5,15,14,1755,11,2018,10,1
Group 3,BB,1.5,15,14,1756,10,2018,12,-2
Group 3,BB,1.5,15,14,1757,9,2018,12,-3
Group 3,BB,1.5,15,14,1758,9,2018,8,1
Group 3,BB,1.5,15,14,1759,14,2018,9,5
Group 3,BB,1.5,15,14,1760,7,2018,11,-4
Group 3,BB,1.5,15,14,1761,13,2018,10,3
Group 3,BB,1.5,15,14,1762,11,2018,12,-1
Group 3,BB,1.5,15,14,1763,9,2018,13,-4
Group 3,BB,1.5,15,14,1764,10,2018,12,-2
Group 3,BB,1.5,15,14,1765,13,2018,10,3
Group 3,BB,1.5,15,14,1766,9,2018,9,0
Group 3,BB,1.5,15,14,1767,11,2018,8,3
Group 3,BB,1.5,15,14,1768,12,2018,10,2
Group 3,BB,1.5,15,14,1769,8,2018,7,1
Group 3,BB,1.5,15,14,1770,10,2018,12,-2
Group 3,BB,1.5,15,14,1771,13,2018,9,4
Group 3,BB,1.5,15,14,1772,12,2018,14,-2
Group 3,BB,1.5,15,14,1773,7,2018,14,-7
Group 3,BB,1.5,15,14,1774,11,2018,10,1
Group 3,BB,1.5,15,14,1775,11,2018,10,1
Group 3,BB,1.5,15,14,1776,11,2018,8,3
Group 3,BB,1.5,15,14,1777,11,2018,11,0
Group 3,BB,1.5,15,14,1778,10,2018,7,3
Group 3,BB,1.5,15,14,1779,10,2018,10,0
Group 3,BB,1.5,15,14,1780,12,2018,9,3
Group 3,BB,1.5,15,14,1781,11,2018,11,0
Group 3,BB,1.5,15,14,1782,14,2018,9,5
Group 3,BB,1.5,15,14,1783,13,2018,8,5
Group 3,BB,1.5,15,14,1784,9,2018,11,-2
Group 3,BB,1.5,15,14,1785,11,2018,10,1
Group 3,BB,1.5,15,14,1786,9,2018,10,-1
Group 3,BB,1.5,15,14,1787,9,2018,10,-1
Group 3,BB,1.5,15,14,1788,10,2018,9,1
Group 3,BB,1.5,15,14,1789,10,2018,12,-2
Group 3,BB,1.5,15,14,1790,8,2018,11,-3
Group 3,BB,1.5,15,14,1791,13,2018,7,6
Group 3,BB,1.5,15,14,1792,8,2018,9,-1
Group 3,BB,1.5,15,14,1793,12,2018,8,4
Group 3,BB,1.5,15,14,1794,13,2018,12,1
Group 3,BB,1.5,15,14,1795,8,2018,10,-2
Group 3,BB,1.5,15,14,1796,11,2018,9,2
Group 3,BB,1.5,15,14,1797,11,2018,8,3
Group 3,BB,1.5,15,14,1798,10,2018,9,1
Group 3,BB,1.5,15,14,1799,6,2018,12,-6
Group 3,BB,1.5,15,14,1800,14,2018,13,1
Group 3,BB,1.5,15,14,1801,8,2018,10,-2
Group 3,BB,1.5,15,14,1802,13,2018,13,0
Group 3,BB,1.5,15,14,1803,7,2018,10,-3
Group 3,BB,1.5,15,14,1804,7,2018,11,-4
Group 3,BB,1.5,15,14,1805,13,2018,9,4
Group 3,BB,1.5,15,14,1806,11,2018,11,0
Group 3,BB,1.5,15,14,1807,8,2018,12,-4
Group 3,BB,1.5,15,14,1808,12,2018,6,6
Group 3,BB,1.5,15,14,1809,11,2018,9,2
Group 3,BB,1.5,15,14,1810,12,2018,10,2
Group 3,BB,1.5,15,14,1811,9,2018,10,-1
Group 3,BB,1.5,15,14,1812,8,2018,11,-3
Group 3,BB,1.5,15,14,1813,11,2018,11,0
Group 3,BB,1.5,15,14,1814,11,2018,10,1
Group 3,BB,1.5,15,14,1815,12,2018,13,-1
Group 3,BB,1.5,15,14,1816,8,2018,12,-4
Group 3,BB,1.5,15,14,1817,10,2018,9,1
Group 3,BB,1.5,15,14,1818,14,2018,13,1
Group 3,BB,1.5,15,14,1819,12,2018,10,2
Group 3,BB,1.5,15,14,1820,12,2018,8,4
Group 3,BB,1.5,15,14,1821,11,2018,9,2
Group 3,BB,1.5,15,14,1822,11,2018,11,0
Group 3,BB,1.5,15,14,1823,8,2018,7,1
Group 3,BB,1.5,15,14,1824,12,2018,11,1
Group 3,BB,1.5,15,14,1825,12,2018,6,6
Group 3,BB,1.5,15,14,1826,11,2018,11,0
Group 3,BB,1.5,15,14,1827,11,2018,7,4
Group 3,BB,1.5,15,14,1828,8,2018,9,-1
Group 3,BB,1.5,15,14,1829,9,2018,13,-4
Group 3,BB,1.5,15,14,1830,8,2018,8,0
Group 3,BB,1.5,15,14,1831,10,2018,10,0
Group 3,BB,1.5,15,14,1832,11,2018,11,0
Group 3,BB,1.5,15,14,1833,12,2018,11,1
Group 3,BB,1.5,15,14,1834,9,2018,11,-2
Group 3,BB,1.5,15,14,1835,9,2018,8,1
Group 3,BB,1.5,15,14,1836,10,2018,12,-2
Group 3,BB,1.5,15,14,1837,9,2018,10,-1
Group 3,BB,1.5,15,14,1838,10,2018,12,-2
Group 3,BB,1.5,15,14,1839,13,2018,6,7
Group 3,BB,1.5,15,14,1840,11,2018,9,2
Group 3,BB,1.5,15,14,1841,6,2018,9,-3
Group 3,BB,1.5,15,14,1842,11,2018,12,-1
Group 3,BB,1.5,15,14,1843,7,2018,8,-1
Group 3,BB,1.5,15,14,1844,9,2018,11,-2
Group 3,BB,1.5,15,14,1845,9,2018,10,-1
Group 3,BB,1.5,15,14,1846,11,2018,12,-1
Group 3,BB,1.5,15,14,1847,12,2018,7,5
Group 3,BB,1.5,15,14,1848,12,2018,6,6
Group 3,BB,1.5,15,14,1849,12,2018,8,4
Group 3,BB,1.5,15,14,1850,9,2018,11,-2
Group 3,BB,1.5,15,14,1851,12,2018,10,2
Group 3,BB,1.5,15,14,1852,9,2018,10,-1
Group 3,BB,1.5,15,14,1853,10,2018,10,0
Group 3,BB,1.5,15,14,1854,13,2018,14,-1
Group 3,BB,1.5,15,14,1855,10,2018,8,2
Group 3,BB,1.5,15,14,1856,13,2018,12,1
Group 3,BB,1.5,15,14,1857,10,2018,7,3
Group 3,BB,1.5,15,14,1858,14,2018,8,6
Group 3,BB,1.5,15,14,1859,9,2018,7,2
Group 3,BB,1.5,15,14,1860,8,2018,11,-3
Group 3,BB,1.5,15,14,1861,12,2018,9,3
Group 3,BB,1.5,15,14,1862,12,2018,11,1
Group 3,BB,1.5,15,14,1863,10,2018,10,0
Group 3,BB,1.5,15,14,1864,11,2018,14,-3
Group 3,BB,1.5,15,14,1865,12,2018,14,-2
Group 3,BB,1.5,15,14,1866,10,2018,7,3
Group 3,BB,1.5,15,14,1867,11,2018,11,0
Group 3,BB,1.5,15,14,1868,10,2018,10,0
Group 3,BB,1.5,15,14,1869,8,2018,11,-3
Group 3,BB,1.5,15,14,1870,11,2018,11,0
Group 3,BB,1.5,15,14,1871,11,2018,8,3
Group 3,BB,1.5,15,14,1872,13,2018,7,6
Group 3,BB,1.5,15,14,1873,10,2018,11,-1
Group 3,BB,1.5,15,14,1874,12,2018,10,2
Group 3,BB,1.5,15,14,1875,13,2018,10,3
Group 3,BB,1.5,15,14,1876,9,2018,10,-1
Group 3,BB,1.5,15,14,1877,11,2018,10,1
Group 3,BB,1.5,15,14,1878,10,2018,10,0
Group 3,BB,1.5,15,14,1879,13,2018,12,1
Group 3,BB,1.5,15,14,1880,10,2018,10,0
Group 3,BB,1.5,15,14,1881,11,2018,11,0
Group 3,BB,1.5,15,14,1882,10,2018,8,2
Group 3,BB,1.5,15,14,1883,11,2018,11,0
Group 3,BB,1.5,15,14,1884,10,2018,10,0
Group 3,BB,1.5,15,14,1885,13,2018,11,2
Group 3,BB,1.5,15,14,1886,5,2018,12,-7
Group 3,BB,1.5,15,14,1887,10,2018,6,4
Group 3,BB,1.5,15,14,1888,8,2018,9,-1
Group 3,BB,1.5,15,14,1889,9,2018,11,-2
Group 3,BB,1.5,15,14,1890,9,2018,6,3
Group 3,BB,1.5,15,14,1891,12,2018,6,6
Group 3,BB,1.5,15,14,1892,11,2018,11,0
Group 3,BB,1.5,15,14,1893,13,2018,11,2
Group 3,BB,1.5,15,14,1894,10,2018,9,1
Group 3,BB,1.5,15,14,1895,11,2018,12,-1
Group 3,BB,1.5,15,14,1896,11,2018,11,0
Group 3,BB,1.5,15,14,1897,9,2018,9,0
Group 3,BB,1.5,15,14,1898,10,2018,10,0
Group 3,BB,1.5,15,14,1899,11,2018,11,0
Group 3,BB,1.5,15,14,1900,13,2018,11,2
Group 3,BB,1.5,15,14,1901,9,2018,9,0
Group 3,BB,1.5,15,14,1902,7,2018,13,-6
Group 3,BB,1.5,15,14,1903,11,2018,10,1
Group 3,BB,1.5,15,14,1904,6,2018,11,-5
Group 3,BB,1.5,15,14,1905,11,2018,10,1
Group 3,BB,1.5,15,14,1906,11,2018,11,0
Group 3,BB,1.5,15,14,1907,12,2018,10,2
Group 3,BB,1.5,15,14,1908,9,2018,12,-3
Group 3,BB,1.5,15,14,1909,12,2018,7,5
Group 3,BB,1.5,15,14,1910,10,2018,11,-1
Group 3,BB,1.5,15,14,1911,14,2018,5,9
Group 3,BB,1.5,15,14,1912,7,2018,8,-1
Group 3,BB,1.5,15,14,1913,12,2018,10,2
Group 3,BB,1.5,15,14,1914,10,2018,7,3
Group 3,BB,1.5,15,14,1915,9,2018,13,-4
Group 3,BB,1.5,15,14,1916,10,2018,11,-1
Group 3,BB,1.5,15,14,1917,11,2018,13,-2
Group 3,BB,1.5,15,14,1918,6,2018,11,-5
Group 3,BB,1.5,15,14,1919,12,2018,9,3
Group 3,BB,1.5,15,14,1920,12,2018,11,1
Group 3,BB,1.5,15,14,1921,9,2018,7,2
Group 3,BB,1.5,15,14,1922,10,2018,10,0
Group 3,BB,1.5,15,14,1923,10,2018,10,0
Group 3,BB,1.5,15,14,1924,11,2018,10,1
Group 3,BB,1.5,15,14,1925,8,2018,7,1
Group 3,BB,1.5,15,14,1926,9,2018,12,-3
Group 3,BB,1.5,15,14,1927,9,2018,11,-2
Group 3,BB,1.5,15,14,1928,11,2018,13,-2
Group 3,BB,1.5,15,14,1929,13,2018,13,0
Group 3,BB,1.5,15,14,1930,11,2018,9,2
Group 3,BB,1.5,15,14,1931,11,2018,14,-3
Group 3,BB,1.5,15,14,1932,12,2018,7,5
Group 3,BB,1.5,15,14,1933,9,2018,12,-3
Group 3,BB,1.5,15,14,1934,12,2018,12,0
Group 3,BB,1.5,15,14,1935,12,2018,11,1
Group 3,BB,1.5,15,14,1936,7,2018,11,-4
Group 3,BB,1.5,15,14,1937,10,2018,9,1
Group 3,BB,1.5,15,14,1938,12,2018,9,3
Group 3,BB,1.5,15,14,1939,11,2018,9,2
Group 3,BB,1.5,15,14,1940,11,2018,11,0
Group 3,BB,1.5,15,14,1941,12,2018,11,1
Group 3,BB,1.5,15,14,1942,12,2018,11,1
Group 3,BB,1.5,15,14,1943,10,2018,10,0
Group 3,BB,1.5,15,14,1944,13,2018,11,2
Group 3,BB,1.5,15,14,1945,12,2018,11,1
Group 3,BB,1.5,15,14,1946,10,2018,6,4
Group 3,BB,1.5,15,14,1947,12,2018,12,0
Group 3,BB,1.5,15,14,1948,13,2018,13,0
Group 3,BB,1.5,15,14,1949,12,2018,11,1
Group 3,BB,1.5,15,14,1950,11,2018,13,-2
Group 3,BB,1.5,15,14,1951,10,2018,12,-2
Group 3,BB,1.5,15,14,1952,9,2018,10,-1
Group 3,BB,1.5,15,14,1953,8,2018,12,-4
Group 3,BB,1.5,15,14,1954,13,2018,11,2
Group 3,BB,1.5,15,14,1955,8,2018,11,-3
Group 3,BB,1.5,15,14,1956,12,2018,9,3
Group 3,BB,1.5,15,14,1957,10,2018,8,2
Group 3,BB,1.5,15,14,1958,10,2018,9,1
Group 3,BB,1.5,15,14,1959,10,2018,7,3
Group 3,BB,1.5,15,14,1960,11,2018,9,2
Group 3,BB,1.5,15,14,1961,11,2018,11,0
Group 3,BB,1.5,15,14,1962,10,2018,9,1
Group 3,BB,1.5,15,14,1963,10,2018,8,2
Group 3,BB,1.5,15,14,1964,11,2018,5,6
Group 3,BB,1.5,15,14,1965,9,2018,6,3
Group 3,BB,1.5,15,14,1966,9,2018,9,0
Group 3,BB,1.5,15,14,1967,12,2018,10,2
Group 3,BB,1.5,15,14,1968,11,2018,12,-1
Group 3,BB,1.5,15,14,1969,6,2018,13,-7
Group 3,BB,1.5,15,14,1970,10,2018,12,-2
Group 3,BB,1.5,15,14,1971,5,2018,7,-2
Group 3,BB,1.5,15,14,1972,12,2018,10,2
Group 3,BB,1.5,15,14,1973,12,2018,6,6
Group 3,BB,1.5,15,14,1974,12,2018,6,6
Group 3,BB,1.5,15,14,1975,11,2018,9,2
Group 3,BB,1.5,15,14,1976,10,2018,5,5
Group 3,BB,1.5,15,14,1977,14,2018,6,8
Group 3,BB,1.5,15,14,1978,12,2018,12,0
Group 3,BB,1.5,15,14,1979,8,2018,12,-4
Group 3,BB,1.5,15,14,1980,11,2018,9,2
Group 3,BB,1.5,15,14,1981,11,2018,8,3
Group 3,BB,1.5,15,14,1982,12,2018,12,0
Group 3,BB,1.5,15,14,1983,9,2018,12,-3
Group 3,BB,1.5,15,14,1984,7,2018,7,0
Group 3,BB,1.5,15,14,1985,11,2018,11,0
Group 3,BB,1.5,15,14,1986,12,2018,8,4
Group 3,BB,1.5,15,14,1987,13,2018,13,0
Group 3,BB,1.5,15,14,1988,10,2018,11,-1
Group 3,BB,1.5,15,14,1989,12,2018,6,6
Group 3,BB,1.5,15,14,1990,12,2018,11,1
Group 3,BB,1.5,15,14,1991,12,2018,12,0
Group 3,BB,1.5,15,14,1992,8,2018,8,0
Group 3,BB,1.5,15,14,1993,11,2018,11,0
Group 3,BB,1.5,15,14,1994,11,2018,9,2
Group 3,BB,1.5,15,14,1995,13,2018,10,3
Group 3,BB,1.5,15,14,1996,11,2018,12,-1
Group 3,BB,1.5,15,14,1997,8,2018,9,-1
Group 3,BB,1.5,15,14,1998,9,2018,6,3
Group 3,BB,1.5,15,14,1999,9,2018,12,-3
Group 3,BB,1.5,15,14,2000,11,2018,11,0
Group 3,BB,1.5,15,14,2001,12,2018,7,5
Group 3,BB,1.5,15,14,2002,11,2018,6,5
Group 3,BB,1.5,15,14,2003,11,2018,11,0
Group 3,BB,1.5,15,14,2004,6,2018,10,-4
Group 3,BB,1.5,15,14,2005,9,2018,10,-1
Group 3,BB,1.5,15,14,2006,8,2018,10,-2
Group 3,BB,1.5,15,14,2007,10,2018,10,0
Group 3,BB,1.5,15,14,2008,11,2018,12,-1
Group 3,BB,1.5,15,14,2009,13,2018,8,5
Group 3,BB,1.5,15,14,2010,10,2018,11,-1
Group 3,BB,1.5,15,14,2011,13,2018,11,2
Group 3,BB,1.5,15,14,2012,8,2018,12,-4
Group 3,BB,1.5,15,14,2013,11,2018,13,-2
Group 3,BB,1.5,15,14,2014,14,2018,8,6
Group 3,BB,1.5,15,14,2015,11,2018,11,0
Group 3,BB,1.5,15,14,2016,9,2018,12,-3
Group 3,BB,1.5,15,14,2017,13,2018,8,5
Group 3,BB,1.5,15,14,2018,10,2018,9,1
Group 3,BB,1.5,15,14,2019,11,2018,11,0
Group 3,BB,1.5,15,14,2020,9,2018,11,-2
Group 3,BB,1.5,15,14,2021,9,2018,10,-1
Group 3,BB,1.5,15,14,2022,11,2018,8,3
Group 3,BB,1.5,15,14,2023,9,2018,10,-1
Group 3,BB,1.5,15,14,2024,11,2018,9,2
Group 3,BB,1.5,15,14,2025,12,2018,13,-1
Group 3,BB,1.5,15,14,2026,8,2018,10,-2
Group 3,BB,1.5,15,14,2027,12,2018,7,5
Group 3,BB,1.5,15,14,2028,9,2018,9,0
Group 3,BB,1.5,15,14,2029,10,2018,12,-2
Group 3,BB,1.5,15,14,2030,9,2018,14,-5
Group 3,BB,1.5,15,14,2031,13,2018,3,10
Group 3,BB,1.5,15,14,2032,9,2018,11,-2
Group 3,BB,1.5,15,14,2033,12,2018,12,0
Group 3,BB,1.5,15,14,2034,9,2018,9,0
Group 3,BB,1.5,15,14,2035,10,2018,6,4
Group 3,BB,1.5,15,14,2036,10,2018,11,-1
Group 3,BB,1.5,15,14,2037,10,2018,12,-2
Group 3,BB,1.5,15,14,2038,11,2018,11,0
Group 3,BB,1.5,15,14,2039,10,2018,10,0
Group 3,BB,1.5,15,14,2040,12,2018,9,3
Group 3,BB,1.5,15,14,2041,8,2018,8,0
Group 3,BB,1.5,15,14,2042,12,2018,8,4
Group 3,BB,1.5,15,14,2043,11,2018,8,3
Group 3,BB,1.5,15,14,2044,10,2018,10,0
Group 3,BB,1.5,15,14,2045,11,2018,12,-1
Group 3,BB,1.5,15,14,2046,11,2018,10,1
Group 3,BB,1.5,15,14,2047,11,2018,9,2
Group 3,BB,1.5,15,14,2048,11,2018,8,3
Group 3,BB,1.5,15,14,2049,12,2018,11,1
Group 3,BB,1.5,15,14,2050,7,2018,10,-3
Group 3,BB,1.5,15,14,2051,11,2018,8,3
Group 3,BB,1.5,15,14,2052,9,2018,11,-2
Group 3,BB,1.5,15,14,2053,8,2018,9,-1
Group 3,BB,1.5,15,14,2054,9,2018,13,-4
Group 3,BB,1.5,15,14,2055,8,2018,14,-6
Group 3,BB,1.5,15,14,2056,12,2018,8,4
Group 3,BB,1.5,15,14,2057,11,2018,7,4
Group 3,BB,1.5,15,14,2058,9,2018,7,2
Group 3,BB,1.5,15,14,2059,11,2018,12,-1
Group 3,BB,1.5,15,14,2060,10,2018,11,-1
Group 3,BB,1.5,15,14,2061,11,2018,11,0
Group 3,BB,1.5,15,14,2062,11,2018,8,3
Group 3,BB,1.5,15,14,2063,10,2018,13,-3
Group 3,BB,1.5,15,14,2064,11,2018,5,6
Group 3,BB,1.5,15,14,2065,13,2018,8,5
Group 3,BB,1.5,15,14,2066,7,2018,9,-2
Group 3,BB,1.5,15,14,2067,12,2018,14,-2
Group 3,BB,1.5,15,14,2068,11,2018,9,2
Group 3,BB,1.5,15,14,2069,7,2018,9,-2
Group 3,BB,1.5,15,14,2070,12,2018,9,3
Group 3,BB,1.5,15,14,2071,13,2018,11,2
Group 3,BB,1.5,15,14,2072,10,2018,9,1
Group 3,BB,1.5,15,14,2073,12,2018,8,4
Group 3,BB,1.5,15,14,2074,10,2018,11,-1
Group 3,BB,1.5,15,14,2075,11,2018,8,3
Group 3,BB,1.5,15,14,2076,13,2018,11,2
Group 3,BB,1.5,15,14,2077,9,2018,11,-2
Group 3,BB,1.5,15,14,2078,8,2018,11,-3
Group 3,BB,1.5,15,14,2079,11,2018,13,-2
Group 3,BB,1.5,15,14,2080,10,2018,8,2
Group 3,BB,1.5,15,14,2081,12,2018,8,4
Group 3,BB,1.5,15,14,2082,9,2018,10,-1
Group 3,BB,1.5,15,14,2083,8,2018,11,-3
Group 3,BB,1.5,15,14,2084,11,2018,12,-1
Group 3,BB,1.5,15,14,2085,9,2018,7,2
Group 3,BB,1.5,15,14,2086,9,2018,11,-2
Group 3,BB,1.5,15,14,2087,10,2018,8,2
Group 3,BB,1.5,15,14,2088,12,2018,10,2
Group 3,BB,1.5,15,14,2089,13,2018,11,2
Group 3,BB,1.5,15,14,2090,9,2018,8,1
Group 3,BB,1.5,15,14,2091,12,2018,12,0
Group 3,BB,1.5,15,14,2092,9,2018,11,-2
Group 3,BB,1.5,15,14,2093,12,2018,12,0
Group 3,BB,1.5,15,14,2094,12,2018,11,1
Group 3,BB,1.5,15,14,2095,8,2018,11,-3
Group 3,BB,1.5,15,14,2096,9,2018,10,-1
Group 3,BB,1.5,15,14,2097,9,2018,8,1
Group 3,BB,1.5,15,14,2098,13,2018,11,2
Group 3,BB,1.5,15,14,2099,11,2018,6,5
Group 3,BB,1.5,15,14,2100,9,2018,11,-2
Group 3,BB,1.5,15,14,2101,12,2018,13,-1
Group 3,BB,1.5,15,14,2102,11,2018,10,1
Group 3,BB,1.5,15,14,2103,9,2018,11,-2
Group 3,BB,1.5,15,14,2104,10,2018,10,0
Group 3,BB,1.5,15,14,2105,12,2018,8,4
Group 3,BB,1.5,15,14,2106,10,2018,14,-4
Group 3,BB,1.5,15,14,2107,12,2018,7,5
Group 3,BB,1.5,15,14,2108,8,2018,11,-3
Group 3,BB,1.5,15,14,2109,11,2018,11,0
Group 3,BB,1.5,15,14,2110,9,2018,11,-2
Group 3,BB,1.5,15,14,2111,12,2018,10,2
Group 3,BB,1.5,15,14,2112,8,2018,11,-3
Group 3,BB,1.5,15,14,2113,11,2018,13,-2
Group 3,BB,1.5,15,14,2114,12,2018,9,3
Group 3,BB,1.5,15,14,2115,10,2018,10,0
Group 3,BB,1.5,15,14,2116,9,2018,8,1
Group 3,BB,1.5,15,14,2117,8,2018,8,0
Group 3,BB,1.5,15,14,2118,11,2018,12,-1
Group 3,BB,1.5,15,14,2119,10,2018,13,-3
Group 3,BB,1.5,15,14,2120,13,2018,11,2
Group 3,BB,1.5,15,14,2121,12,2018,11,1
Group 3,BB,1.5,15,14,2122,9,2018,11,-2
Group 3,BB,1.5,15,14,2123,8,2018,12,-4
Group 3,BB,1.5,15,14,2124,9,2018,7,2
Group 3,BB,1.5,15,14,2125,11,2018,11,0
Group 3,BB,1.5,15,14,2126,13,2018,9,4
Group 3,BB,1.5,15,14,2127,8,2018,8,0
Group 3,BB,1.5,15,14,2128,11,2018,10,1
Group 3,BB,1.5,15,14,2129,12,2018,7,5
Group 3,BB,1.5,15,14,2130,10,2018,9,1
Group 3,BB,1.5,15,14,2131,12,2018,8,4
Group 3,BB,1.5,15,14,2132,12,2018,4,8
Group 3,BB,1.5,15,14,2133,7,2018,8,-1
Group 3,BB,1.5,15,14,2134,11,2018,6,5
Group 3,BB,1.5,15,14,2135,11,2018,10,1
Group 3,BB,1.5,15,14,2136,6,2018,11,-5
Group 3,BB,1.5,15,14,2137,9,2018,7,2
Group 3,BB,1.5,15,14,2138,14,2018,11,3
Group 3,BB,1.5,15,14,2139,13,2018,8,5
Group 3,BB,1.5,15,14,2140,10,2018,10,0
Group 3,BB,1.5,15,14,2141,12,2018,12,0
Group 3,BB,1.5,15,14,2142,11,2018,11,0
Group 3,BB,1.5,15,14,2143,11,2018,8,3
Group 3,BB,1.5,15,14,2144,11,2018,11,0
Group 3,BB,1.5,15,14,2145,9,2018,9,0
Group 3,BB,1.5,15,14,2146,8,2018,10,-2
Group 3,BB,1.5,15,14,2147,11,2018,8,3
Group 3,BB,1.5,15,14,2148,8,2018,12,-4
Group 3,BB,1.5,15,14,2149,7,2018,8,-1
Group 3,BB,1.5,15,14,2150,11,2018,9,2
Group 3,BB,1.5,15,14,2151,9,2018,9,0
Group 3,BB,1.5,15,14,2152,9,2018,11,-2
Group 3,BB,1.5,15,14,2153,12,2018,12,0
Group 3,BB,1.5,15,14,2154,8,2018,12,-4
Group 3,BB,1.5,15,14,2155,11,2018,9,2
Group 3,BB,1.5,15,14,2156,11,2018,11,0
Group 3,BB,1.5,15,14,2157,11,2018,10,1
Group 3,BB,1.5,15,14,2158,7,2018,11,-4
Group 3,BB,1.5,15,14,2159,9,2018,10,-1
Group 3,BB,1.5,15,14,2160,11,2018,10,1
Group 3,BB,1.5,15,14,2161,9,2018,9,0
Group 3,BB,1.5,15,14,2162,11,2018,10,1
Group 3,BB,1.5,15,14,2163,12,2018,13,-1
Group 3,BB,1.5,15,14,2164,10,2018,9,1
Group 3,BB,1.5,15,14,2165,7,2018,10,-3
Group 3,BB,1.5,15,14,2166,14,2018,11,3
Group 3,BB,1.5,15,14,2167,12,2018,7,5
Group 3,BB,1.5,15,14,2168,8,2018,9,-1
Group 3,BB,1.5,15,14,2169,13,2018,6,7
Group 3,BB,1.5,15,14,2170,12,2018,3,9
Group 3,BB,1.5,15,14,2171,12,2018,11,1
Group 3,BB,1.5,15,14,2172,8,2018,9,-1
Group 3,BB,1.5,15,14,2173,12,2018,12,0
Group 3,BB,1.5,15,14,2174,9,2018,10,-1
Group 3,BB,1.5,15,14,2175,10,2018,12,-2
Group 3,BB,1.5,15,14,2176,8,2018,11,-3
Group 3,BB,1.5,15,14,2177,10,2018,12,-2
Group 3,BB,1.5,15,14,2178,11,2018,12,-1
Group 3,BB,1.5,15,14,2179,12,2018,9,3
Group 3,BB,1.5,15,14,2180,14,2018,7,7
Group 3,BB,1.5,15,14,2181,10,2018,8,2
Group 3,BB,1.5,15,14,2182,10,2018,10,0
Group 3,BB,1.5,15,14,2183,8,2018,10,-2
Group 3,BB,1.5,15,14,2184,11,2018,6,5
Group 3,BB,1.5,15,14,2185,13,2018,8,5
Group 3,BB,1.5,15,14,2186,7,2018,12,-5
Group 3,BB,1.5,15,14,2187,7,2018,13,-6
Group 3,BB,1.5,15,14,2188,12,2018,12,0
Group 3,BB,1.5,15,14,2189,14,2018,12,2
Group 3,BB,1.5,15,14,2190,13,2018,11,2
Group 3,BB,1.5,15,14,2191,10,2018,10,0
Group 3,BB,1.5,15,14,2192,9,2018,12,-3
Group 3,BB,1.5,15,14,2193,13,2018,9,4
Group 3,BB,1.5,15,14,2194,9,2018,8,1
Group 3,BB,1.5,15,14,2195,10,2018,8,2
Group 3,BB,1.5,15,14,2196,9,2018,11,-2
Group 3,BB,1.5,15,14,2197,13,2018,9,4
Group 3,BB,1.5,15,14,2198,11,2018,9,2
Group 3,BB,1.5,15,14,2199,13,2018,13,0
Group 3,BB,1.5,15,14,2200,8,2018,11,-3
Group 3,BB,1.5,15,14,2201,11,2018,6,5
Group 3,BB,1.5,15,14,2202,10,2018,13,-3
Group 3,BB,1.5,15,14,2203,9,2018,12,-3
Group 3,BB,1.5,15,14,2204,11,2018,8,3
Group 3,BB,1.5,15,14,2205,12,2018,11,1
Group 3,BB,1.5,15,14,2206,11,2018,10,1
Group 3,BB,1.5,15,14,2207,12,2018,9,3
Group 3,BB,1.5,15,14,2208,8,2018,8,0
Group 3,BB,1.5,15,14,2209,10,2018,8,2
Group 3,BB,1.5,15,14,2210,14,2018,12,2
Group 3,BB,1.5,15,14,2211,10,2018,13,-3
Group 3,BB,1.5,15,14,2212,10,2018,12,-2
Group 3,BB,1.5,15,14,2213,12,2018,9,3
Group 3,BB,1.5,15,14,2214,11,2018,7,4
Group 3,BB,1.5,15,14,2215,6,2018,11,-5
Group 3,BB,1.5,15,14,2216,12,2018,10,2
Group 3,BB,1.5,15,14,2217,10,2018,12,-2
Group 3,BB,1.5,15,14,2218,9,2018,10,-1
Group 3,BB,1.5,15,14,2219,10,2018,10,0
Group 3,BB,1.5,15,14,2220,12,2018,11,1
Group 3,BB,1.5,15,14,2221,8,2018,13,-5
Group 3,BB,1.5,15,14,2222,9,2018,10,-1
Group 3,BB,1.5,15,14,2223,10,2018,6,4
Group 3,BB,1.5,15,14,2224,7,2018,14,-7
Group 3,BB,1.5,15,14,2225,11,2018,10,1
Group 3,BB,1.5,15,14,2226,6,2018,12,-6
Group 3,BB,1.5,15,14,2227,7,2018,13,-6
Group 3,BB,1.5,15,14,2228,11,2018,11,0
Group 3,BB,1.5,15,14,2229,11,2018,12,-1
Group 3,BB,1.5,15,14,2230,10,2018,12,-2
Group 3,BB,1.5,15,14,2231,6,2018,10,-4
Group 3,BB,1.5,15,14,2232,12,2018,8,4
Group 3,BB,1.5,15,14,2233,10,2018,8,2
Group 3,BB,1.5,15,14,2234,12,2018,10,2
Group 3,BB,1.5,15,14,2235,6,2018,9,-3
Group 3,BB,1.5,15,14,2236,11,2018,8,3
Group 3,BB,1.5,15,14,2237,12,2018,12,0
Group 3,BB,1.5,15,14,2238,11,2018,12,-1
Group 3,BB,1.5,15,14,2239,10,2018,10,0
Group 3,BB,1.5,15,14,2240,14,2018,11,3
Group 3,BB,1.5,15,14,2241,12,2018,7,5
Group 3,BB,1.5,15,14,2242,9,2018,6,3
Group 3,BB,1.5,15,14,2243,10,2018,8,2
Group 3,BB,1.5,15,14,2244,10,2018,10,0
Group 3,BB,1.5,15,14,2245,13,2018,12,1
Group 3,BB,1.5,15,14,2246,11,2018,7,4
Group 3,BB,1.5,15,14,2247,11,2018,10,1
Group 3,BB,1.5,15,14,2248,13,2018,9,4
Group 3,BB,1.5,15,14,2249,13,2018,7,6
Group 3,BB,1.5,15,14,2250,11,2018,12,-1
Group 3,BB,1.5,15,14,2251,13,2018,11,2
Group 3,BB,1.5,15,14,2252,13,2018,9,4
Group 3,BB,1.5,15,14,2253,9,2018,10,-1
Group 3,BB,1.5,15,14,2254,11,2018,10,1
Group 3,BB,1.5,15,14,2255,11,2018,12,-1
Group 3,BB,1.5,15,14,2256,8,2018,11,-3
Group 3,BB,1.5,15,14,2257,8,2018,11,-3
Group 3,BB,1.5,15,14,2258,12,2018,11,1
Group 3,BB,1.5,15,14,2259,10,2018,11,-1
Group 3,BB,1.5,15,14,2260,11,2018,9,2
Group 3,BB,1.5,15,14,2261,10,2018,11,-1
Group 3,BB,1.5,15,14,2262,7,2018,10,-3
Group 3,BB,1.5,15,14,2263,7,2018,12,-5
Group 3,BB,1.5,15,14,2264,11,2018,9,2
Group 3,BB,1.5,15,14,2265,12,2018,10,2
Group 3,BB,1.5,15,14,2266,11,2018,10,1
Group 3,BB,1.5,15,14,2267,11,2018,11,0
Group 3,BB,1.5,15,14,2268,12,2018,10,2
Group 3,BB,1.5,15,14,2269,12,2018,8,4
Group 3,BB,1.5,15,14,2270,11,2018,11,0
Group 3,BB,1.5,15,14,2271,9,2018,12,-3
Group 3,BB,1.5,15,14,2272,12,2018,11,1
Group 3,BB,1.5,15,14,2273,10,2018,7,3
Group 3,BB,1.5,15,14,2274,11,2018,8,3
Group 3,BB,1.5,15,14,2275,10,2018,12,-2
Group 3,BB,1.5,15,14,2276,8,2018,7,1
Group 3,BB,1.5,15,14,2277,6,2018,9,-3
Group 3,BB,1.5,15,14,2278,12,2018,11,1
Group 3,BB,1.5,15,14,2279,10,2018,9,1
Group 3,BB,1.5,15,14,2280,13,2018,12,1
Group 3,BB,1.5,15,14,2281,6,2018,12,-6
Group 3,BB,1.5,15,14,2282,10,2018,12,-2
Group 3,BB,1.5,15,14,2283,9,2018,9,0
Group 3,BB,1.5,15,14,2284,8,2018,11,-3
Group 3,BB,1.5,15,14,2285,10,2018,11,-1
Group 3,BB,1.5,15,14,2286,10,2018,9,1
Group 3,BB,1.5,15,14,2287,9,2018,9,0
Group 3,BB,1.5,15,14,2288,9,2018,8,1
Group 3,BB,1.5,15,14,2289,8,2018,10,-2
Group 3,BB,1.5,15,14,2290,9,2018,7,2
Group 3,BB,1.5,15,14,2291,13,2018,11,2
Group 3,BB,1.5,15,14,2292,13,2018,10,3
Group 3,BB,1.5,15,14,2293,8,2018,12,-4
Group 3,BB,1.5,15,14,2294,11,2018,11,0
Group 3,BB,1.5,15,14,2295,13,2018,9,4
Group 3,BB,1.5,15,14,2296,11,2018,10,1
Group 3,BB,1.5,15,14,2297,10,2018,9,1
Group 3,BB,1.5,15,14,2298,13,2018,8,5
Group 3,BB,1.5,15,14,2299,12,2018,8,4
Group 3,BB,1.5,15,14,2300,13,2018,8,5
Group 3,BB,1.5,15,14,2301,7,2018,12,-5
Group 3,BB,1.5,15,14,2302,13,2018,8,5
Group 3,BB,1.5,15,14,2303,8,2018,5,3
Group 3,BB,1.5,15,14,2304,11,2018,12,-1
Group 3,BB,1.5,15,14,2305,12,2018,9,3
Group 3,BB,1.5,15,14,2306,9,2018,12,-3
Group 3,BB,1.5,15,14,2307,11,2018,12,-1
Group 3,BB,1.5,15,14,2308,13,2018,12,1
Group 3,BB,1.5,15,14,2309,12,2018,12,0
Group 3,BB,1.5,15,14,2310,9,2018,14,-5
Group 3,BB,1.5,15,14,2311,8,2018,12,-4
Group 3,BB,1.5,15,14,2312,11,2018,12,-1
Group 3,BB,1.5,15,14,2313,13,2018,9,4
Group 3,BB,1.5,15,14,2314,13,2018,9,4
Group 3,BB,1.5,15,14,2315,7,2018,8,-1
Group 3,BB,1.5,15,14,2316,7,2018,6,1
Group 3,BB,1.5,15,14,2317,14,2018,11,3
Group 3,BB,1.5,15,14,2318,12,2018,11,1
Group 3,BB,1.5,15,14,2319,13,2018,11,2
Group 3,BB,1.5,15,14,2320,10,2018,7,3
Group 3,BB,1.5,15,14,2321,10,2018,12,-2
Group 3,BB,1.5,15,14,2322,9,2018,11,-2
Group 3,BB,1.5,15,14,2323,12,2018,11,1
Group 3,BB,1.5,15,14,2324,12,2018,11,1
Group 3,BB,1.5,15,14,2325,11,2018,10,1
Group 3,BB,1.5,15,14,2326,10,2018,10,0
Group 3,BB,1.5,15,14,2327,9,2018,11,-2
Group 3,BB,1.5,15,14,2328,6,2018,10,-4
Group 3,BB,1.5,15,14,2329,11,2018,9,2
Group 3,BB,1.5,15,14,2330,10,2018,8,2
Group 3,BB,1.5,15,14,2331,9,2018,9,0
Group 3,BB,1.5,15,14,2332,8,2018,7,1
Group 3,BB,1.5,15,14,2333,11,2018,10,1
Group 3,BB,1.5,15,14,2334,7,2018,9,-2
Group 3,BB,1.5,15,14,2335,12,2018,12,0
Group 3,BB,1.5,15,14,2336,14,2018,10,4
Group 3,BB,1.5,15,14,2337,9,2018,12,-3
Group 3,BB,1.5,15,14,2338,8,2018,10,-2
Group 3,BB,1.5,15,14,2339,11,2018,10,1
Group 3,BB,1.5,15,14,2340,13,2018,8,5
Group 3,BB,1.5,15,14,2341,10,2018,12,-2
Group 3,BB,1.5,15,14,2342,11,2018,10,1
Group 3,BB,1.5,15,14,2343,11,2018,12,-1
Group 3,BB,1.5,15,14,2344,10,2018,8,2
Group 3,BB,1.5,15,14,2345,7,2018,10,-3
Group 3,BB,1.5,15,14,2346,8,2018,10,-2
Group 3,BB,1.5,15,14,2347,10,2018,11,-1
Group 3,BB,1.5,15,14,2348,9,2018,9,0
Group 3,BB,1.5,15,14,2349,13,2018,7,6
Group 3,BB,1.5,15,14,2350,12,2018,13,-1
Group 3,BB,1.5,15,14,2351,9,2018,8,1
Group 3,BB,1.5,15,14,2352,11,2018,9,2
Group 3,BB,1.5,15,14,2353,13,2018,8,5
Group 3,BB,1.5,15,14,2354,10,2018,8,2
Group 3,BB,1.5,15,14,2355,13,2018,10,3
Group 3,BB,1.5,15,14,2356,10,2018,11,-1
Group 3,BB,1.5,15,14,2357,13,2018,10,3
Group 3,BB,1.5,15,14,2358,10,2018,10,0
Group 3,BB,1.5,15,14,2359,10,2018,12,-2
Group 3,BB,1.5,15,14,2360,10,2018,10,0
Group 3,BB,1.5,15,14,2361,9,2018,11,-2
Group 3,BB,1.5,15,14,2362,13,2018,11,2
Group 3,BB,1.5,15,14,2363,9,2018,11,-2
Group 3,BB,1.5,15,14,2364,11,2018,8,3
Group 3,BB,1.5,15,14,2365,11,2018,12,-1
Group 3,BB,1.5,15,14,2366,12,2018,12,0
Group 3,BB,1.5,15,14,2367,12,2018,12,0
Group 3,BB,1.5,15,14,2368,11,2018,12,-1
Group 3,BB,1.5,15,14,2369,7,2018,13,-6
Group 3,BB,1.5,15,14,2370,12,2018,12,0
Group 3,BB,1.5,15,14,2371,10,2018,9,1
Group 3,BB,1.5,15,14,2372,12,2018,10,2
Group 3,BB,1.5,15,14,2373,13,2018,9,4
Group 3,BB,1.5,15,14,2374,10,2018,9,1
Group 3,BB,1.5,15,14,2375,10,2018,8,2
Group 3,BB,1.5,15,14,2376,13,2018,8,5
Group 3,BB,1.5,15,14,2377,13,2018,13,0
Group 3,BB,1.5,15,14,2378,11,2018,9,2
Group 3,BB,1.5,15,14,2379,10,2018,10,0
Group 3,BB,1.5,15,14,2380,10,2018,12,-2
Group 3,BB,1.5,15,14,2381,13,2018,12,1
Group 3,BB,1.5,15,14,2382,10,2018,11,-1
Group 3,BB,1.5,15,14,2383,12,2018,8,4
Group 3,BB,1.5,15,14,2384,8,2018,9,-1
Group 3,BB,1.5,15,14,2385,11,2018,8,3
Group 3,BB,1.5,15,14,2386,11,2018,8,3
Group 3,BB,1.5,15,14,2387,11,2018,13,-2
Group 3,BB,1.5,15,14,2388,11,2018,12,-1
Group 3,BB,1.5,15,14,2389,12,2018,11,1
Group 3,BB,1.5,15,14,2390,12,2018,14,-2
Group 3,BB,1.5,15,14,2391,11,2018,11,0
Group 3,BB,1.5,15,14,2392,13,2018,10,3
Group 3,BB,1.5,15,14,2393,11,2018,11,0
Group 3,BB,1.5,15,14,2394,11,2018,5,6
Group 3,BB,1.5,15,14,2395,8,2018,9,-1
Group 3,BB,1.5,15,14,2396,11,2018,11,0
Group 3,BB,1.5,15,14,2397,11,2018,8,3
Group 3,BB,1.5,15,14,2398,10,2018,11,-1
Group 3,BB,1.5,15,14,2399,8,2018,11,-3
Group 3,BB,1.5,15,14,2400,12,2018,12,0
Group 3,BB,1.5,15,14,2401,12,2018,10,2
Group 3,BB,1.5,15,14,2402,10,2018,11,-1
Group 3,BB,1.5,15,14,2403,10,2018,11,-1
Group 3,BB,1.5,15,14,2404,9,2018,11,-2
Group 3,BB,1.5,15,14,2405,7,2018,6,1
Group 3,BB,1.5,15,14,2406,9,2018,9,0
Group 3,BB,1.5,15,14,2407,13,2018,13,0
Group 3,BB,1.5,15,14,2408,5,2018,11,-6
Group 3,BB,1.5,15,14,2409,13,2018,11,2
Group 3,BB,1.5,15,14,2410,11,2018,10,1
Group 3,BB,1.5,15,14,2411,11,2018,9,2
Group 3,BB,1.5,15,14,2412,11,2018,10,1
Group 3,BB,1.5,15,14,2413,9,2018,8,1
Group 3,BB,1.5,15,14,2414,11,2018,10,1
Group 3,BB,1.5,15,14,2415,10,2018,8,2
Group 3,BB,1.5,15,14,2416,8,2018,14,-6
Group 3,BB,1.5,15,14,2417,13,2018,12,1
Group 3,BB,1.5,15,14,2418,12,2018,9,3
Group 3,BB,1.5,15,14,2419,11,2018,11,0
Group 3,BB,1.5,15,14,2420,9,2018,8,1
Group 3,BB,1.5,15,14,2421,8,2018,10,-2
Group 3,BB,1.5,15,14,2422,10,2018,13,-3
Group 3,BB,1.5,15,14,2423,12,2018,9,3
Group 3,BB,1.5,15,14,2424,9,2018,5,4
Group 3,BB,1.5,15,14,2425,10,2018,8,2
Group 3,BB,1.5,15,14,2426,12,2018,10,2
Group 3,BB,1.5,15,14,2427,11,2018,9,2
Group 3,BB,1.5,15,14,2428,11,2018,11,0
Group 3,BB,1.5,15,14,2429,10,2018,10,0
Group 3,BB,1.5,15,14,2430,10,2018,8,2
Group 3,BB,1.5,15,14,2431,12,2018,10,2
Group 3,BB,1.5,15,14,2432,10,2018,13,-3
Group 3,BB,1.5,15,14,2433,14,2018,12,2
Group 3,BB,1.5,15,14,2434,9,2018,11,-2
Group 3,BB,1.5,15,14,2435,12,2018,10,2
Group 3,BB,1.5,15,14,2436,7,2018,10,-3
Group 3,BB,1.5,15,14,2437,11,2018,11,0
Group 3,BB,1.5,15,14,2438,10,2018,9,1
Group 3,BB,1.5,15,14,2439,9,2018,12,-3
Group 3,BB,1.5,15,14,2440,11,2018,11,0
Group 3,BB,1.5,15,14,2441,12,2018,11,1
Group 3,BB,1.5,15,14,2442,8,2018,11,-3
Group 3,BB,1.5,15,14,2443,7,2018,11,-4
Group 3,BB,1.5,15,14,2444,11,2018,11,0
Group 3,BB,1.5,15,14,2445,12,2018,12,0
Group 3,BB,1.5,15,14,2446,11,2018,8,3
Group 3,BB,1.5,15,14,2447,9,2018,11,-2
Group 3,BB,1.5,15,14,2448,11,2018,12,-1
Group 3,BB,1.5,15,14,2449,10,2018,9,1
Group 3,BB,1.5,15,14,2450,11,2018,9,2
Group 3,BB,1.5,15,14,2451,11,2018,9,2
Group 3,BB,1.5,15,14,2452,13,2018,10,3
Group 3,BB,1.5,15,14,2453,10,2018,9,1
Group 3,BB,1.5,15,14,2454,10,2018,12,-2
Group 3,BB,1.5,15,14,2455,12,2018,13,-1
Group 3,BB,1.5,15,14,2456,10,2018,11,-1
Group 3,BB,1.5,15,14,2457,13,2018,10,3
Group 3,BB,1.5,15,14,2458,14,2018,12,2
Group 3,BB,1.5,15,14,2459,11,2018,9,2
Group 3,BB,1.5,15,14,2460,11,2018,9,2
Group 3,BB,1.5,15,14,2461,11,2018,10,1
Group 3,BB,1.5,15,14,2462,8,2018,11,-3
Group 3,BB,1.5,15,14,2463,12,2018,12,0
Group 3,BB,1.5,15,14,2464,10,2018,13,-3
Group 3,BB,1.5,15,14,2465,14,2018,12,2
Group 3,BB,1.5,15,14,2466,11,2018,9,2
Group 3,BB,1.5,15,14,2467,10,2018,12,-2
Group 3,BB,1.5,15,14,2468,12,2018,10,2
Group 3,BB,1.5,15,14,2469,13,2018,12,1
Group 3,BB,1.5,15,14,2470,14,2018,8,6
Group 3,BB,1.5,15,14,2471,9,2018,6,3
Group 3,BB,1.5,15,14,2472,10,2018,10,0
Group 3,BB,1.5,15,14,2473,11,2018,8,3
Group 3,BB,1.5,15,14,2474,13,2018,10,3
Group 3,BB,1.5,15,14,2475,10,2018,13,-3
Group 3,BB,1.5,15,14,2476,10,2018,12,-2
Group 3,BB,1.5,15,14,2477,12,2018,13,-1
Group 3,BB,1.5,15,14,2478,13,2018,9,4
Group 3,BB,1.5,15,14,2479,10,2018,10,0
Group 3,BB,1.5,15,14,2480,10,2018,11,-1
Group 3,BB,1.5,15,14,2481,11,2018,8,3
Group 3,BB,1.5,15,14,2482,9,2018,9,0
Group 3,BB,1.5,15,14,2483,12,2018,11,1
Group 3,BB,1.5,15,14,2484,10,2018,12,-2
Group 3,BB,1.5,15,14,2485,11,2018,8,3
Group 3,BB,1.5,15,14,2486,9,2018,11,-2
Group 3,BB,1.5,15,14,2487,11,2018,9,2
Group 3,BB,1.5,15,14,2488,13,2018,11,2
Group 3,BB,1.5,15,14,2489,8,2018,12,-4
Group 3,BB,1.5,15,14,2490,9,2018,13,-4
Group 3,BB,1.5,15,14,2491,10,2018,11,-1
Group 3,BB,1.5,15,14,2492,13,2018,8,5
Group 3,BB,1.5,15,14,2493,9,2018,12,-3
Group 3,BB,1.5,15,14,2494,10,2018,13,-3
Group 3,BB,1.5,15,14,2495,10,2018,10,0
Group 3,BB,1.5,15,14,2496,13,2018,9,4
Group 3,BB,1.5,15,14,2497,10,2018,9,1
Group 3,BB,1.5,15,14,2498,9,2018,8,1
Group 3,BB,1.5,15,14,2499,12,2018,14,-2
Group 3,BB,1.5,15,14,2500,11,2018,8,3
Group 3,BB,1.5,15,14,2501,10,2018,9,1
Group 3,BB,1.5,15,14,2502,11,2018,12,-1
Group 3,BB,1.5,15,14,2503,9,2018,8,1
Group 3,BB,1.5,15,14,2504,11,2018,13,-2
Group 3,BB,1.5,15,14,2505,10,2018,9,1
Group 3,BB,1.5,15,14,2506,13,2018,9,4
Group 3,BB,1.5,15,14,2507,12,2018,8,4
Group 3,BB,1.5,15,14,2508,12,2018,11,1
Group 3,BB,1.5,15,14,2509,12,2018,10,2
Group 3,BB,1.5,15,14,2510,10,2018,11,-1
Group 3,BB,1.5,15,14,2511,8,2018,11,-3
Group 3,BB,1.5,15,14,2512,9,2018,12,-3
Group 3,BB,1.5,15,14,2513,9,2018,10,-1
Group 3,BB,1.5,15,14,2514,13,2018,12,1
Group 3,BB,1.5,15,14,2515,9,2018,10,-1
Group 3,BB,1.5,15,14,2516,10,2018,10,0
Group 3,BB,1.5,15,14,2517,10,2018,11,-1
Group 3,BB,1.5,15,14,2518,7,2018,9,-2
Group 3,BB,1.5,15,14,2519,9,2018,6,3
Group 3,BB,1.5,15,14,2520,9,2018,11,-2
Group 3,BB,1.5,15,14,2521,12,2018,10,2
Group 3,BB,1.5,15,14,2522,9,2018,9,0
Group 3,BB,1.5,15,14,2523,9,2018,6,3
Group 3,BB,1.5,15,14,2524,13,2018,13,0
Group 3,BB,1.5,15,14,2525,8,2018,13,-5
Group 3,BB,1.5,15,14,2526,7,2018,14,-7
Group 3,BB,1.5,15,14,2527,12,2018,9,3
Group 3,BB,1.5,15,14,2528,8,2018,9,-1
Group 3,BB,1.5,15,14,2529,10,2018,9,1
Group 3,BB,1.5,15,14,2530,12,2018,7,5
Group 3,BB,1.5,15,14,2531,7,2018,11,-4
Group 3,BB,1.5,15,14,2532,12,2018,10,2
Group 3,BB,1.5,15,14,2533,11,2018,10,1
Group 3,BB,1.5,15,14,2534,13,2018,11,2
Group 3,BB,1.5,15,14,2535,11,2018,11,0
Group 3,BB,1.5,15,14,2536,6,2018,7,-1
Group 3,BB,1.5,15,14,2537,11,2018,10,1
Group 3,BB,1.5,15,14,2538,13,2018,8,5
Group 3,BB,1.5,15,14,2539,10,2018,12,-2
Group 3,BB,1.5,15,14,2540,11,2018,10,1
Group 3,BB,1.5,15,14,2541,10,2018,11,-1
Group 3,BB,1.5,15,14,2542,11,2018,10,1
Group 3,BB,1.5,15,14,2543,11,2018,7,4
Group 3,BB,1.5,15,14,2544,6,2018,12,-6
Group 3,BB,1.5,15,14,2545,6,2018,11,-5
Group 3,BB,1.5,15,14,2546,11,2018,8,3
Group 3,BB,1.5,15,14,2547,7,2018,10,-3
Group 3,BB,1.5,15,14,2548,9,2018,11,-2
Group 3,BB,1.5,15,14,2549,10,2018,10,0
Group 3,BB,1.5,15,14,2550,14,2018,8,6
Group 3,BB,1.5,15,14,2551,10,2018,11,-1
Group 3,BB,1.5,15,14,2552,8,2018,13,-5
Group 3,BB,1.5,15,14,2553,10,2018,10,0
Group 3,BB,1.5,15,14,2554,11,2018,12,-1
Group 3,BB,1.5,15,14,2555,9,2018,8,1
Group 3,BB,1.5,15,14,2556,12,2018,10,2
Group 3,BB,1.5,15,14,2557,11,2018,10,1
Group 3,BB,1.5,15,14,2558,11,2018,7,4
Group 3,BB,1.5,15,14,2559,7,2018,14,-7
Group 3,BB,1.5,15,14,2560,11,2018,11,0
Group 3,BB,1.5,15,14,2561,12,2018,9,3
Group 3,BB,1.5,15,14,2562,12,2018,9,3
Group 3,BB,1.5,15,14,2563,8,2018,8,0
Group 3,BB,1.5,15,14,2564,11,2018,13,-2
Group 3,BB,1.5,15,14,2565,6,2018,11,-5
Group 3,BB,1.5,15,14,2566,14,2018,11,3
Group 3,BB,1.5,15,14,2567,13,2018,14,-1
Group 3,BB,1.5,15,14,2568,10,2018,5,5
Group 3,BB,1.5,15,14,2569,7,2018,8,-1
Group 3,BB,1.5,15,14,2570,14,2018,10,4
Group 3,BB,1.5,15,14,2571,12,2018,10,2
Group 3,BB,1.5,15,14,2572,9,2018,8,1
Group 3,BB,1.5,15,14,2573,9,2018,11,-2
Group 3,BB,1.5,15,14,2574,11,2018,12,-1
Group 3,BB,1.5,15,14,2575,10,2018,5,5
Group 3,BB,1.5,15,14,2576,11,2018,12,-1
Group 3,BB,1.5,15,14,2577,13,2018,9,4
Group 3,BB,1.5,15,14,2578,8,2018,11,-3
Group 3,BB,1.5,15,14,2579,8,2018,8,0
Group 3,BB,1.5,15,14,2580,10,2018,12,-2
Group 3,BB,1.5,15,14,2581,14,2018,12,2
Group 3,BB,1.5,15,14,2582,10,2018,11,-1
Group 3,BB,1.5,15,14,2583,11,2018,8,3
Group 3,BB,1.5,15,14,2584,11,2018,10,1
Group 3,BB,1.5,15,14,2585,10,2018,10,0
Group 3,BB,1.5,15,14,2586,9,2018,6,3
Group 3,BB,1.5,15,14,2587,10,2018,12,-2
Group 3,BB,1.5,15,14,2588,10,2018,11,-1
Group 3,BB,1.5,15,14,2589,10,2018,10,0
Group 3,BB,1.5,15,14,2590,12,2018,10,2
Group 3,BB,1.5,15,14,2591,11,2018,11,0
Group 3,BB,1.5,15,14,2592,7,2018,14,-7
Group 3,BB,1.5,15,14,2593,9,2018,10,-1
Group 3,BB,1.5,15,14,2594,7,2018,14,-7
Group 3,BB,1.5,15,14,2595,12,2018,12,0
Group 3,BB,1.5,15,14,2596,11,2018,11,0
Group 3,BB,1.5,15,14,2597,10,2018,13,-3
Group 3,BB,1.5,15,14,2598,8,2018,12,-4
Group 3,BB,1.5,15,14,2599,13,2018,10,3
Group 3,BB,1.5,15,14,2600,12,2018,8,4
Group 3,BB,1.5,15,14,2601,12,2018,9,3
Group 3,BB,1.5,15,14,2602,6,2018,12,-6
Group 3,BB,1.5,15,14,2603,4,2018,14,-10
Group 3,BB,1.5,15,14,2604,9,2018,6,3
Group 3,BB,1.5,15,14,2605,10,2018,9,1
Group 3,BB,1.5,15,14,2606,10,2018,9,1
Group 3,BB,1.5,15,14,2607,9,2018,9,0
Group 3,BB,1.5,15,14,2608,11,2018,11,0
Group 3,BB,1.5,15,14,2609,13,2018,11,2
Group 3,BB,1.5,15,14,2610,9,2018,5,4
Group 3,BB,1.5,15,14,2611,9,2018,9,0
Group 3,BB,1.5,15,14,2612,12,2018,9,3
Group 3,BB,1.5,15,14,2613,9,2018,9,0
Group 3,BB,1.5,15,14,2614,10,2018,12,-2
Group 3,BB,1.5,15,14,2615,10,2018,8,2
Group 3,BB,1.5,15,14,2616,9,2018,12,-3
Group 3,BB,1.5,15,14,2617,14,2018,8,6
Group 3,BB,1.5,15,14,2618,12,2018,12,0
Group 3,BB,1.5,15,14,2619,9,2018,11,-2
Group 3,BB,1.5,15,14,2620,11,2018,10,1
Group 3,BB,1.5,15,14,2621,11,2018,12,-1
Group 3,BB,1.5,15,14,2622,8,2018,13,-5
Group 3,BB,1.5,15,14,2623,9,2018,11,-2
Group 3,BB,1.5,15,14,2624,11,2018,9,2
Group 3,BB,1.5,15,14,2625,12,2018,11,1
Group 3,BB,1.5,15,14,2626,11,2018,11,0
Group 3,BB,1.5,15,14,2627,10,2018,12,-2
Group 3,BB,1.5,15,14,2628,13,2018,10,3
Group 3,BB,1.5,15,14,2629,9,2018,10,-1
Group 3,BB,1.5,15,14,2630,9,2018,9,0
Group 3,BB,1.5,15,14,2631,13,2018,9,4
Group 3,BB,1.5,15,14,2632,11,2018,10,1
Group 3,BB,1.5,15,14,2633,9,2018,7,2
Group 3,BB,1.5,15,14,2634,8,2018,10,-2
Group 3,BB,1.5,15,14,2635,10,2018,10,0
Group 3,BB,1.5,15,14,2636,12,2018,8,4
Group 3,BB,1.5,15,14,2637,11,2018,9,2
Group 3,BB,1.5,15,14,2638,11,2018,10,1
Group 3,BB,1.5,15,14,2639,10,2018,7,3
Group 3,BB,1.5,15,14,2640,12,2018,11,1
Group 3,BB,1.5,15,14,2641,9,2018,11,-2
Group 3,BB,1.5,15,14,2642,11,2018,12,-1
Group 3,BB,1.5,15,14,2643,11,2018,8,3
Group 3,BB,1.5,15,14,2644,11,2018,12,-1
Group 3,BB,1.5,15,14,2645,11,2018,8,3
Group 3,BB,1.5,15,14,2646,11,2018,10,1
Group 3,BB,1.5,15,14,2647,8,2018,11,-3
Group 3,BB,1.5,15,14,2648,10,2018,8,2
Group 3,BB,1.5,15,14,2649,8,2018,11,-3
Group 3,BB,1.5,15,14,2650,9,2018,11,-2
Group 3,BB,1.5,15,14,2651,11,2018,11,0
Group 3,BB,1.5,15,14,2652,13,2018,11,2
Group 3,BB,1.5,15,14,2653,9,2018,5,4
Group 3,BB,1.5,15,14,2654,13,2018,8,5
Group 3,BB,1.5,15,14,2655,9,2018,12,-3
Group 3,BB,1.5,15,14,2656,11,2018,8,3
Group 3,BB,1.5,15,14,2657,9,2018,11,-2
Group 3,BB,1.5,15,14,2658,11,2018,8,3
Group 3,BB,1.5,15,14,2659,10,2018,11,-1
Group 3,BB,1.5,15,14,2660,9,2018,8,1
Group 3,BB,1.5,15,14,2661,12,2018,12,0
Group 3,BB,1.5,15,14,2662,10,2018,11,-1
Group 3,BB,1.5,15,14,2663,10,2018,11,-1
Group 3,BB,1.5,15,14,2664,12,2018,13,-1
Group 3,BB,1.5,15,14,2665,12,2018,12,0
Group 3,BB,1.5,15,14,2666,12,2018,9,3
Group 3,BB,1.5,15,14,2667,9,2018,11,-2
Group 3,BB,1.5,15,14,2668,11,2018,9,2
Group 3,BB,1.5,15,14,2669,13,2018,11,2
Group 3,BB,1.5,15,14,2670,14,2018,12,2
Group 3,BB,1.5,15,14,2671,11,2018,10,1
Group 3,BB,1.5,15,14,2672,12,2018,10,2
Group 3,BB,1.5,15,14,2673,14,2018,7,7
Group 3,BB,1.5,15,14,2674,12,2018,10,2
Group 3,BB,1.5,15,14,2675,11,2018,10,1
Group 3,BB,1.5,15,14,2676,9,2018,9,0
Group 3,BB,1.5,15,14,2677,9,2018,8,1
Group 3,BB,1.5,15,14,2678,9,2018,13,-4
Group 3,BB,1.5,15,14,2679,11,2018,11,0
Group 3,BB,1.5,15,14,2680,9,2018,10,-1
Group 3,BB,1.5,15,14,2681,12,2018,11,1
Group 3,BB,1.5,15,14,2682,9,2018,13,-4
Group 3,BB,1.5,15,14,2683,7,2018,12,-5
Group 3,BB,1.5,15,14,2684,12,2018,11,1
Group 3,BB,1.5,15,14,2685,12,2018,11,1
Group 3,BB,1.5,15,14,2686,9,2018,8,1
Group 3,BB,1.5,15,14,2687,9,2018,9,0
Group 3,BB,1.5,15,14,2688,10,2018,11,-1
Group 3,BB,1.5,15,14,2689,7,2018,11,-4
Group 3,BB,1.5,15,14,2690,11,2018,12,-1
Group 3,BB,1.5,15,14,2691,9,2018,11,-2
Group 3,BB,1.5,15,14,2692,12,2018,7,5
Group 3,BB,1.5,15,14,2693,6,2018,12,-6
Group 3,BB,1.5,15,14,2694,11,2018,11,0
Group 3,BB,1.5,15,14,2695,11,2018,5,6
Group 3,BB,1.5,15,14,2696,8,2018,9,-1
Group 3,BB,1.5,15,14,2697,10,2018,10,0
Group 3,BB,1.5,15,14,2698,11,2018,10,1
Group 3,BB,1.5,15,14,2699,8,2018,9,-1
Group 3,BB,1.5,15,14,2700,11,2018,11,0
Group 3,BB,1.5,15,14,2701,9,2018,10,-1
Group 3,BB,1.5,15,14,2702,10,2018,6,4
Group 3,BB,1.5,15,14,2703,14,2018,11,3
Group 3,BB,1.5,15,14,2704,12,2018,8,4
Group 3,BB,1.5,15,14,2705,5,2018,10,-5
Group 3,BB,1.5,15,14,2706,11,2018,8,3
Group 3,BB,1.5,15,14,2707,10,2018,9,1
Group 3,BB,1.5,15,14,2708,11,2018,12,-1
Group 3,BB,1.5,15,14,2709,8,2018,13,-5
Group 3,BB,1.5,15,14,2710,10,2018,11,-1
Group 3,BB,1.5,15,14,2711,12,2018,7,5
Group 3,BB,1.5,15,14,2712,11,2018,12,-1
Group 3,BB,1.5,15,14,2713,4,2018,11,-7
Group 3,BB,1.5,15,14,2714,8,2018,10,-2
Group 3,BB,1.5,15,14,2715,10,2018,11,-1
Group 3,BB,1.5,15,14,2716,10,2018,5,5
Group 3,BB,1.5,15,14,2717,10,2018,8,2
Group 3,BB,1.5,15,14,2718,9,2018,9,0
Group 3,BB,1.5,15,14,2719,10,2018,9,1
Group 3,BB,1.5,15,14,2720,12,2018,13,-1
Group 3,BB,1.5,15,14,2721,11,2018,11,0
Group 3,BB,1.5,15,14,2722,11,2018,12,-1
Group 3,BB,1.5,15,14,2723,10,2018,9,1
Group 3,BB,1.5,15,14,2724,12,2018,8,4
Group 3,BB,1.5,15,14,2725,11,2018,11,0
Group 3,BB,1.5,15,14,2726,13,2018,11,2
Group 3,BB,1.5,15,14,2727,12,2018,10,2
Group 3,BB,1.5,15,14,2728,8,2018,9,-1
Group 3,BB,1.5,15,14,2729,10,2018,12,-2
Group 3,BB,1.5,15,14,2730,10,2018,9,1
Group 3,BB,1.5,15,14,2731,10,2018,12,-2
Group 3,BB,1.5,15,14,2732,10,2018,8,2
Group 3,BB,1.5,15,14,2733,10,2018,7,3
Group 3,BB,1.5,15,14,2734,10,2018,12,-2
Group 3,BB,1.5,15,14,2735,9,2018,10,-1
Group 3,BB,1.5,15,14,2736,7,2018,9,-2
Group 3,BB,1.5,15,14,2737,11,2018,8,3
Group 3,BB,1.5,15,14,2738,12,2018,8,4
Group 3,BB,1.5,15,14,2739,12,2018,11,1
Group 3,BB,1.5,15,14,2740,13,2018,11,2
Group 3,BB,1.5,15,14,2741,9,2018,5,4
Group 3,BB,1.5,15,14,2742,8,2018,7,1
Group 3,BB,1.5,15,14,2743,10,2018,8,2
Group 3,BB,1.5,15,14,2744,9,2018,7,2
Group 3,BB,1.5,15,14,2745,12,2018,12,0
Group 3,BB,1.5,15,14,2746,12,2018,11,1
Group 3,BB,1.5,15,14,2747,10,2018,13,-3
Group 3,BB,1.5,15,14,2748,13,2018,10,3
Group 3,BB,1.5,15,14,2749,12,2018,11,1
Group 3,BB,1.5,15,14,2750,11,2018,10,1
Group 3,BB,1.5,15,14,2751,11,2018,11,0
Group 3,BB,1.5,15,14,2752,11,2018,10,1
Group 3,BB,1.5,15,14,2753,11,2018,13,-2
Group 3,BB,1.5,15,14,2754,9,2018,10,-1
Group 3,BB,1.5,15,14,2755,9,2018,10,-1
Group 3,BB,1.5,15,14,2756,9,2018,9,0
Group 3,BB,1.5,15,14,2757,10,2018,9,1
Group 3,BB,1.5,15,14,2758,7,2018,14,-7
Group 3,BB,1.5,15,14,2759,12,2018,12,0
Group 3,BB,1.5,15,14,2760,11,2018,10,1
Group 3,BB,1.5,15,14,2761,11,2018,11,0
Group 3,BB,1.5,15,14,2762,10,2018,10,0
Group 3,BB,1.5,15,14,2763,10,2018,11,-1
Group 3,BB,1.5,15,14,2764,8,2018,8,0
Group 3,BB,1.5,15,14,2765,11,2018,8,3
Group 3,BB,1.5,15,14,2766,11,2018,11,0
Group 3,BB,1.5,15,14,2767,10,2018,7,3
Group 3,BB,1.5,15,14,2768,13,2018,10,3
Group 3,BB,1.5,15,14,2769,11,2018,10,1
Group 3,BB,1.5,15,14,2770,12,2018,10,2
Group 3,BB,1.5,15,14,2771,14,2018,11,3
Group 3,BB,1.5,15,14,2772,12,2018,9,3
Group 3,BB,1.5,15,14,2773,11,2018,11,0
Group 3,BB,1.5,15,14,2774,10,2018,10,0
Group 3,BB,1.5,15,14,2775,12,2018,11,1
Group 3,BB,1.5,15,14,2776,11,2018,10,1
Group 3,BB,1.5,15,14,2777,6,2018,12,-6
Group 3,BB,1.5,15,14,2778,11,2018,10,1
Group 3,BB,1.5,15,14,2779,12,2018,10,2
Group 3,BB,1.5,15,14,2780,12,2018,9,3
Group 3,BB,1.5,15,14,2781,11,2018,11,0
Group 3,BB,1.5,15,14,2782,10,2018,9,1
Group 3,BB,1.5,15,14,2783,12,2018,8,4
Group 3,BB,1.5,15,14,2784,7,2018,9,-2
Group 3,BB,1.5,15,14,2785,6,2018,12,-6
Group 3,BB,1.5,15,14,2786,7,2018,7,0
Group 3,BB,1.5,15,14,2787,9,2018,12,-3
Group 3,BB,1.5,15,14,2788,12,2018,12,0
Group 3,BB,1.5,15,14,2789,12,2018,11,1
Group 3,BB,1.5,15,14,2790,9,2018,9,0
Group 3,BB,1.5,15,14,2791,13,2018,9,4
Group 3,BB,1.5,15,14,2792,9,2018,12,-3
Group 3,BB,1.5,15,14,2793,8,2018,13,-5
Group 3,BB,1.5,15,14,2794,7,2018,9,-2
Group 3,BB,1.5,15,14,2795,7,2018,12,-5
Group 3,BB,1.5,15,14,2796,9,2018,9,0
Group 3,BB,1.5,15,14,2797,12,2018,11,1
Group 3,BB,1.5,15,14,2798,11,2018,11,0
Group 3,BB,1.5,15,14,2799,7,2018,11,-4
Group 3,BB,1.5,15,14,2800,7,2018,10,-3
Group 3,BB,1.5,15,14,2801,10,2018,11,-1
Group 3,BB,1.5,15,14,2802,12,2018,9,3
Group 3,BB,1.5,15,14,2803,11,2018,12,-1
Group 3,BB,1.5,15,14,2804,6,2018,13,-7
Group 3,BB,1.5,15,14,2805,10,2018,11,-1
Group 3,BB,1.5,15,14,2806,14,2018,7,7
Group 3,BB,1.5,15,14,2807,10,2018,12,-2
Group 3,BB,1.5,15,14,2808,11,2018,9,2
Group 3,BB,1.5,15,14,2809,12,2018,14,-2
Group 3,BB,1.5,15,14,2810,10,2018,11,-1
Group 3,BB,1.5,15,14,2811,9,2018,12,-3
Group 3,BB,1.5,15,14,2812,13,2018,10,3
Group 3,BB,1.5,15,14,2813,11,2018,10,1
Group 3,BB,1.5,15,14,2814,9,2018,8,1
Group 3,BB,1.5,15,14,2815,11,2018,10,1
Group 3,BB,1.5,15,14,2816,9,2018,8,1
Group 3,BB,1.5,15,14,2817,12,2018,9,3
Group 3,BB,1.5,15,14,2818,9,2018,12,-3
Group 3,BB,1.5,15,14,2819,11,2018,9,2
Group 3,BB,1.5,15,14,2820,11,2018,12,-1
Group 3,BB,1.5,15,14,2821,9,2018,7,2
Group 3,BB,1.5,15,14,2822,5,2018,8,-3
Group 3,BB,1.5,15,14,2823,11,2018,7,4
Group 3,BB,1.5,15,14,2824,13,2018,9,4
Group 3,BB,1.5,15,14,2825,9,2018,11,-2
Group 3,BB,1.5,15,14,2826,9,2018,12,-3
Group 3,BB,1.5,15,14,2827,14,2018,11,3
Group 3,BB,1.5,15,14,2828,10,2018,7,3
Group 3,BB,1.5,15,14,2829,9,2018,10,-1
Group 3,BB,1.5,15,14,2830,8,2018,10,-2
Group 3,BB,1.5,15,14,2831,8,2018,3,5
Group 3,BB,1.5,15,14,2832,10,2018,9,1
Group 3,BB,1.5,15,14,2833,12,2018,7,5
Group 3,BB,1.5,15,14,2834,11,2018,13,-2
Group 3,BB,1.5,15,14,2835,12,2018,7,5
Group 3,BB,1.5,15,14,2836,13,2018,10,3
Group 3,BB,1.5,15,14,2837,13,2018,8,5
Group 3,BB,1.5,15,14,2838,7,2018,11,-4
Group 3,BB,1.5,15,14,2839,14,2018,11,3
Group 3,BB,1.5,15,14,2840,7,2018,8,-1
Group 3,BB,1.5,15,14,2841,12,2018,12,0
Group 3,BB,1.5,15,14,2842,14,2018,9,5
Group 3,BB,1.5,15,14,2843,11,2018,14,-3
Group 3,BB,1.5,15,14,2844,10,2018,10,0
Group 3,BB,1.5,15,14,2845,9,2018,6,3
Group 3,BB,1.5,15,14,2846,10,2018,8,2
Group 3,BB,1.5,15,14,2847,11,2018,8,3
Group 3,BB,1.5,15,14,2848,10,2018,9,1
Group 3,BB,1.5,15,14,2849,13,2018,11,2
Group 3,BB,1.5,15,14,2850,11,2018,7,4
Group 3,BB,1.5,15,14,2851,11,2018,9,2
Group 3,BB,1.5,15,14,2852,9,2018,11,-2
Group 3,BB,1.5,15,14,2853,10,2018,10,0
Group 3,BB,1.5,15,14,2854,12,2018,8,4
Group 3,BB,1.5,15,14,2855,11,2018,13,-2
Group 3,BB,1.5,15,14,2856,10,2018,9,1
Group 3,BB,1.5,15,14,2857,6,2018,9,-3
Group 3,BB,1.5,15,14,2858,12,2018,9,3
Group 3,BB,1.5,15,14,2859,12,2018,12,0
Group 3,BB,1.5,15,14,2860,13,2018,9,4
Group 3,BB,1.5,15,14,2861,8,2018,10,-2
Group 3,BB,1.5,15,14,2862,11,2018,11,0
Group 3,BB,1.5,15,14,2863,11,2018,8,3
Group 3,BB,1.5,15,14,2864,11,2018,10,1
Group 3,BB,1.5,15,14,2865,11,2018,10,1
Group 3,BB,1.5,15,14,2866,13,2018,8,5
Group 3,BB,1.5,15,14,2867,11,2018,11,0
Group 3,BB,1.5,15,14,2868,11,2018,12,-1
Group 3,BB,1.5,15,14,2869,13,2018,8,5
Group 3,BB,1.5,15,14,2870,8,2018,13,-5
Group 3,BB,1.5,15,14,2871,11,2018,11,0
Group 3,BB,1.5,15,14,2872,9,2018,13,-4
Group 3,BB,1.5,15,14,2873,11,2018,13,-2
Group 3,BB,1.5,15,14,2874,13,2018,14,-1
Group 3,BB,1.5,15,14,2875,12,2018,9,3
Group 3,BB,1.5,15,14,2876,11,2018,8,3
Group 3,BB,1.5,15,14,2877,13,2018,10,3
Group 3,BB,1.5,15,14,2878,10,2018,10,0
Group 3,BB,1.5,15,14,2879,13,2018,7,6
Group 3,BB,1.5,15,14,2880,13,2018,10,3
Group 3,BB,1.5,15,14,2881,8,2018,9,-1
Group 3,BB,1.5,15,14,2882,12,2018,9,3
Group 3,BB,1.5,15,14,2883,8,2018,10,-2
Group 3,BB,1.5,15,14,2884,14,2018,9,5
Group 3,BB,1.5,15,14,2885,10,2018,11,-1
Group 3,BB,1.5,15,14,2886,13,2018,12,1
Group 3,BB,1.5,15,14,2887,11,2018,13,-2
Group 3,BB,1.5,15,14,2888,10,2018,13,-3
Group 3,BB,1.5,15,14,2889,12,2018,8,4
Group 3,BB,1.5,15,14,2890,10,2018,10,0
Group 3,BB,1.5,15,14,2891,13,2018,11,2
Group 3,BB,1.5,15,14,2892,10,2018,13,-3
Group 3,BB,1.5,15,14,2893,13,2018,10,3
Group 3,BB,1.5,15,14,2894,10,2018,10,0
Group 3,BB,1.5,15,14,2895,12,2018,10,2
Group 3,BB,1.5,15,14,2896,11,2018,9,2
Group 3,BB,1.5,15,14,2897,10,2018,9,1
Group 3,BB,1.5,15,14,2898,13,2018,10,3
Group 3,BB,1.5,15,14,2899,9,2018,12,-3
Group 3,BB,1.5,15,14,2900,13,2018,9,4
Group 3,BB,1.5,15,14,2901,7,2018,10,-3
Group 3,BB,1.5,15,14,2902,13,2018,10,3
Group 3,BB,1.5,15,14,2903,12,2018,8,4
Group 3,BB,1.5,15,14,2904,9,2018,10,-1
Group 3,BB,1.5,15,14,2905,9,2018,9,0
Group 3,BB,1.5,15,14,2906,11,2018,8,3
Group 3,BB,1.5,15,14,2907,10,2018,9,1
Group 3,BB,1.5,15,14,2908,9,2018,8,1
Group 3,BB,1.5,15,14,2909,9,2018,11,-2
Group 3,BB,1.5,15,14,2910,11,2018,11,0
Group 3,BB,1.5,15,14,2911,10,2018,13,-3
Group 3,BB,1.5,15,14,2912,11,2018,6,5
Group 3,BB,1.5,15,14,2913,10,2018,7,3
Group 3,BB,1.5,15,14,2914,12,2018,12,0
Group 3,BB,1.5,15,14,2915,11,2018,12,-1
Group 3,BB,1.5,15,14,2916,10,2018,8,2
Group 3,BB,1.5,15,14,2917,9,2018,12,-3
Group 3,BB,1.5,15,14,2918,11,2018,10,1
Group 3,BB,1.5,15,14,2919,9,2018,8,1
Group 3,BB,1.5,15,14,2920,11,2018,11,0
Group 3,BB,1.5,15,14,2921,11,2018,7,4
Group 3,BB,1.5,15,14,2922,12,2018,9,3
Group 3,BB,1.5,15,14,2923,11,2018,11,0
Group 3,BB,1.5,15,14,2924,13,2018,6,7
Group 3,BB,1.5,15,14,2925,8,2018,9,-1
Group 3,BB,1.5,15,14,2926,11,2018,11,0
Group 3,BB,1.5,15,14,2927,10,2018,11,-1
Group 3,BB,1.5,15,14,2928,10,2018,9,1
Group 3,BB,1.5,15,14,2929,13,2018,8,5
Group 3,BB,1.5,15,14,2930,9,2018,9,0
Group 3,BB,1.5,15,14,2931,12,2018,11,1
Group 3,BB,1.5,15,14,2932,9,2018,12,-3
Group 3,BB,1.5,15,14,2933,10,2018,11,-1
Group 3,BB,1.5,15,14,2934,11,2018,10,1
Group 3,BB,1.5,15,14,2935,13,2018,11,2
Group 3,BB,1.5,15,14,2936,10,2018,11,-1
Group 3,BB,1.5,15,14,2937,10,2018,10,0
Group 3,BB,1.5,15,14,2938,13,2018,12,1
Group 3,BB,1.5,15,14,2939,11,2018,10,1
Group 3,BB,1.5,15,14,2940,10,2018,11,-1
Group 3,BB,1.5,15,14,2941,8,2018,11,-3
Group 3,BB,1.5,15,14,2942,12,2018,10,2
Group 3,BB,1.5,15,14,2943,11,2018,11,0
Group 3,BB,1.5,15,14,2944,12,2018,9,3
Group 3,BB,1.5,15,14,2945,11,2018,13,-2
Group 3,BB,1.5,15,14,2946,12,2018,10,2
Group 3,BB,1.5,15,14,2947,12,2018,9,3
Group 3,BB,1.5,15,14,2948,11,2018,11,0
Group 3,BB,1.5,15,14,2949,13,2018,10,3
Group 3,BB,1.5,15,14,2950,10,2018,10,0
Group 3,BB,1.5,15,14,2951,10,2018,8,2
Group 3,BB,1.5,15,14,2952,7,2018,10,-3
Group 3,BB,1.5,15,14,2953,9,2018,10,-1
Group 3,BB,1.5,15,14,2954,8,2018,11,-3
Group 3,BB,1.5,15,14,2955,12,2018,8,4
Group 3,BB,1.5,15,14,2956,12,2018,11,1
Group 3,BB,1.5,15,14,2957,10,2018,14,-4
Group 3,BB,1.5,15,14,2958,11,2018,13,-2
Group 3,BB,1.5,15,14,2959,9,2018,12,-3
Group 3,BB,1.5,15,14,2960,13,2018,10,3
Group 3,BB,1.5,15,14,2961,11,2018,9,2
Group 3,BB,1.5,15,14,2962,13,2018,9,4
Group 3,BB,1.5,15,14,2963,11,2018,8,3
Group 3,BB,1.5,15,14,2964,12,2018,10,2
Group 3,BB,1.5,15,14,2965,9,2018,7,2
Group 3,BB,1.5,15,14,2966,12,2018,8,4
Group 3,BB,1.5,15,14,2967,10,2018,9,1
Group 3,BB,1.5,15,14,2968,11,2018,11,0
Group 3,BB,1.5,15,14,2969,10,2018,8,2
Group 3,BB,1.5,15,14,2970,8,2018,7,1
Group 3,BB,1.5,15,14,2971,10,2018,12,-2
Group 3,BB,1.5,15,14,2972,12,2018,9,3
Group 3,BB,1.5,15,14,2973,10,2018,9,1
Group 3,BB,1.5,15,14,2974,5,2018,7,-2
Group 3,BB,1.5,15,14,2975,12,2018,11,1
Group 3,BB,1.5,15,14,2976,11,2018,10,1
Group 3,BB,1.5,15,14,2977,12,2018,12,0
Group 3,BB,1.5,15,14,2978,12,2018,8,4
Group 3,BB,1.5,15,14,2979,7,2018,6,1
Group 3,BB,1.5,15,14,2980,12,2018,9,3
Group 3,BB,1.5,15,14,2981,13,2018,8,5
Group 3,BB,1.5,15,14,2982,11,2018,7,4
Group 3,BB,1.5,15,14,2983,9,2018,8,1
Group 3,BB,1.5,15,14,2984,12,2018,12,0
Group 3,BB,1.5,15,14,2985,12,2018,11,1
Group 3,BB,1.5,15,14,2986,12,2018,11,1
Group 3,BB,1.5,15,14,2987,13,2018,12,1
Group 3,BB,1.5,15,14,2988,8,2018,12,-4
Group 3,BB,1.5,15,14,2989,11,2018,9,2
Group 3,BB,1.5,15,14,2990,12,2018,9,3
Group 3,BB,1.5,15,14,2991,12,2018,10,2
Group 3,BB,1.5,15,14,2992,10,2018,9,1
Group 3,BB,1.5,15,14,2993,11,2018,10,1
Group 3,BB,1.5,15,14,2994,11,2018,7,4
Group 3,BB,1.5,15,14,2995,8,2018,11,-3
Group 3,BB,1.5,15,14,2996,12,2018,9,3
Group 3,BB,1.5,15,14,2997,10,2018,9,1
Group 3,BB,1.5,15,14,2998,4,2018,10,-6
Group 3,BB,1.5,15,14,2999,10,2018,11,-1
Group 3,BB,1.5,15,14,3000,10,2018,13,-3
Group 3,BB,1.5,15,14,3001,11,2018,11,0
Group 3,BB,1.5,15,14,3002,10,2018,9,1
Group 3,BB,1.5,15,14,3003,10,2018,12,-2
Group 3,BB,1.5,15,14,3004,10,2018,7,3
Group 3,BB,1.5,15,14,3005,9,2018,10,-1
Group 3,BB,1.5,15,14,3006,10,2018,11,-1
Group 3,BB,1.5,15,14,3007,12,2018,11,1
Group 3,BB,1.5,15,14,3008,12,2018,12,0
Group 3,BB,1.5,15,14,3009,12,2018,11,1
Group 3,BB,1.5,15,14,3010,12,2018,7,5
Group 3,BB,1.5,15,14,3011,9,2018,9,0
Group 3,BB,1.5,15,14,3012,11,2018,10,1
Group 3,BB,1.5,15,14,3013,10,2018,8,2
Group 3,BB,1.5,15,14,3014,10,2018,9,1
Group 3,BB,1.5,15,14,3015,11,2018,9,2
Group 3,BB,1.5,15,14,3016,11,2018,11,0
Group 3,BB,1.5,15,14,3017,9,2018,12,-3
Group 3,BB,1.5,15,14,3018,12,2018,9,3
Group 3,BB,1.5,15,14,3019,12,2018,11,1
Group 3,BB,1.5,15,14,3020,10,2018,9,1
Group 3,BB,1.5,15,14,3021,12,2018,12,0
Group 3,BB,1.5,15,14,3022,12,2018,6,6
Group 3,BB,1.5,15,14,3023,14,2018,5,9
Group 3,BB,1.5,15,14,3024,11,2018,13,-2
Group 3,BB,1.5,15,14,3025,10,2018,12,-2
Group 3,BB,1.5,15,14,3026,10,2018,10,0
Group 3,BB,1.5,15,14,3027,12,2018,10,2
Group 3,BB,1.5,15,14,3028,11,2018,12,-1
Group 3,BB,1.5,15,14,3029,11,2018,11,0
Group 3,BB,1.5,15,14,3030,10,2018,11,-1
Group 3,BB,1.5,15,14,3031,12,2018,9,3
Group 3,BB,1.5,15,14,3032,13,2018,9,4
Group 3,BB,1.5,15,14,3033,9,2018,11,-2
Group 3,BB,1.5,15,14,3034,9,2018,10,-1
Group 3,BB,1.5,15,14,3035,11,2018,12,-1
Group 3,BB,1.5,15,14,3036,11,2018,6,5
Group 3,BB,1.5,15,14,3037,7,2018,11,-4
Group 3,BB,1.5,15,14,3038,11,2018,10,1
Group 3,BB,1.5,15,14,3039,9,2018,12,-3
Group 3,BB,1.5,15,14,3040,10,2018,10,0
Group 3,BB,1.5,15,14,3041,12,2018,9,3
Group 3,BB,1.5,15,14,3042,11,2018,12,-1
Group 3,BB,1.5,15,14,3043,12,2018,11,1
Group 3,BB,1.5,15,14,3044,10,2018,5,5
Group 3,BB,1.5,15,14,3045,10,2018,9,1
Group 3,BB,1.5,15,14,3046,8,2018,12,-4
Group 3,BB,1.5,15,14,3047,8,2018,10,-2
Group 3,BB,1.5,15,14,3048,10,2018,11,-1
Group 3,BB,1.5,15,14,3049,10,2018,12,-2
Group 3,BB,1.5,15,14,3050,9,2018,12,-3
Group 3,BB,1.5,15,14,3051,13,2018,13,0
Group 3,BB,1.5,15,14,3052,10,2018,11,-1
Group 3,BB,1.5,15,14,3053,11,2018,12,-1
Group 3,BB,1.5,15,14,3054,12,2018,8,4
Group 3,BB,1.5,15,14,3055,12,2018,7,5
Group 3,BB,1.5,15,14,3056,8,2018,11,-3
Group 3,BB,1.5,15,14,3057,11,2018,10,1
Group 3,BB,1.5,15,14,3058,11,2018,11,0
Group 3,BB,1.5,15,14,3059,9,2018,10,-1
Group 3,BB,1.5,15,14,3060,10,2018,11,-1
Group 3,BB,1.5,15,14,3061,11,2018,10,1
Group 3,BB,1.5,15,14,3062,10,2018,8,2
Group 3,BB,1.5,15,14,3063,12,2018,9,3
Group 3,BB,1.5,15,14,3064,11,2018,11,0
Group 3,BB,1.5,15,14,3065,8,2018,10,-2
Group 3,BB,1.5,15,14,3066,13,2018,13,0
Group 3,BB,1.5,15,14,3067,7,2018,10,-3
Group 3,BB,1.5,15,14,3068,10,2018,11,-1
Group 3,BB,1.5,15,14,3069,8,2018,10,-2
Group 3,BB,1.5,15,14,3070,11,2018,11,0
Group 3,BB,1.5,15,14,3071,8,2018,11,-3
Group 3,BB,1.5,15,14,3072,10,2018,11,-1
Group 3,BB,1.5,15,14,3073,11,2018,11,0
Group 3,BB,1.5,15,14,3074,10,2018,10,0
Group 3,BB,1.5,15,14,3075,6,2018,11,-5
Group 3,BB,1.5,15,14,3076,7,2018,10,-3
Group 3,BB,1.5,15,14,3077,9,2018,8,1
Group 3,BB,1.5,15,14,3078,11,2018,13,-2
Group 3,BB,1.5,15,14,3079,9,2018,8,1
Group 3,BB,1.5,15,14,3080,9,2018,10,-1
Group 3,BB,1.5,15,14,3081,8,2018,11,-3
Group 3,BB,1.5,15,14,3082,13,2018,10,3
Group 3,BB,1.5,15,14,3083,13,2018,13,0
Group 3,BB,1.5,15,14,3084,5,2018,11,-6
Group 3,BB,1.5,15,14,3085,10,2018,11,-1
Group 3,BB,1.5,15,14,3086,13,2018,11,2
Group 3,BB,1.5,15,14,3087,12,2018,9,3
Group 3,BB,1.5,15,14,3088,10,2018,8,2
Group 3,BB,1.5,15,14,3089,12,2018,11,1
Group 3,BB,1.5,15,14,3090,11,2018,12,-1
Group 3,BB,1.5,15,14,3091,8,2018,12,-4
Group 3,BB,1.5,15,14,3092,10,2018,13,-3
Group 3,BB,1.5,15,14,3093,10,2018,9,1
Group 3,BB,1.5,15,14,3094,9,2018,10,-1
Group 3,BB,1.5,15,14,3095,8,2018,11,-3
Group 3,BB,1.5,15,14,3096,8,2018,11,-3
Group 3,BB,1.5,15,14,3097,9,2018,9,0
Group 3,BB,1.5,15,14,3098,12,2018,7,5
Group 3,BB,1.5,15,14,3099,9,2018,11,-2
Group 3,BB,1.5,15,14,3100,6,2018,10,-4
Group 3,BB,1.5,15,14,3101,13,2018,11,2
Group 3,BB,1.5,15,14,3102,9,2018,8,1
Group 3,BB,1.5,15,14,3103,7,2018,8,-1
Group 3,BB,1.5,15,14,3104,12,2018,12,0
Group 3,BB,1.5,15,14,3105,8,2018,12,-4
Group 3,BB,1.5,15,14,3106,12,2018,12,0
Group 3,BB,1.5,15,14,3107,11,2018,12,-1
Group 3,BB,1.5,15,14,3108,9,2018,7,2
Group 3,BB,1.5,15,14,3109,9,2018,9,0
Group 3,BB,1.5,15,14,3110,9,2018,12,-3
Group 3,BB,1.5,15,14,3111,11,2018,11,0
Group 3,BB,1.5,15,14,3112,8,2018,10,-2
Group 3,BB,1.5,15,14,3113,8,2018,10,-2
Group 3,BB,1.5,15,14,3114,11,2018,9,2
Group 3,BB,1.5,15,14,3115,9,2018,13,-4
Group 3,BB,1.5,15,14,3116,10,2018,8,2
Group 3,BB,1.5,15,14,3117,12,2018,10,2
Group 3,BB,1.5,15,14,3118,13,2018,7,6
Group 3,BB,1.5,15,14,3119,9,2018,13,-4
Group 3,BB,1.5,15,14,3120,10,2018,7,3
Group 3,BB,1.5,15,14,3121,12,2018,9,3
Group 3,BB,1.5,15,14,3122,10,2018,9,1
Group 3,BB,1.5,15,14,3123,7,2018,10,-3
Group 3,BB,1.5,15,14,3124,13,2018,14,-1
Group 3,BB,1.5,15,14,3125,10,2018,13,-3
Group 3,BB,1.5,15,14,3126,10,2018,12,-2
Group 3,BB,1.5,15,14,3127,13,2018,12,1
Group 3,BB,1.5,15,14,3128,12,2018,12,0
Group 3,BB,1.5,15,14,3129,11,2018,8,3
Group 3,BB,1.5,15,14,3130,13,2018,12,1
Group 3,BB,1.5,15,14,3131,8,2018,10,-2
Group 3,BB,1.5,15,14,3132,11,2018,11,0
Group 3,BB,1.5,15,14,3133,11,2018,9,2
Group 3,BB,1.5,15,14,3134,14,2018,12,2
Group 3,BB,1.5,15,14,3135,10,2018,12,-2
Group 3,BB,1.5,15,14,3136,11,2018,13,-2
Group 3,BB,1.5,15,14,3137,13,2018,11,2
Group 3,BB,1.5,15,14,3138,11,2018,12,-1
Group 3,BB,1.5,15,14,3139,11,2018,10,1
Group 3,BB,1.5,15,14,3140,8,2018,13,-5
Group 3,BB,1.5,15,14,3141,11,2018,11,0
Group 3,BB,1.5,15,14,3142,9,2018,9,0
Group 3,BB,1.5,15,14,3143,12,2018,13,-1
Group 3,BB,1.5,15,14,3144,9,2018,8,1
Group 3,BB,1.5,15,14,3145,7,2018,4,3
Group 3,BB,1.5,15,14,3146,12,2018,5,7
Group 3,BB,1.5,15,14,3147,13,2018,13,0
Group 3,BB,1.5,15,14,3148,10,2018,7,3
Group 3,BB,1.5,15,14,3149,11,2018,10,1
Group 3,BB,1.5,15,14,3150,11,2018,9,2
Group 3,BB,1.5,15,14,3151,13,2018,8,5
Group 3,BB,1.5,15,14,3152,9,2018,10,-1
Group 3,BB,1.5,15,14,3153,9,2018,10,-1
Group 3,BB,1.5,15,14,3154,11,2018,9,2
Group 3,BB,1.5,15,14,3155,8,2018,7,1
Group 3,BB,1.5,15,14,3156,12,2018,10,2
Group 3,BB,1.5,15,14,3157,9,2018,13,-4
Group 3,BB,1.5,15,14,3158,10,2018,13,-3
Group 3,BB,1.5,15,14,3159,10,2018,12,-2
Group 3,BB,1.5,15,14,3160,10,2018,11,-1
Group 3,BB,1.5,15,14,3161,10,2018,11,-1
Group 3,BB,1.5,15,14,3162,11,2018,8,3
Group 3,BB,1.5,15,14,3163,12,2018,10,2
Group 3,BB,1.5,15,14,3164,13,2018,11,2
Group 3,BB,1.5,15,14,3165,13,2018,9,4
Group 3,BB,1.5,15,14,3166,12,2018,10,2
Group 3,BB,1.5,15,14,3167,8,2018,11,-3
Group 3,BB,1.5,15,14,3168,9,2018,12,-3
Group 3,BB,1.5,15,14,3169,10,2018,7,3
Group 3,BB,1.5,15,14,3170,11,2018,12,-1
Group 3,BB,1.5,15,14,3171,11,2018,10,1
Group 3,BB,1.5,15,14,3172,12,2018,8,4
Group 3,BB,1.5,15,14,3173,9,2018,13,-4
Group 3,BB,1.5,15,14,3174,11,2018,13,-2
Group 3,BB,1.5,15,14,3175,13,2018,10,3
Group 3,BB,1.5,15,14,3176,13,2018,11,2
Group 3,BB,1.5,15,14,3177,12,2018,11,1
Group 3,BB,1.5,15,14,3178,11,2018,11,0
Group 3,BB,1.5,15,14,3179,7,2018,12,-5
Group 3,BB,1.5,15,14,3180,8,2018,10,-2
Group 3,BB,1.5,15,14,3181,12,2018,11,1
Group 3,BB,1.5,15,14,3182,10,2018,10,0
Group 3,BB,1.5,15,14,3183,9,2018,9,0
Group 3,BB,1.5,15,14,3184,10,2018,7,3
Group 3,BB,1.5,15,14,3185,10,2018,12,-2
Group 3,BB,1.5,15,14,3186,10,2018,13,-3
Group 3,BB,1.5,15,14,3187,10,2018,10,0
Group 3,BB,1.5,15,14,3188,9,2018,10,-1
Group 3,BB,1.5,15,14,3189,9,2018,5,4
Group 3,BB,1.5,15,14,3190,9,2018,9,0
Group 3,BB,1.5,15,14,3191,10,2018,6,4
Group 3,BB,1.5,15,14,3192,13,2018,6,7
Group 3,BB,1.5,15,14,3193,8,2018,12,-4
Group 3,BB,1.5,15,14,3194,13,2018,8,5
Group 3,BB,1.5,15,14,3195,11,2018,10,1
Group 3,BB,1.5,15,14,3196,12,2018,9,3
Group 3,BB,1.5,15,14,3197,8,2018,9,-1
Group 3,BB,1.5,15,14,3198,10,2018,10,0
Group 3,BB,1.5,15,14,3199,12,2018,13,-1
Group 3,BB,1.5,15,14,3200,10,2018,10,0
Group 3,BB,1.5,15,14,3201,12,2018,12,0
Group 3,BB,1.5,15,14,3202,11,2018,11,0
Group 3,BB,1.5,15,14,3203,11,2018,12,-1
Group 3,BB,1.5,15,14,3204,14,2018,8,6
Group 3,BB,1.5,15,14,3205,10,2018,9,1
Group 3,BB,1.5,15,14,3206,12,2018,9,3
Group 3,BB,1.5,15,14,3207,9,2018,11,-2
Group 3,BB,1.5,15,14,3208,12,2018,9,3
Group 3,BB,1.5,15,14,3209,12,2018,10,2
Group 3,BB,1.5,15,14,3210,12,2018,10,2
Group 3,BB,1.5,15,14,3211,7,2018,7,0
Group 3,BB,1.5,15,14,3212,12,2018,10,2
Group 3,BB,1.5,15,14,3213,9,2018,9,0
Group 3,BB,1.5,15,14,3214,13,2018,7,6
Group 3,BB,1.5,15,14,3215,11,2018,13,-2
Group 3,BB,1.5,15,14,3216,12,2018,11,1
Group 3,BB,1.5,15,14,3217,11,2018,8,3
Group 3,BB,1.5,15,14,3218,12,2018,12,0
Group 3,BB,1.5,15,14,3219,12,2018,11,1
Group 3,BB,1.5,15,14,3220,11,2018,9,2
Group 3,BB,1.5,15,14,3221,13,2018,9,4
Group 3,BB,1.5,15,14,3222,6,2018,12,-6
Group 3,BB,1.5,15,14,3223,10,2018,10,0
Group 3,BB,1.5,15,14,3224,12,2018,12,0
Group 3,BB,1.5,15,14,3225,10,2018,13,-3
Group 3,BB,1.5,15,14,3226,11,2018,12,-1
Group 3,BB,1.5,15,14,3227,13,2018,11,2
Group 3,BB,1.5,15,14,3228,11,2018,9,2
Group 3,BB,1.5,15,14,3229,12,2018,12,0
Group 3,BB,1.5,15,14,3230,10,2018,10,0
Group 3,BB,1.5,15,14,3231,12,2018,6,6
Group 3,BB,1.5,15,14,3232,9,2018,11,-2
Group 3,BB,1.5,15,14,3233,13,2018,12,1
Group 3,BB,1.5,15,14,3234,9,2018,11,-2
Group 3,BB,1.5,15,14,3235,10,2018,13,-3
Group 3,BB,1.5,15,14,3236,9,2018,10,-1
Group 3,BB,1.5,15,14,3237,12,2018,8,4
Group 3,BB,1.5,15,14,3238,10,2018,12,-2
Group 3,BB,1.5,15,14,3239,8,2018,10,-2
Group 3,BB,1.5,15,14,3240,10,2018,8,2
Group 3,BB,1.5,15,14,3241,9,2018,14,-5
Group 3,BB,1.5,15,14,3242,13,2018,7,6
Group 3,BB,1.5,15,14,3243,9,2018,8,1
Group 3,BB,1.5,15,14,3244,12,2018,11,1
Group 3,BB,1.5,15,14,3245,13,2018,10,3
Group 3,BB,1.5,15,14,3246,9,2018,10,-1
Group 3,BB,1.5,15,14,3247,10,2018,11,-1
Group 3,BB,1.5,15,14,3248,13,2018,8,5
Group 3,BB,1.5,15,14,3249,9,2018,9,0
Group 3,BB,1.5,15,14,3250,12,2018,10,2
Group 3,BB,1.5,15,14,3251,7,2018,9,-2
Group 3,BB,1.5,15,14,3252,11,2018,10,1
Group 3,BB,1.5,15,14,3253,8,2018,8,0
Group 3,BB,1.5,15,14,3254,7,2018,6,1
Group 3,BB,1.5,15,14,3255,5,2018,10,-5
Group 3,BB,1.5,15,14,3256,6,2018,8,-2
Group 3,BB,1.5,15,14,3257,10,2018,11,-1
Group 3,BB,1.5,15,14,3258,14,2018,11,3
Group 3,BB,1.5,15,14,3259,11,2018,9,2
Group 3,BB,1.5,15,14,3260,11,2018,10,1
Group 3,BB,1.5,15,14,3261,10,2018,11,-1
Group 3,BB,1.5,15,14,3262,9,2018,9,0
Group 3,BB,1.5,15,14,3263,11,2018,10,1
Group 3,BB,1.5,15,14,3264,7,2018,6,1
Group 3,BB,1.5,15,14,3265,8,2018,5,3
Group 3,BB,1.5,15,14,3266,13,2018,4,9
Group 3,BB,1.5,15,14,3267,11,2018,11,0
Group 3,BB,1.5,15,14,3268,8,2018,7,1
Group 3,BB,1.5,15,14,3269,8,2018,9,-1
Group 3,BB,1.5,15,14,3270,11,2018,8,3
Group 3,BB,1.5,15,14,3271,10,2018,10,0
Group 3,BB,1.5,15,14,3272,10,2018,12,-2
Group 3,BB,1.5,15,14,3273,11,2018,9,2
Group 3,BB,1.5,15,14,3274,12,2018,10,2
Group 3,BB,1.5,15,14,3275,12,2018,12,0
Group 3,BB,1.5,15,14,3276,13,2018,11,2
Group 3,BB,1.5,15,14,3277,11,2018,9,2
Group 3,BB,1.5,15,14,3278,10,2018,9,1
Group 3,BB,1.5,15,14,3279,11,2018,11,0
Group 3,BB,1.5,15,14,3280,11,2018,9,2
Group 3,BB,1.5,15,14,3281,9,2018,12,-3
Group 3,BB,1.5,15,14,3282,12,2018,10,2
Group 3,BB,1.5,15,14,3283,12,2018,12,0
Group 3,BB,1.5,15,14,3284,12,2018,14,-2
Group 3,BB,1.5,15,14,3285,11,2018,11,0
Group 3,BB,1.5,15,14,3286,9,2018,10,-1
Group 3,BB,1.5,15,14,3287,13,2018,12,1
Group 3,BB,1.5,15,14,3288,9,2018,10,-1
Group 3,BB,1.5,15,14,3289,11,2018,11,0
Group 3,BB,1.5,15,14,3290,11,2018,13,-2
Group 3,BB,1.5,15,14,3291,11,2018,9,2
Group 3,BB,1.5,15,14,3292,10,2018,10,0
Group 3,BB,1.5,15,14,3293,11,2018,8,3
Group 3,BB,1.5,15,14,3294,11,2018,10,1
Group 3,BB,1.5,15,14,3295,5,2018,9,-4
Group 3,BB,1.5,15,14,3296,10,2018,10,0
Group 3,BB,1.5,15,14,3297,10,2018,10,0
Group 3,BB,1.5,15,14,3298,11,2018,12,-1
Group 3,BB,1.5,15,14,3299,9,2018,10,-1
Group 3,BB,1.5,15,14,3300,10,2018,12,-2
Group 3,BB,1.5,15,14,3301,13,2018,12,1
Group 3,BB,1.5,15,14,3302,9,2018,13,-4
Group 3,BB,1.5,15,14,3303,10,2018,11,-1
Group 3,BB,1.5,15,14,3304,12,2018,12,0
Group 3,BB,1.5,15,14,3305,13,2018,10,3
Group 3,BB,1.5,15,14,3306,11,2018,10,1
Group 3,BB,1.5,15,14,3307,10,2018,9,1
Group 3,BB,1.5,15,14,3308,11,2018,10,1
Group 3,BB,1.5,15,14,3309,12,2018,8,4
Group 3,BB,1.5,15,14,3310,11,2018,9,2
Group 3,BB,1.5,15,14,3311,13,2018,12,1
Group 3,BB,1.5,15,14,3312,9,2018,7,2
Group 3,BB,1.5,15,14,3313,7,2018,8,-1
Group 3,BB,1.5,15,14,3314,9,2018,10,-1
Group 3,BB,1.5,15,14,3315,12,2018,10,2
Group 3,BB,1.5,15,14,3316,8,2018,11,-3
Group 3,BB,1.5,15,14,3317,12,2018,10,2
Group 3,BB,1.5,15,14,3318,10,2018,12,-2
Group 3,BB,1.5,15,14,3319,13,2018,6,7
Group 3,BB,1.5,15,14,3320,8,2018,12,-4
Group 3,BB,1.5,15,14,3321,13,2018,11,2
Group 3,BB,1.5,15,14,3322,10,2018,8,2
Group 3,BB,1.5,15,14,3323,8,2018,8,0
Group 3,BB,1.5,15,14,3324,8,2018,12,-4
Group 3,BB,1.5,15,14,3325,12,2018,12,0
Group 3,BB,1.5,15,14,3326,9,2018,6,3
Group 3,BB,1.5,15,14,3327,10,2018,11,-1
Group 3,BB,1.5,15,14,3328,10,2018,9,1
Group 3,BB,1.5,15,14,3329,12,2018,12,0
Group 3,BB,1.5,15,14,3330,14,2018,9,5
Group 3,BB,1.5,15,14,3331,11,2018,8,3
Group 3,BB,1.5,15,14,3332,12,2018,7,5
Group 3,BB,1.5,15,14,3333,13,2018,8,5
Group 3,BB,1.5,15,14,3334,10,2018,8,2
Group 3,BB,1.5,15,14,3335,10,2018,12,-2
Group 3,BB,1.5,15,14,3336,11,2018,9,2
Group 3,BB,1.5,15,14,3337,11,2018,13,-2
Group 3,BB,1.5,15,14,3338,12,2018,11,1
Group 3,BB,1.5,15,14,3339,10,2018,11,-1
Group 3,BB,1.5,15,14,3340,12,2018,10,2
Group 3,BB,1.5,15,14,3341,13,2018,8,5
Group 3,BB,1.5,15,14,3342,9,2018,10,-1
Group 3,BB,1.5,15,14,3343,10,2018,8,2
Group 3,BB,1.5,15,14,3344,11,2018,13,-2
Group 3,BB,1.5,15,14,3345,10,2018,11,-1
Group 3,BB,1.5,15,14,3346,9,2018,10,-1
Group 3,BB,1.5,15,14,3347,12,2018,13,-1
Group 3,BB,1.5,15,14,3348,10,2018,8,2
Group 3,BB,1.5,15,14,3349,9,2018,12,-3
Group 3,BB,1.5,15,14,3350,9,2018,10,-1
Group 3,BB,1.5,15,14,3351,8,2018,9,-1
Group 3,BB,1.5,15,14,3352,9,2018,11,-2
Group 3,BB,1.5,15,14,3353,8,2018,8,0
Group 3,BB,1.5,15,14,3354,11,2018,10,1
Group 3,BB,1.5,15,14,3355,12,2018,12,0
Group 3,BB,1.5,15,14,3356,10,2018,12,-2
Group 3,BB,1.5,15,14,3357,8,2018,11,-3
Group 3,BB,1.5,15,14,3358,10,2018,8,2
Group 3,BB,1.5,15,14,3359,9,2018,9,0
Group 3,BB,1.5,15,14,3360,9,2018,11,-2
Group 3,BB,1.5,15,14,3361,12,2018,9,3
Group 3,BB,1.5,15,14,3362,10,2018,12,-2
Group 3,BB,1.5,15,14,3363,12,2018,10,2
Group 3,BB,1.5,15,14,3364,8,2018,8,0
Group 3,BB,1.5,15,14,3365,12,2018,13,-1
Group 3,BB,1.5,15,14,3366,10,2018,9,1
Group 3,BB,1.5,15,14,3367,10,2018,8,2
Group 3,BB,1.5,15,14,3368,12,2018,10,2
Group 3,BB,1.5,15,14,3369,7,2018,7,0
Group 3,BB,1.5,15,14,3370,11,2018,12,-1
Group 3,BB,1.5,15,14,3371,13,2018,11,2
Group 3,BB,1.5,15,14,3372,11,2018,9,2
Group 3,BB,1.5,15,14,3373,10,2018,10,0
Group 3,BB,1.5,15,14,3374,11,2018,7,4
Group 3,BB,1.5,15,14,3375,13,2018,8,5
Group 3,BB,1.5,15,14,3376,10,2018,8,2
Group 3,BB,1.5,15,14,3377,14,2018,8,6
Group 3,BB,1.5,15,14,3378,12,2018,11,1
Group 3,BB,1.5,15,14,3379,10,2018,9,1
Group 3,BB,1.5,15,14,3380,13,2018,8,5
Group 3,BB,1.5,15,14,3381,11,2018,11,0
Group 3,BB,1.5,15,14,3382,13,2018,10,3
Group 3,BB,1.5,15,14,3383,10,2018,8,2
Group 3,BB,1.5,15,14,3384,9,2018,8,1
Group 3,BB,1.5,15,14,3385,11,2018,10,1
Group 3,BB,1.5,15,14,3386,10,2018,7,3
Group 3,BB,1.5,15,14,3387,14,2018,8,6
Group 3,BB,1.5,15,14,3388,12,2018,7,5
Group 3,BB,1.5,15,14,3389,8,2018,10,-2
Group 3,BB,1.5,15,14,3390,10,2018,11,-1
Group 3,BB,1.5,15,14,3391,13,2018,10,3
Group 3,BB,1.5,15,14,3392,10,2018,10,0
Group 3,BB,1.5,15,14,3393,12,2018,11,1
Group 3,BB,1.5,15,14,3394,10,2018,9,1
Group 3,BB,1.5,15,14,3395,12,2018,10,2
Group 3,BB,1.5,15,14,3396,9,2018,10,-1
Group 3,BB,1.5,15,14,3397,9,2018,11,-2
Group 3,BB,1.5,15,14,3398,14,2018,5,9
Group 3,BB,1.5,15,14,3399,12,2018,14,-2
Group 3,BB,1.5,15,14,3400,12,2018,10,2
Group 3,BB,1.5,15,14,3401,11,2018,13,-2
Group 3,BB,1.5,15,14,3402,10,2018,8,2
Group 3,BB,1.5,15,14,3403,9,2018,8,1
Group 3,BB,1.5,15,14,3404,9,2018,11,-2
Group 3,BB,1.5,15,14,3405,11,2018,10,1
Group 3,BB,1.5,15,14,3406,14,2018,8,6
Group 3,BB,1.5,15,14,3407,10,2018,12,-2
Group 3,BB,1.5,15,14,3408,10,2018,12,-2
Group 3,BB,1.5,15,14,3409,9,2018,13,-4
Group 3,BB,1.5,15,14,3410,12,2018,11,1
Group 3,BB,1.5,15,14,3411,7,2018,11,-4
Group 3,BB,1.5,15,14,3412,13,2018,12,1
Group 3,BB,1.5,15,14,3413,10,2018,13,-3
Group 3,BB,1.5,15,14,3414,11,2018,11,0
Group 3,BB,1.5,15,14,3415,9,2018,9,0
Group 3,BB,1.5,15,14,3416,8,2018,11,-3
Group 3,BB,1.5,15,14,3417,12,2018,8,4
Group 3,BB,1.5,15,14,3418,9,2018,9,0
Group 3,BB,1.5,15,14,3419,13,2018,8,5
Group 3,BB,1.5,15,14,3420,10,2018,8,2
Group 3,BB,1.5,15,14,3421,10,2018,12,-2
Group 3,BB,1.5,15,14,3422,8,2018,9,-1
Group 3,BB,1.5,15,14,3423,10,2018,9,1
Group 3,BB,1.5,15,14,3424,10,2018,7,3
Group 3,BB,1.5,15,14,3425,11,2018,11,0
Group 3,BB,1.5,15,14,3426,12,2018,11,1
Group 3,BB,1.5,15,14,3427,11,2018,9,2
Group 3,BB,1.5,15,14,3428,11,2018,6,5
Group 3,BB,1.5,15,14,3429,8,2018,10,-2
Group 3,BB,1.5,15,14,3430,9,2018,9,0
Group 3,BB,1.5,15,14,3431,10,2018,9,1
Group 3,BB,1.5,15,14,3432,10,2018,11,-1
Group 3,BB,1.5,15,14,3433,11,2018,9,2
Group 3,BB,1.5,15,14,3434,12,2018,10,2
Group 3,BB,1.5,15,14,3435,12,2018,10,2
Group 3,BB,1.5,15,14,3436,7,2018,11,-4
Group 3,BB,1.5,15,14,3437,9,2018,9,0
Group 3,BB,1.5,15,14,3438,12,2018,9,3
Group 3,BB,1.5,15,14,3439,8,2018,8,0
Group 3,BB,1.5,15,14,3440,14,2018,10,4
Group 3,BB,1.5,15,14,3441,9,2018,8,1
Group 3,BB,1.5,15,14,3442,12,2018,8,4
Group 3,BB,1.5,15,14,3443,12,2018,13,-1
Group 3,BB,1.5,15,14,3444,8,2018,10,-2
Group 3,BB,1.5,15,14,3445,9,2018,9,0
Group 3,BB,1.5,15,14,3446,9,2018,14,-5
Group 3,BB,1.5,15,14,3447,10,2018,9,1
Group 3,BB,1.5,15,14,3448,9,2018,11,-2
Group 3,BB,1.5,15,14,3449,12,2018,12,0
Group 3,BB,1.5,15,14,3450,9,2018,12,-3
Group 3,BB,1.5,15,14,3451,10,2018,6,4
Group 3,BB,1.5,15,14,3452,13,2018,8,5
Group 3,BB,1.5,15,14,3453,9,2018,11,-2
Group 3,BB,1.5,15,14,3454,13,2018,11,2
Group 3,BB,1.5,15,14,3455,10,2018,8,2
Group 3,BB,1.5,15,14,3456,8,2018,10,-2
Group 3,BB,1.5,15,14,3457,11,2018,12,-1
Group 3,BB,1.5,15,14,3458,13,2018,8,5
Group 3,BB,1.5,15,14,3459,12,2018,11,1
Group 3,BB,1.5,15,14,3460,9,2018,10,-1
Group 3,BB,1.5,15,14,3461,12,2018,8,4
Group 3,BB,1.5,15,14,3462,11,2018,10,1
Group 3,BB,1.5,15,14,3463,12,2018,7,5
Group 3,BB,1.5,15,14,3464,8,2018,11,-3
Group 3,BB,1.5,15,14,3465,13,2018,14,-1
Group 3,BB,1.5,15,14,3466,10,2018,12,-2
Group 3,BB,1.5,15,14,3467,11,2018,12,-1
Group 3,BB,1.5,15,14,3468,10,2018,10,0
Group 3,BB,1.5,15,14,3469,11,2018,10,1
Group 3,BB,1.5,15,14,3470,11,2018,10,1
Group 3,BB,1.5,15,14,3471,11,2018,8,3
Group 3,BB,1.5,15,14,3472,9,2018,11,-2
Group 3,BB,1.5,15,14,3473,12,2018,6,6
Group 3,BB,1.5,15,14,3474,12,2018,9,3
Group 3,BB,1.5,15,14,3475,13,2018,11,2
Group 3,BB,1.5,15,14,3476,11,2018,7,4
Group 3,BB,1.5,15,14,3477,12,2018,12,0
Group 3,BB,1.5,15,14,3478,7,2018,9,-2
Group 3,BB,1.5,15,14,3479,11,2018,13,-2
Group 3,BB,1.5,15,14,3480,10,2018,13,-3
Group 3,BB,1.5,15,14,3481,10,2018,10,0
Group 3,BB,1.5,15,14,3482,13,2018,13,0
Group 3,BB,1.5,15,14,3483,9,2018,9,0
Group 3,BB,1.5,15,14,3484,8,2018,11,-3
Group 3,BB,1.5,15,14,3485,11,2018,12,-1
Group 3,BB,1.5,15,14,3486,11,2018,6,5
Group 3,BB,1.5,15,14,3487,12,2018,11,1
Group 3,BB,1.5,15,14,3488,10,2018,10,0
Group 3,BB,1.5,15,14,3489,10,2018,11,-1
Group 3,BB,1.5,15,14,3490,6,2018,13,-7
Group 3,BB,1.5,15,14,3491,10,2018,11,-1
Group 3,BB,1.5,15,14,3492,9,2018,8,1
Group 3,BB,1.5,15,14,3493,11,2018,8,3
Group 3,BB,1.5,15,14,3494,11,2018,11,0
Group 3,BB,1.5,15,14,3495,8,2018,12,-4
Group 3,BB,1.5,15,14,3496,8,2018,10,-2
Group 3,BB,1.5,15,14,3497,8,2018,7,1
Group 3,BB,1.5,15,14,3498,13,2018,10,3
Group 3,BB,1.5,15,14,3499,9,2018,13,-4
Group 3,BB,1.5,15,14,3500,13,2018,12,1
Group 3,BB,1.5,15,14,3501,10,2018,6,4
Group 3,BB,1.5,15,14,3502,11,2018,10,1
Group 3,BB,1.5,15,14,3503,10,2018,11,-1
Group 3,BB,1.5,15,14,3504,9,2018,10,-1
Group 3,BB,1.5,15,14,3505,11,2018,11,0
Group 3,BB,1.5,15,14,3506,7,2018,10,-3
Group 3,BB,1.5,15,14,3507,12,2018,9,3
Group 3,BB,1.5,15,14,3508,14,2018,10,4
Group 3,BB,1.5,15,14,3509,13,2018,9,4
Group 3,BB,1.5,15,14,3510,13,2018,12,1
Group 3,BB,1.5,15,14,3511,9,2018,14,-5
Group 3,BB,1.5,15,14,3512,8,2018,9,-1
Group 3,BB,1.5,15,14,3513,10,2018,12,-2
Group 3,BB,1.5,15,14,3514,13,2018,12,1
Group 3,BB,1.5,15,14,3515,11,2018,9,2
Group 3,BB,1.5,15,14,3516,13,2018,8,5
Group 3,BB,1.5,15,14,3517,12,2018,12,0
Group 3,BB,1.5,15,14,3518,9,2018,7,2
Group 3,BB,1.5,15,14,3519,10,2018,10,0
Group 3,BB,1.5,15,14,3520,10,2018,9,1
Group 3,BB,1.5,15,14,3521,10,2018,10,0
Group 3,BB,1.5,15,14,3522,10,2018,11,-1
Group 3,BB,1.5,15,14,3523,9,2018,10,-1
Group 3,BB,1.5,15,14,3524,10,2018,10,0
Group 3,BB,1.5,15,14,3525,8,2018,12,-4
Group 3,BB,1.5,15,14,3526,9,2018,10,-1
Group 3,BB,1.5,15,14,3527,12,2018,8,4
Group 3,BB,1.5,15,14,3528,13,2018,9,4
Group 3,BB,1.5,15,14,3529,8,2018,5,3
Group 3,BB,1.5,15,14,3530,11,2018,8,3
Group 3,BB,1.5,15,14,3531,13,2018,11,2
Group 3,BB,1.5,15,14,3532,9,2018,9,0
Group 3,BB,1.5,15,14,3533,9,2018,9,0
Group 3,BB,1.5,15,14,3534,10,2018,10,0
Group 3,BB,1.5,15,14,3535,9,2018,11,-2
Group 3,BB,1.5,15,14,3536,11,2018,13,-2
Group 3,BB,1.5,15,14,3537,9,2018,11,-2
Group 3,BB,1.5,15,14,3538,10,2018,13,-3
Group 3,BB,1.5,15,14,3539,9,2018,12,-3
Group 3,BB,1.5,15,14,3540,8,2018,11,-3
Group 3,BB,1.5,15,14,3541,9,2018,11,-2
Group 3,BB,1.5,15,14,3542,10,2018,9,1
Group 3,BB,1.5,15,14,3543,13,2018,11,2
Group 3,BB,1.5,15,14,3544,10,2018,11,-1
Group 3,BB,1.5,15,14,3545,13,2018,10,3
Group 3,BB,1.5,15,14,3546,13,2018,13,0
Group 3,BB,1.5,15,14,3547,9,2018,11,-2
Group 3,BB,1.5,15,14,3548,5,2018,7,-2
Group 3,BB,1.5,15,14,3549,12,2018,10,2
Group 3,BB,1.5,15,14,3550,12,2018,9,3
Group 3,BB,1.5,15,14,3551,11,2018,12,-1
Group 3,BB,1.5,15,14,3552,11,2018,10,1
Group 3,BB,1.5,15,14,3553,8,2018,4,4
Group 3,BB,1.5,15,14,3554,10,2018,10,0
Group 3,BB,1.5,15,14,3555,13,2018,7,6
Group 3,BB,1.5,15,14,3556,8,2018,14,-6
Group 3,BB,1.5,15,14,3557,11,2018,11,0
Group 3,BB,1.5,15,14,3558,11,2018,13,-2
Group 3,BB,1.5,15,14,3559,10,2018,11,-1
Group 3,BB,1.5,15,14,3560,12,2018,12,0
Group 3,BB,1.5,15,14,3561,13,2018,9,4
Group 3,BB,1.5,15,14,3562,14,2018,12,2
Group 3,BB,1.5,15,14,3563,11,2018,8,3
Group 3,BB,1.5,15,14,3564,7,2018,9,-2
Group 3,BB,1.5,15,14,3565,11,2018,8,3
Group 3,BB,1.5,15,14,3566,12,2018,10,2
Group 3,BB,1.5,15,14,3567,12,2018,9,3
Group 3,BB,1.5,15,14,3568,13,2018,12,1
Group 3,BB,1.5,15,14,3569,7,2018,11,-4
Group 3,BB,1.5,15,14,3570,9,2018,11,-2
Group 3,BB,1.5,15,14,3571,12,2018,8,4
Group 3,BB,1.5,15,14,3572,10,2018,9,1
Group 3,BB,1.5,15,14,3573,11,2018,7,4
Group 3,BB,1.5,15,14,3574,8,2018,6,2
Group 3,BB,1.5,15,14,3575,12,2018,10,2
Group 3,BB,1.5,15,14,3576,12,2018,10,2
Group 3,BB,1.5,15,14,3577,9,2018,8,1
Group 3,BB,1.5,15,14,3578,10,2018,12,-2
Group 3,BB,1.5,15,14,3579,11,2018,11,0
Group 3,BB,1.5,15,14,3580,11,2018,9,2
Group 3,BB,1.5,15,14,3581,8,2018,8,0
Group 3,BB,1.5,15,14,3582,10,2018,10,0
Group 3,BB,1.5,15,14,3583,8,2018,8,0
Group 3,BB,1.5,15,14,3584,7,2018,13,-6
Group 3,BB,1.5,15,14,3585,9,2018,12,-3
Group 3,BB,1.5,15,14,3586,12,2018,7,5
Group 3,BB,1.5,15,14,3587,12,2018,10,2
Group 3,BB,1.5,15,14,3588,10,2018,8,2
Group 3,BB,1.5,15,14,3589,12,2018,6,6
Group 3,BB,1.5,15,14,3590,11,2018,14,-3
Group 3,BB,1.5,15,14,3591,11,2018,14,-3
Group 3,BB,1.5,15,14,3592,11,2018,7,4
Group 3,BB,1.5,15,14,3593,11,2018,10,1
Group 3,BB,1.5,15,14,3594,12,2018,7,5
Group 3,BB,1.5,15,14,3595,12,2018,12,0
Group 3,BB,1.5,15,14,3596,6,2018,10,-4
Group 3,BB,1.5,15,14,3597,12,2018,9,3
Group 3,BB,1.5,15,14,3598,10,2018,11,-1
Group 3,BB,1.5,15,14,3599,13,2018,11,2
Group 3,BB,1.5,15,14,3600,13,2018,8,5
Group 3,BB,1.5,15,14,3601,11,2018,9,2
Group 3,BB,1.5,15,14,3602,8,2018,8,0
Group 3,BB,1.5,15,14,3603,9,2018,11,-2
Group 3,BB,1.5,15,14,3604,11,2018,9,2
Group 3,BB,1.5,15,14,3605,9,2018,9,0
Group 3,BB,1.5,15,14,3606,12,2018,11,1
Group 3,BB,1.5,15,14,3607,10,2018,9,1
Group 3,BB,1.5,15,14,3608,11,2018,11,0
Group 3,BB,1.5,15,14,3609,10,2018,12,-2
Group 3,BB,1.5,15,14,3610,8,2018,9,-1
Group 3,BB,1.5,15,14,3611,8,2018,11,-3
Group 3,BB,1.5,15,14,3612,11,2018,9,2
Group 3,BB,1.5,15,14,3613,12,2018,10,2
Group 3,BB,1.5,15,14,3614,13,2018,11,2
Group 3,BB,1.5,15,14,3615,8,2018,10,-2
Group 3,BB,1.5,15,14,3616,9,2018,11,-2
Group 3,BB,1.5,15,14,3617,9,2018,10,-1
Group 3,BB,1.5,15,14,3618,14,2018,11,3
Group 3,BB,1.5,15,14,3619,12,2018,8,4
Group 3,BB,1.5,15,14,3620,9,2018,9,0
Group 3,BB,1.5,15,14,3621,12,2018,11,1
Group 3,BB,1.5,15,14,3622,12,2018,9,3
Group 3,BB,1.5,15,14,3623,11,2018,7,4
Group 3,BB,1.5,15,14,3624,11,2018,12,-1
Group 3,BB,1.5,15,14,3625,13,2018,13,0
Group 3,BB,1.5,15,14,3626,11,2018,12,-1
Group 3,BB,1.5,15,14,3627,13,2018,11,2
Group 3,BB,1.5,15,14,3628,8,2018,11,-3
Group 3,BB,1.5,15,14,3629,9,2018,11,-2
Group 3,BB,1.5,15,14,3630,8,2018,9,-1
Group 3,BB,1.5,15,14,3631,14,2018,12,2
Group 3,BB,1.5,15,14,3632,10,2018,9,1
Group 3,BB,1.5,15,14,3633,11,2018,11,0
Group 3,BB,1.5,15,14,3634,10,2018,10,0
Group 3,BB,1.5,15,14,3635,9,2018,9,0
Group 3,BB,1.5,15,14,3636,10,2018,10,0
Group 3,BB,1.5,15,14,3637,9,2018,12,-3
Group 3,BB,1.5,15,14,3638,11,2018,11,0
Group 3,BB,1.5,15,14,3639,12,2018,12,0
Group 3,BB,1.5,15,14,3640,9,2018,10,-1
Group 3,BB,1.5,15,14,3641,11,2018,11,0
Group 3,BB,1.5,15,14,3642,10,2018,10,0
Group 3,BB,1.5,15,14,3643,11,2018,11,0
Group 3,BB,1.5,15,14,3644,9,2018,11,-2
Group 3,BB,1.5,15,14,3645,7,2018,8,-1
Group 3,BB,1.5,15,14,3646,9,2018,6,3
Group 3,BB,1.5,15,14,3647,11,2018,13,-2
Group 3,BB,1.5,15,14,3648,11,2018,10,1
Group 3,BB,1.5,15,14,3649,10,2018,8,2
Group 3,BB,1.5,15,14,3650,6,2018,13,-7
Group 3,BB,1.5,15,14,3651,13,2018,12,1
Group 3,BB,1.5,15,14,3652,8,2018,11,-3
Group 3,BB,1.5,15,14,3653,7,2018,10,-3
Group 3,BB,1.5,15,14,3654,11,2018,10,1
Group 3,BB,1.5,15,14,3655,11,2018,10,1
Group 3,BB,1.5,15,14,3656,12,2018,12,0
Group 3,BB,1.5,15,14,3657,12,2018,12,0
Group 3,BB,1.5,15,14,3658,7,2018,11,-4
Group 3,BB,1.5,15,14,3659,11,2018,9,2
Group 3,BB,1.5,15,14,3660,6,2018,12,-6
Group 3,BB,1.5,15,14,3661,10,2018,9,1
Group 3,BB,1.5,15,14,3662,12,2018,12,0
Group 3,BB,1.5,15,14,3663,10,2018,9,1
Group 3,BB,1.5,15,14,3664,10,2018,12,-2
Group 3,BB,1.5,15,14,3665,12,2018,12,0
Group 3,BB,1.5,15,14,3666,13,2018,13,0
Group 3,BB,1.5,15,14,3667,13,2018,10,3
Group 3,BB,1.5,15,14,3668,11,2018,9,2
Group 3,BB,1.5,15,14,3669,9,2018,12,-3
Group 3,BB,1.5,15,14,3670,11,2018,10,1
Group 3,BB,1.5,15,14,3671,6,2018,9,-3
Group 3,BB,1.5,15,14,3672,9,2018,10,-1
Group 3,BB,1.5,15,14,3673,9,2018,12,-3
Group 3,BB,1.5,15,14,3674,8,2018,13,-5
Group 3,BB,1.5,15,14,3675,11,2018,8,3
Group 3,BB,1.5,15,14,3676,12,2018,13,-1
Group 3,BB,1.5,15,14,3677,11,2018,12,-1
Group 3,BB,1.5,15,14,3678,10,2018,9,1
Group 3,BB,1.5,15,14,3679,11,2018,9,2
Group 3,BB,1.5,15,14,3680,5,2018,10,-5
Group 3,BB,1.5,15,14,3681,11,2018,10,1
Group 3,BB,1.5,15,14,3682,10,2018,12,-2
Group 3,BB,1.5,15,14,3683,10,2018,8,2
Group 3,BB,1.5,15,14,3684,10,2018,7,3
Group 3,BB,1.5,15,14,3685,11,2018,13,-2
Group 3,BB,1.5,15,14,3686,9,2018,9,0
Group 3,BB,1.5,15,14,3687,13,2018,7,6
Group 3,BB,1.5,15,14,3688,8,2018,8,0
Group 3,BB,1.5,15,14,3689,12,2018,9,3
Group 3,BB,1.5,15,14,3690,12,2018,8,4
Group 3,BB,1.5,15,14,3691,8,2018,8,0
Group 3,BB,1.5,15,14,3692,8,2018,13,-5
Group 3,BB,1.5,15,14,3693,9,2018,12,-3
Group 3,BB,1.5,15,14,3694,12,2018,8,4
Group 3,BB,1.5,15,14,3695,11,2018,9,2
Group 3,BB,1.5,15,14,3696,8,2018,11,-3
Group 3,BB,1.5,15,14,3697,13,2018,7,6
Group 3,BB,1.5,15,14,3698,10,2018,12,-2
Group 3,BB,1.5,15,14,3699,14,2018,9,5
Group 3,BB,1.5,15,14,3700,10,2018,7,3
Group 3,BB,1.5,15,14,3701,9,2018,13,-4
Group 3,BB,1.5,15,14,3702,8,2018,7,1
Group 3,BB,1.5,15,14,3703,9,2018,11,-2
Group 3,BB,1.5,15,14,3704,9,2018,9,0
Group 3,BB,1.5,15,14,3705,11,2018,10,1
Group 3,BB,1.5,15,14,3706,13,2018,10,3
Group 3,BB,1.5,15,14,3707,10,2018,11,-1
Group 3,BB,1.5,15,14,3708,12,2018,12,0
Group 3,BB,1.5,15,14,3709,8,2018,9,-1
Group 3,BB,1.5,15,14,3710,12,2018,9,3
Group 3,BB,1.5,15,14,3711,10,2018,9,1
Group 3,BB,1.5,15,14,3712,8,2018,11,-3
Group 3,BB,1.5,15,14,3713,11,2018,11,0
Group 3,BB,1.5,15,14,3714,9,2018,10,-1
Group 3,BB,1.5,15,14,3715,9,2018,12,-3
Group 3,BB,1.5,15,14,3716,12,2018,12,0
Group 3,BB,1.5,15,14,3717,12,2018,11,1
Group 3,BB,1.5,15,14,3718,13,2018,11,2
Group 3,BB,1.5,15,14,3719,10,2018,10,0
Group 3,BB,1.5,15,14,3720,13,2018,9,4
Group 3,BB,1.5,15,14,3721,11,2018,7,4
Group 3,BB,1.5,15,14,3722,11,2018,12,-1
Group 3,BB,1.5,15,14,3723,10,2018,9,1
Group 3,BB,1.5,15,14,3724,9,2018,12,-3
Group 3,BB,1.5,15,14,3725,7,2018,6,1
Group 3,BB,1.5,15,14,3726,12,2018,12,0
Group 3,BB,1.5,15,14,3727,8,2018,12,-4
Group 3,BB,1.5,15,14,3728,7,2018,10,-3
Group 3,BB,1.5,15,14,3729,11,2018,9,2
Group 3,BB,1.5,15,14,3730,11,2018,7,4
Group 3,BB,1.5,15,14,3731,13,2018,6,7
Group 3,BB,1.5,15,14,3732,8,2018,7,1
Group 3,BB,1.5,15,14,3733,11,2018,11,0
Group 3,BB,1.5,15,14,3734,12,2018,13,-1
Group 3,BB,1.5,15,14,3735,13,2018,13,0
Group 3,BB,1.5,15,14,3736,8,2018,7,1
Group 3,BB,1.5,15,14,3737,9,2018,12,-3
Group 3,BB,1.5,15,14,3738,11,2018,5,6
Group 3,BB,1.5,15,14,3739,9,2018,9,0
Group 3,BB,1.5,15,14,3740,12,2018,12,0
Group 3,BB,1.5,15,14,3741,8,2018,10,-2
Group 3,BB,1.5,15,14,3742,11,2018,13,-2
Group 3,BB,1.5,15,14,3743,8,2018,10,-2
Group 3,BB,1.5,15,14,3744,8,2018,9,-1
Group 3,BB,1.5,15,14,3745,13,2018,8,5
Group 3,BB,1.5,15,14,3746,10,2018,11,-1
Group 3,BB,1.5,15,14,3747,13,2018,11,2
Group 3,BB,1.5,15,14,3748,11,2018,6,5
Group 3,BB,1.5,15,14,3749,12,2018,10,2
Group 3,BB,1.5,15,14,3750,12,2018,12,0
Group 3,BB,1.5,15,14,3751,10,2018,11,-1
Group 3,BB,1.5,15,14,3752,9,2018,12,-3
Group 3,BB,1.5,15,14,3753,13,2018,14,-1
Group 3,BB,1.5,15,14,3754,12,2018,10,2
Group 3,BB,1.5,15,14,3755,11,2018,11,0
Group 3,BB,1.5,15,14,3756,8,2018,8,0
Group 3,BB,1.5,15,14,3757,11,2018,9,2
Group 3,BB,1.5,15,14,3758,11,2018,11,0
Group 3,BB,1.5,15,14,3759,3,2018,6,-3
Group 3,BB,1.5,15,14,3760,7,2018,7,0
Group 3,BB,1.5,15,14,3761,13,2018,12,1
Group 3,BB,1.5,15,14,3762,11,2018,6,5
Group 3,BB,1.5,15,14,3763,8,2018,12,-4
Group 3,BB,1.5,15,14,3764,10,2018,12,-2
Group 3,BB,1.5,15,14,3765,10,2018,12,-2
Group 3,BB,1.5,15,14,3766,9,2018,11,-2
Group 3,BB,1.5,15,14,3767,8,2018,12,-4
Group 3,BB,1.5,15,14,3768,11,2018,13,-2
Group 3,BB,1.5,15,14,3769,10,2018,11,-1
Group 3,BB,1.5,15,14,3770,13,2018,12,1
Group 3,BB,1.5,15,14,3771,12,2018,13,-1
Group 3,BB,1.5,15,14,3772,12,2018,10,2
Group 3,BB,1.5,15,14,3773,9,2018,10,-1
Group 3,BB,1.5,15,14,3774,9,2018,11,-2
Group 3,BB,1.5,15,14,3775,7,2018,8,-1
Group 3,BB,1.5,15,14,3776,13,2018,11,2
Group 3,BB,1.5,15,14,3777,10,2018,13,-3
Group 3,BB,1.5,15,14,3778,8,2018,6,2
Group 3,BB,1.5,15,14,3779,8,2018,9,-1
Group 3,BB,1.5,15,14,3780,11,2018,10,1
Group 3,BB,1.5,15,14,3781,12,2018,10,2
Group 3,BB,1.5,15,14,3782,12,2018,10,2
Group 3,BB,1.5,15,14,3783,13,2018,7,6
Group 3,BB,1.5,15,14,3784,10,2018,12,-2
Group 3,BB,1.5,15,14,3785,9,2018,9,0
Group 3,BB,1.5,15,14,3786,14,2018,11,3
Group 3,BB,1.5,15,14,3787,8,2018,10,-2
Group 3,BB,1.5,15,14,3788,10,2018,9,1
Group 3,BB,1.5,15,14,3789,13,2018,10,3
Group 3,BB,1.5,15,14,3790,12,2018,11,1
Group 3,BB,1.5,15,14,3791,10,2018,10,0
Group 3,BB,1.5,15,14,3792,9,2018,12,-3
Group 3,BB,1.5,15,14,3793,12,2018,11,1
Group 3,BB,1.5,15,14,3794,12,2018,8,4
Group 3,BB,1.5,15,14,3795,11,2018,10,1
Group 3,BB,1.5,15,14,3796,10,2018,10,0
Group 3,BB,1.5,15,14,3797,9,2018,9,0
Group 3,BB,1.5,15,14,3798,11,2018,12,-1
Group 3,BB,1.5,15,14,3799,11,2018,9,2
Group 3,BB,1.5,15,14,3800,11,2018,14,-3
Group 3,BB,1.5,15,14,3801,8,2018,8,0
Group 3,BB,1.5,15,14,3802,13,2018,11,2
Group 3,BB,1.5,15,14,3803,9,2018,11,-2
Group 3,BB,1.5,15,14,3804,10,2018,7,3
Group 3,BB,1.5,15,14,3805,6,2018,8,-2
Group 3,BB,1.5,15,14,3806,14,2018,11,3
Group 3,BB,1.5,15,14,3807,13,2018,10,3
Group 3,BB,1.5,15,14,3808,10,2018,10,0
Group 3,BB,1.5,15,14,3809,10,2018,11,-1
Group 3,BB,1.5,15,14,3810,9,2018,11,-2
Group 3,BB,1.5,15,14,3811,6,2018,11,-5
Group 3,BB,1.5,15,14,3812,13,2018,10,3
Group 3,BB,1.5,15,14,3813,9,2018,12,-3
Group 3,BB,1.5,15,14,3814,8,2018,9,-1
Group 3,BB,1.5,15,14,3815,7,2018,9,-2
Group 3,BB,1.5,15,14,3816,11,2018,10,1
Group 3,BB,1.5,15,14,3817,13,2018,12,1
Group 3,BB,1.5,15,14,3818,11,2018,12,-1
Group 3,BB,1.5,15,14,3819,10,2018,10,0
Group 3,BB,1.5,15,14,3820,7,2018,9,-2
Group 3,BB,1.5,15,14,3821,7,2018,11,-4
Group 3,BB,1.5,15,14,3822,12,2018,11,1
Group 3,BB,1.5,15,14,3823,12,2018,11,1
Group 3,BB,1.5,15,14,3824,7,2018,10,-3
Group 3,BB,1.5,15,14,3825,12,2018,12,0
Group 3,BB,1.5,15,14,3826,11,2018,14,-3
Group 3,BB,1.5,15,14,3827,10,2018,7,3
Group 3,BB,1.5,15,14,3828,10,2018,6,4
Group 3,BB,1.5,15,14,3829,9,2018,6,3
Group 3,BB,1.5,15,14,3830,12,2018,12,0
Group 3,BB,1.5,15,14,3831,8,2018,12,-4
Group 3,BB,1.5,15,14,3832,10,2018,9,1
Group 3,BB,1.5,15,14,3833,11,2018,11,0
Group 3,BB,1.5,15,14,3834,11,2018,10,1
Group 3,BB,1.5,15,14,3835,10,2018,11,-1
Group 3,BB,1.5,15,14,3836,11,2018,10,1
Group 3,BB,1.5,15,14,3837,11,2018,8,3
Group 3,BB,1.5,15,14,3838,11,2018,12,-1
Group 3,BB,1.5,15,14,3839,11,2018,11,0
Group 3,BB,1.5,15,14,3840,11,2018,11,0
Group 3,BB,1.5,15,14,3841,8,2018,8,0
Group 3,BB,1.5,15,14,3842,4,2018,10,-6
Group 3,BB,1.5,15,14,3843,12,2018,12,0
Group 3,BB,1.5,15,14,3844,10,2018,13,-3
Group 3,BB,1.5,15,14,3845,11,2018,11,0
Group 3,BB,1.5,15,14,3846,13,2018,10,3
Group 3,BB,1.5,15,14,3847,9,2018,9,0
Group 3,BB,1.5,15,14,3848,10,2018,9,1
Group 3,BB,1.5,15,14,3849,9,2018,8,1
Group 3,BB,1.5,15,14,3850,10,2018,10,0
Group 3,BB,1.5,15,14,3851,8,2018,7,1
Group 3,BB,1.5,15,14,3852,10,2018,10,0
Group 3,BB,1.5,15,14,3853,10,2018,9,1
Group 3,BB,1.5,15,14,3854,11,2018,11,0
Group 3,BB,1.5,15,14,3855,11,2018,9,2
Group 3,BB,1.5,15,14,3856,13,2018,11,2
Group 3,BB,1.5,15,14,3857,11,2018,8,3
Group 3,BB,1.5,15,14,3858,11,2018,12,-1
Group 3,BB,1.5,15,14,3859,9,2018,11,-2
Group 3,BB,1.5,15,14,3860,10,2018,9,1
Group 3,BB,1.5,15,14,3861,10,2018,11,-1
Group 3,BB,1.5,15,14,3862,11,2018,13,-2
Group 3,BB,1.5,15,14,3863,11,2018,13,-2
Group 3,BB,1.5,15,14,3864,11,2018,11,0
Group 3,BB,1.5,15,14,3865,12,2018,9,3
Group 3,BB,1.5,15,14,3866,13,2018,10,3
Group 3,BB,1.5,15,14,3867,10,2018,10,0
Group 3,BB,1.5,15,14,3868,9,2018,12,-3
Group 3,BB,1.5,15,14,3869,12,2018,12,0
Group 3,BB,1.5,15,14,3870,11,2018,8,3
Group 3,BB,1.5,15,14,3871,10,2018,10,0
Group 3,BB,1.5,15,14,3872,9,2018,11,-2
Group 3,BB,1.5,15,14,3873,9,2018,14,-5
Group 3,BB,1.5,15,14,3874,10,2018,10,0
Group 3,BB,1.5,15,14,3875,9,2018,9,0
Group 3,BB,1.5,15,14,3876,9,2018,12,-3
Group 3,BB,1.5,15,14,3877,9,2018,11,-2
Group 3,BB,1.5,15,14,3878,8,2018,13,-5
Group 3,BB,1.5,15,14,3879,7,2018,13,-6
Group 3,BB,1.5,15,14,3880,6,2018,9,-3
Group 3,BB,1.5,15,14,3881,11,2018,9,2
Group 3,BB,1.5,15,14,3882,12,2018,10,2
Group 3,BB,1.5,15,14,3883,7,2018,8,-1
Group 3,BB,1.5,15,14,3884,9,2018,10,-1
Group 3,BB,1.5,15,14,3885,14,2018,10,4
Group 3,BB,1.5,15,14,3886,9,2018,11,-2
Group 3,BB,1.5,15,14,3887,8,2018,10,-2
Group 3,BB,1.5,15,14,3888,11,2018,12,-1
Group 3,BB,1.5,15,14,3889,11,2018,10,1
Group 3,BB,1.5,15,14,3890,12,2018,9,3
Group 3,BB,1.5,15,14,3891,13,2018,12,1
Group 3,BB,1.5,15,14,3892,13,2018,10,3
Group 3,BB,1.5,15,14,3893,12,2018,10,2
Group 3,BB,1.5,15,14,3894,9,2018,10,-1
Group 3,BB,1.5,15,14,3895,11,2018,11,0
Group 3,BB,1.5,15,14,3896,10,2018,8,2
Group 3,BB,1.5,15,14,3897,9,2018,10,-1
Group 3,BB,1.5,15,14,3898,8,2018,12,-4
Group 3,BB,1.5,15,14,3899,11,2018,11,0
Group 3,BB,1.5,15,14,3900,14,2018,5,9
Group 3,BB,1.5,15,14,3901,12,2018,11,1
Group 3,BB,1.5,15,14,3902,13,2018,12,1
Group 3,BB,1.5,15,14,3903,13,2018,10,3
Group 3,BB,1.5,15,14,3904,11,2018,10,1
Group 3,BB,1.5,15,14,3905,11,2018,9,2
Group 3,BB,1.5,15,14,3906,10,2018,11,-1
Group 3,BB,1.5,15,14,3907,13,2018,11,2
Group 3,BB,1.5,15,14,3908,12,2018,11,1
Group 3,BB,1.5,15,14,3909,10,2018,12,-2
Group 3,BB,1.5,15,14,3910,11,2018,8,3
Group 3,BB,1.5,15,14,3911,10,2018,10,0
Group 3,BB,1.5,15,14,3912,8,2018,10,-2
Group 3,BB,1.5,15,14,3913,8,2018,11,-3
Group 3,BB,1.5,15,14,3914,12,2018,10,2
Group 3,BB,1.5,15,14,3915,13,2018,5,8
Group 3,BB,1.5,15,14,3916,10,2018,10,0
Group 3,BB,1.5,15,14,3917,11,2018,13,-2
Group 3,BB,1.5,15,14,3918,11,2018,8,3
Group 3,BB,1.5,15,14,3919,13,2018,11,2
Group 3,BB,1.5,15,14,3920,10,2018,5,5
Group 3,BB,1.5,15,14,3921,13,2018,7,6
Group 3,BB,1.5,15,14,3922,11,2018,11,0
Group 3,BB,1.5,15,14,3923,9,2018,9,0
Group 3,BB,1.5,15,14,3924,10,2018,8,2
Group 3,BB,1.5,15,14,3925,10,2018,8,2
Group 3,BB,1.5,15,14,3926,8,2018,10,-2
Group 3,BB,1.5,15,14,3927,13,2018,12,1
Group 3,BB,1.5,15,14,3928,9,2018,10,-1
Group 3,BB,1.5,15,14,3929,11,2018,12,-1
Group 3,BB,1.5,15,14,3930,11,2018,12,-1
Group 3,BB,1.5,15,14,3931,13,2018,7,6
Group 3,BB,1.5,15,14,3932,10,2018,9,1
Group 3,BB,1.5,15,14,3933,10,2018,11,-1
Group 3,BB,1.5,15,14,3934,11,2018,9,2
Group 3,BB,1.5,15,14,3935,10,2018,12,-2
Group 3,BB,1.5,15,14,3936,9,2018,10,-1
Group 3,BB,1.5,15,14,3937,11,2018,8,3
Group 3,BB,1.5,15,14,3938,10,2018,11,-1
Group 3,BB,1.5,15,14,3939,9,2018,8,1
Group 3,BB,1.5,15,14,3940,9,2018,9,0
Group 3,BB,1.5,15,14,3941,11,2018,10,1
Group 3,BB,1.5,15,14,3942,10,2018,10,0
Group 3,BB,1.5,15,14,3943,9,2018,8,1
Group 3,BB,1.5,15,14,3944,9,2018,8,1
Group 3,BB,1.5,15,14,3945,8,2018,6,2
Group 3,BB,1.5,15,14,3946,6,2018,9,-3
Group 3,BB,1.5,15,14,3947,8,2018,7,1
Group 3,BB,1.5,15,14,3948,12,2018,7,5
Group 3,BB,1.5,15,14,3949,7,2018,9,-2
Group 3,BB,1.5,15,14,3950,10,2018,11,-1
Group 3,BB,1.5,15,14,3951,6,2018,7,-1
Group 3,BB,1.5,15,14,3952,10,2018,11,-1
Group 3,BB,1.5,15,14,3953,12,2018,10,2
Group 3,BB,1.5,15,14,3954,11,2018,10,1
Group 3,BB,1.5,15,14,3955,11,2018,12,-1
Group 3,BB,1.5,15,14,3956,10,2018,12,-2
Group 3,BB,1.5,15,14,3957,13,2018,11,2
Group 3,BB,1.5,15,14,3958,12,2018,7,5
Group 3,BB,1.5,15,14,3959,12,2018,5,7
Group 3,BB,1.5,15,14,3960,12,2018,5,7
Group 3,BB,1.5,15,14,3961,11,2018,7,4
Group 3,BB,1.5,15,14,3962,12,2018,14,-2
Group 3,BB,1.5,15,14,3963,11,2018,11,0
Group 3,BB,1.5,15,14,3964,11,2018,6,5
Group 3,BB,1.5,15,14,3965,9,2018,7,2
Group 3,BB,1.5,15,14,3966,7,2018,5,2
Group 3,BB,1.5,15,14,3967,11,2018,11,0
Group 3,BB,1.5,15,14,3968,11,2018,11,0
Group 3,BB,1.5,15,14,3969,13,2018,7,6
Group 3,BB,1.5,15,14,3970,10,2018,11,-1
Group 3,BB,1.5,15,14,3971,9,2018,12,-3
Group 3,BB,1.5,15,14,3972,9,2018,10,-1
Group 3,BB,1.5,15,14,3973,13,2018,12,1
Group 3,BB,1.5,15,14,3974,12,2018,10,2
Group 3,BB,1.5,15,14,3975,11,2018,13,-2
Group 3,BB,1.5,15,14,3976,10,2018,10,0
Group 3,BB,1.5,15,14,3977,9,2018,10,-1
Group 3,BB,1.5,15,14,3978,10,2018,12,-2
Group 3,BB,1.5,15,14,3979,11,2018,10,1
Group 3,BB,1.5,15,14,3980,12,2018,11,1
Group 3,BB,1.5,15,14,3981,12,2018,12,0
Group 3,BB,1.5,15,14,3982,10,2018,10,0
Group 3,BB,1.5,15,14,3983,9,2018,11,-2
Group 3,BB,1.5,15,14,3984,8,2018,10,-2
Group 3,BB,1.5,15,14,3985,9,2018,12,-3
Group 3,BB,1.5,15,14,3986,11,2018,11,0
Group 3,BB,1.5,15,14,3987,11,2018,7,4
Group 3,BB,1.5,15,14,3988,9,2018,11,-2
Group 3,BB,1.5,15,14,3989,11,2018,11,0
Group 3,BB,1.5,15,14,3990,9,2018,11,-2
Group 3,BB,1.5,15,14,3991,10,2018,11,-1
Group 3,BB,1.5,15,14,3992,9,2018,11,-2
Group 3,BB,1.5,15,14,3993,11,2018,13,-2
Group 3,BB,1.5,15,14,3994,10,2018,13,-3
Group 3,BB,1.5,15,14,3995,13,2018,11,2
Group 3,BB,1.5,15,14,3996,12,2018,11,1
Group 3,BB,1.5,15,14,3997,6,2018,12,-6
Group 3,BB,1.5,15,14,3998,11,2018,14,-3
Group 3,BB,1.5,15,14,3999,6,2018,10,-4
Group 3,BB,1.5,15,14,4000,11,2018,9,2
Group 3,RRG,1.5,17,14,1,9,2018,8,1
Group 3,RRG,1.5,17,14,2,13,2018,12,1
Group 3,RRG,1.5,17,14,3,9,2018,7,2
Group 3,RRG,1.5,17,14,4,13,2018,9,4
Group 3,RRG,1.5,17,14,5,12,2018,13,-1
Group 3,RRG,1.5,17,14,6,11,2018,12,-1
Group 3,RRG,1.5,17,14,7,12,2018,11,1
Group 3,RRG,1.5,17,14,8,10,2018,12,-2
Group 3,RRG,1.5,17,14,9,12,2018,9,3
Group 3,RRG,1.5,17,14,10,13,2018,12,1
Group 3,RRG,1.5,17,14,11,14,2018,11,3
Group 3,RRG,1.5,17,14,12,12,2018,12,0
Group 3,RRG,1.5,17,14,13,8,2018,12,-4
Group 3,RRG,1.5,17,14,14,14,2018,11,3
Group 3,RRG,1.5,17,14,15,7,2018,11,-4
Group 3,RRG,1.5,17,14,16,12,2018,11,1
Group 3,RRG,1.5,17,14,17,9,2018,8,1
Group 3,RRG,1.5,17,14,18,12,2018,12,0
Group 3,RRG,1.5,17,14,19,11,2018,11,0
Group 3,RRG,1.5,17,14,20,12,2018,9,3
Group 3,RRG,1.5,17,14,21,11,2018,12,-1
Group 3,RRG,1.5,17,14,22,14,2018,13,1
Group 3,RRG,1.5,17,14,23,13,2018,11,2
Group 3,RRG,1.5,17,14,24,10,2018,13,-3
Group 3,RRG,1.5,17,14,25,9,2018,13,-4
Group 3,RRG,1.5,17,14,26,8,2018,10,-2
Group 3,RRG,1.5,17,14,27,13,2018,11,2
Group 3,RRG,1.5,17,14,28,13,2018,14,-1
Group 3,RRG,1.5,17,14,29,8,2018,4,4
Group 3,RRG,1.5,17,14,30,9,2018,8,1
Group 3,RRG,1.5,17,14,31,12,2018,10,2
Group 3,RRG,1.5,17,14,32,10,2018,11,-1
Group 3,RRG,1.5,17,14,33,8,2018,12,-4
Group 3,RRG,1.5,17,14,34,10,2018,13,-3
Group 3,RRG,1.5,17,14,35,9,2018,9,0
Group 3,RRG,1.5,17,14,36,13,2018,13,0
Group 3,RRG,1.5,17,14,37,12,2018,10,2
Group 3,RRG,1.5,17,14,38,13,2018,12,1
Group 3,RRG,1.5,17,14,39,11,2018,13,-2
Group 3,RRG,1.5,17,14,40,11,2018,11,0
Group 3,RRG,1.5,17,14,41,9,2018,11,-2
Group 3,RRG,1.5,17,14,42,14,2018,10,4
Group 3,RRG,1.5,17,14,43,8,2018,10,-2
Group 3,RRG,1.5,17,14,44,11,2018,12,-1
Group 3,RRG,1.5,17,14,45,14,2018,12,2
Group 3,RRG,1.5,17,14,46,14,2018,11,3
Group 3,RRG,1.5,17,14,47,13,2018,11,2
Group 3,RRG,1.5,17,14,48,11,2018,10,1
Group 3,RRG,1.5,17,14,49,9,2018,8,1
Group 3,RRG,1.5,17,14,50,14,2018,10,4
Group 3,RRG,1.5,17,14,51,10,2018,12,-2
Group 3,RRG,1.5,17,14,52,14,2018,14,0
Group 3,RRG,1.5,17,14,53,12,2018,11,1
Group 3,RRG,1.5,17,14,54,12,2018,11,1
Group 3,RRG,1.5,17,14,55,13,2018,14,-1
Group 3,RRG,1.5,17,14,56,13,2018,13,0
Group 3,RRG,1.5,17,14,57,13,2018,11,2
Group 3,RRG,1.5,17,14,58,9,2018,12,-3
Group 3,RRG,1.5,17,14,59,13,2018,10,3
Group 3,RRG,1.5,17,14,60,7,2018,9,-2
Group 3,RRG,1.5,17,14,61,14,2018,14,0
Group 3,RRG,1.5,17,14,62,13,2018,14,-1
Group 3,RRG,1.5,17,14,63,13,2018,12,1
Group 3,RRG,1.5,17,14,64,13,2018,10,3
Group 3,RRG,1.5,17,14,65,12,2018,11,1
Group 3,RRG,1.5,17,14,66,14,2018,11,3
Group 3,RRG,1.5,17,14,67,13,2018,7,6
Group 3,RRG,1.5,17,14,68,9,2018,9,0
Group 3,RRG,1.5,17,14,69,11,2018,10,1
Group 3,RRG,1.5,17,14,70,10,2018,9,1
Group 3,RRG,1.5,17,14,71,9,2018,9,0
Group 3,RRG,1.5,17,14,72,13,2018,14,-1
Group 3,RRG,1.5,17,14,73,13,2018,11,2
Group 3,RRG,1.5,17,14,74,11,2018,10,1
Group 3,RRG,1.5,17,14,75,10,2018,12,-2
Group 3,RRG,1.5,17,14,76,9,2018,7,2
Group 3,RRG,1.5,17,14,77,9,2018,14,-5
Group 3,RRG,1.5,17,14,78,7,2018,12,-5
Group 3,RRG,1.5,17,14,79,13,2018,13,0
Group 3,RRG,1.5,17,14,80,13,2018,12,1
Group 3,RRG,1.5,17,14,81,9,2018,9,0
Group 3,RRG,1.5,17,14,82,13,2018,10,3
Group 3,RRG,1.5,17,14,83,12,2018,13,-1
Group 3,RRG,1.5,17,14,84,11,2018,10,1
Group 3,RRG,1.5,17,14,85,9,2018,11,-2
Group 3,RRG,1.5,17,14,86,9,2018,11,-2
Group 3,RRG,1.5,17,14,87,12,2018,13,-1
Group 3,RRG,1.5,17,14,88,12,2018,11,1
Group 3,RRG,1.5,17,14,89,12,2018,10,2
Group 3,RRG,1.5,17,14,90,14,2018,10,4
Group 3,RRG,1.5,17,14,91,14,2018,13,1
Group 3,RRG,1.5,17,14,92,14,2018,12,2
Group 3,RRG,1.5,17,14,93,11,2018,13,-2
Group 3,RRG,1.5,17,14,94,13,2018,12,1
Group 3,RRG,1.5,17,14,95,12,2018,11,1
Group 3,RRG,1.5,17,14,96,10,2018,9,1
Group 3,RRG,1.5,17,14,97,13,2018,14,-1
Group 3,RRG,1.5,17,14,98,12,2018,9,3
Group 3,RRG,1.5,17,14,99,12,2018,12,0
Group 3,RRG,1.5,17,14,100,11,2018,14,-3
Group 3,RRG,1.5,17,14,101,12,2018,12,0
Group 3,RRG,1.5,17,14,102,12,2018,8,4
Group 3,RRG,1.5,17,14,103,12,2018,14,-2
Group 3,RRG,1.5,17,14,104,13,2018,11,2
Group 3,RRG,1.5,17,14,105,11,2018,8,3
Group 3,RRG,1.5,17,14,106,14,2018,12,2
Group 3,RRG,1.5,17,14,107,14,2018,9,5
Group 3,RRG,1.5,17,14,108,11,2018,13,-2
Group 3,RRG,1.5,17,14,109,11,2018,12,-1
Group 3,RRG,1.5,17,14,110,13,2018,11,2
Group 3,RRG,1.5,17,14,111,10,2018,9,1
Group 3,RRG,1.5,17,14,112,12,2018,8,4
Group 3,RRG,1.5,17,14,113,12,2018,7,5
Group 3,RRG,1.5,17,14,114,12,2018,12,0
Group 3,RRG,1.5,17,14,115,13,2018,13,0
Group 3,RRG,1.5,17,14,116,13,2018,11,2
Group 3,RRG,1.5,17,14,117,14,2018,13,1
Group 3,RRG,1.5,17,14,118,11,2018,13,-2
Group 3,RRG,1.5,17,14,119,14,2018,13,1
Group 3,RRG,1.5,17,14,120,11,2018,12,-1
Group 3,RRG,1.5,17,14,121,13,2018,14,-1
Group 3,RRG,1.5,17,14,122,12,2018,7,5
Group 3,RRG,1.5,17,14,123,11,2018,13,-2
Group 3,RRG,1.5,17,14,124,13,2018,13,0
Group 3,RRG,1.5,17,14,125,14,2018,12,2
Group 3,RRG,1.5,17,14,126,12,2018,14,-2
Group 3,RRG,1.5,17,14,127,14,2018,14,0
Group 3,RRG,1.5,17,14,128,13,2018,9,4
Group 3,RRG,1.5,17,14,129,8,2018,13,-5
Group 3,RRG,1.5,17,14,130,6,2018,13,-7
Group 3,RRG,1.5,17,14,131,9,2018,13,-4
Group 3,RRG,1.5,17,14,132,13,2018,9,4
Group 3,RRG,1.5,17,14,133,8,2018,13,-5
Group 3,RRG,1.5,17,14,134,10,2018,10,0
Group 3,RRG,1.5,17,14,135,13,2018,12,1
Group 3,RRG,1.5,17,14,136,12,2018,12,0
Group 3,RRG,1.5,17,14,137,12,2018,11,1
Group 3,RRG,1.5,17,14,138,12,2018,13,-1
Group 3,RRG,1.5,17,14,139,10,2018,10,0
Group 3,RRG,1.5,17,14,140,11,2018,12,-1
Group 3,RRG,1.5,17,14,141,11,2018,11,0
Group 3,RRG,1.5,17,14,142,13,2018,14,-1
Group 3,RRG,1.5,17,14,143,14,2018,13,1
Group 3,RRG,1.5,17,14,144,14,2018,13,1
Group 3,RRG,1.5,17,14,145,11,2018,9,2
Group 3,RRG,1.5,17,14,146,13,2018,11,2
Group 3,RRG,1.5,17,14,147,11,2018,10,1
Group 3,RRG,1.5,17,14,148,13,2018,11,2
Group 3,RRG,1.5,17,14,149,10,2018,10,0
Group 3,RRG,1.5,17,14,150,11,2018,12,-1
Group 3,RRG,1.5,17,14,151,11,2018,10,1
Group 3,RRG,1.5,17,14,152,13,2018,14,-1
Group 3,RRG,1.5,17,14,153,10,2018,12,-2
Group 3,RRG,1.5,17,14,154,13,2018,12,1
Group 3,RRG,1.5,17,14,155,13,2018,13,0
Group 3,RRG,1.5,17,14,156,10,2018,10,0
Group 3,RRG,1.5,17,14,157,14,2018,12,2
Group 3,RRG,1.5,17,14,158,12,2018,10,2
Group 3,RRG,1.5,17,14,159,12,2018,9,3
Group 3,RRG,1.5,17,14,160,11,2018,12,-1
Group 3,RRG,1.5,17,14,161,12,2018,10,2
Group 3,RRG,1.5,17,14,162,10,2018,10,0
Group 3,RRG,1.5,17,14,163,10,2018,9,1
Group 3,RRG,1.5,17,14,164,12,2018,11,1
Group 3,RRG,1.5,17,14,165,12,2018,11,1
Group 3,RRG,1.5,17,14,166,9,2018,11,-2
Group 3,RRG,1.5,17,14,167,11,2018,11,0
Group 3,RRG,1.5,17,14,168,13,2018,8,5
Group 3,RRG,1.5,17,14,169,14,2018,10,4
Group 3,RRG,1.5,17,14,170,13,2018,12,1
Group 3,RRG,1.5,17,14,171,12,2018,11,1
Group 3,RRG,1.5,17,14,172,9,2018,5,4
Group 3,RRG,1.5,17,14,173,5,2018,7,-2
Group 3,RRG,1.5,17,14,174,8,2018,7,1
Group 3,RRG,1.5,17,14,175,9,2018,9,0
Group 3,RRG,1.5,17,14,176,12,2018,13,-1
Group 3,RRG,1.5,17,14,177,9,2018,11,-2
Group 3,RRG,1.5,17,14,178,9,2018,14,-5
Group 3,RRG,1.5,17,14,179,11,2018,12,-1
Group 3,RRG,1.5,17,14,180,14,2018,13,1
Group 3,RRG,1.5,17,14,181,13,2018,14,-1
Group 3,RRG,1.5,17,14,182,12,2018,8,4
Group 3,RRG,1.5,17,14,183,13,2018,9,4
Group 3,RRG,1.5,17,14,184,13,2018,10,3
Group 3,RRG,1.5,17,14,185,12,2018,12,0
Group 3,RRG,1.5,17,14,186,13,2018,12,1
Group 3,RRG,1.5,17,14,187,13,2018,9,4
Group 3,RRG,1.5,17,14,188,12,2018,11,1
Group 3,RRG,1.5,17,14,189,11,2018,9,2
Group 3,RRG,1.5,17,14,190,10,2018,9,1
Group 3,RRG,1.5,17,14,191,11,2018,12,-1
Group 3,RRG,1.5,17,14,192,14,2018,9,5
Group 3,RRG,1.5,17,14,193,8,2018,10,-2
Group 3,RRG,1.5,17,14,194,14,2018,13,1
Group 3,RRG,1.5,17,14,195,11,2018,10,1
Group 3,RRG,1.5,17,14,196,10,2018,12,-2
Group 3,RRG,1.5,17,14,197,13,2018,13,0
Group 3,RRG,1.5,17,14,198,14,2018,13,1
Group 3,RRG,1.5,17,14,199,14,2018,10,4
Group 3,RRG,1.5,17,14,200,12,2018,11,1
Group 3,RRG,1.5,17,14,201,11,2018,8,3
Group 3,RRG,1.5,17,14,202,10,2018,9,1
Group 3,RRG,1.5,17,14,203,8,2018,12,-4
Group 3,RRG,1.5,17,14,204,13,2018,11,2
Group 3,RRG,1.5,17,14,205,12,2018,12,0
Group 3,RRG,1.5,17,14,206,8,2018,11,-3
Group 3,RRG,1.5,17,14,207,11,2018,12,-1
Group 3,RRG,1.5,17,14,208,14,2018,10,4
Group 3,RRG,1.5,17,14,209,10,2018,8,2
Group 3,RRG,1.5,17,14,210,10,2018,12,-2
Group 3,RRG,1.5,17,14,211,13,2018,14,-1
Group 3,RRG,1.5,17,14,212,12,2018,11,1
Group 3,RRG,1.5,17,14,213,10,2018,8,2
Group 3,RRG,1.5,17,14,214,5,2018,12,-7
Group 3,RRG,1.5,17,14,215,5,2018,12,-7
Group 3,RRG,1.5,17,14,216,13,2018,11,2
Group 3,RRG,1.5,17,14,217,10,2018,13,-3
Group 3,RRG,1.5,17,14,218,13,2018,11,2
Group 3,RRG,1.5,17,14,219,11,2018,9,2
Group 3,RRG,1.5,17,14,220,13,2018,12,1
Group 3,RRG,1.5,17,14,221,10,2018,11,-1
Group 3,RRG,1.5,17,14,222,11,2018,12,-1
Group 3,RRG,1.5,17,14,223,9,2018,11,-2
Group 3,RRG,1.5,17,14,224,13,2018,10,3
Group 3,RRG,1.5,17,14,225,13,2018,11,2
Group 3,RRG,1.5,17,14,226,11,2018,11,0
Group 3,RRG,1.5,17,14,227,10,2018,11,-1
Group 3,RRG,1.5,17,14,228,10,2018,12,-2
Group 3,RRG,1.5,17,14,229,10,2018,8,2
Group 3,RRG,1.5,17,14,230,12,2018,14,-2
Group 3,RRG,1.5,17,14,231,12,2018,13,-1
Group 3,RRG,1.5,17,14,232,11,2018,12,-1
Group 3,RRG,1.5,17,14,233,11,2018,8,3
Group 3,RRG,1.5,17,14,234,11,2018,10,1
Group 3,RRG,1.5,17,14,235,13,2018,13,0
Group 3,RRG,1.5,17,14,236,14,2018,12,2
Group 3,RRG,1.5,17,14,237,13,2018,12,1
Group 3,RRG,1.5,17,14,238,12,2018,12,0
Group 3,RRG,1.5,17,14,239,13,2018,11,2
Group 3,RRG,1.5,17,14,240,12,2018,12,0
Group 3,RRG,1.5,17,14,241,12,2018,8,4
Group 3,RRG,1.5,17,14,242,12,2018,11,1
Group 3,RRG,1.5,17,14,243,12,2018,9,3
Group 3,RRG,1.5,17,14,244,10,2018,13,-3
Group 3,RRG,1.5,17,14,245,13,2018,11,2
Group 3,RRG,1.5,17,14,246,12,2018,12,0
Group 3,RRG,1.5,17,14,247,13,2018,12,1
Group 3,RRG,1.5,17,14,248,13,2018,8,5
Group 3,RRG,1.5,17,14,249,10,2018,12,-2
Group 3,RRG,1.5,17,14,250,12,2018,13,-1
Group 3,RRG,1.5,17,14,251,12,2018,10,2
Group 3,RRG,1.5,17,14,252,13,2018,12,1
Group 3,RRG,1.5,17,14,253,11,2018,11,0
Group 3,RRG,1.5,17,14,254,8,2018,11,-3
Group 3,RRG,1.5,17,14,255,9,2018,12,-3
Group 3,RRG,1.5,17,14,256,12,2018,13,-1
Group 3,RRG,1.5,17,14,257,12,2018,12,0
Group 3,RRG,1.5,17,14,258,14,2018,10,4
Group 3,RRG,1.5,17,14,259,12,2018,11,1
Group 3,RRG,1.5,17,14,260,14,2018,13,1
Group 3,RRG,1.5,17,14,261,12,2018,11,1
Group 3,RRG,1.5,17,14,262,13,2018,9,4
Group 3,RRG,1.5,17,14,263,8,2018,7,1
Group 3,RRG,1.5,17,14,264,12,2018,12,0
Group 3,RRG,1.5,17,14,265,5,2018,8,-3
Group 3,RRG,1.5,17,14,266,11,2018,9,2
Group 3,RRG,1.5,17,14,267,9,2018,13,-4
Group 3,RRG,1.5,17,14,268,13,2018,12,1
Group 3,RRG,1.5,17,14,269,11,2018,11,0
Group 3,RRG,1.5,17,14,270,14,2018,12,2
Group 3,RRG,1.5,17,14,271,12,2018,9,3
Group 3,RRG,1.5,17,14,272,11,2018,12,-1
Group 3,RRG,1.5,17,14,273,11,2018,13,-2
Group 3,RRG,1.5,17,14,274,11,2018,10,1
Group 3,RRG,1.5,17,14,275,12,2018,12,0
Group 3,RRG,1.5,17,14,276,9,2018,9,0
Group 3,RRG,1.5,17,14,277,13,2018,12,1
Group 3,RRG,1.5,17,14,278,12,2018,12,0
Group 3,RRG,1.5,17,14,279,11,2018,11,0
Group 3,RRG,1.5,17,14,280,10,2018,11,-1
Group 3,RRG,1.5,17,14,281,13,2018,12,1
Group 3,RRG,1.5,17,14,282,13,2018,12,1
Group 3,RRG,1.5,17,14,283,13,2018,12,1
Group 3,RRG,1.5,17,14,284,14,2018,9,5
Group 3,RRG,1.5,17,14,285,12,2018,11,1
Group 3,RRG,1.5,17,14,286,11,2018,9,2
Group 3,RRG,1.5,17,14,287,9,2018,11,-2
Group 3,RRG,1.5,17,14,288,14,2018,13,1
Group 3,RRG,1.5,17,14,289,13,2018,11,2
Group 3,RRG,1.5,17,14,290,11,2018,13,-2
Group 3,RRG,1.5,17,14,291,8,2018,13,-5
Group 3,RRG,1.5,17,14,292,8,2018,10,-2
Group 3,RRG,1.5,17,14,293,14,2018,12,2
Group 3,RRG,1.5,17,14,294,6,2018,9,-3
Group 3,RRG,1.5,17,14,295,9,2018,8,1
Group 3,RRG,1.5,17,14,296,11,2018,13,-2
Group 3,RRG,1.5,17,14,297,13,2018,11,2
Group 3,RRG,1.5,17,14,298,12,2018,13,-1
Group 3,RRG,1.5,17,14,299,10,2018,10,0
Group 3,RRG,1.5,17,14,300,13,2018,12,1
Group 3,RRG,1.5,17,14,301,13,2018,13,0
Group 3,RRG,1.5,17,14,302,14,2018,11,3
Group 3,RRG,1.5,17,14,303,14,2018,13,1
Group 3,RRG,1.5,17,14,304,10,2018,11,-1
Group 3,RRG,1.5,17,14,305,8,2018,11,-3
Group 3,RRG,1.5,17,14,306,11,2018,11,0
Group 3,RRG,1.5,17,14,307,13,2018,10,3
Group 3,RRG,1.5,17,14,308,10,2018,10,0
Group 3,RRG,1.5,17,14,309,9,2018,10,-1
Group 3,RRG,1.5,17,14,310,12,2018,12,0
Group 3,RRG,1.5,17,14,311,13,2018,11,2
Group 3,RRG,1.5,17,14,312,12,2018,12,0
Group 3,RRG,1.5,17,14,313,9,2018,12,-3
Group 3,RRG,1.5,17,14,314,11,2018,13,-2
Group 3,RRG,1.5,17,14,315,12,2018,9,3
Group 3,RRG,1.5,17,14,316,11,2018,12,-1
Group 3,RRG,1.5,17,14,317,10,2018,10,0
Group 3,RRG,1.5,17,14,318,6,2018,10,-4
Group 3,RRG,1.5,17,14,319,12,2018,12,0
Group 3,RRG,1.5,17,14,320,12,2018,14,-2
Group 3,RRG,1.5,17,14,321,13,2018,10,3
Group 3,RRG,1.5,17,14,322,14,2018,10,4
Group 3,RRG,1.5,17,14,323,14,2018,12,2
Group 3,RRG,1.5,17,14,324,13,2018,13,0
Group 3,RRG,1.5,17,14,325,7,2018,10,-3
Group 3,RRG,1.5,17,14,326,11,2018,10,1
Group 3,RRG,1.5,17,14,327,13,2018,11,2
Group 3,RRG,1.5,17,14,328,11,2018,12,-1
Group 3,RRG,1.5,17,14,329,9,2018,9,0
Group 3,RRG,1.5,17,14,330,12,2018,12,0
Group 3,RRG,1.5,17,14,331,11,2018,8,3
Group 3,RRG,1.5,17,14,332,11,2018,11,0
Group 3,RRG,1.5,17,14,333,13,2018,12,1
Group 3,RRG,1.5,17,14,334,9,2018,8,1
Group 3,RRG,1.5,17,14,335,13,2018,13,0
Group 3,RRG,1.5,17,14,336,10,2018,10,0
Group 3,RRG,1.5,17,14,337,13,2018,10,3
Group 3,RRG,1.5,17,14,338,8,2018,9,-1
Group 3,RRG,1.5,17,14,339,13,2018,10,3
Group 3,RRG,1.5,17,14,340,9,2018,12,-3
Group 3,RRG,1.5,17,14,341,3,2018,9,-6
Group 3,RRG,1.5,17,14,342,14,2018,14,0
Group 3,RRG,1.5,17,14,343,9,2018,10,-1
Group 3,RRG,1.5,17,14,344,14,2018,11,3
Group 3,RRG,1.5,17,14,345,9,2018,13,-4
Group 3,RRG,1.5,17,14,346,11,2018,12,-1
Group 3,RRG,1.5,17,14,347,6,2018,14,-8
Group 3,RRG,1.5,17,14,348,10,2018,9,1
Group 3,RRG,1.5,17,14,349,10,2018,13,-3
Group 3,RRG,1.5,17,14,350,8,2018,11,-3
Group 3,RRG,1.5,17,14,351,12,2018,12,0
Group 3,RRG,1.5,17,14,352,13,2018,12,1
Group 3,RRG,1.5,17,14,353,11,2018,7,4
Group 3,RRG,1.5,17,14,354,13,2018,13,0
Group 3,RRG,1.5,17,14,355,14,2018,12,2
Group 3,RRG,1.5,17,14,356,14,2018,10,4
Group 3,RRG,1.5,17,14,357,8,2018,11,-3
Group 3,RRG,1.5,17,14,358,8,2018,9,-1
Group 3,RRG,1.5,17,14,359,9,2018,10,-1
Group 3,RRG,1.5,17,14,360,13,2018,11,2
Group 3,RRG,1.5,17,14,361,11,2018,10,1
Group 3,RRG,1.5,17,14,362,12,2018,8,4
Group 3,RRG,1.5,17,14,363,12,2018,14,-2
Group 3,RRG,1.5,17,14,364,10,2018,13,-3
Group 3,RRG,1.5,17,14,365,12,2018,13,-1
Group 3,RRG,1.5,17,14,366,12,2018,11,1
Group 3,RRG,1.5,17,14,367,11,2018,11,0
Group 3,RRG,1.5,17,14,368,11,2018,12,-1
Group 3,RRG,1.5,17,14,369,12,2018,11,1
Group 3,RRG,1.5,17,14,370,13,2018,13,0
Group 3,RRG,1.5,17,14,371,11,2018,12,-1
Group 3,RRG,1.5,17,14,372,13,2018,10,3
Group 3,RRG,1.5,17,14,373,14,2018,12,2
Group 3,RRG,1.5,17,14,374,13,2018,11,2
Group 3,RRG,1.5,17,14,375,10,2018,13,-3
Group 3,RRG,1.5,17,14,376,11,2018,12,-1
Group 3,RRG,1.5,17,14,377,8,2018,10,-2
Group 3,RRG,1.5,17,14,378,13,2018,10,3
Group 3,RRG,1.5,17,14,379,14,2018,11,3
Group 3,RRG,1.5,17,14,380,11,2018,9,2
Group 3,RRG,1.5,17,14,381,12,2018,11,1
Group 3,RRG,1.5,17,14,382,13,2018,13,0
Group 3,RRG,1.5,17,14,383,14,2018,13,1
Group 3,RRG,1.5,17,14,384,12,2018,11,1
Group 3,RRG,1.5,17,14,385,13,2018,14,-1
Group 3,RRG,1.5,17,14,386,11,2018,12,-1
Group 3,RRG,1.5,17,14,387,10,2018,11,-1
Group 3,RRG,1.5,17,14,388,10,2018,12,-2
Group 3,RRG,1.5,17,14,389,14,2018,14,0
Group 3,RRG,1.5,17,14,390,9,2018,10,-1
Group 3,RRG,1.5,17,14,391,13,2018,12,1
Group 3,RRG,1.5,17,14,392,11,2018,11,0
Group 3,RRG,1.5,17,14,393,13,2018,12,1
Group 3,RRG,1.5,17,14,394,13,2018,10,3
Group 3,RRG,1.5,17,14,395,13,2018,11,2
Group 3,RRG,1.5,17,14,396,14,2018,11,3
Group 3,RRG,1.5,17,14,397,13,2018,14,-1
Group 3,RRG,1.5,17,14,398,12,2018,13,-1
Group 3,RRG,1.5,17,14,399,14,2018,10,4
Group 3,RRG,1.5,17,14,400,10,2018,8,2
Group 3,RRG,1.5,17,14,401,13,2018,10,3
Group 3,RRG,1.5,17,14,402,14,2018,11,3
Group 3,RRG,1.5,17,14,403,12,2018,13,-1
Group 3,RRG,1.5,17,14,404,12,2018,8,4
Group 3,RRG,1.5,17,14,405,14,2018,12,2
Group 3,RRG,1.5,17,14,406,8,2018,11,-3
Group 3,RRG,1.5,17,14,407,12,2018,10,2
Group 3,RRG,1.5,17,14,408,11,2018,9,2
Group 3,RRG,1.5,17,14,409,14,2018,10,4
Group 3,RRG,1.5,17,14,410,13,2018,13,0
Group 3,RRG,1.5,17,14,411,2,2018,9,-7
Group 3,RRG,1.5,17,14,412,10,2018,9,1
Group 3,RRG,1.5,17,14,413,10,2018,13,-3
Group 3,RRG,1.5,17,14,414,12,2018,9,3
Group 3,RRG,1.5,17,14,415,14,2018,12,2
Group 3,RRG,1.5,17,14,416,11,2018,10,1
Group 3,RRG,1.5,17,14,417,13,2018,12,1
Group 3,RRG,1.5,17,14,418,13,2018,12,1
Group 3,RRG,1.5,17,14,419,12,2018,11,1
Group 3,RRG,1.5,17,14,420,12,2018,10,2
Group 3,RRG,1.5,17,14,421,12,2018,14,-2
Group 3,RRG,1.5,17,14,422,9,2018,13,-4
Group 3,RRG,1.5,17,14,423,11,2018,13,-2
Group 3,RRG,1.5,17,14,424,14,2018,13,1
Group 3,RRG,1.5,17,14,425,13,2018,13,0
Group 3,RRG,1.5,17,14,426,10,2018,7,3
Group 3,RRG,1.5,17,14,427,14,2018,13,1
Group 3,RRG,1.5,17,14,428,9,2018,10,-1
Group 3,RRG,1.5,17,14,429,11,2018,12,-1
Group 3,RRG,1.5,17,14,430,12,2018,13,-1
Group 3,RRG,1.5,17,14,431,10,2018,10,0
Group 3,RRG,1.5,17,14,432,11,2018,11,0
Group 3,RRG,1.5,17,14,433,11,2018,11,0
Group 3,RRG,1.5,17,14,434,9,2018,11,-2
Group 3,RRG,1.5,17,14,435,10,2018,11,-1
Group 3,RRG,1.5,17,14,436,14,2018,10,4
Group 3,RRG,1.5,17,14,437,14,2018,12,2
Group 3,RRG,1.5,17,14,438,7,2018,8,-1
Group 3,RRG,1.5,17,14,439,6,2018,10,-4
Group 3,RRG,1.5,17,14,440,11,2018,10,1
Group 3,RRG,1.5,17,14,441,11,2018,12,-1
Group 3,RRG,1.5,17,14,442,13,2018,9,4
Group 3,RRG,1.5,17,14,443,13,2018,13,0
Group 3,RRG,1.5,17,14,444,12,2018,11,1
Group 3,RRG,1.5,17,14,445,11,2018,10,1
Group 3,RRG,1.5,17,14,446,6,2018,8,-2
Group 3,RRG,1.5,17,14,447,14,2018,13,1
Group 3,RRG,1.5,17,14,448,11,2018,12,-1
Group 3,RRG,1.5,17,14,449,13,2018,14,-1
Group 3,RRG,1.5,17,14,450,7,2018,11,-4
Group 3,RRG,1.5,17,14,451,13,2018,9,4
Group 3,RRG,1.5,17,14,452,13,2018,14,-1
Group 3,RRG,1.5,17,14,453,12,2018,10,2
Group 3,RRG,1.5,17,14,454,12,2018,14,-2
Group 3,RRG,1.5,17,14,455,13,2018,11,2
Group 3,RRG,1.5,17,14,456,13,2018,12,1
Group 3,RRG,1.5,17,14,457,11,2018,12,-1
Group 3,RRG,1.5,17,14,458,12,2018,9,3
Group 3,RRG,1.5,17,14,459,11,2018,9,2
Group 3,RRG,1.5,17,14,460,8,2018,12,-4
Group 3,RRG,1.5,17,14,461,5,2018,7,-2
Group 3,RRG,1.5,17,14,462,11,2018,9,2
Group 3,RRG,1.5,17,14,463,11,2018,10,1
Group 3,RRG,1.5,17,14,464,12,2018,11,1
Group 3,RRG,1.5,17,14,465,11,2018,12,-1
Group 3,RRG,1.5,17,14,466,11,2018,7,4
Group 3,RRG,1.5,17,14,467,14,2018,11,3
Group 3,RRG,1.5,17,14,468,9,2018,9,0
Group 3,RRG,1.5,17,14,469,11,2018,10,1
Group 3,RRG,1.5,17,14,470,12,2018,13,-1
Group 3,RRG,1.5,17,14,471,13,2018,10,3
Group 3,RRG,1.5,17,14,472,12,2018,10,2
Group 3,RRG,1.5,17,14,473,13,2018,13,0
Group 3,RRG,1.5,17,14,474,8,2018,9,-1
Group 3,RRG,1.5,17,14,475,10,2018,9,1
Group 3,RRG,1.5,17,14,476,12,2018,10,2
Group 3,RRG,1.5,17,14,477,10,2018,8,2
Group 3,RRG,1.5,17,14,478,12,2018,13,-1
Group 3,RRG,1.5,17,14,479,9,2018,12,-3
Group 3,RRG,1.5,17,14,480,11,2018,11,0
Group 3,RRG,1.5,17,14,481,14,2018,11,3
Group 3,RRG,1.5,17,14,482,8,2018,10,-2
Group 3,RRG,1.5,17,14,483,13,2018,13,0
Group 3,RRG,1.5,17,14,484,12,2018,13,-1
Group 3,RRG,1.5,17,14,485,13,2018,13,0
Group 3,RRG,1.5,17,14,486,14,2018,13,1
Group 3,RRG,1.5,17,14,487,12,2018,14,-2
Group 3,RRG,1.5,17,14,488,11,2018,12,-1
Group 3,RRG,1.5,17,14,489,12,2018,12,0
Group 3,RRG,1.5,17,14,490,11,2018,10,1
Group 3,RRG,1.5,17,14,491,14,2018,12,2
Group 3,RRG,1.5,17,14,492,7,2018,8,-1
Group 3,RRG,1.5,17,14,493,12,2018,10,2
Group 3,RRG,1.5,17,14,494,13,2018,11,2
Group 3,RRG,1.5,17,14,495,14,2018,11,3
Group 3,RRG,1.5,17,14,496,12,2018,14,-2
Group 3,RRG,1.5,17,14,497,10,2018,11,-1
Group 3,RRG,1.5,17,14,498,11,2018,12,-1
Group 3,RRG,1.5,17,14,499,13,2018,13,0
Group 3,RRG,1.5,17,14,500,13,2018,11,2
Group 3,RRG,1.5,17,14,501,11,2018,14,-3
Group 3,RRG,1.5,17,14,502,12,2018,12,0
Group 3,RRG,1.5,17,14,503,11,2018,14,-3
Group 3,RRG,1.5,17,14,504,13,2018,11,2
Group 3,RRG,1.5,17,14,505,13,2018,12,1
Group 3,RRG,1.5,17,14,506,13,2018,14,-1
Group 3,RRG,1.5,17,14,507,12,2018,13,-1
Group 3,RRG,1.5,17,14,508,9,2018,14,-5
Group 3,RRG,1.5,17,14,509,8,2018,12,-4
Group 3,RRG,1.5,17,14,510,12,2018,12,0
Group 3,RRG,1.5,17,14,511,12,2018,10,2
Group 3,RRG,1.5,17,14,512,11,2018,13,-2
Group 3,RRG,1.5,17,14,513,2,2018,7,-5
Group 3,RRG,1.5,17,14,514,13,2018,13,0
Group 3,RRG,1.5,17,14,515,14,2018,14,0
Group 3,RRG,1.5,17,14,516,13,2018,7,6
Group 3,RRG,1.5,17,14,517,14,2018,13,1
Group 3,RRG,1.5,17,14,518,14,2018,9,5
Group 3,RRG,1.5,17,14,519,13,2018,7,6
Group 3,RRG,1.5,17,14,520,14,2018,14,0
Group 3,RRG,1.5,17,14,521,11,2018,10,1
Group 3,RRG,1.5,17,14,522,10,2018,6,4
Group 3,RRG,1.5,17,14,523,12,2018,9,3
Group 3,RRG,1.5,17,14,524,11,2018,10,1
Group 3,RRG,1.5,17,14,525,10,2018,11,-1
Group 3,RRG,1.5,17,14,526,13,2018,12,1
Group 3,RRG,1.5,17,14,527,12,2018,11,1
Group 3,RRG,1.5,17,14,528,11,2018,14,-3
Group 3,RRG,1.5,17,14,529,14,2018,11,3
Group 3,RRG,1.5,17,14,530,11,2018,12,-1
Group 3,RRG,1.5,17,14,531,12,2018,11,1
Group 3,RRG,1.5,17,14,532,10,2018,12,-2
Group 3,RRG,1.5,17,14,533,14,2018,9,5
Group 3,RRG,1.5,17,14,534,10,2018,9,1
Group 3,RRG,1.5,17,14,535,9,2018,9,0
Group 3,RRG,1.5,17,14,536,12,2018,7,5
Group 3,RRG,1.5,17,14,537,14,2018,12,2
Group 3,RRG,1.5,17,14,538,9,2018,13,-4
Group 3,RRG,1.5,17,14,539,14,2018,13,1
Group 3,RRG,1.5,17,14,540,14,2018,11,3
Group 3,RRG,1.5,17,14,541,10,2018,10,0
Group 3,RRG,1.5,17,14,542,8,2018,9,-1
Group 3,RRG,1.5,17,14,543,11,2018,9,2
Group 3,RRG,1.5,17,14,544,9,2018,10,-1
Group 3,RRG,1.5,17,14,545,14,2018,12,2
Group 3,RRG,1.5,17,14,546,12,2018,12,0
Group 3,RRG,1.5,17,14,547,12,2018,8,4
Group 3,RRG,1.5,17,14,548,13,2018,11,2
Group 3,RRG,1.5,17,14,549,13,2018,13,0
Group 3,RRG,1.5,17,14,550,8,2018,6,2
Group 3,RRG,1.5,17,14,551,12,2018,12,0
Group 3,RRG,1.5,17,14,552,6,2018,7,-1
Group 3,RRG,1.5,17,14,553,11,2018,13,-2
Group 3,RRG,1.5,17,14,554,11,2018,12,-1
Group 3,RRG,1.5,17,14,555,7,2018,12,-5
Group 3,RRG,1.5,17,14,556,12,2018,10,2
Group 3,RRG,1.5,17,14,557,13,2018,13,0
Group 3,RRG,1.5,17,14,558,7,2018,9,-2
Group 3,RRG,1.5,17,14,559,14,2018,13,1
Group 3,RRG,1.5,17,14,560,5,2018,12,-7
Group 3,RRG,1.5,17,14,561,11,2018,10,1
Group 3,RRG,1.5,17,14,562,9,2018,8,1
Group 3,RRG,1.5,17,14,563,7,2018,10,-3
Group 3,RRG,1.5,17,14,564,12,2018,10,2
Group 3,RRG,1.5,17,14,565,11,2018,9,2
Group 3,RRG,1.5,17,14,566,11,2018,9,2
Group 3,RRG,1.5,17,14,567,7,2018,10,-3
Group 3,RRG,1.5,17,14,568,11,2018,12,-1
Group 3,RRG,1.5,17,14,569,13,2018,9,4
Group 3,RRG,1.5,17,14,570,10,2018,9,1
Group 3,RRG,1.5,17,14,571,9,2018,11,-2
Group 3,RRG,1.5,17,14,572,12,2018,9,3
Group 3,RRG,1.5,17,14,573,13,2018,10,3
Group 3,RRG,1.5,17,14,574,13,2018,8,5
Group 3,RRG,1.5,17,14,575,5,2018,11,-6
Group 3,RRG,1.5,17,14,576,5,2018,10,-5
Group 3,RRG,1.5,17,14,577,10,2018,13,-3
Group 3,RRG,1.5,17,14,578,12,2018,10,2
Group 3,RRG,1.5,17,14,579,10,2018,13,-3
Group 3,RRG,1.5,17,14,580,10,2018,10,0
Group 3,RRG,1.5,17,14,581,13,2018,11,2
Group 3,RRG,1.5,17,14,582,13,2018,11,2
Group 3,RRG,1.5,17,14,583,10,2018,10,0
Group 3,RRG,1.5,17,14,584,14,2018,11,3
Group 3,RRG,1.5,17,14,585,11,2018,12,-1
Group 3,RRG,1.5,17,14,586,7,2018,13,-6
Group 3,RRG,1.5,17,14,587,6,2018,9,-3
Group 3,RRG,1.5,17,14,588,10,2018,11,-1
Group 3,RRG,1.5,17,14,589,10,2018,10,0
Group 3,RRG,1.5,17,14,590,10,2018,13,-3
Group 3,RRG,1.5,17,14,591,12,2018,10,2
Group 3,RRG,1.5,17,14,592,13,2018,10,3
Group 3,RRG,1.5,17,14,593,12,2018,12,0
Group 3,RRG,1.5,17,14,594,10,2018,11,-1
Group 3,RRG,1.5,17,14,595,9,2018,12,-3
Group 3,RRG,1.5,17,14,596,13,2018,10,3
Group 3,RRG,1.5,17,14,597,13,2018,10,3
Group 3,RRG,1.5,17,14,598,10,2018,8,2
Group 3,RRG,1.5,17,14,599,8,2018,11,-3
Group 3,RRG,1.5,17,14,600,14,2018,14,0
Group 3,RRG,1.5,17,14,601,9,2018,9,0
Group 3,RRG,1.5,17,14,602,11,2018,8,3
Group 3,RRG,1.5,17,14,603,6,2018,11,-5
Group 3,RRG,1.5,17,14,604,11,2018,10,1
Group 3,RRG,1.5,17,14,605,10,2018,11,-1
Group 3,RRG,1.5,17,14,606,10,2018,12,-2
Group 3,RRG,1.5,17,14,607,13,2018,12,1
Group 3,RRG,1.5,17,14,608,14,2018,11,3
Group 3,RRG,1.5,17,14,609,11,2018,11,0
Group 3,RRG,1.5,17,14,610,10,2018,11,-1
Group 3,RRG,1.5,17,14,611,10,2018,14,-4
Group 3,RRG,1.5,17,14,612,12,2018,11,1
Group 3,RRG,1.5,17,14,613,11,2018,11,0
Group 3,RRG,1.5,17,14,614,13,2018,9,4
Group 3,RRG,1.5,17,14,615,12,2018,12,0
Group 3,RRG,1.5,17,14,616,14,2018,12,2
Group 3,RRG,1.5,17,14,617,14,2018,10,4
Group 3,RRG,1.5,17,14,618,11,2018,10,1
Group 3,RRG,1.5,17,14,619,9,2018,8,1
Group 3,RRG,1.5,17,14,620,14,2018,14,0
Group 3,RRG,1.5,17,14,621,11,2018,12,-1
Group 3,RRG,1.5,17,14,622,11,2018,14,-3
Group 3,RRG,1.5,17,14,623,12,2018,13,-1
Group 3,RRG,1.5,17,14,624,12,2018,11,1
Group 3,RRG,1.5,17,14,625,13,2018,13,0
Group 3,RRG,1.5,17,14,626,13,2018,14,-1
Group 3,RRG,1.5,17,14,627,9,2018,8,1
Group 3,RRG,1.5,17,14,628,14,2018,13,1
Group 3,RRG,1.5,17,14,629,13,2018,10,3
Group 3,RRG,1.5,17,14,630,12,2018,14,-2
Group 3,RRG,1.5,17,14,631,12,2018,13,-1
Group 3,RRG,1.5,17,14,632,11,2018,14,-3
Group 3,RRG,1.5,17,14,633,10,2018,11,-1
Group 3,RRG,1.5,17,14,634,13,2018,12,1
Group 3,RRG,1.5,17,14,635,14,2018,9,5
Group 3,RRG,1.5,17,14,636,11,2018,11,0
Group 3,RRG,1.5,17,14,637,12,2018,12,0
Group 3,RRG,1.5,17,14,638,13,2018,11,2
Group 3,RRG,1.5,17,14,639,12,2018,8,4
Group 3,RRG,1.5,17,14,640,14,2018,13,1
Group 3,RRG,1.5,17,14,641,10,2018,11,-1
Group 3,RRG,1.5,17,14,642,11,2018,9,2
Group 3,RRG,1.5,17,14,643,11,2018,12,-1
Group 3,RRG,1.5,17,14,644,13,2018,11,2
Group 3,RRG,1.5,17,14,645,12,2018,11,1
Group 3,RRG,1.5,17,14,646,11,2018,10,1
Group 3,RRG,1.5,17,14,647,11,2018,12,-1
Group 3,RRG,1.5,17,14,648,9,2018,8,1
Group 3,RRG,1.5,17,14,649,12,2018,13,-1
Group 3,RRG,1.5,17,14,650,10,2018,11,-1
Group 3,RRG,1.5,17,14,651,11,2018,9,2
Group 3,RRG,1.5,17,14,652,11,2018,10,1
Group 3,RRG,1.5,17,14,653,11,2018,7,4
Group 3,RRG,1.5,17,14,654,11,2018,10,1
Group 3,RRG,1.5,17,14,655,9,2018,11,-2
Group 3,RRG,1.5,17,14,656,10,2018,10,0
Group 3,RRG,1.5,17,14,657,11,2018,13,-2
Group 3,RRG,1.5,17,14,658,11,2018,7,4
Group 3,RRG,1.5,17,14,659,13,2018,10,3
Group 3,RRG,1.5,17,14,660,12,2018,9,3
Group 3,RRG,1.5,17,14,661,11,2018,11,0
Group 3,RRG,1.5,17,14,662,13,2018,11,2
Group 3,RRG,1.5,17,14,663,12,2018,12,0
Group 3,RRG,1.5,17,14,664,14,2018,8,6
Group 3,RRG,1.5,17,14,665,10,2018,12,-2
Group 3,RRG,1.5,17,14,666,14,2018,11,3
Group 3,RRG,1.5,17,14,667,13,2018,12,1
Group 3,RRG,1.5,17,14,668,12,2018,9,3
Group 3,RRG,1.5,17,14,669,12,2018,11,1
Group 3,RRG,1.5,17,14,670,13,2018,12,1
Group 3,RRG,1.5,17,14,671,8,2018,12,-4
Group 3,RRG,1.5,17,14,672,12,2018,5,7
Group 3,RRG,1.5,17,14,673,13,2018,13,0
Group 3,RRG,1.5,17,14,674,9,2018,8,1
Group 3,RRG,1.5,17,14,675,13,2018,10,3
Group 3,RRG,1.5,17,14,676,14,2018,10,4
Group 3,RRG,1.5,17,14,677,14,2018,12,2
Group 3,RRG,1.5,17,14,678,13,2018,14,-1
Group 3,RRG,1.5,17,14,679,9,2018,14,-5
Group 3,RRG,1.5,17,14,680,11,2018,6,5
Group 3,RRG,1.5,17,14,681,13,2018,11,2
Group 3,RRG,1.5,17,14,682,10,2018,10,0
Group 3,RRG,1.5,17,14,683,12,2018,8,4
Group 3,RRG,1.5,17,14,684,13,2018,11,2
Group 3,RRG,1.5,17,14,685,12,2018,13,-1
Group 3,RRG,1.5,17,14,686,10,2018,11,-1
Group 3,RRG,1.5,17,14,687,8,2018,12,-4
Group 3,RRG,1.5,17,14,688,12,2018,11,1
Group 3,RRG,1.5,17,14,689,13,2018,12,1
Group 3,RRG,1.5,17,14,690,12,2018,11,1
Group 3,RRG,1.5,17,14,691,12,2018,12,0
Group 3,RRG,1.5,17,14,692,14,2018,11,3
Group 3,RRG,1.5,17,14,693,7,2018,7,0
Group 3,RRG,1.5,17,14,694,12,2018,12,0
Group 3,RRG,1.5,17,14,695,14,2018,12,2
Group 3,RRG,1.5,17,14,696,9,2018,9,0
Group 3,RRG,1.5,17,14,697,13,2018,13,0
Group 3,RRG,1.5,17,14,698,13,2018,10,3
Group 3,RRG,1.5,17,14,699,12,2018,10,2
Group 3,RRG,1.5,17,14,700,12,2018,12,0
Group 3,RRG,1.5,17,14,701,11,2018,11,0
Group 3,RRG,1.5,17,14,702,9,2018,8,1
Group 3,RRG,1.5,17,14,703,12,2018,12,0
Group 3,RRG,1.5,17,14,704,11,2018,13,-2
Group 3,RRG,1.5,17,14,705,11,2018,12,-1
Group 3,RRG,1.5,17,14,706,11,2018,10,1
Group 3,RRG,1.5,17,14,707,6,2018,8,-2
Group 3,RRG,1.5,17,14,708,12,2018,14,-2
Group 3,RRG,1.5,17,14,709,10,2018,12,-2
Group 3,RRG,1.5,17,14,710,9,2018,10,-1
Group 3,RRG,1.5,17,14,711,14,2018,10,4
Group 3,RRG,1.5,17,14,712,3,2018,8,-5
Group 3,RRG,1.5,17,14,713,11,2018,8,3
Group 3,RRG,1.5,17,14,714,11,2018,10,1
Group 3,RRG,1.5,17,14,715,9,2018,10,-1
Group 3,RRG,1.5,17,14,716,4,2018,3,1
Group 3,RRG,1.5,17,14,717,14,2018,13,1
Group 3,RRG,1.5,17,14,718,5,2018,4,1
Group 3,RRG,1.5,17,14,719,13,2018,13,0
Group 3,RRG,1.5,17,14,720,13,2018,12,1
Group 3,RRG,1.5,17,14,721,13,2018,13,0
Group 3,RRG,1.5,17,14,722,14,2018,14,0
Group 3,RRG,1.5,17,14,723,14,2018,12,2
Group 3,RRG,1.5,17,14,724,13,2018,11,2
Group 3,RRG,1.5,17,14,725,11,2018,11,0
Group 3,RRG,1.5,17,14,726,8,2018,10,-2
Group 3,RRG,1.5,17,14,727,10,2018,14,-4
Group 3,RRG,1.5,17,14,728,12,2018,13,-1
Group 3,RRG,1.5,17,14,729,13,2018,8,5
Group 3,RRG,1.5,17,14,730,6,2018,13,-7
Group 3,RRG,1.5,17,14,731,13,2018,13,0
Group 3,RRG,1.5,17,14,732,13,2018,13,0
Group 3,RRG,1.5,17,14,733,9,2018,10,-1
Group 3,RRG,1.5,17,14,734,11,2018,12,-1
Group 3,RRG,1.5,17,14,735,13,2018,11,2
Group 3,RRG,1.5,17,14,736,13,2018,14,-1
Group 3,RRG,1.5,17,14,737,9,2018,10,-1
Group 3,RRG,1.5,17,14,738,9,2018,10,-1
Group 3,RRG,1.5,17,14,739,12,2018,11,1
Group 3,RRG,1.5,17,14,740,12,2018,12,0
Group 3,RRG,1.5,17,14,741,13,2018,10,3
Group 3,RRG,1.5,17,14,742,10,2018,14,-4
Group 3,RRG,1.5,17,14,743,11,2018,12,-1
Group 3,RRG,1.5,17,14,744,10,2018,13,-3
Group 3,RRG,1.5,17,14,745,12,2018,12,0
Group 3,RRG,1.5,17,14,746,11,2018,10,1
Group 3,RRG,1.5,17,14,747,9,2018,10,-1
Group 3,RRG,1.5,17,14,748,9,2018,12,-3
Group 3,RRG,1.5,17,14,749,9,2018,11,-2
Group 3,RRG,1.5,17,14,750,12,2018,11,1
Group 3,RRG,1.5,17,14,751,11,2018,13,-2
Group 3,RRG,1.5,17,14,752,12,2018,14,-2
Group 3,RRG,1.5,17,14,753,13,2018,9,4
Group 3,RRG,1.5,17,14,754,13,2018,11,2
Group 3,RRG,1.5,17,14,755,12,2018,9,3
Group 3,RRG,1.5,17,14,756,13,2018,11,2
Group 3,RRG,1.5,17,14,757,14,2018,13,1
Group 3,RRG,1.5,17,14,758,8,2018,9,-1
Group 3,RRG,1.5,17,14,759,14,2018,14,0
Group 3,RRG,1.5,17,14,760,11,2018,12,-1
Group 3,RRG,1.5,17,14,761,13,2018,12,1
Group 3,RRG,1.5,17,14,762,13,2018,9,4
Group 3,RRG,1.5,17,14,763,7,2018,9,-2
Group 3,RRG,1.5,17,14,764,9,2018,10,-1
Group 3,RRG,1.5,17,14,765,13,2018,11,2
Group 3,RRG,1.5,17,14,766,10,2018,11,-1
Group 3,RRG,1.5,17,14,767,11,2018,10,1
Group 3,RRG,1.5,17,14,768,12,2018,12,0
Group 3,RRG,1.5,17,14,769,13,2018,11,2
Group 3,RRG,1.5,17,14,770,6,2018,7,-1
Group 3,RRG,1.5,17,14,771,11,2018,9,2
Group 3,RRG,1.5,17,14,772,11,2018,13,-2
Group 3,RRG,1.5,17,14,773,14,2018,11,3
Group 3,RRG,1.5,17,14,774,13,2018,13,0
Group 3,RRG,1.5,17,14,775,10,2018,10,0
Group 3,RRG,1.5,17,14,776,14,2018,9,5
Group 3,RRG,1.5,17,14,777,13,2018,13,0
Group 3,RRG,1.5,17,14,778,14,2018,11,3
Group 3,RRG,1.5,17,14,779,13,2018,13,0
Group 3,RRG,1.5,17,14,780,14,2018,13,1
Group 3,RRG,1.5,17,14,781,9,2018,10,-1
Group 3,RRG,1.5,17,14,782,7,2018,10,-3
Group 3,RRG,1.5,17,14,783,7,2018,11,-4
Group 3,RRG,1.5,17,14,784,11,2018,11,0
Group 3,RRG,1.5,17,14,785,12,2018,9,3
Group 3,RRG,1.5,17,14,786,11,2018,6,5
Group 3,RRG,1.5,17,14,787,7,2018,9,-2
Group 3,RRG,1.5,17,14,788,8,2018,6,2
Group 3,RRG,1.5,17,14,789,12,2018,9,3
Group 3,RRG,1.5,17,14,790,14,2018,12,2
Group 3,RRG,1.5,17,14,791,7,2018,9,-2
Group 3,RRG,1.5,17,14,792,11,2018,14,-3
Group 3,RRG,1.5,17,14,793,13,2018,10,3
Group 3,RRG,1.5,17,14,794,13,2018,12,1
Group 3,RRG,1.5,17,14,795,12,2018,11,1
Group 3,RRG,1.5,17,14,796,10,2018,9,1
Group 3,RRG,1.5,17,14,797,13,2018,13,0
Group 3,RRG,1.5,17,14,798,9,2018,8,1
Group 3,RRG,1.5,17,14,799,14,2018,10,4
Group 3,RRG,1.5,17,14,800,12,2018,8,4
Group 3,RRG,1.5,17,14,801,11,2018,6,5
Group 3,RRG,1.5,17,14,802,10,2018,11,-1
Group 3,RRG,1.5,17,14,803,10,2018,9,1
Group 3,RRG,1.5,17,14,804,11,2018,7,4
Group 3,RRG,1.5,17,14,805,9,2018,9,0
Group 3,RRG,1.5,17,14,806,13,2018,13,0
Group 3,RRG,1.5,17,14,807,14,2018,13,1
Group 3,RRG,1.5,17,14,808,9,2018,10,-1
Group 3,RRG,1.5,17,14,809,9,2018,10,-1
Group 3,RRG,1.5,17,14,810,13,2018,9,4
Group 3,RRG,1.5,17,14,811,10,2018,12,-2
Group 3,RRG,1.5,17,14,812,14,2018,12,2
Group 3,RRG,1.5,17,14,813,12,2018,13,-1
Group 3,RRG,1.5,17,14,814,12,2018,13,-1
Group 3,RRG,1.5,17,14,815,13,2018,13,0
Group 3,RRG,1.5,17,14,816,12,2018,12,0
Group 3,RRG,1.5,17,14,817,9,2018,12,-3
Group 3,RRG,1.5,17,14,818,12,2018,10,2
Group 3,RRG,1.5,17,14,819,10,2018,8,2
Group 3,RRG,1.5,17,14,820,14,2018,11,3
Group 3,RRG,1.5,17,14,821,12,2018,10,2
Group 3,RRG,1.5,17,14,822,11,2018,12,-1
Group 3,RRG,1.5,17,14,823,13,2018,13,0
Group 3,RRG,1.5,17,14,824,12,2018,12,0
Group 3,RRG,1.5,17,14,825,10,2018,12,-2
Group 3,RRG,1.5,17,14,826,12,2018,11,1
Group 3,RRG,1.5,17,14,827,13,2018,8,5
Group 3,RRG,1.5,17,14,828,14,2018,13,1
Group 3,RRG,1.5,17,14,829,12,2018,8,4
Group 3,RRG,1.5,17,14,830,11,2018,13,-2
Group 3,RRG,1.5,17,14,831,14,2018,11,3
Group 3,RRG,1.5,17,14,832,7,2018,10,-3
Group 3,RRG,1.5,17,14,833,12,2018,13,-1
Group 3,RRG,1.5,17,14,834,14,2018,13,1
Group 3,RRG,1.5,17,14,835,9,2018,10,-1
Group 3,RRG,1.5,17,14,836,14,2018,13,1
Group 3,RRG,1.5,17,14,837,12,2018,14,-2
Group 3,RRG,1.5,17,14,838,7,2018,12,-5
Group 3,RRG,1.5,17,14,839,12,2018,11,1
Group 3,RRG,1.5,17,14,840,13,2018,14,-1
Group 3,RRG,1.5,17,14,841,12,2018,11,1
Group 3,RRG,1.5,17,14,842,11,2018,13,-2
Group 3,RRG,1.5,17,14,843,13,2018,11,2
Group 3,RRG,1.5,17,14,844,12,2018,5,7
Group 3,RRG,1.5,17,14,845,14,2018,10,4
Group 3,RRG,1.5,17,14,846,14,2018,13,1
Group 3,RRG,1.5,17,14,847,12,2018,12,0
Group 3,RRG,1.5,17,14,848,9,2018,9,0
Group 3,RRG,1.5,17,14,849,13,2018,10,3
Group 3,RRG,1.5,17,14,850,13,2018,12,1
Group 3,RRG,1.5,17,14,851,14,2018,12,2
Group 3,RRG,1.5,17,14,852,14,2018,13,1
Group 3,RRG,1.5,17,14,853,11,2018,10,1
Group 3,RRG,1.5,17,14,854,12,2018,9,3
Group 3,RRG,1.5,17,14,855,14,2018,14,0
Group 3,RRG,1.5,17,14,856,10,2018,12,-2
Group 3,RRG,1.5,17,14,857,12,2018,10,2
Group 3,RRG,1.5,17,14,858,11,2018,11,0
Group 3,RRG,1.5,17,14,859,11,2018,11,0
Group 3,RRG,1.5,17,14,860,13,2018,11,2
Group 3,RRG,1.5,17,14,861,11,2018,9,2
Group 3,RRG,1.5,17,14,862,12,2018,12,0
Group 3,RRG,1.5,17,14,863,11,2018,14,-3
Group 3,RRG,1.5,17,14,864,9,2018,13,-4
Group 3,RRG,1.5,17,14,865,13,2018,10,3
Group 3,RRG,1.5,17,14,866,13,2018,13,0
Group 3,RRG,1.5,17,14,867,11,2018,8,3
Group 3,RRG,1.5,17,14,868,13,2018,9,4
Group 3,RRG,1.5,17,14,869,10,2018,10,0
Group 3,RRG,1.5,17,14,870,11,2018,10,1
Group 3,RRG,1.5,17,14,871,12,2018,10,2
Group 3,RRG,1.5,17,14,872,13,2018,11,2
Group 3,RRG,1.5,17,14,873,14,2018,12,2
Group 3,RRG,1.5,17,14,874,12,2018,12,0
Group 3,RRG,1.5,17,14,875,12,2018,9,3
Group 3,RRG,1.5,17,14,876,11,2018,11,0
Group 3,RRG,1.5,17,14,877,12,2018,11,1
Group 3,RRG,1.5,17,14,878,10,2018,6,4
Group 3,RRG,1.5,17,14,879,13,2018,11,2
Group 3,RRG,1.5,17,14,880,11,2018,11,0
Group 3,RRG,1.5,17,14,881,12,2018,11,1
Group 3,RRG,1.5,17,14,882,13,2018,14,-1
Group 3,RRG,1.5,17,14,883,13,2018,14,-1
Group 3,RRG,1.5,17,14,884,11,2018,12,-1
Group 3,RRG,1.5,17,14,885,13,2018,13,0
Group 3,RRG,1.5,17,14,886,13,2018,12,1
Group 3,RRG,1.5,17,14,887,11,2018,12,-1
Group 3,RRG,1.5,17,14,888,8,2018,13,-5
Group 3,RRG,1.5,17,14,889,10,2018,10,0
Group 3,RRG,1.5,17,14,890,12,2018,11,1
Group 3,RRG,1.5,17,14,891,12,2018,12,0
Group 3,RRG,1.5,17,14,892,12,2018,11,1
Group 3,RRG,1.5,17,14,893,11,2018,10,1
Group 3,RRG,1.5,17,14,894,13,2018,13,0
Group 3,RRG,1.5,17,14,895,9,2018,9,0
Group 3,RRG,1.5,17,14,896,11,2018,12,-1
Group 3,RRG,1.5,17,14,897,14,2018,10,4
Group 3,RRG,1.5,17,14,898,11,2018,11,0
Group 3,RRG,1.5,17,14,899,8,2018,8,0
Group 3,RRG,1.5,17,14,900,10,2018,9,1
Group 3,RRG,1.5,17,14,901,10,2018,7,3
Group 3,RRG,1.5,17,14,902,12,2018,10,2
Group 3,RRG,1.5,17,14,903,12,2018,12,0
Group 3,RRG,1.5,17,14,904,12,2018,9,3
Group 3,RRG,1.5,17,14,905,13,2018,10,3
Group 3,RRG,1.5,17,14,906,9,2018,10,-1
Group 3,RRG,1.5,17,14,907,11,2018,11,0
Group 3,RRG,1.5,17,14,908,9,2018,10,-1
Group 3,RRG,1.5,17,14,909,11,2018,9,2
Group 3,RRG,1.5,17,14,910,7,2018,8,-1
Group 3,RRG,1.5,17,14,911,10,2018,11,-1
Group 3,RRG,1.5,17,14,912,13,2018,9,4
Group 3,RRG,1.5,17,14,913,7,2018,6,1
Group 3,RRG,1.5,17,14,914,8,2018,10,-2
Group 3,RRG,1.5,17,14,915,6,2018,8,-2
Group 3,RRG,1.5,17,14,916,9,2018,9,0
Group 3,RRG,1.5,17,14,917,14,2018,12,2
Group 3,RRG,1.5,17,14,918,14,2018,11,3
Group 3,RRG,1.5,17,14,919,13,2018,11,2
Group 3,RRG,1.5,17,14,920,13,2018,14,-1
Group 3,RRG,1.5,17,14,921,10,2018,12,-2
Group 3,RRG,1.5,17,14,922,12,2018,11,1
Group 3,RRG,1.5,17,14,923,11,2018,10,1
Group 3,RRG,1.5,17,14,924,12,2018,12,0
Group 3,RRG,1.5,17,14,925,11,2018,11,0
Group 3,RRG,1.5,17,14,926,11,2018,12,-1
Group 3,RRG,1.5,17,14,927,10,2018,12,-2
Group 3,RRG,1.5,17,14,928,13,2018,12,1
Group 3,RRG,1.5,17,14,929,13,2018,11,2
Group 3,RRG,1.5,17,14,930,12,2018,13,-1
Group 3,RRG,1.5,17,14,931,12,2018,13,-1
Group 3,RRG,1.5,17,14,932,13,2018,13,0
Group 3,RRG,1.5,17,14,933,10,2018,9,1
Group 3,RRG,1.5,17,14,934,12,2018,10,2
Group 3,RRG,1.5,17,14,935,11,2018,11,0
Group 3,RRG,1.5,17,14,936,13,2018,12,1
Group 3,RRG,1.5,17,14,937,9,2018,12,-3
Group 3,RRG,1.5,17,14,938,13,2018,13,0
Group 3,RRG,1.5,17,14,939,12,2018,12,0
Group 3,RRG,1.5,17,14,940,10,2018,10,0
Group 3,RRG,1.5,17,14,941,11,2018,12,-1
Group 3,RRG,1.5,17,14,942,14,2018,12,2
Group 3,RRG,1.5,17,14,943,11,2018,9,2
Group 3,RRG,1.5,17,14,944,8,2018,11,-3
Group 3,RRG,1.5,17,14,945,10,2018,10,0
Group 3,RRG,1.5,17,14,946,12,2018,13,-1
Group 3,RRG,1.5,17,14,947,12,2018,12,0
Group 3,RRG,1.5,17,14,948,11,2018,13,-2
Group 3,RRG,1.5,17,14,949,13,2018,11,2
Group 3,RRG,1.5,17,14,950,13,2018,14,-1
Group 3,RRG,1.5,17,14,951,12,2018,11,1
Group 3,RRG,1.5,17,14,952,11,2018,12,-1
Group 3,RRG,1.5,17,14,953,12,2018,9,3
Group 3,RRG,1.5,17,14,954,12,2018,8,4
Group 3,RRG,1.5,17,14,955,14,2018,13,1
Group 3,RRG,1.5,17,14,956,10,2018,8,2
Group 3,RRG,1.5,17,14,957,11,2018,12,-1
Group 3,RRG,1.5,17,14,958,9,2018,14,-5
Group 3,RRG,1.5,17,14,959,12,2018,10,2
Group 3,RRG,1.5,17,14,960,9,2018,8,1
Group 3,RRG,1.5,17,14,961,9,2018,11,-2
Group 3,RRG,1.5,17,14,962,14,2018,11,3
Group 3,RRG,1.5,17,14,963,13,2018,11,2
Group 3,RRG,1.5,17,14,964,13,2018,9,4
Group 3,RRG,1.5,17,14,965,11,2018,11,0
Group 3,RRG,1.5,17,14,966,11,2018,7,4
Group 3,RRG,1.5,17,14,967,11,2018,12,-1
Group 3,RRG,1.5,17,14,968,11,2018,9,2
Group 3,RRG,1.5,17,14,969,11,2018,12,-1
Group 3,RRG,1.5,17,14,970,13,2018,12,1
Group 3,RRG,1.5,17,14,971,13,2018,11,2
Group 3,RRG,1.5,17,14,972,13,2018,8,5
Group 3,RRG,1.5,17,14,973,11,2018,13,-2
Group 3,RRG,1.5,17,14,974,11,2018,11,0
Group 3,RRG,1.5,17,14,975,9,2018,12,-3
Group 3,RRG,1.5,17,14,976,12,2018,10,2
Group 3,RRG,1.5,17,14,977,12,2018,9,3
Group 3,RRG,1.5,17,14,978,11,2018,13,-2
Group 3,RRG,1.5,17,14,979,14,2018,8,6
Group 3,RRG,1.5,17,14,980,11,2018,10,1
Group 3,RRG,1.5,17,14,981,14,2018,14,0
Group 3,RRG,1.5,17,14,982,12,2018,10,2
Group 3,RRG,1.5,17,14,983,13,2018,13,0
Group 3,RRG,1.5,17,14,984,13,2018,9,4
Group 3,RRG,1.5,17,14,985,10,2018,12,-2
Group 3,RRG,1.5,17,14,986,8,2018,12,-4
Group 3,RRG,1.5,17,14,987,12,2018,13,-1
Group 3,RRG,1.5,17,14,988,10,2018,12,-2
Group 3,RRG,1.5,17,14,989,10,2018,10,0
Group 3,RRG,1.5,17,14,990,12,2018,9,3
Group 3,RRG,1.5,17,14,991,12,2018,13,-1
Group 3,RRG,1.5,17,14,992,12,2018,13,-1
Group 3,RRG,1.5,17,14,993,13,2018,10,3
Group 3,RRG,1.5,17,14,994,13,2018,9,4
Group 3,RRG,1.5,17,14,995,9,2018,10,-1
Group 3,RRG,1.5,17,14,996,11,2018,12,-1
Group 3,RRG,1.5,17,14,997,11,2018,11,0
Group 3,RRG,1.5,17,14,998,11,2018,11,0
Group 3,RRG,1.5,17,14,999,12,2018,12,0
Group 3,RRG,1.5,17,14,1000,14,2018,11,3
Group 3,RRG,1.5,17,14,1001,14,2018,14,0
Group 3,RRG,1.5,17,14,1002,14,2018,13,1
Group 3,RRG,1.5,17,14,1003,14,2018,14,0
Group 3,RRG,1.5,17,14,1004,14,2018,14,0
Group 3,RRG,1.5,17,14,1005,9,2018,13,-4
Group 3,RRG,1.5,17,14,1006,14,2018,10,4
Group 3,RRG,1.5,17,14,1007,14,2018,11,3
Group 3,RRG,1.5,17,14,1008,13,2018,12,1
Group 3,RRG,1.5,17,14,1009,12,2018,12,0
Group 3,RRG,1.5,17,14,1010,12,2018,10,2
Group 3,RRG,1.5,17,14,1011,9,2018,10,-1
Group 3,RRG,1.5,17,14,1012,12,2018,13,-1
Group 3,RRG,1.5,17,14,1013,13,2018,11,2
Group 3,RRG,1.5,17,14,1014,14,2018,13,1
Group 3,RRG,1.5,17,14,1015,13,2018,10,3
Group 3,RRG,1.5,17,14,1016,13,2018,8,5
Group 3,RRG,1.5,17,14,1017,13,2018,10,3
Group 3,RRG,1.5,17,14,1018,10,2018,7,3
Group 3,RRG,1.5,17,14,1019,13,2018,9,4
Group 3,RRG,1.5,17,14,1020,12,2018,10,2
Group 3,RRG,1.5,17,14,1021,13,2018,13,0
Group 3,RRG,1.5,17,14,1022,8,2018,11,-3
Group 3,RRG,1.5,17,14,1023,12,2018,11,1
Group 3,RRG,1.5,17,14,1024,14,2018,9,5
Group 3,RRG,1.5,17,14,1025,14,2018,12,2
Group 3,RRG,1.5,17,14,1026,14,2018,14,0
Group 3,RRG,1.5,17,14,1027,13,2018,12,1
Group 3,RRG,1.5,17,14,1028,8,2018,13,-5
Group 3,RRG,1.5,17,14,1029,6,2018,7,-1
Group 3,RRG,1.5,17,14,1030,10,2018,11,-1
Group 3,RRG,1.5,17,14,1031,12,2018,11,1
Group 3,RRG,1.5,17,14,1032,11,2018,10,1
Group 3,RRG,1.5,17,14,1033,12,2018,12,0
Group 3,RRG,1.5,17,14,1034,10,2018,11,-1
Group 3,RRG,1.5,17,14,1035,7,2018,10,-3
Group 3,RRG,1.5,17,14,1036,12,2018,13,-1
Group 3,RRG,1.5,17,14,1037,14,2018,12,2
Group 3,RRG,1.5,17,14,1038,9,2018,12,-3
Group 3,RRG,1.5,17,14,1039,14,2018,13,1
Group 3,RRG,1.5,17,14,1040,13,2018,10,3
Group 3,RRG,1.5,17,14,1041,10,2018,11,-1
Group 3,RRG,1.5,17,14,1042,13,2018,9,4
Group 3,RRG,1.5,17,14,1043,13,2018,14,-1
Group 3,RRG,1.5,17,14,1044,11,2018,12,-1
Group 3,RRG,1.5,17,14,1045,11,2018,10,1
Group 3,RRG,1.5,17,14,1046,13,2018,9,4
Group 3,RRG,1.5,17,14,1047,10,2018,10,0
Group 3,RRG,1.5,17,14,1048,12,2018,9,3
Group 3,RRG,1.5,17,14,1049,13,2018,12,1
Group 3,RRG,1.5,17,14,1050,11,2018,10,1
Group 3,RRG,1.5,17,14,1051,11,2018,8,3
Group 3,RRG,1.5,17,14,1052,12,2018,10,2
Group 3,RRG,1.5,17,14,1053,8,2018,9,-1
Group 3,RRG,1.5,17,14,1054,13,2018,7,6
Group 3,RRG,1.5,17,14,1055,11,2018,12,-1
Group 3,RRG,1.5,17,14,1056,13,2018,10,3
Group 3,RRG,1.5,17,14,1057,8,2018,9,-1
Group 3,RRG,1.5,17,14,1058,13,2018,11,2
Group 3,RRG,1.5,17,14,1059,14,2018,14,0
Group 3,RRG,1.5,17,14,1060,14,2018,14,0
Group 3,RRG,1.5,17,14,1061,7,2018,10,-3
Group 3,RRG,1.5,17,14,1062,14,2018,11,3
Group 3,RRG,1.5,17,14,1063,12,2018,13,-1
Group 3,RRG,1.5,17,14,1064,13,2018,13,0
Group 3,RRG,1.5,17,14,1065,11,2018,10,1
Group 3,RRG,1.5,17,14,1066,12,2018,9,3
Group 3,RRG,1.5,17,14,1067,12,2018,13,-1
Group 3,RRG,1.5,17,14,1068,10,2018,11,-1
Group 3,RRG,1.5,17,14,1069,7,2018,6,1
Group 3,RRG,1.5,17,14,1070,14,2018,9,5
Group 3,RRG,1.5,17,14,1071,10,2018,11,-1
Group 3,RRG,1.5,17,14,1072,10,2018,9,1
Group 3,RRG,1.5,17,14,1073,14,2018,13,1
Group 3,RRG,1.5,17,14,1074,13,2018,7,6
Group 3,RRG,1.5,17,14,1075,12,2018,12,0
Group 3,RRG,1.5,17,14,1076,13,2018,11,2
Group 3,RRG,1.5,17,14,1077,13,2018,13,0
Group 3,RRG,1.5,17,14,1078,14,2018,13,1
Group 3,RRG,1.5,17,14,1079,11,2018,11,0
Group 3,RRG,1.5,17,14,1080,12,2018,12,0
Group 3,RRG,1.5,17,14,1081,10,2018,12,-2
Group 3,RRG,1.5,17,14,1082,11,2018,8,3
Group 3,RRG,1.5,17,14,1083,13,2018,11,2
Group 3,RRG,1.5,17,14,1084,8,2018,11,-3
Group 3,RRG,1.5,17,14,1085,10,2018,9,1
Group 3,RRG,1.5,17,14,1086,9,2018,9,0
Group 3,RRG,1.5,17,14,1087,12,2018,10,2
Group 3,RRG,1.5,17,14,1088,12,2018,8,4
Group 3,RRG,1.5,17,14,1089,13,2018,13,0
Group 3,RRG,1.5,17,14,1090,10,2018,12,-2
Group 3,RRG,1.5,17,14,1091,12,2018,11,1
Group 3,RRG,1.5,17,14,1092,12,2018,9,3
Group 3,RRG,1.5,17,14,1093,14,2018,13,1
Group 3,RRG,1.5,17,14,1094,12,2018,10,2
Group 3,RRG,1.5,17,14,1095,11,2018,10,1
Group 3,RRG,1.5,17,14,1096,5,2018,8,-3
Group 3,RRG,1.5,17,14,1097,9,2018,12,-3
Group 3,RRG,1.5,17,14,1098,13,2018,9,4
Group 3,RRG,1.5,17,14,1099,8,2018,7,1
Group 3,RRG,1.5,17,14,1100,4,2018,6,-2
Group 3,RRG,1.5,17,14,1101,9,2018,9,0
Group 3,RRG,1.5,17,14,1102,14,2018,10,4
Group 3,RRG,1.5,17,14,1103,11,2018,9,2
Group 3,RRG,1.5,17,14,1104,12,2018,13,-1
Group 3,RRG,1.5,17,14,1105,10,2018,12,-2
Group 3,RRG,1.5,17,14,1106,10,2018,11,-1
Group 3,RRG,1.5,17,14,1107,11,2018,10,1
Group 3,RRG,1.5,17,14,1108,12,2018,10,2
Group 3,RRG,1.5,17,14,1109,10,2018,14,-4
Group 3,RRG,1.5,17,14,1110,11,2018,8,3
Group 3,RRG,1.5,17,14,1111,4,2018,11,-7
Group 3,RRG,1.5,17,14,1112,5,2018,11,-6
Group 3,RRG,1.5,17,14,1113,13,2018,11,2
Group 3,RRG,1.5,17,14,1114,12,2018,10,2
Group 3,RRG,1.5,17,14,1115,13,2018,11,2
Group 3,RRG,1.5,17,14,1116,10,2018,13,-3
Group 3,RRG,1.5,17,14,1117,9,2018,11,-2
Group 3,RRG,1.5,17,14,1118,13,2018,12,1
Group 3,RRG,1.5,17,14,1119,13,2018,14,-1
Group 3,RRG,1.5,17,14,1120,14,2018,14,0
Group 3,RRG,1.5,17,14,1121,10,2018,10,0
Group 3,RRG,1.5,17,14,1122,10,2018,8,2
Group 3,RRG,1.5,17,14,1123,13,2018,10,3
Group 3,RRG,1.5,17,14,1124,11,2018,9,2
Group 3,RRG,1.5,17,14,1125,8,2018,10,-2
Group 3,RRG,1.5,17,14,1126,13,2018,10,3
Group 3,RRG,1.5,17,14,1127,13,2018,10,3
Group 3,RRG,1.5,17,14,1128,11,2018,10,1
Group 3,RRG,1.5,17,14,1129,12,2018,12,0
Group 3,RRG,1.5,17,14,1130,13,2018,11,2
Group 3,RRG,1.5,17,14,1131,13,2018,13,0
Group 3,RRG,1.5,17,14,1132,12,2018,13,-1
Group 3,RRG,1.5,17,14,1133,8,2018,14,-6
Group 3,RRG,1.5,17,14,1134,11,2018,11,0
Group 3,RRG,1.5,17,14,1135,13,2018,13,0
Group 3,RRG,1.5,17,14,1136,11,2018,10,1
Group 3,RRG,1.5,17,14,1137,8,2018,10,-2
Group 3,RRG,1.5,17,14,1138,12,2018,8,4
Group 3,RRG,1.5,17,14,1139,12,2018,11,1
Group 3,RRG,1.5,17,14,1140,14,2018,11,3
Group 3,RRG,1.5,17,14,1141,10,2018,11,-1
Group 3,RRG,1.5,17,14,1142,13,2018,13,0
Group 3,RRG,1.5,17,14,1143,13,2018,10,3
Group 3,RRG,1.5,17,14,1144,13,2018,11,2
Group 3,RRG,1.5,17,14,1145,11,2018,14,-3
Group 3,RRG,1.5,17,14,1146,7,2018,12,-5
Group 3,RRG,1.5,17,14,1147,14,2018,11,3
Group 3,RRG,1.5,17,14,1148,7,2018,11,-4
Group 3,RRG,1.5,17,14,1149,12,2018,12,0
Group 3,RRG,1.5,17,14,1150,9,2018,12,-3
Group 3,RRG,1.5,17,14,1151,9,2018,10,-1
Group 3,RRG,1.5,17,14,1152,12,2018,11,1
Group 3,RRG,1.5,17,14,1153,13,2018,13,0
Group 3,RRG,1.5,17,14,1154,12,2018,12,0
Group 3,RRG,1.5,17,14,1155,13,2018,11,2
Group 3,RRG,1.5,17,14,1156,14,2018,11,3
Group 3,RRG,1.5,17,14,1157,8,2018,10,-2
Group 3,RRG,1.5,17,14,1158,9,2018,11,-2
Group 3,RRG,1.5,17,14,1159,14,2018,13,1
Group 3,RRG,1.5,17,14,1160,13,2018,10,3
Group 3,RRG,1.5,17,14,1161,11,2018,13,-2
Group 3,RRG,1.5,17,14,1162,13,2018,13,0
Group 3,RRG,1.5,17,14,1163,10,2018,10,0
Group 3,RRG,1.5,17,14,1164,9,2018,9,0
Group 3,RRG,1.5,17,14,1165,14,2018,13,1
Group 3,RRG,1.5,17,14,1166,12,2018,11,1
Group 3,RRG,1.5,17,14,1167,12,2018,10,2
Group 3,RRG,1.5,17,14,1168,11,2018,12,-1
Group 3,RRG,1.5,17,14,1169,12,2018,11,1
Group 3,RRG,1.5,17,14,1170,10,2018,12,-2
Group 3,RRG,1.5,17,14,1171,12,2018,10,2
Group 3,RRG,1.5,17,14,1172,12,2018,14,-2
Group 3,RRG,1.5,17,14,1173,13,2018,13,0
Group 3,RRG,1.5,17,14,1174,12,2018,11,1
Group 3,RRG,1.5,17,14,1175,13,2018,11,2
Group 3,RRG,1.5,17,14,1176,12,2018,10,2
Group 3,RRG,1.5,17,14,1177,10,2018,14,-4
Group 3,RRG,1.5,17,14,1178,13,2018,11,2
Group 3,RRG,1.5,17,14,1179,13,2018,14,-1
Group 3,RRG,1.5,17,14,1180,10,2018,10,0
Group 3,RRG,1.5,17,14,1181,13,2018,12,1
Group 3,RRG,1.5,17,14,1182,11,2018,12,-1
Group 3,RRG,1.5,17,14,1183,11,2018,10,1
Group 3,RRG,1.5,17,14,1184,11,2018,11,0
Group 3,RRG,1.5,17,14,1185,8,2018,9,-1
Group 3,RRG,1.5,17,14,1186,10,2018,14,-4
Group 3,RRG,1.5,17,14,1187,12,2018,10,2
Group 3,RRG,1.5,17,14,1188,14,2018,13,1
Group 3,RRG,1.5,17,14,1189,10,2018,11,-1
Group 3,RRG,1.5,17,14,1190,11,2018,13,-2
Group 3,RRG,1.5,17,14,1191,13,2018,12,1
Group 3,RRG,1.5,17,14,1192,8,2018,10,-2
Group 3,RRG,1.5,17,14,1193,10,2018,14,-4
Group 3,RRG,1.5,17,14,1194,8,2018,11,-3
Group 3,RRG,1.5,17,14,1195,9,2018,11,-2
Group 3,RRG,1.5,17,14,1196,11,2018,13,-2
Group 3,RRG,1.5,17,14,1197,8,2018,12,-4
Group 3,RRG,1.5,17,14,1198,11,2018,7,4
Group 3,RRG,1.5,17,14,1199,12,2018,7,5
Group 3,RRG,1.5,17,14,1200,12,2018,12,0
Group 3,RRG,1.5,17,14,1201,13,2018,11,2
Group 3,RRG,1.5,17,14,1202,6,2018,8,-2
Group 3,RRG,1.5,17,14,1203,6,2018,7,-1
Group 3,RRG,1.5,17,14,1204,14,2018,12,2
Group 3,RRG,1.5,17,14,1205,13,2018,12,1
Group 3,RRG,1.5,17,14,1206,11,2018,13,-2
Group 3,RRG,1.5,17,14,1207,10,2018,10,0
Group 3,RRG,1.5,17,14,1208,14,2018,8,6
Group 3,RRG,1.5,17,14,1209,13,2018,12,1
Group 3,RRG,1.5,17,14,1210,12,2018,10,2
Group 3,RRG,1.5,17,14,1211,14,2018,12,2
Group 3,RRG,1.5,17,14,1212,11,2018,7,4
Group 3,RRG,1.5,17,14,1213,14,2018,11,3
Group 3,RRG,1.5,17,14,1214,14,2018,14,0
Group 3,RRG,1.5,17,14,1215,12,2018,6,6
Group 3,RRG,1.5,17,14,1216,9,2018,12,-3
Group 3,RRG,1.5,17,14,1217,13,2018,13,0
Group 3,RRG,1.5,17,14,1218,5,2018,10,-5
Group 3,RRG,1.5,17,14,1219,14,2018,13,1
Group 3,RRG,1.5,17,14,1220,7,2018,12,-5
Group 3,RRG,1.5,17,14,1221,12,2018,13,-1
Group 3,RRG,1.5,17,14,1222,13,2018,11,2
Group 3,RRG,1.5,17,14,1223,14,2018,12,2
Group 3,RRG,1.5,17,14,1224,12,2018,13,-1
Group 3,RRG,1.5,17,14,1225,11,2018,11,0
Group 3,RRG,1.5,17,14,1226,10,2018,12,-2
Group 3,RRG,1.5,17,14,1227,14,2018,12,2
Group 3,RRG,1.5,17,14,1228,10,2018,12,-2
Group 3,RRG,1.5,17,14,1229,13,2018,11,2
Group 3,RRG,1.5,17,14,1230,13,2018,13,0
Group 3,RRG,1.5,17,14,1231,12,2018,11,1
Group 3,RRG,1.5,17,14,1232,12,2018,14,-2
Group 3,RRG,1.5,17,14,1233,11,2018,12,-1
Group 3,RRG,1.5,17,14,1234,9,2018,12,-3
Group 3,RRG,1.5,17,14,1235,9,2018,10,-1
Group 3,RRG,1.5,17,14,1236,14,2018,12,2
Group 3,RRG,1.5,17,14,1237,12,2018,10,2
Group 3,RRG,1.5,17,14,1238,9,2018,8,1
Group 3,RRG,1.5,17,14,1239,12,2018,11,1
Group 3,RRG,1.5,17,14,1240,11,2018,12,-1
Group 3,RRG,1.5,17,14,1241,7,2018,10,-3
Group 3,RRG,1.5,17,14,1242,12,2018,12,0
Group 3,RRG,1.5,17,14,1243,11,2018,12,-1
Group 3,RRG,1.5,17,14,1244,11,2018,11,0
Group 3,RRG,1.5,17,14,1245,12,2018,9,3
Group 3,RRG,1.5,17,14,1246,13,2018,13,0
Group 3,RRG,1.5,17,14,1247,10,2018,14,-4
Group 3,RRG,1.5,17,14,1248,14,2018,13,1
Group 3,RRG,1.5,17,14,1249,13,2018,13,0
Group 3,RRG,1.5,17,14,1250,13,2018,12,1
Group 3,RRG,1.5,17,14,1251,14,2018,12,2
Group 3,RRG,1.5,17,14,1252,10,2018,11,-1
Group 3,RRG,1.5,17,14,1253,8,2018,8,0
Group 3,RRG,1.5,17,14,1254,12,2018,10,2
Group 3,RRG,1.5,17,14,1255,13,2018,11,2
Group 3,RRG,1.5,17,14,1256,12,2018,11,1
Group 3,RRG,1.5,17,14,1257,12,2018,12,0
Group 3,RRG,1.5,17,14,1258,14,2018,9,5
Group 3,RRG,1.5,17,14,1259,11,2018,8,3
Group 3,RRG,1.5,17,14,1260,12,2018,10,2
Group 3,RRG,1.5,17,14,1261,13,2018,13,0
Group 3,RRG,1.5,17,14,1262,11,2018,8,3
Group 3,RRG,1.5,17,14,1263,12,2018,10,2
Group 3,RRG,1.5,17,14,1264,11,2018,11,0
Group 3,RRG,1.5,17,14,1265,11,2018,11,0
Group 3,RRG,1.5,17,14,1266,9,2018,11,-2
Group 3,RRG,1.5,17,14,1267,11,2018,9,2
Group 3,RRG,1.5,17,14,1268,13,2018,14,-1
Group 3,RRG,1.5,17,14,1269,11,2018,13,-2
Group 3,RRG,1.5,17,14,1270,9,2018,12,-3
Group 3,RRG,1.5,17,14,1271,5,2018,10,-5
Group 3,RRG,1.5,17,14,1272,12,2018,11,1
Group 3,RRG,1.5,17,14,1273,11,2018,11,0
Group 3,RRG,1.5,17,14,1274,11,2018,12,-1
Group 3,RRG,1.5,17,14,1275,10,2018,9,1
Group 3,RRG,1.5,17,14,1276,11,2018,13,-2
Group 3,RRG,1.5,17,14,1277,11,2018,10,1
Group 3,RRG,1.5,17,14,1278,13,2018,12,1
Group 3,RRG,1.5,17,14,1279,10,2018,12,-2
Group 3,RRG,1.5,17,14,1280,13,2018,14,-1
Group 3,RRG,1.5,17,14,1281,10,2018,11,-1
Group 3,RRG,1.5,17,14,1282,8,2018,9,-1
Group 3,RRG,1.5,17,14,1283,13,2018,13,0
Group 3,RRG,1.5,17,14,1284,14,2018,12,2
Group 3,RRG,1.5,17,14,1285,12,2018,12,0
Group 3,RRG,1.5,17,14,1286,11,2018,14,-3
Group 3,RRG,1.5,17,14,1287,10,2018,10,0
Group 3,RRG,1.5,17,14,1288,12,2018,10,2
Group 3,RRG,1.5,17,14,1289,13,2018,13,0
Group 3,RRG,1.5,17,14,1290,13,2018,11,2
Group 3,RRG,1.5,17,14,1291,13,2018,13,0
Group 3,RRG,1.5,17,14,1292,14,2018,13,1
Group 3,RRG,1.5,17,14,1293,13,2018,13,0
Group 3,RRG,1.5,17,14,1294,13,2018,10,3
Group 3,RRG,1.5,17,14,1295,14,2018,13,1
Group 3,RRG,1.5,17,14,1296,4,2018,7,-3
Group 3,RRG,1.5,17,14,1297,6,2018,8,-2
Group 3,RRG,1.5,17,14,1298,5,2018,11,-6
Group 3,RRG,1.5,17,14,1299,10,2018,11,-1
Group 3,RRG,1.5,17,14,1300,11,2018,12,-1
Group 3,RRG,1.5,17,14,1301,12,2018,8,4
Group 3,RRG,1.5,17,14,1302,6,2018,5,1
Group 3,RRG,1.5,17,14,1303,5,2018,9,-4
Group 3,RRG,1.5,17,14,1304,7,2018,13,-6
Group 3,RRG,1.5,17,14,1305,13,2018,14,-1
Group 3,RRG,1.5,17,14,1306,13,2018,12,1
Group 3,RRG,1.5,17,14,1307,12,2018,12,0
Group 3,RRG,1.5,17,14,1308,14,2018,11,3
Group 3,RRG,1.5,17,14,1309,9,2018,11,-2
Group 3,RRG,1.5,17,14,1310,12,2018,12,0
Group 3,RRG,1.5,17,14,1311,10,2018,11,-1
Group 3,RRG,1.5,17,14,1312,11,2018,12,-1
Group 3,RRG,1.5,17,14,1313,12,2018,12,0
Group 3,RRG,1.5,17,14,1314,9,2018,7,2
Group 3,RRG,1.5,17,14,1315,12,2018,12,0
Group 3,RRG,1.5,17,14,1316,10,2018,13,-3
Group 3,RRG,1.5,17,14,1317,13,2018,12,1
Group 3,RRG,1.5,17,14,1318,14,2018,11,3
Group 3,RRG,1.5,17,14,1319,5,2018,10,-5
Group 3,RRG,1.5,17,14,1320,3,2018,14,-11
Group 3,RRG,1.5,17,14,1321,14,2018,13,1
Group 3,RRG,1.5,17,14,1322,10,2018,11,-1
Group 3,RRG,1.5,17,14,1323,14,2018,11,3
Group 3,RRG,1.5,17,14,1324,14,2018,11,3
Group 3,RRG,1.5,17,14,1325,13,2018,8,5
Group 3,RRG,1.5,17,14,1326,12,2018,12,0
Group 3,RRG,1.5,17,14,1327,9,2018,14,-5
Group 3,RRG,1.5,17,14,1328,12,2018,11,1
Group 3,RRG,1.5,17,14,1329,11,2018,12,-1
Group 3,RRG,1.5,17,14,1330,12,2018,13,-1
Group 3,RRG,1.5,17,14,1331,10,2018,12,-2
Group 3,RRG,1.5,17,14,1332,14,2018,10,4
Group 3,RRG,1.5,17,14,1333,13,2018,12,1
Group 3,RRG,1.5,17,14,1334,14,2018,9,5
Group 3,RRG,1.5,17,14,1335,14,2018,14,0
Group 3,RRG,1.5,17,14,1336,11,2018,11,0
Group 3,RRG,1.5,17,14,1337,11,2018,12,-1
Group 3,RRG,1.5,17,14,1338,12,2018,11,1
Group 3,RRG,1.5,17,14,1339,8,2018,12,-4
Group 3,RRG,1.5,17,14,1340,12,2018,12,0
Group 3,RRG,1.5,17,14,1341,11,2018,11,0
Group 3,RRG,1.5,17,14,1342,9,2018,11,-2
Group 3,RRG,1.5,17,14,1343,14,2018,9,5
Group 3,RRG,1.5,17,14,1344,11,2018,11,0
Group 3,RRG,1.5,17,14,1345,12,2018,13,-1
Group 3,RRG,1.5,17,14,1346,12,2018,11,1
Group 3,RRG,1.5,17,14,1347,8,2018,12,-4
Group 3,RRG,1.5,17,14,1348,13,2018,13,0
Group 3,RRG,1.5,17,14,1349,13,2018,11,2
Group 3,RRG,1.5,17,14,1350,11,2018,12,-1
Group 3,RRG,1.5,17,14,1351,13,2018,12,1
Group 3,RRG,1.5,17,14,1352,11,2018,10,1
Group 3,RRG,1.5,17,14,1353,7,2018,9,-2
Group 3,RRG,1.5,17,14,1354,11,2018,11,0
Group 3,RRG,1.5,17,14,1355,12,2018,12,0
Group 3,RRG,1.5,17,14,1356,10,2018,12,-2
Group 3,RRG,1.5,17,14,1357,12,2018,13,-1
Group 3,RRG,1.5,17,14,1358,11,2018,13,-2
Group 3,RRG,1.5,17,14,1359,10,2018,12,-2
Group 3,RRG,1.5,17,14,1360,8,2018,9,-1
Group 3,RRG,1.5,17,14,1361,11,2018,13,-2
Group 3,RRG,1.5,17,14,1362,12,2018,12,0
Group 3,RRG,1.5,17,14,1363,11,2018,13,-2
Group 3,RRG,1.5,17,14,1364,13,2018,11,2
Group 3,RRG,1.5,17,14,1365,11,2018,12,-1
Group 3,RRG,1.5,17,14,1366,13,2018,12,1
Group 3,RRG,1.5,17,14,1367,11,2018,12,-1
Group 3,RRG,1.5,17,14,1368,9,2018,10,-1
Group 3,RRG,1.5,17,14,1369,10,2018,8,2
Group 3,RRG,1.5,17,14,1370,10,2018,11,-1
Group 3,RRG,1.5,17,14,1371,10,2018,14,-4
Group 3,RRG,1.5,17,14,1372,12,2018,14,-2
Group 3,RRG,1.5,17,14,1373,11,2018,11,0
Group 3,RRG,1.5,17,14,1374,12,2018,10,2
Group 3,RRG,1.5,17,14,1375,14,2018,7,7
Group 3,RRG,1.5,17,14,1376,10,2018,12,-2
Group 3,RRG,1.5,17,14,1377,11,2018,11,0
Group 3,RRG,1.5,17,14,1378,11,2018,10,1
Group 3,RRG,1.5,17,14,1379,12,2018,14,-2
Group 3,RRG,1.5,17,14,1380,13,2018,13,0
Group 3,RRG,1.5,17,14,1381,13,2018,14,-1
Group 3,RRG,1.5,17,14,1382,10,2018,9,1
Group 3,RRG,1.5,17,14,1383,10,2018,8,2
Group 3,RRG,1.5,17,14,1384,9,2018,11,-2
Group 3,RRG,1.5,17,14,1385,13,2018,11,2
Group 3,RRG,1.5,17,14,1386,13,2018,11,2
Group 3,RRG,1.5,17,14,1387,10,2018,11,-1
Group 3,RRG,1.5,17,14,1388,13,2018,9,4
Group 3,RRG,1.5,17,14,1389,13,2018,14,-1
Group 3,RRG,1.5,17,14,1390,12,2018,9,3
Group 3,RRG,1.5,17,14,1391,13,2018,13,0
Group 3,RRG,1.5,17,14,1392,14,2018,12,2
Group 3,RRG,1.5,17,14,1393,10,2018,11,-1
Group 3,RRG,1.5,17,14,1394,12,2018,12,0
Group 3,RRG,1.5,17,14,1395,13,2018,11,2
Group 3,RRG,1.5,17,14,1396,9,2018,11,-2
Group 3,RRG,1.5,17,14,1397,12,2018,10,2
Group 3,RRG,1.5,17,14,1398,11,2018,5,6
Group 3,RRG,1.5,17,14,1399,12,2018,10,2
Group 3,RRG,1.5,17,14,1400,11,2018,11,0
Group 3,RRG,1.5,17,14,1401,14,2018,8,6
Group 3,RRG,1.5,17,14,1402,10,2018,10,0
Group 3,RRG,1.5,17,14,1403,10,2018,11,-1
Group 3,RRG,1.5,17,14,1404,13,2018,13,0
Group 3,RRG,1.5,17,14,1405,14,2018,14,0
Group 3,RRG,1.5,17,14,1406,12,2018,13,-1
Group 3,RRG,1.5,17,14,1407,13,2018,11,2
Group 3,RRG,1.5,17,14,1408,13,2018,11,2
Group 3,RRG,1.5,17,14,1409,12,2018,13,-1
Group 3,RRG,1.5,17,14,1410,14,2018,11,3
Group 3,RRG,1.5,17,14,1411,13,2018,10,3
Group 3,RRG,1.5,17,14,1412,13,2018,14,-1
Group 3,RRG,1.5,17,14,1413,10,2018,11,-1
Group 3,RRG,1.5,17,14,1414,13,2018,12,1
Group 3,RRG,1.5,17,14,1415,8,2018,9,-1
Group 3,RRG,1.5,17,14,1416,13,2018,11,2
Group 3,RRG,1.5,17,14,1417,9,2018,11,-2
Group 3,RRG,1.5,17,14,1418,8,2018,6,2
Group 3,RRG,1.5,17,14,1419,8,2018,10,-2
Group 3,RRG,1.5,17,14,1420,9,2018,13,-4
Group 3,RRG,1.5,17,14,1421,7,2018,12,-5
Group 3,RRG,1.5,17,14,1422,11,2018,10,1
Group 3,RRG,1.5,17,14,1423,8,2018,7,1
Group 3,RRG,1.5,17,14,1424,14,2018,12,2
Group 3,RRG,1.5,17,14,1425,11,2018,11,0
Group 3,RRG,1.5,17,14,1426,14,2018,12,2
Group 3,RRG,1.5,17,14,1427,13,2018,12,1
Group 3,RRG,1.5,17,14,1428,14,2018,11,3
Group 3,RRG,1.5,17,14,1429,11,2018,12,-1
Group 3,RRG,1.5,17,14,1430,11,2018,9,2
Group 3,RRG,1.5,17,14,1431,14,2018,12,2
Group 3,RRG,1.5,17,14,1432,11,2018,12,-1
Group 3,RRG,1.5,17,14,1433,12,2018,10,2
Group 3,RRG,1.5,17,14,1434,10,2018,9,1
Group 3,RRG,1.5,17,14,1435,12,2018,8,4
Group 3,RRG,1.5,17,14,1436,11,2018,11,0
Group 3,RRG,1.5,17,14,1437,8,2018,11,-3
Group 3,RRG,1.5,17,14,1438,9,2018,14,-5
Group 3,RRG,1.5,17,14,1439,6,2018,9,-3
Group 3,RRG,1.5,17,14,1440,12,2018,12,0
Group 3,RRG,1.5,17,14,1441,13,2018,11,2
Group 3,RRG,1.5,17,14,1442,12,2018,11,1
Group 3,RRG,1.5,17,14,1443,9,2018,14,-5
Group 3,RRG,1.5,17,14,1444,12,2018,10,2
Group 3,RRG,1.5,17,14,1445,11,2018,12,-1
Group 3,RRG,1.5,17,14,1446,13,2018,12,1
Group 3,RRG,1.5,17,14,1447,7,2018,11,-4
Group 3,RRG,1.5,17,14,1448,10,2018,11,-1
Group 3,RRG,1.5,17,14,1449,13,2018,9,4
Group 3,RRG,1.5,17,14,1450,9,2018,13,-4
Group 3,RRG,1.5,17,14,1451,12,2018,11,1
Group 3,RRG,1.5,17,14,1452,10,2018,8,2
Group 3,RRG,1.5,17,14,1453,11,2018,11,0
Group 3,RRG,1.5,17,14,1454,11,2018,6,5
Group 3,RRG,1.5,17,14,1455,13,2018,12,1
Group 3,RRG,1.5,17,14,1456,11,2018,7,4
Group 3,RRG,1.5,17,14,1457,13,2018,14,-1
Group 3,RRG,1.5,17,14,1458,13,2018,14,-1
Group 3,RRG,1.5,17,14,1459,7,2018,8,-1
Group 3,RRG,1.5,17,14,1460,8,2018,9,-1
Group 3,RRG,1.5,17,14,1461,13,2018,11,2
Group 3,RRG,1.5,17,14,1462,12,2018,12,0
Group 3,RRG,1.5,17,14,1463,9,2018,10,-1
Group 3,RRG,1.5,17,14,1464,12,2018,11,1
Group 3,RRG,1.5,17,14,1465,3,2018,11,-8
Group 3,RRG,1.5,17,14,1466,6,2018,9,-3
Group 3,RRG,1.5,17,14,1467,13,2018,12,1
Group 3,RRG,1.5,17,14,1468,14,2018,12,2
Group 3,RRG,1.5,17,14,1469,13,2018,12,1
Group 3,RRG,1.5,17,14,1470,14,2018,12,2
Group 3,RRG,1.5,17,14,1471,14,2018,14,0
Group 3,RRG,1.5,17,14,1472,11,2018,14,-3
Group 3,RRG,1.5,17,14,1473,10,2018,11,-1
Group 3,RRG,1.5,17,14,1474,8,2018,11,-3
Group 3,RRG,1.5,17,14,1475,13,2018,10,3
Group 3,RRG,1.5,17,14,1476,13,2018,11,2
Group 3,RRG,1.5,17,14,1477,10,2018,9,1
Group 3,RRG,1.5,17,14,1478,13,2018,12,1
Group 3,RRG,1.5,17,14,1479,12,2018,6,6
Group 3,RRG,1.5,17,14,1480,11,2018,9,2
Group 3,RRG,1.5,17,14,1481,13,2018,9,4
Group 3,RRG,1.5,17,14,1482,11,2018,11,0
Group 3,RRG,1.5,17,14,1483,13,2018,13,0
Group 3,RRG,1.5,17,14,1484,14,2018,14,0
Group 3,RRG,1.5,17,14,1485,13,2018,11,2
Group 3,RRG,1.5,17,14,1486,12,2018,13,-1
Group 3,RRG,1.5,17,14,1487,14,2018,13,1
Group 3,RRG,1.5,17,14,1488,8,2018,10,-2
Group 3,RRG,1.5,17,14,1489,13,2018,13,0
Group 3,RRG,1.5,17,14,1490,13,2018,14,-1
Group 3,RRG,1.5,17,14,1491,14,2018,6,8
Group 3,RRG,1.5,17,14,1492,14,2018,11,3
Group 3,RRG,1.5,17,14,1493,13,2018,9,4
Group 3,RRG,1.5,17,14,1494,11,2018,8,3
Group 3,RRG,1.5,17,14,1495,6,2018,8,-2
Group 3,RRG,1.5,17,14,1496,14,2018,13,1
Group 3,RRG,1.5,17,14,1497,10,2018,12,-2
Group 3,RRG,1.5,17,14,1498,12,2018,11,1
Group 3,RRG,1.5,17,14,1499,10,2018,13,-3
Group 3,RRG,1.5,17,14,1500,11,2018,11,0
Group 3,RRG,1.5,17,14,1501,13,2018,12,1
Group 3,RRG,1.5,17,14,1502,14,2018,13,1
Group 3,RRG,1.5,17,14,1503,9,2018,12,-3
Group 3,RRG,1.5,17,14,1504,10,2018,13,-3
Group 3,RRG,1.5,17,14,1505,11,2018,11,0
Group 3,RRG,1.5,17,14,1506,14,2018,13,1
Group 3,RRG,1.5,17,14,1507,11,2018,9,2
Group 3,RRG,1.5,17,14,1508,11,2018,11,0
Group 3,RRG,1.5,17,14,1509,11,2018,12,-1
Group 3,RRG,1.5,17,14,1510,13,2018,7,6
Group 3,RRG,1.5,17,14,1511,11,2018,11,0
Group 3,RRG,1.5,17,14,1512,7,2018,11,-4
Group 3,RRG,1.5,17,14,1513,4,2018,12,-8
Group 3,RRG,1.5,17,14,1514,13,2018,9,4
Group 3,RRG,1.5,17,14,1515,11,2018,10,1
Group 3,RRG,1.5,17,14,1516,13,2018,11,2
Group 3,RRG,1.5,17,14,1517,10,2018,12,-2
Group 3,RRG,1.5,17,14,1518,10,2018,6,4
Group 3,RRG,1.5,17,14,1519,12,2018,9,3
Group 3,RRG,1.5,17,14,1520,13,2018,12,1
Group 3,RRG,1.5,17,14,1521,9,2018,9,0
Group 3,RRG,1.5,17,14,1522,12,2018,12,0
Group 3,RRG,1.5,17,14,1523,12,2018,11,1
Group 3,RRG,1.5,17,14,1524,13,2018,14,-1
Group 3,RRG,1.5,17,14,1525,13,2018,11,2
Group 3,RRG,1.5,17,14,1526,12,2018,10,2
Group 3,RRG,1.5,17,14,1527,12,2018,11,1
Group 3,RRG,1.5,17,14,1528,9,2018,13,-4
Group 3,RRG,1.5,17,14,1529,12,2018,9,3
Group 3,RRG,1.5,17,14,1530,11,2018,11,0
Group 3,RRG,1.5,17,14,1531,12,2018,10,2
Group 3,RRG,1.5,17,14,1532,11,2018,11,0
Group 3,RRG,1.5,17,14,1533,13,2018,13,0
Group 3,RRG,1.5,17,14,1534,8,2018,9,-1
Group 3,RRG,1.5,17,14,1535,7,2018,12,-5
Group 3,RRG,1.5,17,14,1536,14,2018,13,1
Group 3,RRG,1.5,17,14,1537,9,2018,11,-2
Group 3,RRG,1.5,17,14,1538,12,2018,11,1
Group 3,RRG,1.5,17,14,1539,13,2018,12,1
Group 3,RRG,1.5,17,14,1540,11,2018,11,0
Group 3,RRG,1.5,17,14,1541,14,2018,11,3
Group 3,RRG,1.5,17,14,1542,12,2018,12,0
Group 3,RRG,1.5,17,14,1543,10,2018,12,-2
Group 3,RRG,1.5,17,14,1544,14,2018,11,3
Group 3,RRG,1.5,17,14,1545,8,2018,9,-1
Group 3,RRG,1.5,17,14,1546,9,2018,8,1
Group 3,RRG,1.5,17,14,1547,13,2018,12,1
Group 3,RRG,1.5,17,14,1548,9,2018,13,-4
Group 3,RRG,1.5,17,14,1549,12,2018,13,-1
Group 3,RRG,1.5,17,14,1550,7,2018,11,-4
Group 3,RRG,1.5,17,14,1551,8,2018,11,-3
Group 3,RRG,1.5,17,14,1552,14,2018,12,2
Group 3,RRG,1.5,17,14,1553,11,2018,7,4
Group 3,RRG,1.5,17,14,1554,12,2018,8,4
Group 3,RRG,1.5,17,14,1555,8,2018,10,-2
Group 3,RRG,1.5,17,14,1556,14,2018,9,5
Group 3,RRG,1.5,17,14,1557,11,2018,13,-2
Group 3,RRG,1.5,17,14,1558,13,2018,14,-1
Group 3,RRG,1.5,17,14,1559,14,2018,10,4
Group 3,RRG,1.5,17,14,1560,10,2018,12,-2
Group 3,RRG,1.5,17,14,1561,14,2018,10,4
Group 3,RRG,1.5,17,14,1562,10,2018,11,-1
Group 3,RRG,1.5,17,14,1563,14,2018,11,3
Group 3,RRG,1.5,17,14,1564,14,2018,12,2
Group 3,RRG,1.5,17,14,1565,2,2018,7,-5
Group 3,RRG,1.5,17,14,1566,8,2018,11,-3
Group 3,RRG,1.5,17,14,1567,12,2018,12,0
Group 3,RRG,1.5,17,14,1568,14,2018,11,3
Group 3,RRG,1.5,17,14,1569,14,2018,14,0
Group 3,RRG,1.5,17,14,1570,12,2018,11,1
Group 3,RRG,1.5,17,14,1571,12,2018,12,0
Group 3,RRG,1.5,17,14,1572,9,2018,13,-4
Group 3,RRG,1.5,17,14,1573,13,2018,10,3
Group 3,RRG,1.5,17,14,1574,13,2018,7,6
Group 3,RRG,1.5,17,14,1575,14,2018,13,1
Group 3,RRG,1.5,17,14,1576,7,2018,13,-6
Group 3,RRG,1.5,17,14,1577,10,2018,7,3
Group 3,RRG,1.5,17,14,1578,13,2018,10,3
Group 3,RRG,1.5,17,14,1579,5,2018,12,-7
Group 3,RRG,1.5,17,14,1580,12,2018,14,-2
Group 3,RRG,1.5,17,14,1581,14,2018,13,1
Group 3,RRG,1.5,17,14,1582,13,2018,8,5
Group 3,RRG,1.5,17,14,1583,12,2018,11,1
Group 3,RRG,1.5,17,14,1584,9,2018,10,-1
Group 3,RRG,1.5,17,14,1585,4,2018,10,-6
Group 3,RRG,1.5,17,14,1586,13,2018,10,3
Group 3,RRG,1.5,17,14,1587,12,2018,13,-1
Group 3,RRG,1.5,17,14,1588,11,2018,12,-1
Group 3,RRG,1.5,17,14,1589,10,2018,4,6
Group 3,RRG,1.5,17,14,1590,12,2018,11,1
Group 3,RRG,1.5,17,14,1591,13,2018,10,3
Group 3,RRG,1.5,17,14,1592,9,2018,12,-3
Group 3,RRG,1.5,17,14,1593,11,2018,13,-2
Group 3,RRG,1.5,17,14,1594,11,2018,12,-1
Group 3,RRG,1.5,17,14,1595,11,2018,12,-1
Group 3,RRG,1.5,17,14,1596,13,2018,11,2
Group 3,RRG,1.5,17,14,1597,11,2018,12,-1
Group 3,RRG,1.5,17,14,1598,11,2018,11,0
Group 3,RRG,1.5,17,14,1599,9,2018,11,-2
Group 3,RRG,1.5,17,14,1600,12,2018,11,1
Group 3,RRG,1.5,17,14,1601,12,2018,12,0
Group 3,RRG,1.5,17,14,1602,12,2018,12,0
Group 3,RRG,1.5,17,14,1603,12,2018,10,2
Group 3,RRG,1.5,17,14,1604,10,2018,8,2
Group 3,RRG,1.5,17,14,1605,9,2018,9,0
Group 3,RRG,1.5,17,14,1606,9,2018,8,1
Group 3,RRG,1.5,17,14,1607,12,2018,12,0
Group 3,RRG,1.5,17,14,1608,10,2018,14,-4
Group 3,RRG,1.5,17,14,1609,11,2018,13,-2
Group 3,RRG,1.5,17,14,1610,11,2018,10,1
Group 3,RRG,1.5,17,14,1611,13,2018,10,3
Group 3,RRG,1.5,17,14,1612,7,2018,11,-4
Group 3,RRG,1.5,17,14,1613,12,2018,12,0
Group 3,RRG,1.5,17,14,1614,12,2018,10,2
Group 3,RRG,1.5,17,14,1615,11,2018,12,-1
Group 3,RRG,1.5,17,14,1616,13,2018,11,2
Group 3,RRG,1.5,17,14,1617,10,2018,14,-4
Group 3,RRG,1.5,17,14,1618,5,2018,7,-2
Group 3,RRG,1.5,17,14,1619,13,2018,9,4
Group 3,RRG,1.5,17,14,1620,13,2018,9,4
Group 3,RRG,1.5,17,14,1621,14,2018,14,0
Group 3,RRG,1.5,17,14,1622,11,2018,11,0
Group 3,RRG,1.5,17,14,1623,10,2018,10,0
Group 3,RRG,1.5,17,14,1624,6,2018,13,-7
Group 3,RRG,1.5,17,14,1625,9,2018,12,-3
Group 3,RRG,1.5,17,14,1626,14,2018,14,0
Group 3,RRG,1.5,17,14,1627,14,2018,13,1
Group 3,RRG,1.5,17,14,1628,8,2018,12,-4
Group 3,RRG,1.5,17,14,1629,11,2018,10,1
Group 3,RRG,1.5,17,14,1630,9,2018,10,-1
Group 3,RRG,1.5,17,14,1631,8,2018,9,-1
Group 3,RRG,1.5,17,14,1632,7,2018,14,-7
Group 3,RRG,1.5,17,14,1633,9,2018,13,-4
Group 3,RRG,1.5,17,14,1634,8,2018,9,-1
Group 3,RRG,1.5,17,14,1635,9,2018,9,0
Group 3,RRG,1.5,17,14,1636,9,2018,12,-3
Group 3,RRG,1.5,17,14,1637,9,2018,10,-1
Group 3,RRG,1.5,17,14,1638,11,2018,11,0
Group 3,RRG,1.5,17,14,1639,4,2018,8,-4
Group 3,RRG,1.5,17,14,1640,13,2018,11,2
Group 3,RRG,1.5,17,14,1641,14,2018,11,3
Group 3,RRG,1.5,17,14,1642,13,2018,11,2
Group 3,RRG,1.5,17,14,1643,12,2018,10,2
Group 3,RRG,1.5,17,14,1644,9,2018,11,-2
Group 3,RRG,1.5,17,14,1645,13,2018,12,1
Group 3,RRG,1.5,17,14,1646,11,2018,9,2
Group 3,RRG,1.5,17,14,1647,10,2018,13,-3
Group 3,RRG,1.5,17,14,1648,11,2018,12,-1
Group 3,RRG,1.5,17,14,1649,12,2018,11,1
Group 3,RRG,1.5,17,14,1650,7,2018,10,-3
Group 3,RRG,1.5,17,14,1651,10,2018,10,0
Group 3,RRG,1.5,17,14,1652,14,2018,8,6
Group 3,RRG,1.5,17,14,1653,11,2018,8,3
Group 3,RRG,1.5,17,14,1654,13,2018,9,4
Group 3,RRG,1.5,17,14,1655,8,2018,9,-1
Group 3,RRG,1.5,17,14,1656,10,2018,13,-3
Group 3,RRG,1.5,17,14,1657,11,2018,10,1
Group 3,RRG,1.5,17,14,1658,8,2018,13,-5
Group 3,RRG,1.5,17,14,1659,10,2018,10,0
Group 3,RRG,1.5,17,14,1660,11,2018,6,5
Group 3,RRG,1.5,17,14,1661,10,2018,9,1
Group 3,RRG,1.5,17,14,1662,13,2018,12,1
Group 3,RRG,1.5,17,14,1663,13,2018,11,2
Group 3,RRG,1.5,17,14,1664,12,2018,14,-2
Group 3,RRG,1.5,17,14,1665,12,2018,12,0
Group 3,RRG,1.5,17,14,1666,13,2018,12,1
Group 3,RRG,1.5,17,14,1667,11,2018,12,-1
Group 3,RRG,1.5,17,14,1668,5,2018,10,-5
Group 3,RRG,1.5,17,14,1669,13,2018,14,-1
Group 3,RRG,1.5,17,14,1670,12,2018,12,0
Group 3,RRG,1.5,17,14,1671,8,2018,12,-4
Group 3,RRG,1.5,17,14,1672,10,2018,9,1
Group 3,RRG,1.5,17,14,1673,14,2018,11,3
Group 3,RRG,1.5,17,14,1674,12,2018,11,1
Group 3,RRG,1.5,17,14,1675,12,2018,13,-1
Group 3,RRG,1.5,17,14,1676,12,2018,14,-2
Group 3,RRG,1.5,17,14,1677,12,2018,10,2
Group 3,RRG,1.5,17,14,1678,13,2018,12,1
Group 3,RRG,1.5,17,14,1679,12,2018,10,2
Group 3,RRG,1.5,17,14,1680,7,2018,11,-4
Group 3,RRG,1.5,17,14,1681,8,2018,12,-4
Group 3,RRG,1.5,17,14,1682,12,2018,11,1
Group 3,RRG,1.5,17,14,1683,12,2018,13,-1
Group 3,RRG,1.5,17,14,1684,13,2018,14,-1
Group 3,RRG,1.5,17,14,1685,13,2018,14,-1
Group 3,RRG,1.5,17,14,1686,14,2018,9,5
Group 3,RRG,1.5,17,14,1687,9,2018,14,-5
Group 3,RRG,1.5,17,14,1688,10,2018,8,2
Group 3,RRG,1.5,17,14,1689,11,2018,13,-2
Group 3,RRG,1.5,17,14,1690,10,2018,14,-4
Group 3,RRG,1.5,17,14,1691,11,2018,12,-1
Group 3,RRG,1.5,17,14,1692,13,2018,13,0
Group 3,RRG,1.5,17,14,1693,11,2018,10,1
Group 3,RRG,1.5,17,14,1694,11,2018,10,1
Group 3,RRG,1.5,17,14,1695,9,2018,11,-2
Group 3,RRG,1.5,17,14,1696,12,2018,9,3
Group 3,RRG,1.5,17,14,1697,13,2018,10,3
Group 3,RRG,1.5,17,14,1698,8,2018,10,-2
Group 3,RRG,1.5,17,14,1699,11,2018,11,0
Group 3,RRG,1.5,17,14,1700,10,2018,11,-1
Group 3,RRG,1.5,17,14,1701,9,2018,12,-3
Group 3,RRG,1.5,17,14,1702,12,2018,12,0
Group 3,RRG,1.5,17,14,1703,7,2018,12,-5
Group 3,RRG,1.5,17,14,1704,12,2018,11,1
Group 3,RRG,1.5,17,14,1705,11,2018,13,-2
Group 3,RRG,1.5,17,14,1706,12,2018,11,1
Group 3,RRG,1.5,17,14,1707,10,2018,9,1
Group 3,RRG,1.5,17,14,1708,6,2018,10,-4
Group 3,RRG,1.5,17,14,1709,7,2018,8,-1
Group 3,RRG,1.5,17,14,1710,12,2018,11,1
Group 3,RRG,1.5,17,14,1711,10,2018,5,5
Group 3,RRG,1.5,17,14,1712,14,2018,14,0
Group 3,RRG,1.5,17,14,1713,14,2018,14,0
Group 3,RRG,1.5,17,14,1714,11,2018,11,0
Group 3,RRG,1.5,17,14,1715,6,2018,10,-4
Group 3,RRG,1.5,17,14,1716,13,2018,11,2
Group 3,RRG,1.5,17,14,1717,9,2018,9,0
Group 3,RRG,1.5,17,14,1718,11,2018,11,0
Group 3,RRG,1.5,17,14,1719,12,2018,12,0
Group 3,RRG,1.5,17,14,1720,9,2018,8,1
Group 3,RRG,1.5,17,14,1721,13,2018,11,2
Group 3,RRG,1.5,17,14,1722,11,2018,12,-1
Group 3,RRG,1.5,17,14,1723,14,2018,13,1
Group 3,RRG,1.5,17,14,1724,12,2018,11,1
Group 3,RRG,1.5,17,14,1725,14,2018,11,3
Group 3,RRG,1.5,17,14,1726,10,2018,10,0
Group 3,RRG,1.5,17,14,1727,13,2018,12,1
Group 3,RRG,1.5,17,14,1728,9,2018,11,-2
Group 3,RRG,1.5,17,14,1729,8,2018,9,-1
Group 3,RRG,1.5,17,14,1730,14,2018,12,2
Group 3,RRG,1.5,17,14,1731,12,2018,10,2
Group 3,RRG,1.5,17,14,1732,12,2018,10,2
Group 3,RRG,1.5,17,14,1733,10,2018,12,-2
Group 3,RRG,1.5,17,14,1734,13,2018,14,-1
Group 3,RRG,1.5,17,14,1735,10,2018,7,3
Group 3,RRG,1.5,17,14,1736,10,2018,9,1
Group 3,RRG,1.5,17,14,1737,14,2018,11,3
Group 3,RRG,1.5,17,14,1738,13,2018,13,0
Group 3,RRG,1.5,17,14,1739,12,2018,14,-2
Group 3,RRG,1.5,17,14,1740,13,2018,11,2
Group 3,RRG,1.5,17,14,1741,13,2018,13,0
Group 3,RRG,1.5,17,14,1742,13,2018,11,2
Group 3,RRG,1.5,17,14,1743,14,2018,12,2
Group 3,RRG,1.5,17,14,1744,9,2018,10,-1
Group 3,RRG,1.5,17,14,1745,9,2018,8,1
Group 3,RRG,1.5,17,14,1746,10,2018,10,0
Group 3,RRG,1.5,17,14,1747,14,2018,13,1
Group 3,RRG,1.5,17,14,1748,9,2018,11,-2
Group 3,RRG,1.5,17,14,1749,13,2018,11,2
Group 3,RRG,1.5,17,14,1750,12,2018,11,1
Group 3,RRG,1.5,17,14,1751,11,2018,11,0
Group 3,RRG,1.5,17,14,1752,8,2018,13,-5
Group 3,RRG,1.5,17,14,1753,4,2018,8,-4
Group 3,RRG,1.5,17,14,1754,10,2018,11,-1
Group 3,RRG,1.5,17,14,1755,14,2018,12,2
Group 3,RRG,1.5,17,14,1756,11,2018,9,2
Group 3,RRG,1.5,17,14,1757,12,2018,11,1
Group 3,RRG,1.5,17,14,1758,11,2018,10,1
Group 3,RRG,1.5,17,14,1759,14,2018,7,7
Group 3,RRG,1.5,17,14,1760,13,2018,10,3
Group 3,RRG,1.5,17,14,1761,13,2018,7,6
Group 3,RRG,1.5,17,14,1762,14,2018,14,0
Group 3,RRG,1.5,17,14,1763,11,2018,13,-2
Group 3,RRG,1.5,17,14,1764,13,2018,11,2
Group 3,RRG,1.5,17,14,1765,12,2018,13,-1
Group 3,RRG,1.5,17,14,1766,12,2018,10,2
Group 3,RRG,1.5,17,14,1767,11,2018,14,-3
Group 3,RRG,1.5,17,14,1768,11,2018,10,1
Group 3,RRG,1.5,17,14,1769,13,2018,14,-1
Group 3,RRG,1.5,17,14,1770,12,2018,12,0
Group 3,RRG,1.5,17,14,1771,11,2018,13,-2
Group 3,RRG,1.5,17,14,1772,12,2018,12,0
Group 3,RRG,1.5,17,14,1773,10,2018,11,-1
Group 3,RRG,1.5,17,14,1774,14,2018,12,2
Group 3,RRG,1.5,17,14,1775,13,2018,13,0
Group 3,RRG,1.5,17,14,1776,11,2018,10,1
Group 3,RRG,1.5,17,14,1777,10,2018,9,1
Group 3,RRG,1.5,17,14,1778,11,2018,14,-3
Group 3,RRG,1.5,17,14,1779,12,2018,11,1
Group 3,RRG,1.5,17,14,1780,13,2018,10,3
Group 3,RRG,1.5,17,14,1781,12,2018,10,2
Group 3,RRG,1.5,17,14,1782,12,2018,12,0
Group 3,RRG,1.5,17,14,1783,7,2018,10,-3
Group 3,RRG,1.5,17,14,1784,11,2018,11,0
Group 3,RRG,1.5,17,14,1785,12,2018,8,4
Group 3,RRG,1.5,17,14,1786,14,2018,11,3
Group 3,RRG,1.5,17,14,1787,12,2018,10,2
Group 3,RRG,1.5,17,14,1788,11,2018,10,1
Group 3,RRG,1.5,17,14,1789,13,2018,12,1
Group 3,RRG,1.5,17,14,1790,14,2018,10,4
Group 3,RRG,1.5,17,14,1791,13,2018,7,6
Group 3,RRG,1.5,17,14,1792,11,2018,10,1
Group 3,RRG,1.5,17,14,1793,12,2018,10,2
Group 3,RRG,1.5,17,14,1794,12,2018,8,4
Group 3,RRG,1.5,17,14,1795,11,2018,13,-2
Group 3,RRG,1.5,17,14,1796,12,2018,13,-1
Group 3,RRG,1.5,17,14,1797,14,2018,11,3
Group 3,RRG,1.5,17,14,1798,13,2018,14,-1
Group 3,RRG,1.5,17,14,1799,13,2018,13,0
Group 3,RRG,1.5,17,14,1800,13,2018,10,3
Group 3,RRG,1.5,17,14,1801,14,2018,13,1
Group 3,RRG,1.5,17,14,1802,12,2018,9,3
Group 3,RRG,1.5,17,14,1803,12,2018,10,2
Group 3,RRG,1.5,17,14,1804,11,2018,13,-2
Group 3,RRG,1.5,17,14,1805,12,2018,14,-2
Group 3,RRG,1.5,17,14,1806,14,2018,8,6
Group 3,RRG,1.5,17,14,1807,11,2018,12,-1
Group 3,RRG,1.5,17,14,1808,13,2018,11,2
Group 3,RRG,1.5,17,14,1809,11,2018,12,-1
Group 3,RRG,1.5,17,14,1810,8,2018,11,-3
Group 3,RRG,1.5,17,14,1811,12,2018,6,6
Group 3,RRG,1.5,17,14,1812,11,2018,8,3
Group 3,RRG,1.5,17,14,1813,12,2018,9,3
Group 3,RRG,1.5,17,14,1814,13,2018,13,0
Group 3,RRG,1.5,17,14,1815,7,2018,13,-6
Group 3,RRG,1.5,17,14,1816,10,2018,13,-3
Group 3,RRG,1.5,17,14,1817,10,2018,11,-1
Group 3,RRG,1.5,17,14,1818,13,2018,12,1
Group 3,RRG,1.5,17,14,1819,13,2018,12,1
Group 3,RRG,1.5,17,14,1820,13,2018,13,0
Group 3,RRG,1.5,17,14,1821,11,2018,8,3
Group 3,RRG,1.5,17,14,1822,10,2018,11,-1
Group 3,RRG,1.5,17,14,1823,13,2018,12,1
Group 3,RRG,1.5,17,14,1824,10,2018,11,-1
Group 3,RRG,1.5,17,14,1825,14,2018,11,3
Group 3,RRG,1.5,17,14,1826,9,2018,9,0
Group 3,RRG,1.5,17,14,1827,13,2018,11,2
Group 3,RRG,1.5,17,14,1828,8,2018,13,-5
Group 3,RRG,1.5,17,14,1829,11,2018,10,1
Group 3,RRG,1.5,17,14,1830,11,2018,11,0
Group 3,RRG,1.5,17,14,1831,7,2018,7,0
Group 3,RRG,1.5,17,14,1832,10,2018,9,1
Group 3,RRG,1.5,17,14,1833,12,2018,13,-1
Group 3,RRG,1.5,17,14,1834,10,2018,11,-1
Group 3,RRG,1.5,17,14,1835,13,2018,13,0
Group 3,RRG,1.5,17,14,1836,13,2018,13,0
Group 3,RRG,1.5,17,14,1837,13,2018,10,3
Group 3,RRG,1.5,17,14,1838,12,2018,9,3
Group 3,RRG,1.5,17,14,1839,14,2018,9,5
Group 3,RRG,1.5,17,14,1840,11,2018,14,-3
Group 3,RRG,1.5,17,14,1841,13,2018,12,1
Group 3,RRG,1.5,17,14,1842,13,2018,12,1
Group 3,RRG,1.5,17,14,1843,12,2018,11,1
Group 3,RRG,1.5,17,14,1844,13,2018,14,-1
Group 3,RRG,1.5,17,14,1845,8,2018,11,-3
Group 3,RRG,1.5,17,14,1846,10,2018,10,0
Group 3,RRG,1.5,17,14,1847,14,2018,11,3
Group 3,RRG,1.5,17,14,1848,14,2018,13,1
Group 3,RRG,1.5,17,14,1849,11,2018,11,0
Group 3,RRG,1.5,17,14,1850,11,2018,12,-1
Group 3,RRG,1.5,17,14,1851,10,2018,12,-2
Group 3,RRG,1.5,17,14,1852,13,2018,13,0
Group 3,RRG,1.5,17,14,1853,13,2018,11,2
Group 3,RRG,1.5,17,14,1854,12,2018,12,0
Group 3,RRG,1.5,17,14,1855,9,2018,10,-1
Group 3,RRG,1.5,17,14,1856,11,2018,11,0
Group 3,RRG,1.5,17,14,1857,13,2018,12,1
Group 3,RRG,1.5,17,14,1858,13,2018,11,2
Group 3,RRG,1.5,17,14,1859,13,2018,10,3
Group 3,RRG,1.5,17,14,1860,10,2018,10,0
Group 3,RRG,1.5,17,14,1861,10,2018,9,1
Group 3,RRG,1.5,17,14,1862,14,2018,12,2
Group 3,RRG,1.5,17,14,1863,12,2018,12,0
Group 3,RRG,1.5,17,14,1864,13,2018,13,0
Group 3,RRG,1.5,17,14,1865,11,2018,10,1
Group 3,RRG,1.5,17,14,1866,11,2018,9,2
Group 3,RRG,1.5,17,14,1867,13,2018,11,2
Group 3,RRG,1.5,17,14,1868,11,2018,9,2
Group 3,RRG,1.5,17,14,1869,6,2018,9,-3
Group 3,RRG,1.5,17,14,1870,9,2018,9,0
Group 3,RRG,1.5,17,14,1871,14,2018,10,4
Group 3,RRG,1.5,17,14,1872,12,2018,10,2
Group 3,RRG,1.5,17,14,1873,11,2018,14,-3
Group 3,RRG,1.5,17,14,1874,12,2018,12,0
Group 3,RRG,1.5,17,14,1875,7,2018,11,-4
Group 3,RRG,1.5,17,14,1876,7,2018,9,-2
Group 3,RRG,1.5,17,14,1877,7,2018,12,-5
Group 3,RRG,1.5,17,14,1878,11,2018,11,0
Group 3,RRG,1.5,17,14,1879,11,2018,10,1
Group 3,RRG,1.5,17,14,1880,9,2018,13,-4
Group 3,RRG,1.5,17,14,1881,12,2018,11,1
Group 3,RRG,1.5,17,14,1882,11,2018,10,1
Group 3,RRG,1.5,17,14,1883,8,2018,8,0
Group 3,RRG,1.5,17,14,1884,13,2018,10,3
Group 3,RRG,1.5,17,14,1885,11,2018,11,0
Group 3,RRG,1.5,17,14,1886,11,2018,8,3
Group 3,RRG,1.5,17,14,1887,12,2018,13,-1
Group 3,RRG,1.5,17,14,1888,8,2018,11,-3
Group 3,RRG,1.5,17,14,1889,14,2018,11,3
Group 3,RRG,1.5,17,14,1890,12,2018,12,0
Group 3,RRG,1.5,17,14,1891,10,2018,11,-1
Group 3,RRG,1.5,17,14,1892,12,2018,10,2
Group 3,RRG,1.5,17,14,1893,10,2018,11,-1
Group 3,RRG,1.5,17,14,1894,11,2018,8,3
Group 3,RRG,1.5,17,14,1895,12,2018,12,0
Group 3,RRG,1.5,17,14,1896,11,2018,8,3
Group 3,RRG,1.5,17,14,1897,13,2018,12,1
Group 3,RRG,1.5,17,14,1898,13,2018,13,0
Group 3,RRG,1.5,17,14,1899,10,2018,11,-1
Group 3,RRG,1.5,17,14,1900,10,2018,7,3
Group 3,RRG,1.5,17,14,1901,11,2018,9,2
Group 3,RRG,1.5,17,14,1902,7,2018,14,-7
Group 3,RRG,1.5,17,14,1903,10,2018,12,-2
Group 3,RRG,1.5,17,14,1904,12,2018,12,0
Group 3,RRG,1.5,17,14,1905,7,2018,13,-6
Group 3,RRG,1.5,17,14,1906,8,2018,12,-4
Group 3,RRG,1.5,17,14,1907,10,2018,11,-1
Group 3,RRG,1.5,17,14,1908,9,2018,13,-4
Group 3,RRG,1.5,17,14,1909,7,2018,11,-4
Group 3,RRG,1.5,17,14,1910,12,2018,14,-2
Group 3,RRG,1.5,17,14,1911,13,2018,12,1
Group 3,RRG,1.5,17,14,1912,14,2018,10,4
Group 3,RRG,1.5,17,14,1913,12,2018,10,2
Group 3,RRG,1.5,17,14,1914,14,2018,13,1
Group 3,RRG,1.5,17,14,1915,12,2018,13,-1
Group 3,RRG,1.5,17,14,1916,8,2018,12,-4
Group 3,RRG,1.5,17,14,1917,11,2018,10,1
Group 3,RRG,1.5,17,14,1918,11,2018,7,4
Group 3,RRG,1.5,17,14,1919,11,2018,10,1
Group 3,RRG,1.5,17,14,1920,13,2018,12,1
Group 3,RRG,1.5,17,14,1921,12,2018,14,-2
Group 3,RRG,1.5,17,14,1922,14,2018,13,1
Group 3,RRG,1.5,17,14,1923,12,2018,9,3
Group 3,RRG,1.5,17,14,1924,13,2018,12,1
Group 3,RRG,1.5,17,14,1925,14,2018,14,0
Group 3,RRG,1.5,17,14,1926,12,2018,9,3
Group 3,RRG,1.5,17,14,1927,13,2018,9,4
Group 3,RRG,1.5,17,14,1928,10,2018,11,-1
Group 3,RRG,1.5,17,14,1929,13,2018,12,1
Group 3,RRG,1.5,17,14,1930,10,2018,11,-1
Group 3,RRG,1.5,17,14,1931,12,2018,12,0
Group 3,RRG,1.5,17,14,1932,13,2018,10,3
Group 3,RRG,1.5,17,14,1933,12,2018,11,1
Group 3,RRG,1.5,17,14,1934,11,2018,9,2
Group 3,RRG,1.5,17,14,1935,9,2018,7,2
Group 3,RRG,1.5,17,14,1936,10,2018,8,2
Group 3,RRG,1.5,17,14,1937,10,2018,10,0
Group 3,RRG,1.5,17,14,1938,10,2018,10,0
Group 3,RRG,1.5,17,14,1939,14,2018,13,1
Group 3,RRG,1.5,17,14,1940,11,2018,13,-2
Group 3,RRG,1.5,17,14,1941,9,2018,14,-5
Group 3,RRG,1.5,17,14,1942,12,2018,11,1
Group 3,RRG,1.5,17,14,1943,13,2018,13,0
Group 3,RRG,1.5,17,14,1944,12,2018,8,4
Group 3,RRG,1.5,17,14,1945,14,2018,11,3
Group 3,RRG,1.5,17,14,1946,10,2018,8,2
Group 3,RRG,1.5,17,14,1947,8,2018,13,-5
Group 3,RRG,1.5,17,14,1948,9,2018,8,1
Group 3,RRG,1.5,17,14,1949,12,2018,10,2
Group 3,RRG,1.5,17,14,1950,7,2018,12,-5
Group 3,RRG,1.5,17,14,1951,12,2018,11,1
Group 3,RRG,1.5,17,14,1952,12,2018,10,2
Group 3,RRG,1.5,17,14,1953,10,2018,10,0
Group 3,RRG,1.5,17,14,1954,14,2018,13,1
Group 3,RRG,1.5,17,14,1955,11,2018,12,-1
Group 3,RRG,1.5,17,14,1956,13,2018,12,1
Group 3,RRG,1.5,17,14,1957,13,2018,14,-1
Group 3,RRG,1.5,17,14,1958,13,2018,12,1
Group 3,RRG,1.5,17,14,1959,14,2018,12,2
Group 3,RRG,1.5,17,14,1960,12,2018,12,0
Group 3,RRG,1.5,17,14,1961,12,2018,12,0
Group 3,RRG,1.5,17,14,1962,12,2018,13,-1
Group 3,RRG,1.5,17,14,1963,14,2018,10,4
Group 3,RRG,1.5,17,14,1964,14,2018,13,1
Group 3,RRG,1.5,17,14,1965,12,2018,8,4
Group 3,RRG,1.5,17,14,1966,8,2018,11,-3
Group 3,RRG,1.5,17,14,1967,9,2018,13,-4
Group 3,RRG,1.5,17,14,1968,10,2018,10,0
Group 3,RRG,1.5,17,14,1969,12,2018,11,1
Group 3,RRG,1.5,17,14,1970,10,2018,7,3
Group 3,RRG,1.5,17,14,1971,9,2018,9,0
Group 3,RRG,1.5,17,14,1972,8,2018,8,0
Group 3,RRG,1.5,17,14,1973,13,2018,13,0
Group 3,RRG,1.5,17,14,1974,13,2018,7,6
Group 3,RRG,1.5,17,14,1975,14,2018,14,0
Group 3,RRG,1.5,17,14,1976,14,2018,12,2
Group 3,RRG,1.5,17,14,1977,13,2018,12,1
Group 3,RRG,1.5,17,14,1978,6,2018,12,-6
Group 3,RRG,1.5,17,14,1979,4,2018,11,-7
Group 3,RRG,1.5,17,14,1980,10,2018,9,1
Group 3,RRG,1.5,17,14,1981,11,2018,10,1
Group 3,RRG,1.5,17,14,1982,13,2018,11,2
Group 3,RRG,1.5,17,14,1983,10,2018,11,-1
Group 3,RRG,1.5,17,14,1984,12,2018,12,0
Group 3,RRG,1.5,17,14,1985,11,2018,14,-3
Group 3,RRG,1.5,17,14,1986,8,2018,13,-5
Group 3,RRG,1.5,17,14,1987,13,2018,10,3
Group 3,RRG,1.5,17,14,1988,11,2018,11,0
Group 3,RRG,1.5,17,14,1989,14,2018,13,1
Group 3,RRG,1.5,17,14,1990,13,2018,9,4
Group 3,RRG,1.5,17,14,1991,10,2018,7,3
Group 3,RRG,1.5,17,14,1992,13,2018,11,2
Group 3,RRG,1.5,17,14,1993,12,2018,13,-1
Group 3,RRG,1.5,17,14,1994,12,2018,5,7
Group 3,RRG,1.5,17,14,1995,14,2018,12,2
Group 3,RRG,1.5,17,14,1996,13,2018,12,1
Group 3,RRG,1.5,17,14,1997,14,2018,12,2
Group 3,RRG,1.5,17,14,1998,9,2018,10,-1
Group 3,RRG,1.5,17,14,1999,12,2018,7,5
Group 3,RRG,1.5,17,14,2000,12,2018,10,2
Group 3,RRG,1.5,17,14,2001,10,2018,8,2
Group 3,RRG,1.5,17,14,2002,10,2018,7,3
Group 3,RRG,1.5,17,14,2003,13,2018,11,2
Group 3,RRG,1.5,17,14,2004,10,2018,12,-2
Group 3,RRG,1.5,17,14,2005,12,2018,7,5
Group 3,RRG,1.5,17,14,2006,9,2018,9,0
Group 3,RRG,1.5,17,14,2007,13,2018,13,0
Group 3,RRG,1.5,17,14,2008,11,2018,12,-1
Group 3,RRG,1.5,17,14,2009,11,2018,13,-2
Group 3,RRG,1.5,17,14,2010,10,2018,13,-3
Group 3,RRG,1.5,17,14,2011,12,2018,10,2
Group 3,RRG,1.5,17,14,2012,9,2018,5,4
Group 3,RRG,1.5,17,14,2013,13,2018,10,3
Group 3,RRG,1.5,17,14,2014,11,2018,9,2
Group 3,RRG,1.5,17,14,2015,12,2018,10,2
Group 3,RRG,1.5,17,14,2016,11,2018,10,1
Group 3,RRG,1.5,17,14,2017,13,2018,10,3
Group 3,RRG,1.5,17,14,2018,13,2018,8,5
Group 3,RRG,1.5,17,14,2019,11,2018,12,-1
Group 3,RRG,1.5,17,14,2020,13,2018,11,2
Group 3,RRG,1.5,17,14,2021,12,2018,9,3
Group 3,RRG,1.5,17,14,2022,11,2018,7,4
Group 3,RRG,1.5,17,14,2023,12,2018,11,1
Group 3,RRG,1.5,17,14,2024,10,2018,11,-1
Group 3,RRG,1.5,17,14,2025,12,2018,12,0
Group 3,RRG,1.5,17,14,2026,10,2018,10,0
Group 3,RRG,1.5,17,14,2027,10,2018,12,-2
Group 3,RRG,1.5,17,14,2028,11,2018,10,1
Group 3,RRG,1.5,17,14,2029,11,2018,6,5
Group 3,RRG,1.5,17,14,2030,7,2018,7,0
Group 3,RRG,1.5,17,14,2031,13,2018,13,0
Group 3,RRG,1.5,17,14,2032,7,2018,11,-4
Group 3,RRG,1.5,17,14,2033,13,2018,13,0
Group 3,RRG,1.5,17,14,2034,11,2018,11,0
Group 3,RRG,1.5,17,14,2035,12,2018,11,1
Group 3,RRG,1.5,17,14,2036,13,2018,9,4
Group 3,RRG,1.5,17,14,2037,13,2018,9,4
Group 3,RRG,1.5,17,14,2038,10,2018,12,-2
Group 3,RRG,1.5,17,14,2039,9,2018,12,-3
Group 3,RRG,1.5,17,14,2040,10,2018,11,-1
Group 3,RRG,1.5,17,14,2041,12,2018,10,2
Group 3,RRG,1.5,17,14,2042,12,2018,10,2
Group 3,RRG,1.5,17,14,2043,13,2018,13,0
Group 3,RRG,1.5,17,14,2044,10,2018,12,-2
Group 3,RRG,1.5,17,14,2045,12,2018,11,1
Group 3,RRG,1.5,17,14,2046,12,2018,10,2
Group 3,RRG,1.5,17,14,2047,11,2018,13,-2
Group 3,RRG,1.5,17,14,2048,12,2018,10,2
Group 3,RRG,1.5,17,14,2049,13,2018,14,-1
Group 3,RRG,1.5,17,14,2050,13,2018,13,0
Group 3,RRG,1.5,17,14,2051,12,2018,11,1
Group 3,RRG,1.5,17,14,2052,12,2018,12,0
Group 3,RRG,1.5,17,14,2053,12,2018,13,-1
Group 3,RRG,1.5,17,14,2054,9,2018,7,2
Group 3,RRG,1.5,17,14,2055,9,2018,13,-4
Group 3,RRG,1.5,17,14,2056,12,2018,9,3
Group 3,RRG,1.5,17,14,2057,14,2018,10,4
Group 3,RRG,1.5,17,14,2058,9,2018,6,3
Group 3,RRG,1.5,17,14,2059,13,2018,11,2
Group 3,RRG,1.5,17,14,2060,12,2018,11,1
Group 3,RRG,1.5,17,14,2061,12,2018,10,2
Group 3,RRG,1.5,17,14,2062,13,2018,7,6
Group 3,RRG,1.5,17,14,2063,11,2018,12,-1
Group 3,RRG,1.5,17,14,2064,13,2018,10,3
Group 3,RRG,1.5,17,14,2065,12,2018,11,1
Group 3,RRG,1.5,17,14,2066,13,2018,12,1
Group 3,RRG,1.5,17,14,2067,13,2018,11,2
Group 3,RRG,1.5,17,14,2068,7,2018,8,-1
Group 3,RRG,1.5,17,14,2069,12,2018,10,2
Group 3,RRG,1.5,17,14,2070,11,2018,12,-1
Group 3,RRG,1.5,17,14,2071,12,2018,13,-1
Group 3,RRG,1.5,17,14,2072,13,2018,13,0
Group 3,RRG,1.5,17,14,2073,10,2018,7,3
Group 3,RRG,1.5,17,14,2074,9,2018,14,-5
Group 3,RRG,1.5,17,14,2075,12,2018,10,2
Group 3,RRG,1.5,17,14,2076,10,2018,12,-2
Group 3,RRG,1.5,17,14,2077,10,2018,12,-2
Group 3,RRG,1.5,17,14,2078,12,2018,13,-1
Group 3,RRG,1.5,17,14,2079,13,2018,14,-1
Group 3,RRG,1.5,17,14,2080,13,2018,14,-1
Group 3,RRG,1.5,17,14,2081,13,2018,12,1
Group 3,RRG,1.5,17,14,2082,6,2018,11,-5
Group 3,RRG,1.5,17,14,2083,12,2018,11,1
Group 3,RRG,1.5,17,14,2084,9,2018,9,0
Group 3,RRG,1.5,17,14,2085,14,2018,11,3
Group 3,RRG,1.5,17,14,2086,14,2018,14,0
Group 3,RRG,1.5,17,14,2087,12,2018,11,1
Group 3,RRG,1.5,17,14,2088,11,2018,9,2
Group 3,RRG,1.5,17,14,2089,12,2018,9,3
Group 3,RRG,1.5,17,14,2090,12,2018,10,2
Group 3,RRG,1.5,17,14,2091,11,2018,13,-2
Group 3,RRG,1.5,17,14,2092,14,2018,13,1
Group 3,RRG,1.5,17,14,2093,12,2018,11,1
Group 3,RRG,1.5,17,14,2094,13,2018,12,1
Group 3,RRG,1.5,17,14,2095,11,2018,11,0
Group 3,RRG,1.5,17,14,2096,13,2018,14,-1
Group 3,RRG,1.5,17,14,2097,14,2018,11,3
Group 3,RRG,1.5,17,14,2098,11,2018,12,-1
Group 3,RRG,1.5,17,14,2099,14,2018,10,4
Group 3,RRG,1.5,17,14,2100,14,2018,10,4
Group 3,RRG,1.5,17,14,2101,13,2018,9,4
Group 3,RRG,1.5,17,14,2102,9,2018,13,-4
Group 3,RRG,1.5,17,14,2103,12,2018,11,1
Group 3,RRG,1.5,17,14,2104,11,2018,10,1
Group 3,RRG,1.5,17,14,2105,13,2018,13,0
Group 3,RRG,1.5,17,14,2106,13,2018,10,3
Group 3,RRG,1.5,17,14,2107,7,2018,11,-4
Group 3,RRG,1.5,17,14,2108,14,2018,11,3
Group 3,RRG,1.5,17,14,2109,8,2018,11,-3
Group 3,RRG,1.5,17,14,2110,8,2018,12,-4
Group 3,RRG,1.5,17,14,2111,12,2018,8,4
Group 3,RRG,1.5,17,14,2112,13,2018,9,4
Group 3,RRG,1.5,17,14,2113,14,2018,14,0
Group 3,RRG,1.5,17,14,2114,13,2018,12,1
Group 3,RRG,1.5,17,14,2115,13,2018,10,3
Group 3,RRG,1.5,17,14,2116,10,2018,9,1
Group 3,RRG,1.5,17,14,2117,14,2018,11,3
Group 3,RRG,1.5,17,14,2118,11,2018,12,-1
Group 3,RRG,1.5,17,14,2119,11,2018,6,5
Group 3,RRG,1.5,17,14,2120,11,2018,12,-1
Group 3,RRG,1.5,17,14,2121,10,2018,12,-2
Group 3,RRG,1.5,17,14,2122,6,2018,6,0
Group 3,RRG,1.5,17,14,2123,6,2018,11,-5
Group 3,RRG,1.5,17,14,2124,11,2018,9,2
Group 3,RRG,1.5,17,14,2125,8,2018,6,2
Group 3,RRG,1.5,17,14,2126,7,2018,8,-1
Group 3,RRG,1.5,17,14,2127,11,2018,9,2
Group 3,RRG,1.5,17,14,2128,9,2018,13,-4
Group 3,RRG,1.5,17,14,2129,14,2018,12,2
Group 3,RRG,1.5,17,14,2130,12,2018,12,0
Group 3,RRG,1.5,17,14,2131,12,2018,9,3
Group 3,RRG,1.5,17,14,2132,13,2018,13,0
Group 3,RRG,1.5,17,14,2133,11,2018,12,-1
Group 3,RRG,1.5,17,14,2134,11,2018,10,1
Group 3,RRG,1.5,17,14,2135,10,2018,8,2
Group 3,RRG,1.5,17,14,2136,8,2018,13,-5
Group 3,RRG,1.5,17,14,2137,13,2018,11,2
Group 3,RRG,1.5,17,14,2138,13,2018,9,4
Group 3,RRG,1.5,17,14,2139,12,2018,10,2
Group 3,RRG,1.5,17,14,2140,11,2018,10,1
Group 3,RRG,1.5,17,14,2141,11,2018,10,1
Group 3,RRG,1.5,17,14,2142,10,2018,11,-1
Group 3,RRG,1.5,17,14,2143,13,2018,13,0
Group 3,RRG,1.5,17,14,2144,10,2018,8,2
Group 3,RRG,1.5,17,14,2145,10,2018,11,-1
Group 3,RRG,1.5,17,14,2146,12,2018,10,2
Group 3,RRG,1.5,17,14,2147,11,2018,9,2
Group 3,RRG,1.5,17,14,2148,11,2018,10,1
Group 3,RRG,1.5,17,14,2149,12,2018,13,-1
Group 3,RRG,1.5,17,14,2150,13,2018,9,4
Group 3,RRG,1.5,17,14,2151,13,2018,9,4
Group 3,RRG,1.5,17,14,2152,9,2018,13,-4
Group 3,RRG,1.5,17,14,2153,13,2018,11,2
Group 3,RRG,1.5,17,14,2154,13,2018,10,3
Group 3,RRG,1.5,17,14,2155,6,2018,10,-4
Group 3,RRG,1.5,17,14,2156,11,2018,10,1
Group 3,RRG,1.5,17,14,2157,11,2018,12,-1
Group 3,RRG,1.5,17,14,2158,13,2018,9,4
Group 3,RRG,1.5,17,14,2159,13,2018,11,2
Group 3,RRG,1.5,17,14,2160,11,2018,11,0
Group 3,RRG,1.5,17,14,2161,12,2018,12,0
Group 3,RRG,1.5,17,14,2162,10,2018,14,-4
Group 3,RRG,1.5,17,14,2163,9,2018,10,-1
Group 3,RRG,1.5,17,14,2164,11,2018,10,1
Group 3,RRG,1.5,17,14,2165,11,2018,11,0
Group 3,RRG,1.5,17,14,2166,13,2018,9,4
Group 3,RRG,1.5,17,14,2167,13,2018,11,2
Group 3,RRG,1.5,17,14,2168,6,2018,11,-5
Group 3,RRG,1.5,17,14,2169,14,2018,12,2
Group 3,RRG,1.5,17,14,2170,14,2018,9,5
Group 3,RRG,1.5,17,14,2171,14,2018,11,3
Group 3,RRG,1.5,17,14,2172,11,2018,4,7
Group 3,RRG,1.5,17,14,2173,11,2018,12,-1
Group 3,RRG,1.5,17,14,2174,6,2018,13,-7
Group 3,RRG,1.5,17,14,2175,11,2018,12,-1
Group 3,RRG,1.5,17,14,2176,11,2018,10,1
Group 3,RRG,1.5,17,14,2177,12,2018,11,1
Group 3,RRG,1.5,17,14,2178,14,2018,10,4
Group 3,RRG,1.5,17,14,2179,13,2018,8,5
Group 3,RRG,1.5,17,14,2180,13,2018,8,5
Group 3,RRG,1.5,17,14,2181,10,2018,10,0
Group 3,RRG,1.5,17,14,2182,11,2018,10,1
Group 3,RRG,1.5,17,14,2183,12,2018,10,2
Group 3,RRG,1.5,17,14,2184,13,2018,11,2
Group 3,RRG,1.5,17,14,2185,12,2018,9,3
Group 3,RRG,1.5,17,14,2186,10,2018,12,-2
Group 3,RRG,1.5,17,14,2187,9,2018,13,-4
Group 3,RRG,1.5,17,14,2188,13,2018,11,2
Group 3,RRG,1.5,17,14,2189,13,2018,12,1
Group 3,RRG,1.5,17,14,2190,11,2018,10,1
Group 3,RRG,1.5,17,14,2191,13,2018,13,0
Group 3,RRG,1.5,17,14,2192,13,2018,10,3
Group 3,RRG,1.5,17,14,2193,14,2018,11,3
Group 3,RRG,1.5,17,14,2194,11,2018,14,-3
Group 3,RRG,1.5,17,14,2195,14,2018,11,3
Group 3,RRG,1.5,17,14,2196,12,2018,11,1
Group 3,RRG,1.5,17,14,2197,13,2018,10,3
Group 3,RRG,1.5,17,14,2198,10,2018,12,-2
Group 3,RRG,1.5,17,14,2199,14,2018,10,4
Group 3,RRG,1.5,17,14,2200,12,2018,10,2
Group 3,RRG,1.5,17,14,2201,12,2018,13,-1
Group 3,RRG,1.5,17,14,2202,10,2018,8,2
Group 3,RRG,1.5,17,14,2203,9,2018,12,-3
Group 3,RRG,1.5,17,14,2204,12,2018,12,0
Group 3,RRG,1.5,17,14,2205,10,2018,11,-1
Group 3,RRG,1.5,17,14,2206,3,2018,10,-7
Group 3,RRG,1.5,17,14,2207,12,2018,14,-2
Group 3,RRG,1.5,17,14,2208,10,2018,10,0
Group 3,RRG,1.5,17,14,2209,12,2018,12,0
Group 3,RRG,1.5,17,14,2210,12,2018,10,2
Group 3,RRG,1.5,17,14,2211,8,2018,10,-2
Group 3,RRG,1.5,17,14,2212,9,2018,9,0
Group 3,RRG,1.5,17,14,2213,9,2018,11,-2
Group 3,RRG,1.5,17,14,2214,12,2018,8,4
Group 3,RRG,1.5,17,14,2215,13,2018,9,4
Group 3,RRG,1.5,17,14,2216,9,2018,6,3
Group 3,RRG,1.5,17,14,2217,8,2018,12,-4
Group 3,RRG,1.5,17,14,2218,13,2018,12,1
Group 3,RRG,1.5,17,14,2219,14,2018,12,2
Group 3,RRG,1.5,17,14,2220,14,2018,10,4
Group 3,RRG,1.5,17,14,2221,10,2018,9,1
Group 3,RRG,1.5,17,14,2222,9,2018,11,-2
Group 3,RRG,1.5,17,14,2223,14,2018,14,0
Group 3,RRG,1.5,17,14,2224,2,2018,9,-7
Group 3,RRG,1.5,17,14,2225,8,2018,12,-4
Group 3,RRG,1.5,17,14,2226,11,2018,12,-1
Group 3,RRG,1.5,17,14,2227,14,2018,13,1
Group 3,RRG,1.5,17,14,2228,9,2018,9,0
Group 3,RRG,1.5,17,14,2229,11,2018,12,-1
Group 3,RRG,1.5,17,14,2230,13,2018,11,2
Group 3,RRG,1.5,17,14,2231,12,2018,13,-1
Group 3,RRG,1.5,17,14,2232,13,2018,12,1
Group 3,RRG,1.5,17,14,2233,8,2018,5,3
Group 3,RRG,1.5,17,14,2234,13,2018,12,1
Group 3,RRG,1.5,17,14,2235,14,2018,14,0
Group 3,RRG,1.5,17,14,2236,6,2018,9,-3
Group 3,RRG,1.5,17,14,2237,8,2018,11,-3
Group 3,RRG,1.5,17,14,2238,10,2018,9,1
Group 3,RRG,1.5,17,14,2239,12,2018,10,2
Group 3,RRG,1.5,17,14,2240,12,2018,12,0
Group 3,RRG,1.5,17,14,2241,14,2018,11,3
Group 3,RRG,1.5,17,14,2242,14,2018,13,1
Group 3,RRG,1.5,17,14,2243,12,2018,12,0
Group 3,RRG,1.5,17,14,2244,13,2018,11,2
Group 3,RRG,1.5,17,14,2245,14,2018,13,1
Group 3,RRG,1.5,17,14,2246,14,2018,8,6
Group 3,RRG,1.5,17,14,2247,14,2018,12,2
Group 3,RRG,1.5,17,14,2248,12,2018,14,-2
Group 3,RRG,1.5,17,14,2249,14,2018,10,4
Group 3,RRG,1.5,17,14,2250,14,2018,12,2
Group 3,RRG,1.5,17,14,2251,13,2018,13,0
Group 3,RRG,1.5,17,14,2252,14,2018,13,1
Group 3,RRG,1.5,17,14,2253,12,2018,13,-1
Group 3,RRG,1.5,17,14,2254,14,2018,12,2
Group 3,RRG,1.5,17,14,2255,14,2018,10,4
Group 3,RRG,1.5,17,14,2256,11,2018,10,1
Group 3,RRG,1.5,17,14,2257,6,2018,10,-4
Group 3,RRG,1.5,17,14,2258,14,2018,10,4
Group 3,RRG,1.5,17,14,2259,11,2018,8,3
Group 3,RRG,1.5,17,14,2260,11,2018,13,-2
Group 3,RRG,1.5,17,14,2261,11,2018,10,1
Group 3,RRG,1.5,17,14,2262,9,2018,10,-1
Group 3,RRG,1.5,17,14,2263,9,2018,9,0
Group 3,RRG,1.5,17,14,2264,8,2018,13,-5
Group 3,RRG,1.5,17,14,2265,10,2018,11,-1
Group 3,RRG,1.5,17,14,2266,14,2018,11,3
Group 3,RRG,1.5,17,14,2267,14,2018,11,3
Group 3,RRG,1.5,17,14,2268,12,2018,13,-1
Group 3,RRG,1.5,17,14,2269,11,2018,9,2
Group 3,RRG,1.5,17,14,2270,13,2018,12,1
Group 3,RRG,1.5,17,14,2271,10,2018,11,-1
Group 3,RRG,1.5,17,14,2272,7,2018,7,0
Group 3,RRG,1.5,17,14,2273,11,2018,8,3
Group 3,RRG,1.5,17,14,2274,12,2018,11,1
Group 3,RRG,1.5,17,14,2275,8,2018,11,-3
Group 3,RRG,1.5,17,14,2276,12,2018,10,2
Group 3,RRG,1.5,17,14,2277,12,2018,12,0
Group 3,RRG,1.5,17,14,2278,13,2018,12,1
Group 3,RRG,1.5,17,14,2279,14,2018,11,3
Group 3,RRG,1.5,17,14,2280,11,2018,13,-2
Group 3,RRG,1.5,17,14,2281,11,2018,14,-3
Group 3,RRG,1.5,17,14,2282,14,2018,10,4
Group 3,RRG,1.5,17,14,2283,14,2018,8,6
Group 3,RRG,1.5,17,14,2284,10,2018,9,1
Group 3,RRG,1.5,17,14,2285,12,2018,13,-1
Group 3,RRG,1.5,17,14,2286,11,2018,12,-1
Group 3,RRG,1.5,17,14,2287,13,2018,12,1
Group 3,RRG,1.5,17,14,2288,10,2018,13,-3
Group 3,RRG,1.5,17,14,2289,12,2018,13,-1
Group 3,RRG,1.5,17,14,2290,12,2018,14,-2
Group 3,RRG,1.5,17,14,2291,12,2018,13,-1
Group 3,RRG,1.5,17,14,2292,13,2018,12,1
Group 3,RRG,1.5,17,14,2293,12,2018,14,-2
Group 3,RRG,1.5,17,14,2294,13,2018,11,2
Group 3,RRG,1.5,17,14,2295,11,2018,11,0
Group 3,RRG,1.5,17,14,2296,11,2018,11,0
Group 3,RRG,1.5,17,14,2297,13,2018,9,4
Group 3,RRG,1.5,17,14,2298,10,2018,12,-2
Group 3,RRG,1.5,17,14,2299,10,2018,13,-3
Group 3,RRG,1.5,17,14,2300,12,2018,11,1
Group 3,RRG,1.5,17,14,2301,8,2018,12,-4
Group 3,RRG,1.5,17,14,2302,8,2018,11,-3
Group 3,RRG,1.5,17,14,2303,13,2018,11,2
Group 3,RRG,1.5,17,14,2304,9,2018,10,-1
Group 3,RRG,1.5,17,14,2305,10,2018,9,1
Group 3,RRG,1.5,17,14,2306,9,2018,9,0
Group 3,RRG,1.5,17,14,2307,11,2018,4,7
Group 3,RRG,1.5,17,14,2308,13,2018,11,2
Group 3,RRG,1.5,17,14,2309,10,2018,10,0
Group 3,RRG,1.5,17,14,2310,11,2018,13,-2
Group 3,RRG,1.5,17,14,2311,13,2018,11,2
Group 3,RRG,1.5,17,14,2312,6,2018,8,-2
Group 3,RRG,1.5,17,14,2313,9,2018,5,4
Group 3,RRG,1.5,17,14,2314,8,2018,7,1
Group 3,RRG,1.5,17,14,2315,13,2018,11,2
Group 3,RRG,1.5,17,14,2316,13,2018,9,4
Group 3,RRG,1.5,17,14,2317,14,2018,13,1
Group 3,RRG,1.5,17,14,2318,12,2018,10,2
Group 3,RRG,1.5,17,14,2319,14,2018,12,2
Group 3,RRG,1.5,17,14,2320,11,2018,12,-1
Group 3,RRG,1.5,17,14,2321,11,2018,13,-2
Group 3,RRG,1.5,17,14,2322,13,2018,10,3
Group 3,RRG,1.5,17,14,2323,12,2018,10,2
Group 3,RRG,1.5,17,14,2324,14,2018,14,0
Group 3,RRG,1.5,17,14,2325,10,2018,10,0
Group 3,RRG,1.5,17,14,2326,13,2018,14,-1
Group 3,RRG,1.5,17,14,2327,11,2018,13,-2
Group 3,RRG,1.5,17,14,2328,13,2018,10,3
Group 3,RRG,1.5,17,14,2329,8,2018,9,-1
Group 3,RRG,1.5,17,14,2330,7,2018,9,-2
Group 3,RRG,1.5,17,14,2331,8,2018,9,-1
Group 3,RRG,1.5,17,14,2332,11,2018,12,-1
Group 3,RRG,1.5,17,14,2333,11,2018,8,3
Group 3,RRG,1.5,17,14,2334,11,2018,10,1
Group 3,RRG,1.5,17,14,2335,11,2018,8,3
Group 3,RRG,1.5,17,14,2336,13,2018,11,2
Group 3,RRG,1.5,17,14,2337,11,2018,9,2
Group 3,RRG,1.5,17,14,2338,12,2018,13,-1
Group 3,RRG,1.5,17,14,2339,14,2018,10,4
Group 3,RRG,1.5,17,14,2340,14,2018,14,0
Group 3,RRG,1.5,17,14,2341,11,2018,8,3
Group 3,RRG,1.5,17,14,2342,11,2018,10,1
Group 3,RRG,1.5,17,14,2343,12,2018,10,2
Group 3,RRG,1.5,17,14,2344,14,2018,14,0
Group 3,RRG,1.5,17,14,2345,13,2018,11,2
Group 3,RRG,1.5,17,14,2346,11,2018,10,1
Group 3,RRG,1.5,17,14,2347,11,2018,12,-1
Group 3,RRG,1.5,17,14,2348,10,2018,11,-1
Group 3,RRG,1.5,17,14,2349,12,2018,8,4
Group 3,RRG,1.5,17,14,2350,14,2018,12,2
Group 3,RRG,1.5,17,14,2351,12,2018,11,1
Group 3,RRG,1.5,17,14,2352,12,2018,11,1
Group 3,RRG,1.5,17,14,2353,14,2018,11,3
Group 3,RRG,1.5,17,14,2354,12,2018,8,4
Group 3,RRG,1.5,17,14,2355,14,2018,12,2
Group 3,RRG,1.5,17,14,2356,14,2018,12,2
Group 3,RRG,1.5,17,14,2357,8,2018,10,-2
Group 3,RRG,1.5,17,14,2358,10,2018,12,-2
Group 3,RRG,1.5,17,14,2359,9,2018,12,-3
Group 3,RRG,1.5,17,14,2360,7,2018,11,-4
Group 3,RRG,1.5,17,14,2361,14,2018,13,1
Group 3,RRG,1.5,17,14,2362,12,2018,12,0
Group 3,RRG,1.5,17,14,2363,12,2018,10,2
Group 3,RRG,1.5,17,14,2364,11,2018,10,1
Group 3,RRG,1.5,17,14,2365,13,2018,9,4
Group 3,RRG,1.5,17,14,2366,12,2018,11,1
Group 3,RRG,1.5,17,14,2367,13,2018,13,0
Group 3,RRG,1.5,17,14,2368,10,2018,13,-3
Group 3,RRG,1.5,17,14,2369,10,2018,8,2
Group 3,RRG,1.5,17,14,2370,12,2018,6,6
Group 3,RRG,1.5,17,14,2371,13,2018,10,3
Group 3,RRG,1.5,17,14,2372,13,2018,10,3
Group 3,RRG,1.5,17,14,2373,8,2018,11,-3
Group 3,RRG,1.5,17,14,2374,14,2018,13,1
Group 3,RRG,1.5,17,14,2375,11,2018,11,0
Group 3,RRG,1.5,17,14,2376,9,2018,9,0
Group 3,RRG,1.5,17,14,2377,11,2018,10,1
Group 3,RRG,1.5,17,14,2378,13,2018,10,3
Group 3,RRG,1.5,17,14,2379,4,2018,10,-6
Group 3,RRG,1.5,17,14,2380,12,2018,13,-1
Group 3,RRG,1.5,17,14,2381,10,2018,7,3
Group 3,RRG,1.5,17,14,2382,10,2018,13,-3
Group 3,RRG,1.5,17,14,2383,12,2018,11,1
Group 3,RRG,1.5,17,14,2384,13,2018,13,0
Group 3,RRG,1.5,17,14,2385,10,2018,7,3
Group 3,RRG,1.5,17,14,2386,12,2018,8,4
Group 3,RRG,1.5,17,14,2387,11,2018,12,-1
Group 3,RRG,1.5,17,14,2388,13,2018,11,2
Group 3,RRG,1.5,17,14,2389,14,2018,13,1
Group 3,RRG,1.5,17,14,2390,14,2018,13,1
Group 3,RRG,1.5,17,14,2391,13,2018,12,1
Group 3,RRG,1.5,17,14,2392,14,2018,9,5
Group 3,RRG,1.5,17,14,2393,12,2018,12,0
Group 3,RRG,1.5,17,14,2394,10,2018,11,-1
Group 3,RRG,1.5,17,14,2395,11,2018,12,-1
Group 3,RRG,1.5,17,14,2396,13,2018,14,-1
Group 3,RRG,1.5,17,14,2397,11,2018,10,1
Group 3,RRG,1.5,17,14,2398,10,2018,11,-1
Group 3,RRG,1.5,17,14,2399,12,2018,11,1
Group 3,RRG,1.5,17,14,2400,12,2018,11,1
Group 3,RRG,1.5,17,14,2401,13,2018,12,1
Group 3,RRG,1.5,17,14,2402,13,2018,11,2
Group 3,RRG,1.5,17,14,2403,12,2018,11,1
Group 3,RRG,1.5,17,14,2404,12,2018,11,1
Group 3,RRG,1.5,17,14,2405,14,2018,12,2
Group 3,RRG,1.5,17,14,2406,13,2018,10,3
Group 3,RRG,1.5,17,14,2407,13,2018,12,1
Group 3,RRG,1.5,17,14,2408,10,2018,13,-3
Group 3,RRG,1.5,17,14,2409,12,2018,10,2
Group 3,RRG,1.5,17,14,2410,8,2018,10,-2
Group 3,RRG,1.5,17,14,2411,12,2018,11,1
Group 3,RRG,1.5,17,14,2412,11,2018,13,-2
Group 3,RRG,1.5,17,14,2413,10,2018,10,0
Group 3,RRG,1.5,17,14,2414,13,2018,11,2
Group 3,RRG,1.5,17,14,2415,13,2018,10,3
Group 3,RRG,1.5,17,14,2416,10,2018,13,-3
Group 3,RRG,1.5,17,14,2417,13,2018,13,0
Group 3,RRG,1.5,17,14,2418,8,2018,11,-3
Group 3,RRG,1.5,17,14,2419,10,2018,12,-2
Group 3,RRG,1.5,17,14,2420,13,2018,10,3
Group 3,RRG,1.5,17,14,2421,11,2018,11,0
Group 3,RRG,1.5,17,14,2422,12,2018,12,0
Group 3,RRG,1.5,17,14,2423,14,2018,11,3
Group 3,RRG,1.5,17,14,2424,9,2018,12,-3
Group 3,RRG,1.5,17,14,2425,12,2018,13,-1
Group 3,RRG,1.5,17,14,2426,12,2018,11,1
Group 3,RRG,1.5,17,14,2427,11,2018,11,0
Group 3,RRG,1.5,17,14,2428,7,2018,12,-5
Group 3,RRG,1.5,17,14,2429,11,2018,8,3
Group 3,RRG,1.5,17,14,2430,12,2018,11,1
Group 3,RRG,1.5,17,14,2431,12,2018,9,3
Group 3,RRG,1.5,17,14,2432,11,2018,13,-2
Group 3,RRG,1.5,17,14,2433,13,2018,12,1
Group 3,RRG,1.5,17,14,2434,13,2018,10,3
Group 3,RRG,1.5,17,14,2435,9,2018,9,0
Group 3,RRG,1.5,17,14,2436,12,2018,10,2
Group 3,RRG,1.5,17,14,2437,14,2018,12,2
Group 3,RRG,1.5,17,14,2438,7,2018,13,-6
Group 3,RRG,1.5,17,14,2439,13,2018,13,0
Group 3,RRG,1.5,17,14,2440,11,2018,12,-1
Group 3,RRG,1.5,17,14,2441,13,2018,7,6
Group 3,RRG,1.5,17,14,2442,12,2018,14,-2
Group 3,RRG,1.5,17,14,2443,12,2018,12,0
Group 3,RRG,1.5,17,14,2444,13,2018,12,1
Group 3,RRG,1.5,17,14,2445,12,2018,10,2
Group 3,RRG,1.5,17,14,2446,12,2018,11,1
Group 3,RRG,1.5,17,14,2447,11,2018,11,0
Group 3,RRG,1.5,17,14,2448,10,2018,9,1
Group 3,RRG,1.5,17,14,2449,12,2018,10,2
Group 3,RRG,1.5,17,14,2450,8,2018,8,0
Group 3,RRG,1.5,17,14,2451,11,2018,2,9
Group 3,RRG,1.5,17,14,2452,10,2018,10,0
Group 3,RRG,1.5,17,14,2453,10,2018,11,-1
Group 3,RRG,1.5,17,14,2454,10,2018,9,1
Group 3,RRG,1.5,17,14,2455,5,2018,10,-5
Group 3,RRG,1.5,17,14,2456,6,2018,11,-5
Group 3,RRG,1.5,17,14,2457,10,2018,4,6
Group 3,RRG,1.5,17,14,2458,10,2018,11,-1
Group 3,RRG,1.5,17,14,2459,10,2018,12,-2
Group 3,RRG,1.5,17,14,2460,12,2018,13,-1
Group 3,RRG,1.5,17,14,2461,12,2018,12,0
Group 3,RRG,1.5,17,14,2462,12,2018,13,-1
Group 3,RRG,1.5,17,14,2463,12,2018,10,2
Group 3,RRG,1.5,17,14,2464,11,2018,12,-1
Group 3,RRG,1.5,17,14,2465,14,2018,12,2
Group 3,RRG,1.5,17,14,2466,14,2018,11,3
Group 3,RRG,1.5,17,14,2467,10,2018,11,-1
Group 3,RRG,1.5,17,14,2468,14,2018,13,1
Group 3,RRG,1.5,17,14,2469,13,2018,11,2
Group 3,RRG,1.5,17,14,2470,12,2018,10,2
Group 3,RRG,1.5,17,14,2471,12,2018,11,1
Group 3,RRG,1.5,17,14,2472,14,2018,14,0
Group 3,RRG,1.5,17,14,2473,13,2018,9,4
Group 3,RRG,1.5,17,14,2474,12,2018,12,0
Group 3,RRG,1.5,17,14,2475,12,2018,10,2
Group 3,RRG,1.5,17,14,2476,14,2018,13,1
Group 3,RRG,1.5,17,14,2477,9,2018,11,-2
Group 3,RRG,1.5,17,14,2478,11,2018,10,1
Group 3,RRG,1.5,17,14,2479,13,2018,7,6
Group 3,RRG,1.5,17,14,2480,13,2018,13,0
Group 3,RRG,1.5,17,14,2481,13,2018,14,-1
Group 3,RRG,1.5,17,14,2482,14,2018,11,3
Group 3,RRG,1.5,17,14,2483,14,2018,13,1
Group 3,RRG,1.5,17,14,2484,9,2018,10,-1
Group 3,RRG,1.5,17,14,2485,8,2018,14,-6
Group 3,RRG,1.5,17,14,2486,11,2018,12,-1
Group 3,RRG,1.5,17,14,2487,13,2018,13,0
Group 3,RRG,1.5,17,14,2488,9,2018,8,1
Group 3,RRG,1.5,17,14,2489,11,2018,12,-1
Group 3,RRG,1.5,17,14,2490,11,2018,13,-2
Group 3,RRG,1.5,17,14,2491,14,2018,13,1
Group 3,RRG,1.5,17,14,2492,9,2018,8,1
Group 3,RRG,1.5,17,14,2493,14,2018,11,3
Group 3,RRG,1.5,17,14,2494,12,2018,13,-1
Group 3,RRG,1.5,17,14,2495,10,2018,9,1
Group 3,RRG,1.5,17,14,2496,13,2018,12,1
Group 3,RRG,1.5,17,14,2497,13,2018,14,-1
Group 3,RRG,1.5,17,14,2498,12,2018,11,1
Group 3,RRG,1.5,17,14,2499,11,2018,10,1
Group 3,RRG,1.5,17,14,2500,9,2018,11,-2
Group 3,RRG,1.5,17,14,2501,5,2018,7,-2
Group 3,RRG,1.5,17,14,2502,6,2018,8,-2
Group 3,RRG,1.5,17,14,2503,12,2018,11,1
Group 3,RRG,1.5,17,14,2504,13,2018,12,1
Group 3,RRG,1.5,17,14,2505,13,2018,8,5
Group 3,RRG,1.5,17,14,2506,13,2018,7,6
Group 3,RRG,1.5,17,14,2507,10,2018,10,0
Group 3,RRG,1.5,17,14,2508,11,2018,9,2
Group 3,RRG,1.5,17,14,2509,10,2018,10,0
Group 3,RRG,1.5,17,14,2510,8,2018,10,-2
Group 3,RRG,1.5,17,14,2511,11,2018,11,0
Group 3,RRG,1.5,17,14,2512,10,2018,11,-1
Group 3,RRG,1.5,17,14,2513,12,2018,11,1
Group 3,RRG,1.5,17,14,2514,8,2018,11,-3
Group 3,RRG,1.5,17,14,2515,9,2018,14,-5
Group 3,RRG,1.5,17,14,2516,11,2018,13,-2
Group 3,RRG,1.5,17,14,2517,12,2018,13,-1
Group 3,RRG,1.5,17,14,2518,11,2018,12,-1
Group 3,RRG,1.5,17,14,2519,10,2018,12,-2
Group 3,RRG,1.5,17,14,2520,12,2018,13,-1
Group 3,RRG,1.5,17,14,2521,11,2018,11,0
Group 3,RRG,1.5,17,14,2522,8,2018,13,-5
Group 3,RRG,1.5,17,14,2523,12,2018,11,1
Group 3,RRG,1.5,17,14,2524,13,2018,11,2
Group 3,RRG,1.5,17,14,2525,12,2018,13,-1
Group 3,RRG,1.5,17,14,2526,11,2018,10,1
Group 3,RRG,1.5,17,14,2527,9,2018,9,0
Group 3,RRG,1.5,17,14,2528,10,2018,12,-2
Group 3,RRG,1.5,17,14,2529,14,2018,14,0
Group 3,RRG,1.5,17,14,2530,9,2018,13,-4
Group 3,RRG,1.5,17,14,2531,10,2018,7,3
Group 3,RRG,1.5,17,14,2532,14,2018,10,4
Group 3,RRG,1.5,17,14,2533,11,2018,12,-1
Group 3,RRG,1.5,17,14,2534,14,2018,11,3
Group 3,RRG,1.5,17,14,2535,13,2018,13,0
Group 3,RRG,1.5,17,14,2536,14,2018,13,1
Group 3,RRG,1.5,17,14,2537,14,2018,14,0
Group 3,RRG,1.5,17,14,2538,8,2018,8,0
Group 3,RRG,1.5,17,14,2539,13,2018,12,1
Group 3,RRG,1.5,17,14,2540,9,2018,10,-1
Group 3,RRG,1.5,17,14,2541,10,2018,12,-2
Group 3,RRG,1.5,17,14,2542,11,2018,13,-2
Group 3,RRG,1.5,17,14,2543,11,2018,12,-1
Group 3,RRG,1.5,17,14,2544,11,2018,10,1
Group 3,RRG,1.5,17,14,2545,10,2018,12,-2
Group 3,RRG,1.5,17,14,2546,12,2018,12,0
Group 3,RRG,1.5,17,14,2547,10,2018,13,-3
Group 3,RRG,1.5,17,14,2548,10,2018,9,1
Group 3,RRG,1.5,17,14,2549,10,2018,13,-3
Group 3,RRG,1.5,17,14,2550,14,2018,10,4
Group 3,RRG,1.5,17,14,2551,8,2018,12,-4
Group 3,RRG,1.5,17,14,2552,14,2018,13,1
Group 3,RRG,1.5,17,14,2553,12,2018,5,7
Group 3,RRG,1.5,17,14,2554,11,2018,11,0
Group 3,RRG,1.5,17,14,2555,14,2018,11,3
Group 3,RRG,1.5,17,14,2556,11,2018,11,0
Group 3,RRG,1.5,17,14,2557,9,2018,10,-1
Group 3,RRG,1.5,17,14,2558,14,2018,11,3
Group 3,RRG,1.5,17,14,2559,9,2018,14,-5
Group 3,RRG,1.5,17,14,2560,9,2018,5,4
Group 3,RRG,1.5,17,14,2561,8,2018,10,-2
Group 3,RRG,1.5,17,14,2562,9,2018,11,-2
Group 3,RRG,1.5,17,14,2563,11,2018,10,1
Group 3,RRG,1.5,17,14,2564,13,2018,9,4
Group 3,RRG,1.5,17,14,2565,11,2018,12,-1
Group 3,RRG,1.5,17,14,2566,12,2018,11,1
Group 3,RRG,1.5,17,14,2567,13,2018,11,2
Group 3,RRG,1.5,17,14,2568,14,2018,12,2
Group 3,RRG,1.5,17,14,2569,8,2018,7,1
Group 3,RRG,1.5,17,14,2570,12,2018,10,2
Group 3,RRG,1.5,17,14,2571,14,2018,11,3
Group 3,RRG,1.5,17,14,2572,10,2018,11,-1
Group 3,RRG,1.5,17,14,2573,13,2018,14,-1
Group 3,RRG,1.5,17,14,2574,12,2018,12,0
Group 3,RRG,1.5,17,14,2575,14,2018,14,0
Group 3,RRG,1.5,17,14,2576,10,2018,14,-4
Group 3,RRG,1.5,17,14,2577,12,2018,14,-2
Group 3,RRG,1.5,17,14,2578,13,2018,11,2
Group 3,RRG,1.5,17,14,2579,8,2018,12,-4
Group 3,RRG,1.5,17,14,2580,11,2018,10,1
Group 3,RRG,1.5,17,14,2581,10,2018,8,2
Group 3,RRG,1.5,17,14,2582,8,2018,12,-4
Group 3,RRG,1.5,17,14,2583,9,2018,9,0
Group 3,RRG,1.5,17,14,2584,12,2018,11,1
Group 3,RRG,1.5,17,14,2585,10,2018,12,-2
Group 3,RRG,1.5,17,14,2586,14,2018,8,6
Group 3,RRG,1.5,17,14,2587,12,2018,12,0
Group 3,RRG,1.5,17,14,2588,12,2018,11,1
Group 3,RRG,1.5,17,14,2589,13,2018,11,2
Group 3,RRG,1.5,17,14,2590,11,2018,11,0
Group 3,RRG,1.5,17,14,2591,11,2018,8,3
Group 3,RRG,1.5,17,14,2592,6,2018,12,-6
Group 3,RRG,1.5,17,14,2593,14,2018,13,1
Group 3,RRG,1.5,17,14,2594,6,2018,12,-6
Group 3,RRG,1.5,17,14,2595,12,2018,12,0
Group 3,RRG,1.5,17,14,2596,12,2018,12,0
Group 3,RRG,1.5,17,14,2597,11,2018,12,-1
Group 3,RRG,1.5,17,14,2598,7,2018,11,-4
Group 3,RRG,1.5,17,14,2599,12,2018,12,0
Group 3,RRG,1.5,17,14,2600,12,2018,10,2
Group 3,RRG,1.5,17,14,2601,10,2018,12,-2
Group 3,RRG,1.5,17,14,2602,9,2018,13,-4
Group 3,RRG,1.5,17,14,2603,12,2018,12,0
Group 3,RRG,1.5,17,14,2604,12,2018,14,-2
Group 3,RRG,1.5,17,14,2605,8,2018,11,-3
Group 3,RRG,1.5,17,14,2606,13,2018,12,1
Group 3,RRG,1.5,17,14,2607,10,2018,14,-4
Group 3,RRG,1.5,17,14,2608,14,2018,13,1
Group 3,RRG,1.5,17,14,2609,12,2018,9,3
Group 3,RRG,1.5,17,14,2610,12,2018,11,1
Group 3,RRG,1.5,17,14,2611,12,2018,14,-2
Group 3,RRG,1.5,17,14,2612,11,2018,12,-1
Group 3,RRG,1.5,17,14,2613,9,2018,10,-1
Group 3,RRG,1.5,17,14,2614,11,2018,13,-2
Group 3,RRG,1.5,17,14,2615,12,2018,12,0
Group 3,RRG,1.5,17,14,2616,12,2018,11,1
Group 3,RRG,1.5,17,14,2617,14,2018,13,1
Group 3,RRG,1.5,17,14,2618,8,2018,10,-2
Group 3,RRG,1.5,17,14,2619,11,2018,11,0
Group 3,RRG,1.5,17,14,2620,12,2018,10,2
Group 3,RRG,1.5,17,14,2621,9,2018,8,1
Group 3,RRG,1.5,17,14,2622,13,2018,13,0
Group 3,RRG,1.5,17,14,2623,12,2018,11,1
Group 3,RRG,1.5,17,14,2624,11,2018,13,-2
Group 3,RRG,1.5,17,14,2625,12,2018,12,0
Group 3,RRG,1.5,17,14,2626,11,2018,12,-1
Group 3,RRG,1.5,17,14,2627,9,2018,9,0
Group 3,RRG,1.5,17,14,2628,11,2018,11,0
Group 3,RRG,1.5,17,14,2629,14,2018,13,1
Group 3,RRG,1.5,17,14,2630,12,2018,11,1
Group 3,RRG,1.5,17,14,2631,14,2018,14,0
Group 3,RRG,1.5,17,14,2632,12,2018,8,4
Group 3,RRG,1.5,17,14,2633,13,2018,14,-1
Group 3,RRG,1.5,17,14,2634,10,2018,10,0
Group 3,RRG,1.5,17,14,2635,8,2018,10,-2
Group 3,RRG,1.5,17,14,2636,8,2018,9,-1
Group 3,RRG,1.5,17,14,2637,10,2018,8,2
Group 3,RRG,1.5,17,14,2638,10,2018,10,0
Group 3,RRG,1.5,17,14,2639,14,2018,13,1
Group 3,RRG,1.5,17,14,2640,14,2018,10,4
Group 3,RRG,1.5,17,14,2641,12,2018,12,0
Group 3,RRG,1.5,17,14,2642,12,2018,12,0
Group 3,RRG,1.5,17,14,2643,12,2018,11,1
Group 3,RRG,1.5,17,14,2644,12,2018,11,1
Group 3,RRG,1.5,17,14,2645,13,2018,11,2
Group 3,RRG,1.5,17,14,2646,12,2018,11,1
Group 3,RRG,1.5,17,14,2647,11,2018,11,0
Group 3,RRG,1.5,17,14,2648,12,2018,11,1
Group 3,RRG,1.5,17,14,2649,12,2018,10,2
Group 3,RRG,1.5,17,14,2650,12,2018,11,1
Group 3,RRG,1.5,17,14,2651,10,2018,10,0
Group 3,RRG,1.5,17,14,2652,13,2018,13,0
Group 3,RRG,1.5,17,14,2653,13,2018,10,3
Group 3,RRG,1.5,17,14,2654,13,2018,12,1
Group 3,RRG,1.5,17,14,2655,11,2018,9,2
Group 3,RRG,1.5,17,14,2656,10,2018,11,-1
Group 3,RRG,1.5,17,14,2657,10,2018,11,-1
Group 3,RRG,1.5,17,14,2658,11,2018,10,1
Group 3,RRG,1.5,17,14,2659,12,2018,13,-1
Group 3,RRG,1.5,17,14,2660,10,2018,8,2
Group 3,RRG,1.5,17,14,2661,11,2018,10,1
Group 3,RRG,1.5,17,14,2662,12,2018,10,2
Group 3,RRG,1.5,17,14,2663,14,2018,14,0
Group 3,RRG,1.5,17,14,2664,11,2018,12,-1
Group 3,RRG,1.5,17,14,2665,7,2018,10,-3
Group 3,RRG,1.5,17,14,2666,11,2018,13,-2
Group 3,RRG,1.5,17,14,2667,10,2018,11,-1
Group 3,RRG,1.5,17,14,2668,10,2018,10,0
Group 3,RRG,1.5,17,14,2669,14,2018,9,5
Group 3,RRG,1.5,17,14,2670,11,2018,11,0
Group 3,RRG,1.5,17,14,2671,11,2018,11,0
Group 3,RRG,1.5,17,14,2672,11,2018,11,0
Group 3,RRG,1.5,17,14,2673,12,2018,11,1
Group 3,RRG,1.5,17,14,2674,12,2018,12,0
Group 3,RRG,1.5,17,14,2675,12,2018,11,1
Group 3,RRG,1.5,17,14,2676,14,2018,12,2
Group 3,RRG,1.5,17,14,2677,12,2018,11,1
Group 3,RRG,1.5,17,14,2678,10,2018,10,0
Group 3,RRG,1.5,17,14,2679,13,2018,12,1
Group 3,RRG,1.5,17,14,2680,10,2018,11,-1
Group 3,RRG,1.5,17,14,2681,13,2018,10,3
Group 3,RRG,1.5,17,14,2682,11,2018,13,-2
Group 3,RRG,1.5,17,14,2683,14,2018,13,1
Group 3,RRG,1.5,17,14,2684,13,2018,10,3
Group 3,RRG,1.5,17,14,2685,10,2018,13,-3
Group 3,RRG,1.5,17,14,2686,12,2018,12,0
Group 3,RRG,1.5,17,14,2687,13,2018,12,1
Group 3,RRG,1.5,17,14,2688,8,2018,12,-4
Group 3,RRG,1.5,17,14,2689,11,2018,7,4
Group 3,RRG,1.5,17,14,2690,12,2018,10,2
Group 3,RRG,1.5,17,14,2691,14,2018,13,1
Group 3,RRG,1.5,17,14,2692,14,2018,14,0
Group 3,RRG,1.5,17,14,2693,14,2018,14,0
Group 3,RRG,1.5,17,14,2694,13,2018,12,1
Group 3,RRG,1.5,17,14,2695,12,2018,9,3
Group 3,RRG,1.5,17,14,2696,11,2018,10,1
Group 3,RRG,1.5,17,14,2697,13,2018,10,3
Group 3,RRG,1.5,17,14,2698,13,2018,14,-1
Group 3,RRG,1.5,17,14,2699,6,2018,9,-3
Group 3,RRG,1.5,17,14,2700,9,2018,11,-2
Group 3,RRG,1.5,17,14,2701,14,2018,13,1
Group 3,RRG,1.5,17,14,2702,12,2018,12,0
Group 3,RRG,1.5,17,14,2703,12,2018,13,-1
Group 3,RRG,1.5,17,14,2704,12,2018,14,-2
Group 3,RRG,1.5,17,14,2705,11,2018,14,-3
Group 3,RRG,1.5,17,14,2706,10,2018,11,-1
Group 3,RRG,1.5,17,14,2707,13,2018,13,0
Group 3,RRG,1.5,17,14,2708,6,2018,13,-7
Group 3,RRG,1.5,17,14,2709,11,2018,10,1
Group 3,RRG,1.5,17,14,2710,10,2018,9,1
Group 3,RRG,1.5,17,14,2711,13,2018,14,-1
Group 3,RRG,1.5,17,14,2712,9,2018,11,-2
Group 3,RRG,1.5,17,14,2713,11,2018,11,0
Group 3,RRG,1.5,17,14,2714,9,2018,9,0
Group 3,RRG,1.5,17,14,2715,12,2018,13,-1
Group 3,RRG,1.5,17,14,2716,7,2018,7,0
Group 3,RRG,1.5,17,14,2717,9,2018,7,2
Group 3,RRG,1.5,17,14,2718,11,2018,9,2
Group 3,RRG,1.5,17,14,2719,10,2018,10,0
Group 3,RRG,1.5,17,14,2720,12,2018,14,-2
Group 3,RRG,1.5,17,14,2721,14,2018,9,5
Group 3,RRG,1.5,17,14,2722,14,2018,14,0
Group 3,RRG,1.5,17,14,2723,12,2018,11,1
Group 3,RRG,1.5,17,14,2724,13,2018,11,2
Group 3,RRG,1.5,17,14,2725,8,2018,10,-2
Group 3,RRG,1.5,17,14,2726,10,2018,8,2
Group 3,RRG,1.5,17,14,2727,12,2018,10,2
Group 3,RRG,1.5,17,14,2728,11,2018,6,5
Group 3,RRG,1.5,17,14,2729,11,2018,10,1
Group 3,RRG,1.5,17,14,2730,12,2018,10,2
Group 3,RRG,1.5,17,14,2731,12,2018,12,0
Group 3,RRG,1.5,17,14,2732,11,2018,11,0
Group 3,RRG,1.5,17,14,2733,13,2018,11,2
Group 3,RRG,1.5,17,14,2734,7,2018,10,-3
Group 3,RRG,1.5,17,14,2735,8,2018,8,0
Group 3,RRG,1.5,17,14,2736,13,2018,13,0
Group 3,RRG,1.5,17,14,2737,13,2018,10,3
Group 3,RRG,1.5,17,14,2738,12,2018,12,0
Group 3,RRG,1.5,17,14,2739,13,2018,11,2
Group 3,RRG,1.5,17,14,2740,14,2018,11,3
Group 3,RRG,1.5,17,14,2741,11,2018,10,1
Group 3,RRG,1.5,17,14,2742,11,2018,11,0
Group 3,RRG,1.5,17,14,2743,13,2018,11,2
Group 3,RRG,1.5,17,14,2744,9,2018,11,-2
Group 3,RRG,1.5,17,14,2745,11,2018,11,0
Group 3,RRG,1.5,17,14,2746,14,2018,13,1
Group 3,RRG,1.5,17,14,2747,13,2018,14,-1
Group 3,RRG,1.5,17,14,2748,14,2018,14,0
Group 3,RRG,1.5,17,14,2749,10,2018,13,-3
Group 3,RRG,1.5,17,14,2750,12,2018,11,1
Group 3,RRG,1.5,17,14,2751,9,2018,11,-2
Group 3,RRG,1.5,17,14,2752,9,2018,11,-2
Group 3,RRG,1.5,17,14,2753,11,2018,10,1
Group 3,RRG,1.5,17,14,2754,11,2018,8,3
Group 3,RRG,1.5,17,14,2755,10,2018,9,1
Group 3,RRG,1.5,17,14,2756,13,2018,11,2
Group 3,RRG,1.5,17,14,2757,10,2018,11,-1
Group 3,RRG,1.5,17,14,2758,8,2018,10,-2
Group 3,RRG,1.5,17,14,2759,14,2018,13,1
Group 3,RRG,1.5,17,14,2760,13,2018,13,0
Group 3,RRG,1.5,17,14,2761,14,2018,9,5
Group 3,RRG,1.5,17,14,2762,11,2018,11,0
Group 3,RRG,1.5,17,14,2763,11,2018,11,0
Group 3,RRG,1.5,17,14,2764,13,2018,11,2
Group 3,RRG,1.5,17,14,2765,13,2018,11,2
Group 3,RRG,1.5,17,14,2766,14,2018,12,2
Group 3,RRG,1.5,17,14,2767,13,2018,9,4
Group 3,RRG,1.5,17,14,2768,12,2018,13,-1
Group 3,RRG,1.5,17,14,2769,12,2018,12,0
Group 3,RRG,1.5,17,14,2770,12,2018,11,1
Group 3,RRG,1.5,17,14,2771,13,2018,14,-1
Group 3,RRG,1.5,17,14,2772,14,2018,11,3
Group 3,RRG,1.5,17,14,2773,11,2018,12,-1
Group 3,RRG,1.5,17,14,2774,13,2018,14,-1
Group 3,RRG,1.5,17,14,2775,14,2018,12,2
Group 3,RRG,1.5,17,14,2776,13,2018,13,0
Group 3,RRG,1.5,17,14,2777,13,2018,12,1
Group 3,RRG,1.5,17,14,2778,12,2018,11,1
Group 3,RRG,1.5,17,14,2779,11,2018,11,0
Group 3,RRG,1.5,17,14,2780,13,2018,14,-1
Group 3,RRG,1.5,17,14,2781,10,2018,11,-1
Group 3,RRG,1.5,17,14,2782,13,2018,13,0
Group 3,RRG,1.5,17,14,2783,12,2018,12,0
Group 3,RRG,1.5,17,14,2784,13,2018,13,0
Group 3,RRG,1.5,17,14,2785,10,2018,12,-2
Group 3,RRG,1.5,17,14,2786,11,2018,10,1
Group 3,RRG,1.5,17,14,2787,9,2018,13,-4
Group 3,RRG,1.5,17,14,2788,13,2018,11,2
Group 3,RRG,1.5,17,14,2789,12,2018,14,-2
Group 3,RRG,1.5,17,14,2790,10,2018,12,-2
Group 3,RRG,1.5,17,14,2791,8,2018,5,3
Group 3,RRG,1.5,17,14,2792,12,2018,12,0
Group 3,RRG,1.5,17,14,2793,12,2018,12,0
Group 3,RRG,1.5,17,14,2794,11,2018,13,-2
Group 3,RRG,1.5,17,14,2795,10,2018,11,-1
Group 3,RRG,1.5,17,14,2796,10,2018,12,-2
Group 3,RRG,1.5,17,14,2797,12,2018,9,3
Group 3,RRG,1.5,17,14,2798,8,2018,9,-1
Group 3,RRG,1.5,17,14,2799,12,2018,13,-1
Group 3,RRG,1.5,17,14,2800,8,2018,6,2
Group 3,RRG,1.5,17,14,2801,9,2018,12,-3
Group 3,RRG,1.5,17,14,2802,12,2018,9,3
Group 3,RRG,1.5,17,14,2803,11,2018,12,-1
Group 3,RRG,1.5,17,14,2804,10,2018,13,-3
Group 3,RRG,1.5,17,14,2805,13,2018,10,3
Group 3,RRG,1.5,17,14,2806,13,2018,12,1
Group 3,RRG,1.5,17,14,2807,12,2018,14,-2
Group 3,RRG,1.5,17,14,2808,11,2018,11,0
Group 3,RRG,1.5,17,14,2809,11,2018,13,-2
Group 3,RRG,1.5,17,14,2810,9,2018,6,3
Group 3,RRG,1.5,17,14,2811,13,2018,6,7
Group 3,RRG,1.5,17,14,2812,12,2018,11,1
Group 3,RRG,1.5,17,14,2813,8,2018,6,2
Group 3,RRG,1.5,17,14,2814,11,2018,13,-2
Group 3,RRG,1.5,17,14,2815,14,2018,14,0
Group 3,RRG,1.5,17,14,2816,8,2018,10,-2
Group 3,RRG,1.5,17,14,2817,7,2018,4,3
Group 3,RRG,1.5,17,14,2818,9,2018,10,-1
Group 3,RRG,1.5,17,14,2819,14,2018,12,2
Group 3,RRG,1.5,17,14,2820,12,2018,11,1
Group 3,RRG,1.5,17,14,2821,9,2018,9,0
Group 3,RRG,1.5,17,14,2822,8,2018,12,-4
Group 3,RRG,1.5,17,14,2823,13,2018,8,5
Group 3,RRG,1.5,17,14,2824,12,2018,13,-1
Group 3,RRG,1.5,17,14,2825,11,2018,12,-1
Group 3,RRG,1.5,17,14,2826,12,2018,12,0
Group 3,RRG,1.5,17,14,2827,12,2018,8,4
Group 3,RRG,1.5,17,14,2828,13,2018,13,0
Group 3,RRG,1.5,17,14,2829,14,2018,12,2
Group 3,RRG,1.5,17,14,2830,13,2018,10,3
Group 3,RRG,1.5,17,14,2831,13,2018,10,3
Group 3,RRG,1.5,17,14,2832,11,2018,12,-1
Group 3,RRG,1.5,17,14,2833,11,2018,11,0
Group 3,RRG,1.5,17,14,2834,14,2018,12,2
Group 3,RRG,1.5,17,14,2835,13,2018,10,3
Group 3,RRG,1.5,17,14,2836,12,2018,9,3
Group 3,RRG,1.5,17,14,2837,12,2018,11,1
Group 3,RRG,1.5,17,14,2838,11,2018,13,-2
Group 3,RRG,1.5,17,14,2839,11,2018,10,1
Group 3,RRG,1.5,17,14,2840,8,2018,9,-1
Group 3,RRG,1.5,17,14,2841,14,2018,10,4
Group 3,RRG,1.5,17,14,2842,11,2018,13,-2
Group 3,RRG,1.5,17,14,2843,14,2018,11,3
Group 3,RRG,1.5,17,14,2844,14,2018,14,0
Group 3,RRG,1.5,17,14,2845,13,2018,13,0
Group 3,RRG,1.5,17,14,2846,13,2018,14,-1
Group 3,RRG,1.5,17,14,2847,12,2018,13,-1
Group 3,RRG,1.5,17,14,2848,12,2018,11,1
Group 3,RRG,1.5,17,14,2849,9,2018,10,-1
Group 3,RRG,1.5,17,14,2850,14,2018,8,6
Group 3,RRG,1.5,17,14,2851,12,2018,13,-1
Group 3,RRG,1.5,17,14,2852,9,2018,13,-4
Group 3,RRG,1.5,17,14,2853,12,2018,13,-1
Group 3,RRG,1.5,17,14,2854,11,2018,10,1
Group 3,RRG,1.5,17,14,2855,13,2018,11,2
Group 3,RRG,1.5,17,14,2856,9,2018,13,-4
Group 3,RRG,1.5,17,14,2857,9,2018,8,1
Group 3,RRG,1.5,17,14,2858,14,2018,13,1
Group 3,RRG,1.5,17,14,2859,10,2018,11,-1
Group 3,RRG,1.5,17,14,2860,11,2018,9,2
Group 3,RRG,1.5,17,14,2861,9,2018,9,0
Group 3,RRG,1.5,17,14,2862,11,2018,13,-2
Group 3,RRG,1.5,17,14,2863,11,2018,10,1
Group 3,RRG,1.5,17,14,2864,10,2018,11,-1
Group 3,RRG,1.5,17,14,2865,12,2018,14,-2
Group 3,RRG,1.5,17,14,2866,5,2018,8,-3
Group 3,RRG,1.5,17,14,2867,9,2018,11,-2
Group 3,RRG,1.5,17,14,2868,11,2018,9,2
Group 3,RRG,1.5,17,14,2869,11,2018,13,-2
Group 3,RRG,1.5,17,14,2870,11,2018,13,-2
Group 3,RRG,1.5,17,14,2871,10,2018,13,-3
Group 3,RRG,1.5,17,14,2872,11,2018,8,3
Group 3,RRG,1.5,17,14,2873,6,2018,8,-2
Group 3,RRG,1.5,17,14,2874,10,2018,12,-2
Group 3,RRG,1.5,17,14,2875,14,2018,11,3
Group 3,RRG,1.5,17,14,2876,12,2018,12,0
Group 3,RRG,1.5,17,14,2877,13,2018,13,0
Group 3,RRG,1.5,17,14,2878,11,2018,13,-2
Group 3,RRG,1.5,17,14,2879,13,2018,13,0
Group 3,RRG,1.5,17,14,2880,13,2018,10,3
Group 3,RRG,1.5,17,14,2881,10,2018,11,-1
Group 3,RRG,1.5,17,14,2882,11,2018,10,1
Group 3,RRG,1.5,17,14,2883,13,2018,11,2
Group 3,RRG,1.5,17,14,2884,10,2018,11,-1
Group 3,RRG,1.5,17,14,2885,10,2018,9,1
Group 3,RRG,1.5,17,14,2886,12,2018,14,-2
Group 3,RRG,1.5,17,14,2887,11,2018,12,-1
Group 3,RRG,1.5,17,14,2888,14,2018,8,6
Group 3,RRG,1.5,17,14,2889,12,2018,11,1
Group 3,RRG,1.5,17,14,2890,13,2018,14,-1
Group 3,RRG,1.5,17,14,2891,9,2018,11,-2
Group 3,RRG,1.5,17,14,2892,9,2018,12,-3
Group 3,RRG,1.5,17,14,2893,12,2018,10,2
Group 3,RRG,1.5,17,14,2894,10,2018,14,-4
Group 3,RRG,1.5,17,14,2895,14,2018,13,1
Group 3,RRG,1.5,17,14,2896,14,2018,11,3
Group 3,RRG,1.5,17,14,2897,13,2018,12,1
Group 3,RRG,1.5,17,14,2898,10,2018,8,2
Group 3,RRG,1.5,17,14,2899,11,2018,10,1
Group 3,RRG,1.5,17,14,2900,9,2018,10,-1
Group 3,RRG,1.5,17,14,2901,9,2018,10,-1
Group 3,RRG,1.5,17,14,2902,12,2018,11,1
Group 3,RRG,1.5,17,14,2903,13,2018,7,6
Group 3,RRG,1.5,17,14,2904,11,2018,13,-2
Group 3,RRG,1.5,17,14,2905,12,2018,12,0
Group 3,RRG,1.5,17,14,2906,13,2018,12,1
Group 3,RRG,1.5,17,14,2907,11,2018,10,1
Group 3,RRG,1.5,17,14,2908,12,2018,10,2
Group 3,RRG,1.5,17,14,2909,13,2018,8,5
Group 3,RRG,1.5,17,14,2910,11,2018,10,1
Group 3,RRG,1.5,17,14,2911,10,2018,12,-2
Group 3,RRG,1.5,17,14,2912,12,2018,12,0
Group 3,RRG,1.5,17,14,2913,11,2018,9,2
Group 3,RRG,1.5,17,14,2914,13,2018,11,2
Group 3,RRG,1.5,17,14,2915,11,2018,10,1
Group 3,RRG,1.5,17,14,2916,8,2018,12,-4
Group 3,RRG,1.5,17,14,2917,14,2018,12,2
Group 3,RRG,1.5,17,14,2918,12,2018,13,-1
Group 3,RRG,1.5,17,14,2919,14,2018,14,0
Group 3,RRG,1.5,17,14,2920,12,2018,12,0
Group 3,RRG,1.5,17,14,2921,13,2018,12,1
Group 3,RRG,1.5,17,14,2922,12,2018,8,4
Group 3,RRG,1.5,17,14,2923,14,2018,9,5
Group 3,RRG,1.5,17,14,2924,12,2018,9,3
Group 3,RRG,1.5,17,14,2925,13,2018,14,-1
Group 3,RRG,1.5,17,14,2926,12,2018,12,0
Group 3,RRG,1.5,17,14,2927,11,2018,11,0
Group 3,RRG,1.5,17,14,2928,12,2018,11,1
Group 3,RRG,1.5,17,14,2929,14,2018,11,3
Group 3,RRG,1.5,17,14,2930,13,2018,10,3
Group 3,RRG,1.5,17,14,2931,13,2018,14,-1
Group 3,RRG,1.5,17,14,2932,9,2018,9,0
Group 3,RRG,1.5,17,14,2933,14,2018,12,2
Group 3,RRG,1.5,17,14,2934,7,2018,13,-6
Group 3,RRG,1.5,17,14,2935,8,2018,11,-3
Group 3,RRG,1.5,17,14,2936,11,2018,11,0
Group 3,RRG,1.5,17,14,2937,12,2018,11,1
Group 3,RRG,1.5,17,14,2938,12,2018,12,0
Group 3,RRG,1.5,17,14,2939,12,2018,10,2
Group 3,RRG,1.5,17,14,2940,10,2018,12,-2
Group 3,RRG,1.5,17,14,2941,10,2018,13,-3
Group 3,RRG,1.5,17,14,2942,12,2018,12,0
Group 3,RRG,1.5,17,14,2943,13,2018,10,3
Group 3,RRG,1.5,17,14,2944,14,2018,10,4
Group 3,RRG,1.5,17,14,2945,8,2018,11,-3
Group 3,RRG,1.5,17,14,2946,11,2018,12,-1
Group 3,RRG,1.5,17,14,2947,11,2018,13,-2
Group 3,RRG,1.5,17,14,2948,13,2018,11,2
Group 3,RRG,1.5,17,14,2949,13,2018,10,3
Group 3,RRG,1.5,17,14,2950,11,2018,13,-2
Group 3,RRG,1.5,17,14,2951,11,2018,9,2
Group 3,RRG,1.5,17,14,2952,13,2018,9,4
Group 3,RRG,1.5,17,14,2953,13,2018,12,1
Group 3,RRG,1.5,17,14,2954,13,2018,5,8
Group 3,RRG,1.5,17,14,2955,14,2018,11,3
Group 3,RRG,1.5,17,14,2956,14,2018,11,3
Group 3,RRG,1.5,17,14,2957,12,2018,12,0
Group 3,RRG,1.5,17,14,2958,10,2018,11,-1
Group 3,RRG,1.5,17,14,2959,9,2018,13,-4
Group 3,RRG,1.5,17,14,2960,7,2018,8,-1
Group 3,RRG,1.5,17,14,2961,10,2018,8,2
Group 3,RRG,1.5,17,14,2962,14,2018,11,3
Group 3,RRG,1.5,17,14,2963,14,2018,14,0
Group 3,RRG,1.5,17,14,2964,13,2018,13,0
Group 3,RRG,1.5,17,14,2965,13,2018,11,2
Group 3,RRG,1.5,17,14,2966,12,2018,12,0
Group 3,RRG,1.5,17,14,2967,10,2018,11,-1
Group 3,RRG,1.5,17,14,2968,14,2018,14,0
Group 3,RRG,1.5,17,14,2969,12,2018,13,-1
Group 3,RRG,1.5,17,14,2970,12,2018,9,3
Group 3,RRG,1.5,17,14,2971,12,2018,14,-2
Group 3,RRG,1.5,17,14,2972,11,2018,14,-3
Group 3,RRG,1.5,17,14,2973,14,2018,13,1
Group 3,RRG,1.5,17,14,2974,8,2018,13,-5
Group 3,RRG,1.5,17,14,2975,10,2018,10,0
Group 3,RRG,1.5,17,14,2976,12,2018,13,-1
Group 3,RRG,1.5,17,14,2977,10,2018,12,-2
Group 3,RRG,1.5,17,14,2978,11,2018,8,3
Group 3,RRG,1.5,17,14,2979,10,2018,11,-1
Group 3,RRG,1.5,17,14,2980,12,2018,11,1
Group 3,RRG,1.5,17,14,2981,11,2018,7,4
Group 3,RRG,1.5,17,14,2982,10,2018,8,2
Group 3,RRG,1.5,17,14,2983,11,2018,10,1
Group 3,RRG,1.5,17,14,2984,11,2018,8,3
Group 3,RRG,1.5,17,14,2985,14,2018,12,2
Group 3,RRG,1.5,17,14,2986,13,2018,13,0
Group 3,RRG,1.5,17,14,2987,8,2018,8,0
Group 3,RRG,1.5,17,14,2988,10,2018,8,2
Group 3,RRG,1.5,17,14,2989,11,2018,13,-2
Group 3,RRG,1.5,17,14,2990,12,2018,10,2
Group 3,RRG,1.5,17,14,2991,13,2018,9,4
Group 3,RRG,1.5,17,14,2992,13,2018,13,0
Group 3,RRG,1.5,17,14,2993,11,2018,11,0
Group 3,RRG,1.5,17,14,2994,12,2018,12,0
Group 3,RRG,1.5,17,14,2995,10,2018,12,-2
Group 3,RRG,1.5,17,14,2996,13,2018,10,3
Group 3,RRG,1.5,17,14,2997,9,2018,9,0
Group 3,RRG,1.5,17,14,2998,10,2018,10,0
Group 3,RRG,1.5,17,14,2999,9,2018,14,-5
Group 3,RRG,1.5,17,14,3000,9,2018,12,-3
Group 3,RRG,1.5,17,14,3001,11,2018,11,0
Group 3,RRG,1.5,17,14,3002,10,2018,11,-1
Group 3,RRG,1.5,17,14,3003,11,2018,12,-1
Group 3,RRG,1.5,17,14,3004,14,2018,11,3
Group 3,RRG,1.5,17,14,3005,8,2018,12,-4
Group 3,RRG,1.5,17,14,3006,12,2018,12,0
Group 3,RRG,1.5,17,14,3007,12,2018,10,2
Group 3,RRG,1.5,17,14,3008,11,2018,9,2
Group 3,RRG,1.5,17,14,3009,12,2018,14,-2
Group 3,RRG,1.5,17,14,3010,14,2018,12,2
Group 3,RRG,1.5,17,14,3011,8,2018,7,1
Group 3,RRG,1.5,17,14,3012,12,2018,12,0
Group 3,RRG,1.5,17,14,3013,13,2018,12,1
Group 3,RRG,1.5,17,14,3014,14,2018,11,3
Group 3,RRG,1.5,17,14,3015,14,2018,10,4
Group 3,RRG,1.5,17,14,3016,13,2018,14,-1
Group 3,RRG,1.5,17,14,3017,11,2018,10,1
Group 3,RRG,1.5,17,14,3018,13,2018,8,5
Group 3,RRG,1.5,17,14,3019,10,2018,12,-2
Group 3,RRG,1.5,17,14,3020,11,2018,14,-3
Group 3,RRG,1.5,17,14,3021,12,2018,12,0
Group 3,RRG,1.5,17,14,3022,14,2018,10,4
Group 3,RRG,1.5,17,14,3023,13,2018,7,6
Group 3,RRG,1.5,17,14,3024,10,2018,11,-1
Group 3,RRG,1.5,17,14,3025,9,2018,12,-3
Group 3,RRG,1.5,17,14,3026,6,2018,10,-4
Group 3,RRG,1.5,17,14,3027,8,2018,13,-5
Group 3,RRG,1.5,17,14,3028,13,2018,12,1
Group 3,RRG,1.5,17,14,3029,13,2018,13,0
Group 3,RRG,1.5,17,14,3030,8,2018,6,2
Group 3,RRG,1.5,17,14,3031,11,2018,9,2
Group 3,RRG,1.5,17,14,3032,13,2018,10,3
Group 3,RRG,1.5,17,14,3033,9,2018,11,-2
Group 3,RRG,1.5,17,14,3034,14,2018,10,4
Group 3,RRG,1.5,17,14,3035,14,2018,13,1
Group 3,RRG,1.5,17,14,3036,12,2018,10,2
Group 3,RRG,1.5,17,14,3037,10,2018,11,-1
Group 3,RRG,1.5,17,14,3038,13,2018,12,1
Group 3,RRG,1.5,17,14,3039,12,2018,14,-2
Group 3,RRG,1.5,17,14,3040,13,2018,12,1
Group 3,RRG,1.5,17,14,3041,11,2018,10,1
Group 3,RRG,1.5,17,14,3042,5,2018,11,-6
Group 3,RRG,1.5,17,14,3043,11,2018,13,-2
Group 3,RRG,1.5,17,14,3044,13,2018,12,1
Group 3,RRG,1.5,17,14,3045,9,2018,9,0
Group 3,RRG,1.5,17,14,3046,10,2018,10,0
Group 3,RRG,1.5,17,14,3047,12,2018,11,1
Group 3,RRG,1.5,17,14,3048,14,2018,13,1
Group 3,RRG,1.5,17,14,3049,10,2018,11,-1
Group 3,RRG,1.5,17,14,3050,11,2018,7,4
Group 3,RRG,1.5,17,14,3051,8,2018,11,-3
Group 3,RRG,1.5,17,14,3052,7,2018,9,-2
Group 3,RRG,1.5,17,14,3053,13,2018,10,3
Group 3,RRG,1.5,17,14,3054,12,2018,13,-1
Group 3,RRG,1.5,17,14,3055,14,2018,12,2
Group 3,RRG,1.5,17,14,3056,14,2018,9,5
Group 3,RRG,1.5,17,14,3057,12,2018,11,1
Group 3,RRG,1.5,17,14,3058,12,2018,9,3
Group 3,RRG,1.5,17,14,3059,10,2018,11,-1
Group 3,RRG,1.5,17,14,3060,13,2018,14,-1
Group 3,RRG,1.5,17,14,3061,9,2018,10,-1
Group 3,RRG,1.5,17,14,3062,8,2018,12,-4
Group 3,RRG,1.5,17,14,3063,8,2018,6,2
Group 3,RRG,1.5,17,14,3064,8,2018,8,0
Group 3,RRG,1.5,17,14,3065,13,2018,12,1
Group 3,RRG,1.5,17,14,3066,12,2018,9,3
Group 3,RRG,1.5,17,14,3067,14,2018,12,2
Group 3,RRG,1.5,17,14,3068,14,2018,11,3
Group 3,RRG,1.5,17,14,3069,13,2018,13,0
Group 3,RRG,1.5,17,14,3070,11,2018,10,1
Group 3,RRG,1.5,17,14,3071,14,2018,13,1
Group 3,RRG,1.5,17,14,3072,7,2018,13,-6
Group 3,RRG,1.5,17,14,3073,8,2018,11,-3
Group 3,RRG,1.5,17,14,3074,12,2018,13,-1
Group 3,RRG,1.5,17,14,3075,7,2018,8,-1
Group 3,RRG,1.5,17,14,3076,11,2018,8,3
Group 3,RRG,1.5,17,14,3077,11,2018,8,3
Group 3,RRG,1.5,17,14,3078,11,2018,13,-2
Group 3,RRG,1.5,17,14,3079,7,2018,11,-4
Group 3,RRG,1.5,17,14,3080,13,2018,12,1
Group 3,RRG,1.5,17,14,3081,13,2018,12,1
Group 3,RRG,1.5,17,14,3082,14,2018,11,3
Group 3,RRG,1.5,17,14,3083,13,2018,8,5
Group 3,RRG,1.5,17,14,3084,11,2018,14,-3
Group 3,RRG,1.5,17,14,3085,14,2018,10,4
Group 3,RRG,1.5,17,14,3086,11,2018,10,1
Group 3,RRG,1.5,17,14,3087,13,2018,14,-1
Group 3,RRG,1.5,17,14,3088,10,2018,12,-2
Group 3,RRG,1.5,17,14,3089,9,2018,9,0
Group 3,RRG,1.5,17,14,3090,9,2018,10,-1
Group 3,RRG,1.5,17,14,3091,11,2018,12,-1
Group 3,RRG,1.5,17,14,3092,8,2018,11,-3
Group 3,RRG,1.5,17,14,3093,14,2018,10,4
Group 3,RRG,1.5,17,14,3094,10,2018,12,-2
Group 3,RRG,1.5,17,14,3095,9,2018,10,-1
Group 3,RRG,1.5,17,14,3096,11,2018,11,0
Group 3,RRG,1.5,17,14,3097,11,2018,14,-3
Group 3,RRG,1.5,17,14,3098,12,2018,11,1
Group 3,RRG,1.5,17,14,3099,11,2018,8,3
Group 3,RRG,1.5,17,14,3100,8,2018,9,-1
Group 3,RRG,1.5,17,14,3101,14,2018,13,1
Group 3,RRG,1.5,17,14,3102,10,2018,10,0
Group 3,RRG,1.5,17,14,3103,13,2018,11,2
Group 3,RRG,1.5,17,14,3104,11,2018,12,-1
Group 3,RRG,1.5,17,14,3105,13,2018,13,0
Group 3,RRG,1.5,17,14,3106,8,2018,10,-2
Group 3,RRG,1.5,17,14,3107,10,2018,13,-3
Group 3,RRG,1.5,17,14,3108,12,2018,13,-1
Group 3,RRG,1.5,17,14,3109,13,2018,11,2
Group 3,RRG,1.5,17,14,3110,10,2018,10,0
Group 3,RRG,1.5,17,14,3111,13,2018,11,2
Group 3,RRG,1.5,17,14,3112,9,2018,11,-2
Group 3,RRG,1.5,17,14,3113,5,2018,8,-3
Group 3,RRG,1.5,17,14,3114,13,2018,10,3
Group 3,RRG,1.5,17,14,3115,9,2018,11,-2
Group 3,RRG,1.5,17,14,3116,9,2018,10,-1
Group 3,RRG,1.5,17,14,3117,12,2018,10,2
Group 3,RRG,1.5,17,14,3118,14,2018,11,3
Group 3,RRG,1.5,17,14,3119,8,2018,13,-5
Group 3,RRG,1.5,17,14,3120,12,2018,12,0
Group 3,RRG,1.5,17,14,3121,12,2018,13,-1
Group 3,RRG,1.5,17,14,3122,14,2018,6,8
Group 3,RRG,1.5,17,14,3123,10,2018,10,0
Group 3,RRG,1.5,17,14,3124,11,2018,10,1
Group 3,RRG,1.5,17,14,3125,11,2018,14,-3
Group 3,RRG,1.5,17,14,3126,12,2018,10,2
Group 3,RRG,1.5,17,14,3127,10,2018,9,1
Group 3,RRG,1.5,17,14,3128,10,2018,11,-1
Group 3,RRG,1.5,17,14,3129,9,2018,8,1
Group 3,RRG,1.5,17,14,3130,12,2018,11,1
Group 3,RRG,1.5,17,14,3131,12,2018,13,-1
Group 3,RRG,1.5,17,14,3132,12,2018,13,-1
Group 3,RRG,1.5,17,14,3133,14,2018,10,4
Group 3,RRG,1.5,17,14,3134,11,2018,10,1
Group 3,RRG,1.5,17,14,3135,11,2018,11,0
Group 3,RRG,1.5,17,14,3136,9,2018,8,1
Group 3,RRG,1.5,17,14,3137,11,2018,14,-3
Group 3,RRG,1.5,17,14,3138,13,2018,9,4
Group 3,RRG,1.5,17,14,3139,12,2018,10,2
Group 3,RRG,1.5,17,14,3140,10,2018,9,1
Group 3,RRG,1.5,17,14,3141,12,2018,10,2
Group 3,RRG,1.5,17,14,3142,11,2018,8,3
Group 3,RRG,1.5,17,14,3143,4,2018,12,-8
Group 3,RRG,1.5,17,14,3144,14,2018,10,4
Group 3,RRG,1.5,17,14,3145,13,2018,14,-1
Group 3,RRG,1.5,17,14,3146,14,2018,12,2
Group 3,RRG,1.5,17,14,3147,11,2018,12,-1
Group 3,RRG,1.5,17,14,3148,12,2018,12,0
Group 3,RRG,1.5,17,14,3149,12,2018,11,1
Group 3,RRG,1.5,17,14,3150,11,2018,12,-1
Group 3,RRG,1.5,17,14,3151,11,2018,11,0
Group 3,RRG,1.5,17,14,3152,13,2018,11,2
Group 3,RRG,1.5,17,14,3153,13,2018,10,3
Group 3,RRG,1.5,17,14,3154,13,2018,12,1
Group 3,RRG,1.5,17,14,3155,12,2018,13,-1
Group 3,RRG,1.5,17,14,3156,14,2018,13,1
Group 3,RRG,1.5,17,14,3157,11,2018,13,-2
Group 3,RRG,1.5,17,14,3158,6,2018,9,-3
Group 3,RRG,1.5,17,14,3159,13,2018,13,0
Group 3,RRG,1.5,17,14,3160,12,2018,12,0
Group 3,RRG,1.5,17,14,3161,6,2018,10,-4
Group 3,RRG,1.5,17,14,3162,13,2018,10,3
Group 3,RRG,1.5,17,14,3163,12,2018,11,1
Group 3,RRG,1.5,17,14,3164,10,2018,11,-1
Group 3,RRG,1.5,17,14,3165,14,2018,9,5
Group 3,RRG,1.5,17,14,3166,12,2018,12,0
Group 3,RRG,1.5,17,14,3167,12,2018,8,4
Group 3,RRG,1.5,17,14,3168,12,2018,11,1
Group 3,RRG,1.5,17,14,3169,13,2018,14,-1
Group 3,RRG,1.5,17,14,3170,11,2018,12,-1
Group 3,RRG,1.5,17,14,3171,11,2018,12,-1
Group 3,RRG,1.5,17,14,3172,9,2018,9,0
Group 3,RRG,1.5,17,14,3173,11,2018,10,1
Group 3,RRG,1.5,17,14,3174,12,2018,10,2
Group 3,RRG,1.5,17,14,3175,13,2018,12,1
Group 3,RRG,1.5,17,14,3176,14,2018,13,1
Group 3,RRG,1.5,17,14,3177,13,2018,10,3
Group 3,RRG,1.5,17,14,3178,13,2018,12,1
Group 3,RRG,1.5,17,14,3179,12,2018,13,-1
Group 3,RRG,1.5,17,14,3180,10,2018,11,-1
Group 3,RRG,1.5,17,14,3181,11,2018,11,0
Group 3,RRG,1.5,17,14,3182,13,2018,10,3
Group 3,RRG,1.5,17,14,3183,13,2018,13,0
Group 3,RRG,1.5,17,14,3184,14,2018,11,3
Group 3,RRG,1.5,17,14,3185,11,2018,10,1
Group 3,RRG,1.5,17,14,3186,9,2018,13,-4
Group 3,RRG,1.5,17,14,3187,13,2018,9,4
Group 3,RRG,1.5,17,14,3188,11,2018,10,1
Group 3,RRG,1.5,17,14,3189,14,2018,10,4
Group 3,RRG,1.5,17,14,3190,11,2018,13,-2
Group 3,RRG,1.5,17,14,3191,13,2018,12,1
Group 3,RRG,1.5,17,14,3192,11,2018,10,1
Group 3,RRG,1.5,17,14,3193,13,2018,13,0
Group 3,RRG,1.5,17,14,3194,14,2018,13,1
Group 3,RRG,1.5,17,14,3195,11,2018,12,-1
Group 3,RRG,1.5,17,14,3196,10,2018,11,-1
Group 3,RRG,1.5,17,14,3197,11,2018,10,1
Group 3,RRG,1.5,17,14,3198,13,2018,10,3
Group 3,RRG,1.5,17,14,3199,13,2018,10,3
Group 3,RRG,1.5,17,14,3200,12,2018,9,3
Group 3,RRG,1.5,17,14,3201,11,2018,11,0
Group 3,RRG,1.5,17,14,3202,11,2018,12,-1
Group 3,RRG,1.5,17,14,3203,13,2018,10,3
Group 3,RRG,1.5,17,14,3204,14,2018,12,2
Group 3,RRG,1.5,17,14,3205,10,2018,9,1
Group 3,RRG,1.5,17,14,3206,11,2018,11,0
Group 3,RRG,1.5,17,14,3207,7,2018,10,-3
Group 3,RRG,1.5,17,14,3208,12,2018,7,5
Group 3,RRG,1.5,17,14,3209,13,2018,11,2
Group 3,RRG,1.5,17,14,3210,7,2018,7,0
Group 3,RRG,1.5,17,14,3211,12,2018,14,-2
Group 3,RRG,1.5,17,14,3212,8,2018,9,-1
Group 3,RRG,1.5,17,14,3213,14,2018,13,1
Group 3,RRG,1.5,17,14,3214,10,2018,11,-1
Group 3,RRG,1.5,17,14,3215,10,2018,11,-1
Group 3,RRG,1.5,17,14,3216,9,2018,8,1
Group 3,RRG,1.5,17,14,3217,10,2018,12,-2
Group 3,RRG,1.5,17,14,3218,9,2018,13,-4
Group 3,RRG,1.5,17,14,3219,13,2018,9,4
Group 3,RRG,1.5,17,14,3220,10,2018,7,3
Group 3,RRG,1.5,17,14,3221,11,2018,12,-1
Group 3,RRG,1.5,17,14,3222,13,2018,9,4
Group 3,RRG,1.5,17,14,3223,14,2018,12,2
Group 3,RRG,1.5,17,14,3224,13,2018,12,1
Group 3,RRG,1.5,17,14,3225,10,2018,11,-1
Group 3,RRG,1.5,17,14,3226,14,2018,12,2
Group 3,RRG,1.5,17,14,3227,14,2018,13,1
Group 3,RRG,1.5,17,14,3228,9,2018,12,-3
Group 3,RRG,1.5,17,14,3229,14,2018,13,1
Group 3,RRG,1.5,17,14,3230,9,2018,9,0
Group 3,RRG,1.5,17,14,3231,13,2018,11,2
Group 3,RRG,1.5,17,14,3232,12,2018,14,-2
Group 3,RRG,1.5,17,14,3233,12,2018,12,0
Group 3,RRG,1.5,17,14,3234,7,2018,12,-5
Group 3,RRG,1.5,17,14,3235,10,2018,11,-1
Group 3,RRG,1.5,17,14,3236,11,2018,13,-2
Group 3,RRG,1.5,17,14,3237,12,2018,13,-1
Group 3,RRG,1.5,17,14,3238,12,2018,11,1
Group 3,RRG,1.5,17,14,3239,12,2018,12,0
Group 3,RRG,1.5,17,14,3240,12,2018,11,1
Group 3,RRG,1.5,17,14,3241,11,2018,11,0
Group 3,RRG,1.5,17,14,3242,10,2018,13,-3
Group 3,RRG,1.5,17,14,3243,14,2018,10,4
Group 3,RRG,1.5,17,14,3244,11,2018,11,0
Group 3,RRG,1.5,17,14,3245,14,2018,14,0
Group 3,RRG,1.5,17,14,3246,9,2018,12,-3
Group 3,RRG,1.5,17,14,3247,11,2018,13,-2
Group 3,RRG,1.5,17,14,3248,13,2018,9,4
Group 3,RRG,1.5,17,14,3249,13,2018,13,0
Group 3,RRG,1.5,17,14,3250,12,2018,14,-2
Group 3,RRG,1.5,17,14,3251,11,2018,12,-1
Group 3,RRG,1.5,17,14,3252,13,2018,13,0
Group 3,RRG,1.5,17,14,3253,10,2018,11,-1
Group 3,RRG,1.5,17,14,3254,14,2018,8,6
Group 3,RRG,1.5,17,14,3255,13,2018,13,0
Group 3,RRG,1.5,17,14,3256,12,2018,10,2
Group 3,RRG,1.5,17,14,3257,12,2018,11,1
Group 3,RRG,1.5,17,14,3258,12,2018,10,2
Group 3,RRG,1.5,17,14,3259,14,2018,10,4
Group 3,RRG,1.5,17,14,3260,12,2018,4,8
Group 3,RRG,1.5,17,14,3261,11,2018,10,1
Group 3,RRG,1.5,17,14,3262,8,2018,10,-2
Group 3,RRG,1.5,17,14,3263,10,2018,8,2
Group 3,RRG,1.5,17,14,3264,12,2018,9,3
Group 3,RRG,1.5,17,14,3265,9,2018,9,0
Group 3,RRG,1.5,17,14,3266,9,2018,9,0
Group 3,RRG,1.5,17,14,3267,10,2018,12,-2
Group 3,RRG,1.5,17,14,3268,13,2018,11,2
Group 3,RRG,1.5,17,14,3269,13,2018,11,2
Group 3,RRG,1.5,17,14,3270,9,2018,12,-3
Group 3,RRG,1.5,17,14,3271,9,2018,11,-2
Group 3,RRG,1.5,17,14,3272,13,2018,14,-1
Group 3,RRG,1.5,17,14,3273,12,2018,13,-1
Group 3,RRG,1.5,17,14,3274,13,2018,12,1
Group 3,RRG,1.5,17,14,3275,13,2018,13,0
Group 3,RRG,1.5,17,14,3276,14,2018,13,1
Group 3,RRG,1.5,17,14,3277,10,2018,9,1
Group 3,RRG,1.5,17,14,3278,9,2018,13,-4
Group 3,RRG,1.5,17,14,3279,13,2018,11,2
Group 3,RRG,1.5,17,14,3280,12,2018,7,5
Group 3,RRG,1.5,17,14,3281,14,2018,12,2
Group 3,RRG,1.5,17,14,3282,13,2018,10,3
Group 3,RRG,1.5,17,14,3283,12,2018,11,1
Group 3,RRG,1.5,17,14,3284,11,2018,13,-2
Group 3,RRG,1.5,17,14,3285,10,2018,13,-3
Group 3,RRG,1.5,17,14,3286,10,2018,10,0
Group 3,RRG,1.5,17,14,3287,11,2018,11,0
Group 3,RRG,1.5,17,14,3288,13,2018,13,0
Group 3,RRG,1.5,17,14,3289,14,2018,13,1
Group 3,RRG,1.5,17,14,3290,8,2018,8,0
Group 3,RRG,1.5,17,14,3291,3,2018,6,-3
Group 3,RRG,1.5,17,14,3292,5,2018,5,0
Group 3,RRG,1.5,17,14,3293,5,2018,11,-6
Group 3,RRG,1.5,17,14,3294,6,2018,11,-5
Group 3,RRG,1.5,17,14,3295,8,2018,11,-3
Group 3,RRG,1.5,17,14,3296,12,2018,10,2
Group 3,RRG,1.5,17,14,3297,11,2018,10,1
Group 3,RRG,1.5,17,14,3298,14,2018,14,0
Group 3,RRG,1.5,17,14,3299,9,2018,11,-2
Group 3,RRG,1.5,17,14,3300,13,2018,14,-1
Group 3,RRG,1.5,17,14,3301,8,2018,7,1
Group 3,RRG,1.5,17,14,3302,14,2018,14,0
Group 3,RRG,1.5,17,14,3303,13,2018,8,5
Group 3,RRG,1.5,17,14,3304,14,2018,10,4
Group 3,RRG,1.5,17,14,3305,8,2018,6,2
Group 3,RRG,1.5,17,14,3306,7,2018,8,-1
Group 3,RRG,1.5,17,14,3307,13,2018,14,-1
Group 3,RRG,1.5,17,14,3308,3,2018,9,-6
Group 3,RRG,1.5,17,14,3309,13,2018,13,0
Group 3,RRG,1.5,17,14,3310,13,2018,14,-1
Group 3,RRG,1.5,17,14,3311,13,2018,11,2
Group 3,RRG,1.5,17,14,3312,10,2018,8,2
Group 3,RRG,1.5,17,14,3313,8,2018,10,-2
Group 3,RRG,1.5,17,14,3314,13,2018,8,5
Group 3,RRG,1.5,17,14,3315,13,2018,10,3
Group 3,RRG,1.5,17,14,3316,12,2018,12,0
Group 3,RRG,1.5,17,14,3317,13,2018,10,3
Group 3,RRG,1.5,17,14,3318,14,2018,10,4
Group 3,RRG,1.5,17,14,3319,11,2018,12,-1
Group 3,RRG,1.5,17,14,3320,7,2018,11,-4
Group 3,RRG,1.5,17,14,3321,11,2018,9,2
Group 3,RRG,1.5,17,14,3322,10,2018,11,-1
Group 3,RRG,1.5,17,14,3323,11,2018,11,0
Group 3,RRG,1.5,17,14,3324,7,2018,9,-2
Group 3,RRG,1.5,17,14,3325,12,2018,11,1
Group 3,RRG,1.5,17,14,3326,13,2018,9,4
Group 3,RRG,1.5,17,14,3327,13,2018,13,0
Group 3,RRG,1.5,17,14,3328,13,2018,11,2
Group 3,RRG,1.5,17,14,3329,13,2018,12,1
Group 3,RRG,1.5,17,14,3330,14,2018,12,2
Group 3,RRG,1.5,17,14,3331,10,2018,8,2
Group 3,RRG,1.5,17,14,3332,14,2018,10,4
Group 3,RRG,1.5,17,14,3333,13,2018,10,3
Group 3,RRG,1.5,17,14,3334,9,2018,8,1
Group 3,RRG,1.5,17,14,3335,13,2018,8,5
Group 3,RRG,1.5,17,14,3336,13,2018,11,2
Group 3,RRG,1.5,17,14,3337,12,2018,9,3
Group 3,RRG,1.5,17,14,3338,12,2018,10,2
Group 3,RRG,1.5,17,14,3339,10,2018,9,1
Group 3,RRG,1.5,17,14,3340,11,2018,10,1
Group 3,RRG,1.5,17,14,3341,13,2018,10,3
Group 3,RRG,1.5,17,14,3342,13,2018,8,5
Group 3,RRG,1.5,17,14,3343,11,2018,12,-1
Group 3,RRG,1.5,17,14,3344,8,2018,9,-1
Group 3,RRG,1.5,17,14,3345,8,2018,10,-2
Group 3,RRG,1.5,17,14,3346,11,2018,11,0
Group 3,RRG,1.5,17,14,3347,10,2018,10,0
Group 3,RRG,1.5,17,14,3348,13,2018,9,4
Group 3,RRG,1.5,17,14,3349,11,2018,13,-2
Group 3,RRG,1.5,17,14,3350,10,2018,11,-1
Group 3,RRG,1.5,17,14,3351,10,2018,9,1
Group 3,RRG,1.5,17,14,3352,8,2018,11,-3
Group 3,RRG,1.5,17,14,3353,13,2018,11,2
Group 3,RRG,1.5,17,14,3354,10,2018,12,-2
Group 3,RRG,1.5,17,14,3355,14,2018,12,2
Group 3,RRG,1.5,17,14,3356,9,2018,8,1
Group 3,RRG,1.5,17,14,3357,14,2018,11,3
Group 3,RRG,1.5,17,14,3358,10,2018,7,3
Group 3,RRG,1.5,17,14,3359,12,2018,12,0
Group 3,RRG,1.5,17,14,3360,9,2018,9,0
Group 3,RRG,1.5,17,14,3361,13,2018,14,-1
Group 3,RRG,1.5,17,14,3362,11,2018,11,0
Group 3,RRG,1.5,17,14,3363,9,2018,11,-2
Group 3,RRG,1.5,17,14,3364,14,2018,8,6
Group 3,RRG,1.5,17,14,3365,12,2018,13,-1
Group 3,RRG,1.5,17,14,3366,12,2018,12,0
Group 3,RRG,1.5,17,14,3367,12,2018,11,1
Group 3,RRG,1.5,17,14,3368,11,2018,9,2
Group 3,RRG,1.5,17,14,3369,10,2018,13,-3
Group 3,RRG,1.5,17,14,3370,12,2018,10,2
Group 3,RRG,1.5,17,14,3371,13,2018,12,1
Group 3,RRG,1.5,17,14,3372,14,2018,10,4
Group 3,RRG,1.5,17,14,3373,12,2018,12,0
Group 3,RRG,1.5,17,14,3374,13,2018,11,2
Group 3,RRG,1.5,17,14,3375,13,2018,11,2
Group 3,RRG,1.5,17,14,3376,12,2018,12,0
Group 3,RRG,1.5,17,14,3377,10,2018,11,-1
Group 3,RRG,1.5,17,14,3378,11,2018,14,-3
Group 3,RRG,1.5,17,14,3379,9,2018,7,2
Group 3,RRG,1.5,17,14,3380,11,2018,10,1
Group 3,RRG,1.5,17,14,3381,10,2018,12,-2
Group 3,RRG,1.5,17,14,3382,11,2018,12,-1
Group 3,RRG,1.5,17,14,3383,7,2018,11,-4
Group 3,RRG,1.5,17,14,3384,9,2018,11,-2
Group 3,RRG,1.5,17,14,3385,12,2018,11,1
Group 3,RRG,1.5,17,14,3386,11,2018,9,2
Group 3,RRG,1.5,17,14,3387,11,2018,12,-1
Group 3,RRG,1.5,17,14,3388,12,2018,10,2
Group 3,RRG,1.5,17,14,3389,8,2018,9,-1
Group 3,RRG,1.5,17,14,3390,10,2018,12,-2
Group 3,RRG,1.5,17,14,3391,14,2018,14,0
Group 3,RRG,1.5,17,14,3392,11,2018,10,1
Group 3,RRG,1.5,17,14,3393,11,2018,11,0
Group 3,RRG,1.5,17,14,3394,11,2018,13,-2
Group 3,RRG,1.5,17,14,3395,12,2018,12,0
Group 3,RRG,1.5,17,14,3396,11,2018,12,-1
Group 3,RRG,1.5,17,14,3397,13,2018,12,1
Group 3,RRG,1.5,17,14,3398,14,2018,12,2
Group 3,RRG,1.5,17,14,3399,8,2018,10,-2
Group 3,RRG,1.5,17,14,3400,11,2018,14,-3
Group 3,RRG,1.5,17,14,3401,13,2018,13,0
Group 3,RRG,1.5,17,14,3402,12,2018,9,3
Group 3,RRG,1.5,17,14,3403,13,2018,7,6
Group 3,RRG,1.5,17,14,3404,9,2018,7,2
Group 3,RRG,1.5,17,14,3405,12,2018,9,3
Group 3,RRG,1.5,17,14,3406,12,2018,10,2
Group 3,RRG,1.5,17,14,3407,14,2018,11,3
Group 3,RRG,1.5,17,14,3408,8,2018,11,-3
Group 3,RRG,1.5,17,14,3409,9,2018,12,-3
Group 3,RRG,1.5,17,14,3410,6,2018,11,-5
Group 3,RRG,1.5,17,14,3411,11,2018,12,-1
Group 3,RRG,1.5,17,14,3412,12,2018,12,0
Group 3,RRG,1.5,17,14,3413,10,2018,11,-1
Group 3,RRG,1.5,17,14,3414,12,2018,13,-1
Group 3,RRG,1.5,17,14,3415,13,2018,11,2
Group 3,RRG,1.5,17,14,3416,12,2018,11,1
Group 3,RRG,1.5,17,14,3417,11,2018,9,2
Group 3,RRG,1.5,17,14,3418,10,2018,10,0
Group 3,RRG,1.5,17,14,3419,11,2018,8,3
Group 3,RRG,1.5,17,14,3420,14,2018,9,5
Group 3,RRG,1.5,17,14,3421,11,2018,12,-1
Group 3,RRG,1.5,17,14,3422,8,2018,10,-2
Group 3,RRG,1.5,17,14,3423,13,2018,12,1
Group 3,RRG,1.5,17,14,3424,13,2018,14,-1
Group 3,RRG,1.5,17,14,3425,14,2018,12,2
Group 3,RRG,1.5,17,14,3426,11,2018,9,2
Group 3,RRG,1.5,17,14,3427,12,2018,12,0
Group 3,RRG,1.5,17,14,3428,14,2018,11,3
Group 3,RRG,1.5,17,14,3429,10,2018,11,-1
Group 3,RRG,1.5,17,14,3430,14,2018,11,3
Group 3,RRG,1.5,17,14,3431,11,2018,9,2
Group 3,RRG,1.5,17,14,3432,12,2018,9,3
Group 3,RRG,1.5,17,14,3433,12,2018,10,2
Group 3,RRG,1.5,17,14,3434,13,2018,12,1
Group 3,RRG,1.5,17,14,3435,14,2018,12,2
Group 3,RRG,1.5,17,14,3436,11,2018,8,3
Group 3,RRG,1.5,17,14,3437,12,2018,11,1
Group 3,RRG,1.5,17,14,3438,8,2018,10,-2
Group 3,RRG,1.5,17,14,3439,13,2018,12,1
Group 3,RRG,1.5,17,14,3440,13,2018,12,1
Group 3,RRG,1.5,17,14,3441,11,2018,11,0
Group 3,RRG,1.5,17,14,3442,14,2018,14,0
Group 3,RRG,1.5,17,14,3443,7,2018,11,-4
Group 3,RRG,1.5,17,14,3444,7,2018,12,-5
Group 3,RRG,1.5,17,14,3445,10,2018,12,-2
Group 3,RRG,1.5,17,14,3446,11,2018,8,3
Group 3,RRG,1.5,17,14,3447,12,2018,11,1
Group 3,RRG,1.5,17,14,3448,10,2018,12,-2
Group 3,RRG,1.5,17,14,3449,13,2018,11,2
Group 3,RRG,1.5,17,14,3450,12,2018,11,1
Group 3,RRG,1.5,17,14,3451,11,2018,9,2
Group 3,RRG,1.5,17,14,3452,13,2018,11,2
Group 3,RRG,1.5,17,14,3453,8,2018,10,-2
Group 3,RRG,1.5,17,14,3454,13,2018,10,3
Group 3,RRG,1.5,17,14,3455,14,2018,13,1
Group 3,RRG,1.5,17,14,3456,12,2018,10,2
Group 3,RRG,1.5,17,14,3457,6,2018,10,-4
Group 3,RRG,1.5,17,14,3458,11,2018,11,0
Group 3,RRG,1.5,17,14,3459,10,2018,13,-3
Group 3,RRG,1.5,17,14,3460,13,2018,13,0
Group 3,RRG,1.5,17,14,3461,11,2018,9,2
Group 3,RRG,1.5,17,14,3462,11,2018,10,1
Group 3,RRG,1.5,17,14,3463,12,2018,11,1
Group 3,RRG,1.5,17,14,3464,9,2018,11,-2
Group 3,RRG,1.5,17,14,3465,11,2018,8,3
Group 3,RRG,1.5,17,14,3466,9,2018,12,-3
Group 3,RRG,1.5,17,14,3467,9,2018,9,0
Group 3,RRG,1.5,17,14,3468,9,2018,14,-5
Group 3,RRG,1.5,17,14,3469,8,2018,12,-4
Group 3,RRG,1.5,17,14,3470,10,2018,13,-3
Group 3,RRG,1.5,17,14,3471,13,2018,11,2
Group 3,RRG,1.5,17,14,3472,13,2018,10,3
Group 3,RRG,1.5,17,14,3473,13,2018,14,-1
Group 3,RRG,1.5,17,14,3474,13,2018,13,0
Group 3,RRG,1.5,17,14,3475,13,2018,11,2
Group 3,RRG,1.5,17,14,3476,11,2018,13,-2
Group 3,RRG,1.5,17,14,3477,13,2018,14,-1
Group 3,RRG,1.5,17,14,3478,9,2018,12,-3
Group 3,RRG,1.5,17,14,3479,10,2018,10,0
Group 3,RRG,1.5,17,14,3480,10,2018,13,-3
Group 3,RRG,1.5,17,14,3481,11,2018,9,2
Group 3,RRG,1.5,17,14,3482,13,2018,13,0
Group 3,RRG,1.5,17,14,3483,14,2018,11,3
Group 3,RRG,1.5,17,14,3484,11,2018,13,-2
Group 3,RRG,1.5,17,14,3485,10,2018,11,-1
Group 3,RRG,1.5,17,14,3486,13,2018,9,4
Group 3,RRG,1.5,17,14,3487,11,2018,12,-1
Group 3,RRG,1.5,17,14,3488,5,2018,7,-2
Group 3,RRG,1.5,17,14,3489,12,2018,9,3
Group 3,RRG,1.5,17,14,3490,8,2018,11,-3
Group 3,RRG,1.5,17,14,3491,10,2018,11,-1
Group 3,RRG,1.5,17,14,3492,10,2018,8,2
Group 3,RRG,1.5,17,14,3493,10,2018,13,-3
Group 3,RRG,1.5,17,14,3494,12,2018,13,-1
Group 3,RRG,1.5,17,14,3495,12,2018,13,-1
Group 3,RRG,1.5,17,14,3496,9,2018,13,-4
Group 3,RRG,1.5,17,14,3497,9,2018,11,-2
Group 3,RRG,1.5,17,14,3498,14,2018,12,2
Group 3,RRG,1.5,17,14,3499,9,2018,14,-5
Group 3,RRG,1.5,17,14,3500,12,2018,12,0
Group 3,RRG,1.5,17,14,3501,12,2018,8,4
Group 3,RRG,1.5,17,14,3502,13,2018,14,-1
Group 3,RRG,1.5,17,14,3503,12,2018,14,-2
Group 3,RRG,1.5,17,14,3504,8,2018,10,-2
Group 3,RRG,1.5,17,14,3505,9,2018,6,3
Group 3,RRG,1.5,17,14,3506,10,2018,12,-2
Group 3,RRG,1.5,17,14,3507,12,2018,8,4
Group 3,RRG,1.5,17,14,3508,11,2018,7,4
Group 3,RRG,1.5,17,14,3509,9,2018,11,-2
Group 3,RRG,1.5,17,14,3510,11,2018,8,3
Group 3,RRG,1.5,17,14,3511,14,2018,14,0
Group 3,RRG,1.5,17,14,3512,10,2018,9,1
Group 3,RRG,1.5,17,14,3513,8,2018,10,-2
Group 3,RRG,1.5,17,14,3514,12,2018,13,-1
Group 3,RRG,1.5,17,14,3515,14,2018,11,3
Group 3,RRG,1.5,17,14,3516,8,2018,12,-4
Group 3,RRG,1.5,17,14,3517,10,2018,12,-2
Group 3,RRG,1.5,17,14,3518,12,2018,10,2
Group 3,RRG,1.5,17,14,3519,13,2018,8,5
Group 3,RRG,1.5,17,14,3520,10,2018,11,-1
Group 3,RRG,1.5,17,14,3521,13,2018,11,2
Group 3,RRG,1.5,17,14,3522,13,2018,11,2
Group 3,RRG,1.5,17,14,3523,14,2018,10,4
Group 3,RRG,1.5,17,14,3524,10,2018,11,-1
Group 3,RRG,1.5,17,14,3525,13,2018,12,1
Group 3,RRG,1.5,17,14,3526,13,2018,10,3
Group 3,RRG,1.5,17,14,3527,12,2018,11,1
Group 3,RRG,1.5,17,14,3528,14,2018,11,3
Group 3,RRG,1.5,17,14,3529,14,2018,11,3
Group 3,RRG,1.5,17,14,3530,13,2018,11,2
Group 3,RRG,1.5,17,14,3531,13,2018,11,2
Group 3,RRG,1.5,17,14,3532,12,2018,14,-2
Group 3,RRG,1.5,17,14,3533,5,2018,7,-2
Group 3,RRG,1.5,17,14,3534,7,2018,10,-3
Group 3,RRG,1.5,17,14,3535,14,2018,14,0
Group 3,RRG,1.5,17,14,3536,12,2018,14,-2
Group 3,RRG,1.5,17,14,3537,12,2018,12,0
Group 3,RRG,1.5,17,14,3538,10,2018,13,-3
Group 3,RRG,1.5,17,14,3539,6,2018,12,-6
Group 3,RRG,1.5,17,14,3540,3,2018,9,-6
Group 3,RRG,1.5,17,14,3541,8,2018,9,-1
Group 3,RRG,1.5,17,14,3542,12,2018,11,1
Group 3,RRG,1.5,17,14,3543,10,2018,10,0
Group 3,RRG,1.5,17,14,3544,11,2018,14,-3
Group 3,RRG,1.5,17,14,3545,13,2018,9,4
Group 3,RRG,1.5,17,14,3546,14,2018,12,2
Group 3,RRG,1.5,17,14,3547,12,2018,11,1
Group 3,RRG,1.5,17,14,3548,12,2018,12,0
Group 3,RRG,1.5,17,14,3549,10,2018,13,-3
Group 3,RRG,1.5,17,14,3550,14,2018,12,2
Group 3,RRG,1.5,17,14,3551,11,2018,7,4
Group 3,RRG,1.5,17,14,3552,11,2018,10,1
Group 3,RRG,1.5,17,14,3553,10,2018,9,1
Group 3,RRG,1.5,17,14,3554,11,2018,10,1
Group 3,RRG,1.5,17,14,3555,11,2018,11,0
Group 3,RRG,1.5,17,14,3556,6,2018,12,-6
Group 3,RRG,1.5,17,14,3557,11,2018,8,3
Group 3,RRG,1.5,17,14,3558,13,2018,12,1
Group 3,RRG,1.5,17,14,3559,12,2018,13,-1
Group 3,RRG,1.5,17,14,3560,11,2018,10,1
Group 3,RRG,1.5,17,14,3561,13,2018,8,5
Group 3,RRG,1.5,17,14,3562,12,2018,7,5
Group 3,RRG,1.5,17,14,3563,10,2018,8,2
Group 3,RRG,1.5,17,14,3564,6,2018,7,-1
Group 3,RRG,1.5,17,14,3565,11,2018,13,-2
Group 3,RRG,1.5,17,14,3566,6,2018,8,-2
Group 3,RRG,1.5,17,14,3567,14,2018,13,1
Group 3,RRG,1.5,17,14,3568,14,2018,13,1
Group 3,RRG,1.5,17,14,3569,14,2018,11,3
Group 3,RRG,1.5,17,14,3570,10,2018,7,3
Group 3,RRG,1.5,17,14,3571,13,2018,11,2
Group 3,RRG,1.5,17,14,3572,12,2018,12,0
Group 3,RRG,1.5,17,14,3573,12,2018,12,0
Group 3,RRG,1.5,17,14,3574,12,2018,13,-1
Group 3,RRG,1.5,17,14,3575,13,2018,11,2
Group 3,RRG,1.5,17,14,3576,13,2018,11,2
Group 3,RRG,1.5,17,14,3577,10,2018,14,-4
Group 3,RRG,1.5,17,14,3578,9,2018,11,-2
Group 3,RRG,1.5,17,14,3579,10,2018,12,-2
Group 3,RRG,1.5,17,14,3580,11,2018,11,0
Group 3,RRG,1.5,17,14,3581,12,2018,9,3
Group 3,RRG,1.5,17,14,3582,10,2018,12,-2
Group 3,RRG,1.5,17,14,3583,4,2018,7,-3
Group 3,RRG,1.5,17,14,3584,13,2018,11,2
Group 3,RRG,1.5,17,14,3585,14,2018,14,0
Group 3,RRG,1.5,17,14,3586,11,2018,12,-1
Group 3,RRG,1.5,17,14,3587,10,2018,10,0
Group 3,RRG,1.5,17,14,3588,13,2018,13,0
Group 3,RRG,1.5,17,14,3589,11,2018,12,-1
Group 3,RRG,1.5,17,14,3590,8,2018,11,-3
Group 3,RRG,1.5,17,14,3591,6,2018,12,-6
Group 3,RRG,1.5,17,14,3592,10,2018,10,0
Group 3,RRG,1.5,17,14,3593,8,2018,12,-4
Group 3,RRG,1.5,17,14,3594,9,2018,12,-3
Group 3,RRG,1.5,17,14,3595,13,2018,10,3
Group 3,RRG,1.5,17,14,3596,13,2018,10,3
Group 3,RRG,1.5,17,14,3597,12,2018,9,3
Group 3,RRG,1.5,17,14,3598,7,2018,8,-1
Group 3,RRG,1.5,17,14,3599,14,2018,13,1
Group 3,RRG,1.5,17,14,3600,14,2018,12,2
Group 3,RRG,1.5,17,14,3601,14,2018,13,1
Group 3,RRG,1.5,17,14,3602,13,2018,11,2
Group 3,RRG,1.5,17,14,3603,12,2018,12,0
Group 3,RRG,1.5,17,14,3604,10,2018,10,0
Group 3,RRG,1.5,17,14,3605,10,2018,11,-1
Group 3,RRG,1.5,17,14,3606,11,2018,9,2
Group 3,RRG,1.5,17,14,3607,12,2018,12,0
Group 3,RRG,1.5,17,14,3608,12,2018,9,3
Group 3,RRG,1.5,17,14,3609,11,2018,10,1
Group 3,RRG,1.5,17,14,3610,11,2018,10,1
Group 3,RRG,1.5,17,14,3611,10,2018,13,-3
Group 3,RRG,1.5,17,14,3612,13,2018,14,-1
Group 3,RRG,1.5,17,14,3613,11,2018,10,1
Group 3,RRG,1.5,17,14,3614,13,2018,12,1
Group 3,RRG,1.5,17,14,3615,12,2018,13,-1
Group 3,RRG,1.5,17,14,3616,13,2018,12,1
Group 3,RRG,1.5,17,14,3617,9,2018,12,-3
Group 3,RRG,1.5,17,14,3618,12,2018,12,0
Group 3,RRG,1.5,17,14,3619,13,2018,11,2
Group 3,RRG,1.5,17,14,3620,13,2018,9,4
Group 3,RRG,1.5,17,14,3621,11,2018,10,1
Group 3,RRG,1.5,17,14,3622,14,2018,12,2
Group 3,RRG,1.5,17,14,3623,10,2018,13,-3
Group 3,RRG,1.5,17,14,3624,12,2018,9,3
Group 3,RRG,1.5,17,14,3625,13,2018,13,0
Group 3,RRG,1.5,17,14,3626,10,2018,13,-3
Group 3,RRG,1.5,17,14,3627,13,2018,12,1
Group 3,RRG,1.5,17,14,3628,11,2018,13,-2
Group 3,RRG,1.5,17,14,3629,12,2018,10,2
Group 3,RRG,1.5,17,14,3630,11,2018,9,2
Group 3,RRG,1.5,17,14,3631,12,2018,11,1
Group 3,RRG,1.5,17,14,3632,12,2018,9,3
Group 3,RRG,1.5,17,14,3633,11,2018,11,0
Group 3,RRG,1.5,17,14,3634,12,2018,9,3
Group 3,RRG,1.5,17,14,3635,10,2018,9,1
Group 3,RRG,1.5,17,14,3636,13,2018,10,3
Group 3,RRG,1.5,17,14,3637,7,2018,10,-3
Group 3,RRG,1.5,17,14,3638,8,2018,10,-2
Group 3,RRG,1.5,17,14,3639,9,2018,10,-1
Group 3,RRG,1.5,17,14,3640,10,2018,10,0
Group 3,RRG,1.5,17,14,3641,11,2018,13,-2
Group 3,RRG,1.5,17,14,3642,11,2018,12,-1
Group 3,RRG,1.5,17,14,3643,11,2018,11,0
Group 3,RRG,1.5,17,14,3644,10,2018,11,-1
Group 3,RRG,1.5,17,14,3645,12,2018,13,-1
Group 3,RRG,1.5,17,14,3646,11,2018,11,0
Group 3,RRG,1.5,17,14,3647,13,2018,12,1
Group 3,RRG,1.5,17,14,3648,13,2018,13,0
Group 3,RRG,1.5,17,14,3649,13,2018,13,0
Group 3,RRG,1.5,17,14,3650,13,2018,13,0
Group 3,RRG,1.5,17,14,3651,14,2018,13,1
Group 3,RRG,1.5,17,14,3652,10,2018,12,-2
Group 3,RRG,1.5,17,14,3653,9,2018,9,0
Group 3,RRG,1.5,17,14,3654,11,2018,13,-2
Group 3,RRG,1.5,17,14,3655,12,2018,12,0
Group 3,RRG,1.5,17,14,3656,10,2018,8,2
Group 3,RRG,1.5,17,14,3657,9,2018,9,0
Group 3,RRG,1.5,17,14,3658,9,2018,10,-1
Group 3,RRG,1.5,17,14,3659,8,2018,11,-3
Group 3,RRG,1.5,17,14,3660,9,2018,9,0
Group 3,RRG,1.5,17,14,3661,11,2018,12,-1
Group 3,RRG,1.5,17,14,3662,13,2018,13,0
Group 3,RRG,1.5,17,14,3663,13,2018,8,5
Group 3,RRG,1.5,17,14,3664,8,2018,12,-4
Group 3,RRG,1.5,17,14,3665,13,2018,11,2
Group 3,RRG,1.5,17,14,3666,12,2018,11,1
Group 3,RRG,1.5,17,14,3667,11,2018,14,-3
Group 3,RRG,1.5,17,14,3668,11,2018,8,3
Group 3,RRG,1.5,17,14,3669,10,2018,8,2
Group 3,RRG,1.5,17,14,3670,8,2018,13,-5
Group 3,RRG,1.5,17,14,3671,11,2018,11,0
Group 3,RRG,1.5,17,14,3672,7,2018,10,-3
Group 3,RRG,1.5,17,14,3673,10,2018,13,-3
Group 3,RRG,1.5,17,14,3674,10,2018,10,0
Group 3,RRG,1.5,17,14,3675,6,2018,9,-3
Group 3,RRG,1.5,17,14,3676,14,2018,13,1
Group 3,RRG,1.5,17,14,3677,11,2018,7,4
Group 3,RRG,1.5,17,14,3678,10,2018,12,-2
Group 3,RRG,1.5,17,14,3679,12,2018,9,3
Group 3,RRG,1.5,17,14,3680,11,2018,11,0
Group 3,RRG,1.5,17,14,3681,14,2018,7,7
Group 3,RRG,1.5,17,14,3682,10,2018,9,1
Group 3,RRG,1.5,17,14,3683,13,2018,11,2
Group 3,RRG,1.5,17,14,3684,12,2018,11,1
Group 3,RRG,1.5,17,14,3685,11,2018,11,0
Group 3,RRG,1.5,17,14,3686,12,2018,12,0
Group 3,RRG,1.5,17,14,3687,14,2018,10,4
Group 3,RRG,1.5,17,14,3688,10,2018,12,-2
Group 3,RRG,1.5,17,14,3689,14,2018,10,4
Group 3,RRG,1.5,17,14,3690,13,2018,10,3
Group 3,RRG,1.5,17,14,3691,11,2018,14,-3
Group 3,RRG,1.5,17,14,3692,13,2018,13,0
Group 3,RRG,1.5,17,14,3693,13,2018,13,0
Group 3,RRG,1.5,17,14,3694,9,2018,9,0
Group 3,RRG,1.5,17,14,3695,11,2018,9,2
Group 3,RRG,1.5,17,14,3696,12,2018,10,2
Group 3,RRG,1.5,17,14,3697,13,2018,11,2
Group 3,RRG,1.5,17,14,3698,13,2018,12,1
Group 3,RRG,1.5,17,14,3699,11,2018,10,1
Group 3,RRG,1.5,17,14,3700,6,2018,9,-3
Group 3,RRG,1.5,17,14,3701,3,2018,9,-6
Group 3,RRG,1.5,17,14,3702,14,2018,14,0
Group 3,RRG,1.5,17,14,3703,7,2018,10,-3
Group 3,RRG,1.5,17,14,3704,8,2018,11,-3
Group 3,RRG,1.5,17,14,3705,9,2018,10,-1
Group 3,RRG,1.5,17,14,3706,13,2018,9,4
Group 3,RRG,1.5,17,14,3707,11,2018,10,1
Group 3,RRG,1.5,17,14,3708,13,2018,12,1
Group 3,RRG,1.5,17,14,3709,14,2018,10,4
Group 3,RRG,1.5,17,14,3710,13,2018,10,3
Group 3,RRG,1.5,17,14,3711,14,2018,13,1
Group 3,RRG,1.5,17,14,3712,13,2018,12,1
Group 3,RRG,1.5,17,14,3713,11,2018,11,0
Group 3,RRG,1.5,17,14,3714,14,2018,13,1
Group 3,RRG,1.5,17,14,3715,9,2018,10,-1
Group 3,RRG,1.5,17,14,3716,11,2018,11,0
Group 3,RRG,1.5,17,14,3717,13,2018,11,2
Group 3,RRG,1.5,17,14,3718,13,2018,12,1
Group 3,RRG,1.5,17,14,3719,13,2018,11,2
Group 3,RRG,1.5,17,14,3720,8,2018,14,-6
Group 3,RRG,1.5,17,14,3721,13,2018,11,2
Group 3,RRG,1.5,17,14,3722,11,2018,11,0
Group 3,RRG,1.5,17,14,3723,12,2018,9,3
Group 3,RRG,1.5,17,14,3724,11,2018,14,-3
Group 3,RRG,1.5,17,14,3725,13,2018,8,5
Group 3,RRG,1.5,17,14,3726,14,2018,10,4
Group 3,RRG,1.5,17,14,3727,11,2018,13,-2
Group 3,RRG,1.5,17,14,3728,8,2018,9,-1
Group 3,RRG,1.5,17,14,3729,11,2018,10,1
Group 3,RRG,1.5,17,14,3730,13,2018,11,2
Group 3,RRG,1.5,17,14,3731,12,2018,13,-1
Group 3,RRG,1.5,17,14,3732,11,2018,12,-1
Group 3,RRG,1.5,17,14,3733,14,2018,10,4
Group 3,RRG,1.5,17,14,3734,13,2018,11,2
Group 3,RRG,1.5,17,14,3735,13,2018,11,2
Group 3,RRG,1.5,17,14,3736,6,2018,8,-2
Group 3,RRG,1.5,17,14,3737,11,2018,11,0
Group 3,RRG,1.5,17,14,3738,13,2018,11,2
Group 3,RRG,1.5,17,14,3739,14,2018,11,3
Group 3,RRG,1.5,17,14,3740,13,2018,13,0
Group 3,RRG,1.5,17,14,3741,7,2018,6,1
Group 3,RRG,1.5,17,14,3742,8,2018,11,-3
Group 3,RRG,1.5,17,14,3743,10,2018,10,0
Group 3,RRG,1.5,17,14,3744,13,2018,9,4
Group 3,RRG,1.5,17,14,3745,12,2018,12,0
Group 3,RRG,1.5,17,14,3746,11,2018,13,-2
Group 3,RRG,1.5,17,14,3747,13,2018,13,0
Group 3,RRG,1.5,17,14,3748,12,2018,9,3
Group 3,RRG,1.5,17,14,3749,14,2018,10,4
Group 3,RRG,1.5,17,14,3750,13,2018,13,0
Group 3,RRG,1.5,17,14,3751,10,2018,8,2
Group 3,RRG,1.5,17,14,3752,12,2018,10,2
Group 3,RRG,1.5,17,14,3753,5,2018,7,-2
Group 3,RRG,1.5,17,14,3754,14,2018,14,0
Group 3,RRG,1.5,17,14,3755,8,2018,12,-4
Group 3,RRG,1.5,17,14,3756,11,2018,11,0
Group 3,RRG,1.5,17,14,3757,11,2018,11,0
Group 3,RRG,1.5,17,14,3758,13,2018,11,2
Group 3,RRG,1.5,17,14,3759,12,2018,11,1
Group 3,RRG,1.5,17,14,3760,11,2018,12,-1
Group 3,RRG,1.5,17,14,3761,9,2018,13,-4
Group 3,RRG,1.5,17,14,3762,13,2018,13,0
Group 3,RRG,1.5,17,14,3763,9,2018,7,2
Group 3,RRG,1.5,17,14,3764,8,2018,9,-1
Group 3,RRG,1.5,17,14,3765,8,2018,6,2
Group 3,RRG,1.5,17,14,3766,12,2018,6,6
Group 3,RRG,1.5,17,14,3767,11,2018,12,-1
Group 3,RRG,1.5,17,14,3768,14,2018,14,0
Group 3,RRG,1.5,17,14,3769,14,2018,13,1
Group 3,RRG,1.5,17,14,3770,12,2018,12,0
Group 3,RRG,1.5,17,14,3771,12,2018,12,0
Group 3,RRG,1.5,17,14,3772,13,2018,10,3
Group 3,RRG,1.5,17,14,3773,9,2018,12,-3
Group 3,RRG,1.5,17,14,3774,8,2018,8,0
Group 3,RRG,1.5,17,14,3775,10,2018,9,1
Group 3,RRG,1.5,17,14,3776,14,2018,12,2
Group 3,RRG,1.5,17,14,3777,12,2018,10,2
Group 3,RRG,1.5,17,14,3778,13,2018,9,4
Group 3,RRG,1.5,17,14,3779,10,2018,10,0
Group 3,RRG,1.5,17,14,3780,10,2018,9,1
Group 3,RRG,1.5,17,14,3781,7,2018,10,-3
Group 3,RRG,1.5,17,14,3782,13,2018,10,3
Group 3,RRG,1.5,17,14,3783,12,2018,13,-1
Group 3,RRG,1.5,17,14,3784,9,2018,10,-1
Group 3,RRG,1.5,17,14,3785,9,2018,8,1
Group 3,RRG,1.5,17,14,3786,11,2018,9,2
Group 3,RRG,1.5,17,14,3787,12,2018,8,4
Group 3,RRG,1.5,17,14,3788,13,2018,11,2
Group 3,RRG,1.5,17,14,3789,13,2018,12,1
Group 3,RRG,1.5,17,14,3790,12,2018,11,1
Group 3,RRG,1.5,17,14,3791,10,2018,10,0
Group 3,RRG,1.5,17,14,3792,8,2018,14,-6
Group 3,RRG,1.5,17,14,3793,8,2018,11,-3
Group 3,RRG,1.5,17,14,3794,14,2018,12,2
Group 3,RRG,1.5,17,14,3795,13,2018,10,3
Group 3,RRG,1.5,17,14,3796,13,2018,9,4
Group 3,RRG,1.5,17,14,3797,13,2018,10,3
Group 3,RRG,1.5,17,14,3798,6,2018,11,-5
Group 3,RRG,1.5,17,14,3799,11,2018,11,0
Group 3,RRG,1.5,17,14,3800,8,2018,13,-5
Group 3,RRG,1.5,17,14,3801,8,2018,10,-2
Group 3,RRG,1.5,17,14,3802,7,2018,10,-3
Group 3,RRG,1.5,17,14,3803,12,2018,14,-2
Group 3,RRG,1.5,17,14,3804,13,2018,13,0
Group 3,RRG,1.5,17,14,3805,13,2018,10,3
Group 3,RRG,1.5,17,14,3806,10,2018,8,2
Group 3,RRG,1.5,17,14,3807,14,2018,12,2
Group 3,RRG,1.5,17,14,3808,7,2018,11,-4
Group 3,RRG,1.5,17,14,3809,10,2018,10,0
Group 3,RRG,1.5,17,14,3810,14,2018,12,2
Group 3,RRG,1.5,17,14,3811,8,2018,10,-2
Group 3,RRG,1.5,17,14,3812,14,2018,9,5
Group 3,RRG,1.5,17,14,3813,12,2018,12,0
Group 3,RRG,1.5,17,14,3814,11,2018,11,0
Group 3,RRG,1.5,17,14,3815,13,2018,9,4
Group 3,RRG,1.5,17,14,3816,7,2018,9,-2
Group 3,RRG,1.5,17,14,3817,8,2018,8,0
Group 3,RRG,1.5,17,14,3818,7,2018,7,0
Group 3,RRG,1.5,17,14,3819,5,2018,6,-1
Group 3,RRG,1.5,17,14,3820,12,2018,11,1
Group 3,RRG,1.5,17,14,3821,12,2018,11,1
Group 3,RRG,1.5,17,14,3822,9,2018,8,1
Group 3,RRG,1.5,17,14,3823,11,2018,13,-2
Group 3,RRG,1.5,17,14,3824,12,2018,11,1
Group 3,RRG,1.5,17,14,3825,11,2018,9,2
Group 3,RRG,1.5,17,14,3826,10,2018,10,0
Group 3,RRG,1.5,17,14,3827,14,2018,8,6
Group 3,RRG,1.5,17,14,3828,14,2018,10,4
Group 3,RRG,1.5,17,14,3829,13,2018,10,3
Group 3,RRG,1.5,17,14,3830,12,2018,11,1
Group 3,RRG,1.5,17,14,3831,7,2018,9,-2
Group 3,RRG,1.5,17,14,3832,13,2018,13,0
Group 3,RRG,1.5,17,14,3833,13,2018,11,2
Group 3,RRG,1.5,17,14,3834,12,2018,13,-1
Group 3,RRG,1.5,17,14,3835,13,2018,12,1
Group 3,RRG,1.5,17,14,3836,14,2018,12,2
Group 3,RRG,1.5,17,14,3837,10,2018,11,-1
Group 3,RRG,1.5,17,14,3838,9,2018,11,-2
Group 3,RRG,1.5,17,14,3839,10,2018,13,-3
Group 3,RRG,1.5,17,14,3840,14,2018,11,3
Group 3,RRG,1.5,17,14,3841,12,2018,12,0
Group 3,RRG,1.5,17,14,3842,11,2018,13,-2
Group 3,RRG,1.5,17,14,3843,10,2018,14,-4
Group 3,RRG,1.5,17,14,3844,13,2018,11,2
Group 3,RRG,1.5,17,14,3845,12,2018,12,0
Group 3,RRG,1.5,17,14,3846,12,2018,11,1
Group 3,RRG,1.5,17,14,3847,12,2018,10,2
Group 3,RRG,1.5,17,14,3848,14,2018,11,3
Group 3,RRG,1.5,17,14,3849,12,2018,11,1
Group 3,RRG,1.5,17,14,3850,13,2018,11,2
Group 3,RRG,1.5,17,14,3851,12,2018,14,-2
Group 3,RRG,1.5,17,14,3852,7,2018,12,-5
Group 3,RRG,1.5,17,14,3853,8,2018,10,-2
Group 3,RRG,1.5,17,14,3854,12,2018,11,1
Group 3,RRG,1.5,17,14,3855,11,2018,11,0
Group 3,RRG,1.5,17,14,3856,10,2018,13,-3
Group 3,RRG,1.5,17,14,3857,14,2018,11,3
Group 3,RRG,1.5,17,14,3858,12,2018,12,0
Group 3,RRG,1.5,17,14,3859,10,2018,11,-1
Group 3,RRG,1.5,17,14,3860,11,2018,9,2
Group 3,RRG,1.5,17,14,3861,9,2018,12,-3
Group 3,RRG,1.5,17,14,3862,14,2018,9,5
Group 3,RRG,1.5,17,14,3863,13,2018,13,0
Group 3,RRG,1.5,17,14,3864,11,2018,12,-1
Group 3,RRG,1.5,17,14,3865,12,2018,10,2
Group 3,RRG,1.5,17,14,3866,12,2018,12,0
Group 3,RRG,1.5,17,14,3867,10,2018,9,1
Group 3,RRG,1.5,17,14,3868,11,2018,11,0
Group 3,RRG,1.5,17,14,3869,8,2018,12,-4
Group 3,RRG,1.5,17,14,3870,14,2018,13,1
Group 3,RRG,1.5,17,14,3871,11,2018,8,3
Group 3,RRG,1.5,17,14,3872,9,2018,11,-2
Group 3,RRG,1.5,17,14,3873,5,2018,10,-5
Group 3,RRG,1.5,17,14,3874,14,2018,11,3
Group 3,RRG,1.5,17,14,3875,12,2018,11,1
Group 3,RRG,1.5,17,14,3876,9,2018,7,2
Group 3,RRG,1.5,17,14,3877,9,2018,9,0
Group 3,RRG,1.5,17,14,3878,13,2018,10,3
Group 3,RRG,1.5,17,14,3879,11,2018,13,-2
Group 3,RRG,1.5,17,14,3880,11,2018,11,0
Group 3,RRG,1.5,17,14,3881,11,2018,9,2
Group 3,RRG,1.5,17,14,3882,14,2018,10,4
Group 3,RRG,1.5,17,14,3883,11,2018,12,-1
Group 3,RRG,1.5,17,14,3884,10,2018,11,-1
Group 3,RRG,1.5,17,14,3885,13,2018,11,2
Group 3,RRG,1.5,17,14,3886,8,2018,13,-5
Group 3,RRG,1.5,17,14,3887,9,2018,11,-2
Group 3,RRG,1.5,17,14,3888,10,2018,10,0
Group 3,RRG,1.5,17,14,3889,10,2018,9,1
Group 3,RRG,1.5,17,14,3890,12,2018,13,-1
Group 3,RRG,1.5,17,14,3891,2,2018,13,-11
Group 3,RRG,1.5,17,14,3892,14,2018,13,1
Group 3,RRG,1.5,17,14,3893,7,2018,6,1
Group 3,RRG,1.5,17,14,3894,12,2018,12,0
Group 3,RRG,1.5,17,14,3895,11,2018,9,2
Group 3,RRG,1.5,17,14,3896,13,2018,8,5
Group 3,RRG,1.5,17,14,3897,6,2018,8,-2
Group 3,RRG,1.5,17,14,3898,10,2018,14,-4
Group 3,RRG,1.5,17,14,3899,11,2018,12,-1
Group 3,RRG,1.5,17,14,3900,9,2018,13,-4
Group 3,RRG,1.5,17,14,3901,11,2018,10,1
Group 3,RRG,1.5,17,14,3902,12,2018,13,-1
Group 3,RRG,1.5,17,14,3903,12,2018,12,0
Group 3,RRG,1.5,17,14,3904,12,2018,13,-1
Group 3,RRG,1.5,17,14,3905,12,2018,12,0
Group 3,RRG,1.5,17,14,3906,13,2018,11,2
Group 3,RRG,1.5,17,14,3907,14,2018,10,4
Group 3,RRG,1.5,17,14,3908,12,2018,12,0
Group 3,RRG,1.5,17,14,3909,13,2018,12,1
Group 3,RRG,1.5,17,14,3910,6,2018,9,-3
Group 3,RRG,1.5,17,14,3911,13,2018,10,3
Group 3,RRG,1.5,17,14,3912,10,2018,7,3
Group 3,RRG,1.5,17,14,3913,9,2018,12,-3
Group 3,RRG,1.5,17,14,3914,11,2018,11,0
Group 3,RRG,1.5,17,14,3915,13,2018,12,1
Group 3,RRG,1.5,17,14,3916,12,2018,12,0
Group 3,RRG,1.5,17,14,3917,12,2018,12,0
Group 3,RRG,1.5,17,14,3918,8,2018,12,-4
Group 3,RRG,1.5,17,14,3919,12,2018,12,0
Group 3,RRG,1.5,17,14,3920,14,2018,11,3
Group 3,RRG,1.5,17,14,3921,14,2018,9,5
Group 3,RRG,1.5,17,14,3922,11,2018,13,-2
Group 3,RRG,1.5,17,14,3923,10,2018,12,-2
Group 3,RRG,1.5,17,14,3924,14,2018,10,4
Group 3,RRG,1.5,17,14,3925,11,2018,12,-1
Group 3,RRG,1.5,17,14,3926,11,2018,11,0
Group 3,RRG,1.5,17,14,3927,11,2018,12,-1
Group 3,RRG,1.5,17,14,3928,9,2018,9,0
Group 3,RRG,1.5,17,14,3929,6,2018,8,-2
Group 3,RRG,1.5,17,14,3930,13,2018,14,-1
Group 3,RRG,1.5,17,14,3931,13,2018,10,3
Group 3,RRG,1.5,17,14,3932,12,2018,8,4
Group 3,RRG,1.5,17,14,3933,13,2018,14,-1
Group 3,RRG,1.5,17,14,3934,13,2018,11,2
Group 3,RRG,1.5,17,14,3935,13,2018,11,2
Group 3,RRG,1.5,17,14,3936,9,2018,7,2
Group 3,RRG,1.5,17,14,3937,9,2018,13,-4
Group 3,RRG,1.5,17,14,3938,12,2018,13,-1
Group 3,RRG,1.5,17,14,3939,11,2018,11,0
Group 3,RRG,1.5,17,14,3940,12,2018,10,2
Group 3,RRG,1.5,17,14,3941,12,2018,9,3
Group 3,RRG,1.5,17,14,3942,10,2018,12,-2
Group 3,RRG,1.5,17,14,3943,10,2018,10,0
Group 3,RRG,1.5,17,14,3944,7,2018,12,-5
Group 3,RRG,1.5,17,14,3945,11,2018,12,-1
Group 3,RRG,1.5,17,14,3946,12,2018,14,-2
Group 3,RRG,1.5,17,14,3947,10,2018,12,-2
Group 3,RRG,1.5,17,14,3948,14,2018,11,3
Group 3,RRG,1.5,17,14,3949,10,2018,12,-2
Group 3,RRG,1.5,17,14,3950,11,2018,10,1
Group 3,RRG,1.5,17,14,3951,12,2018,12,0
Group 3,RRG,1.5,17,14,3952,13,2018,10,3
Group 3,RRG,1.5,17,14,3953,13,2018,10,3
Group 3,RRG,1.5,17,14,3954,13,2018,11,2
Group 3,RRG,1.5,17,14,3955,12,2018,11,1
Group 3,RRG,1.5,17,14,3956,11,2018,11,0
Group 3,RRG,1.5,17,14,3957,14,2018,13,1
Group 3,RRG,1.5,17,14,3958,11,2018,13,-2
Group 3,RRG,1.5,17,14,3959,12,2018,12,0
Group 3,RRG,1.5,17,14,3960,11,2018,12,-1
Group 3,RRG,1.5,17,14,3961,14,2018,10,4
Group 3,RRG,1.5,17,14,3962,9,2018,11,-2
Group 3,RRG,1.5,17,14,3963,12,2018,13,-1
Group 3,RRG,1.5,17,14,3964,8,2018,8,0
Group 3,RRG,1.5,17,14,3965,9,2018,12,-3
Group 3,RRG,1.5,17,14,3966,8,2018,8,0
Group 3,RRG,1.5,17,14,3967,12,2018,13,-1
Group 3,RRG,1.5,17,14,3968,12,2018,12,0
Group 3,RRG,1.5,17,14,3969,10,2018,12,-2
Group 3,RRG,1.5,17,14,3970,11,2018,9,2
Group 3,RRG,1.5,17,14,3971,12,2018,8,4
Group 3,RRG,1.5,17,14,3972,13,2018,11,2
Group 3,RRG,1.5,17,14,3973,10,2018,12,-2
Group 3,RRG,1.5,17,14,3974,12,2018,11,1
Group 3,RRG,1.5,17,14,3975,14,2018,12,2
Group 3,RRG,1.5,17,14,3976,11,2018,12,-1
Group 3,RRG,1.5,17,14,3977,11,2018,11,0
Group 3,RRG,1.5,17,14,3978,11,2018,10,1
Group 3,RRG,1.5,17,14,3979,8,2018,12,-4
Group 3,RRG,1.5,17,14,3980,8,2018,12,-4
Group 3,RRG,1.5,17,14,3981,9,2018,11,-2
Group 3,RRG,1.5,17,14,3982,11,2018,11,0
Group 3,RRG,1.5,17,14,3983,14,2018,13,1
Group 3,RRG,1.5,17,14,3984,8,2018,10,-2
Group 3,RRG,1.5,17,14,3985,8,2018,11,-3
Group 3,RRG,1.5,17,14,3986,6,2018,8,-2
Group 3,RRG,1.5,17,14,3987,9,2018,6,3
Group 3,RRG,1.5,17,14,3988,9,2018,7,2
Group 3,RRG,1.5,17,14,3989,9,2018,11,-2
Group 3,RRG,1.5,17,14,3990,12,2018,10,2
Group 3,RRG,1.5,17,14,3991,13,2018,12,1
Group 3,RRG,1.5,17,14,3992,9,2018,11,-2
Group 3,RRG,1.5,17,14,3993,13,2018,12,1
Group 3,RRG,1.5,17,14,3994,11,2018,9,2
Group 3,RRG,1.5,17,14,3995,13,2018,10,3
Group 3,RRG,1.5,17,14,3996,10,2018,12,-2
Group 3,RRG,1.5,17,14,3997,11,2018,12,-1
Group 3,RRG,1.5,17,14,3998,11,2018,13,-2
Group 3,RRG,1.5,17,14,3999,9,2018,12,-3
Group 3,RRG,1.5,17,14,4000,10,2018,8,2
Group 5,RRG,1.5,18,14,1,13,2018,8,5
Group 5,RRG,1.5,18,14,2,13,2018,12,1
Group 5,RRG,1.5,18,14,3,8,2018,7,1
Group 5,RRG,1.5,18,14,4,12,2018,9,3
Group 5,RRG,1.5,18,14,5,10,2018,13,-3
Group 5,RRG,1.5,18,14,6,13,2018,12,1
Group 5,RRG,1.5,18,14,7,12,2018,11,1
Group 5,RRG,1.5,18,14,8,10,2018,12,-2
Group 5,RRG,1.5,18,14,9,10,2018,9,1
Group 5,RRG,1.5,18,14,10,12,2018,12,0
Group 5,RRG,1.5,18,14,11,13,2018,11,2
Group 5,RRG,1.5,18,14,12,11,2018,12,-1
Group 5,RRG,1.5,18,14,13,12,2018,12,0
Group 5,RRG,1.5,18,14,14,14,2018,11,3
Group 5,RRG,1.5,18,14,15,11,2018,11,0
Group 5,RRG,1.5,18,14,16,13,2018,11,2
Group 5,RRG,1.5,18,14,17,8,2018,8,0
Group 5,RRG,1.5,18,14,18,13,2018,12,1
Group 5,RRG,1.5,18,14,19,13,2018,11,2
Group 5,RRG,1.5,18,14,20,13,2018,9,4
Group 5,RRG,1.5,18,14,21,8,2018,12,-4
Group 5,RRG,1.5,18,14,22,10,2018,13,-3
Group 5,RRG,1.5,18,14,23,9,2018,11,-2
Group 5,RRG,1.5,18,14,24,13,2018,13,0
Group 5,RRG,1.5,18,14,25,14,2018,13,1
Group 5,RRG,1.5,18,14,26,13,2018,10,3
Group 5,RRG,1.5,18,14,27,3,2018,11,-8
Group 5,RRG,1.5,18,14,28,12,2018,14,-2
Group 5,RRG,1.5,18,14,29,12,2018,4,8
Group 5,RRG,1.5,18,14,30,7,2018,8,-1
Group 5,RRG,1.5,18,14,31,10,2018,10,0
Group 5,RRG,1.5,18,14,32,11,2018,11,0
Group 5,RRG,1.5,18,14,33,9,2018,12,-3
Group 5,RRG,1.5,18,14,34,12,2018,13,-1
Group 5,RRG,1.5,18,14,35,7,2018,9,-2
Group 5,RRG,1.5,18,14,36,13,2018,13,0
Group 5,RRG,1.5,18,14,37,12,2018,10,2
Group 5,RRG,1.5,18,14,38,13,2018,12,1
Group 5,RRG,1.5,18,14,39,9,2018,13,-4
Group 5,RRG,1.5,18,14,40,12,2018,11,1
Group 5,RRG,1.5,18,14,41,9,2018,11,-2
Group 5,RRG,1.5,18,14,42,11,2018,10,1
Group 5,RRG,1.5,18,14,43,10,2018,10,0
Group 5,RRG,1.5,18,14,44,11,2018,12,-1
Group 5,RRG,1.5,18,14,45,13,2018,12,1
Group 5,RRG,1.5,18,14,46,13,2018,11,2
Group 5,RRG,1.5,18,14,47,12,2018,11,1
Group 5,RRG,1.5,18,14,48,12,2018,10,2
Group 5,RRG,1.5,18,14,49,13,2018,8,5
Group 5,RRG,1.5,18,14,50,10,2018,10,0
Group 5,RRG,1.5,18,14,51,12,2018,12,0
Group 5,RRG,1.5,18,14,52,13,2018,14,-1
Group 5,RRG,1.5,18,14,53,12,2018,11,1
Group 5,RRG,1.5,18,14,54,14,2018,11,3
Group 5,RRG,1.5,18,14,55,14,2018,14,0
Group 5,RRG,1.5,18,14,56,14,2018,13,1
Group 5,RRG,1.5,18,14,57,11,2018,11,0
Group 5,RRG,1.5,18,14,58,13,2018,12,1
Group 5,RRG,1.5,18,14,59,11,2018,10,1
Group 5,RRG,1.5,18,14,60,14,2018,9,5
Group 5,RRG,1.5,18,14,61,3,2018,14,-11
Group 5,RRG,1.5,18,14,62,7,2018,14,-7
Group 5,RRG,1.5,18,14,63,11,2018,12,-1
Group 5,RRG,1.5,18,14,64,11,2018,10,1
Group 5,RRG,1.5,18,14,65,12,2018,11,1
Group 5,RRG,1.5,18,14,66,11,2018,11,0
Group 5,RRG,1.5,18,14,67,13,2018,7,6
Group 5,RRG,1.5,18,14,68,11,2018,9,2
Group 5,RRG,1.5,18,14,69,13,2018,10,3
Group 5,RRG,1.5,18,14,70,7,2018,9,-2
Group 5,RRG,1.5,18,14,71,11,2018,9,2
Group 5,RRG,1.5,18,14,72,12,2018,14,-2
Group 5,RRG,1.5,18,14,73,7,2018,11,-4
Group 5,RRG,1.5,18,14,74,11,2018,10,1
Group 5,RRG,1.5,18,14,75,11,2018,12,-1
Group 5,RRG,1.5,18,14,76,7,2018,7,0
Group 5,RRG,1.5,18,14,77,13,2018,14,-1
Group 5,RRG,1.5,18,14,78,12,2018,12,0
Group 5,RRG,1.5,18,14,79,13,2018,13,0
Group 5,RRG,1.5,18,14,80,13,2018,12,1
Group 5,RRG,1.5,18,14,81,13,2018,9,4
Group 5,RRG,1.5,18,14,82,13,2018,10,3
Group 5,RRG,1.5,18,14,83,12,2018,13,-1
Group 5,RRG,1.5,18,14,84,8,2018,10,-2
Group 5,RRG,1.5,18,14,85,8,2018,11,-3
Group 5,RRG,1.5,18,14,86,13,2018,11,2
Group 5,RRG,1.5,18,14,87,11,2018,13,-2
Group 5,RRG,1.5,18,14,88,13,2018,11,2
Group 5,RRG,1.5,18,14,89,10,2018,10,0
Group 5,RRG,1.5,18,14,90,9,2018,10,-1
Group 5,RRG,1.5,18,14,91,14,2018,13,1
Group 5,RRG,1.5,18,14,92,12,2018,12,0
Group 5,RRG,1.5,18,14,93,13,2018,13,0
Group 5,RRG,1.5,18,14,94,11,2018,12,-1
Group 5,RRG,1.5,18,14,95,12,2018,11,1
Group 5,RRG,1.5,18,14,96,13,2018,9,4
Group 5,RRG,1.5,18,14,97,9,2018,14,-5
Group 5,RRG,1.5,18,14,98,11,2018,9,2
Group 5,RRG,1.5,18,14,99,13,2018,12,1
Group 5,RRG,1.5,18,14,100,10,2018,14,-4
Group 5,RRG,1.5,18,14,101,12,2018,12,0
Group 5,RRG,1.5,18,14,102,11,2018,8,3
Group 5,RRG,1.5,18,14,103,10,2018,14,-4
Group 5,RRG,1.5,18,14,104,11,2018,11,0
Group 5,RRG,1.5,18,14,105,14,2018,8,6
Group 5,RRG,1.5,18,14,106,13,2018,12,1
Group 5,RRG,1.5,18,14,107,11,2018,9,2
Group 5,RRG,1.5,18,14,108,14,2018,13,1
Group 5,RRG,1.5,18,14,109,13,2018,12,1
Group 5,RRG,1.5,18,14,110,14,2018,11,3
Group 5,RRG,1.5,18,14,111,12,2018,9,3
Group 5,RRG,1.5,18,14,112,12,2018,8,4
Group 5,RRG,1.5,18,14,113,13,2018,7,6
Group 5,RRG,1.5,18,14,114,12,2018,12,0
Group 5,RRG,1.5,18,14,115,12,2018,13,-1
Group 5,RRG,1.5,18,14,116,11,2018,11,0
Group 5,RRG,1.5,18,14,117,11,2018,13,-2
Group 5,RRG,1.5,18,14,118,13,2018,13,0
Group 5,RRG,1.5,18,14,119,10,2018,13,-3
Group 5,RRG,1.5,18,14,120,13,2018,12,1
Group 5,RRG,1.5,18,14,121,13,2018,14,-1
Group 5,RRG,1.5,18,14,122,11,2018,7,4
Group 5,RRG,1.5,18,14,123,12,2018,13,-1
Group 5,RRG,1.5,18,14,124,9,2018,13,-4
Group 5,RRG,1.5,18,14,125,13,2018,12,1
Group 5,RRG,1.5,18,14,126,9,2018,14,-5
Group 5,RRG,1.5,18,14,127,12,2018,14,-2
Group 5,RRG,1.5,18,14,128,11,2018,9,2
Group 5,RRG,1.5,18,14,129,12,2018,13,-1
Group 5,RRG,1.5,18,14,130,11,2018,13,-2
Group 5,RRG,1.5,18,14,131,14,2018,13,1
Group 5,RRG,1.5,18,14,132,11,2018,9,2
Group 5,RRG,1.5,18,14,133,12,2018,13,-1
Group 5,RRG,1.5,18,14,134,11,2018,10,1
Group 5,RRG,1.5,18,14,135,13,2018,12,1
Group 5,RRG,1.5,18,14,136,13,2018,12,1
Group 5,RRG,1.5,18,14,137,7,2018,11,-4
Group 5,RRG,1.5,18,14,138,12,2018,13,-1
Group 5,RRG,1.5,18,14,139,12,2018,10,2
Group 5,RRG,1.5,18,14,140,7,2018,12,-5
Group 5,RRG,1.5,18,14,141,12,2018,11,1
Group 5,RRG,1.5,18,14,142,14,2018,14,0
Group 5,RRG,1.5,18,14,143,14,2018,13,1
Group 5,RRG,1.5,18,14,144,10,2018,13,-3
Group 5,RRG,1.5,18,14,145,12,2018,9,3
Group 5,RRG,1.5,18,14,146,13,2018,11,2
Group 5,RRG,1.5,18,14,147,8,2018,10,-2
Group 5,RRG,1.5,18,14,148,13,2018,11,2
Group 5,RRG,1.5,18,14,149,11,2018,10,1
Group 5,RRG,1.5,18,14,150,11,2018,12,-1
Group 5,RRG,1.5,18,14,151,12,2018,10,2
Group 5,RRG,1.5,18,14,152,14,2018,14,0
Group 5,RRG,1.5,18,14,153,9,2018,12,-3
Group 5,RRG,1.5,18,14,154,13,2018,12,1
Group 5,RRG,1.5,18,14,155,14,2018,13,1
Group 5,RRG,1.5,18,14,156,12,2018,10,2
Group 5,RRG,1.5,18,14,157,12,2018,12,0
Group 5,RRG,1.5,18,14,158,7,2018,10,-3
Group 5,RRG,1.5,18,14,159,12,2018,9,3
Group 5,RRG,1.5,18,14,160,10,2018,12,-2
Group 5,RRG,1.5,18,14,161,13,2018,10,3
Group 5,RRG,1.5,18,14,162,13,2018,10,3
Group 5,RRG,1.5,18,14,163,13,2018,9,4
Group 5,RRG,1.5,18,14,164,9,2018,11,-2
Group 5,RRG,1.5,18,14,165,13,2018,11,2
Group 5,RRG,1.5,18,14,166,12,2018,11,1
Group 5,RRG,1.5,18,14,167,8,2018,11,-3
Group 5,RRG,1.5,18,14,168,13,2018,8,5
Group 5,RRG,1.5,18,14,169,13,2018,10,3
Group 5,RRG,1.5,18,14,170,7,2018,12,-5
Group 5,RRG,1.5,18,14,171,8,2018,11,-3
Group 5,RRG,1.5,18,14,172,13,2018,5,8
Group 5,RRG,1.5,18,14,173,14,2018,7,7
Group 5,RRG,1.5,18,14,174,11,2018,7,4
Group 5,RRG,1.5,18,14,175,14,2018,9,5
Group 5,RRG,1.5,18,14,176,10,2018,13,-3
Group 5,RRG,1.5,18,14,177,6,2018,11,-5
Group 5,RRG,1.5,18,14,178,13,2018,14,-1
Group 5,RRG,1.5,18,14,179,11,2018,12,-1
Group 5,RRG,1.5,18,14,180,11,2018,13,-2
Group 5,RRG,1.5,18,14,181,12,2018,14,-2
Group 5,RRG,1.5,18,14,182,11,2018,8,3
Group 5,RRG,1.5,18,14,183,13,2018,9,4
Group 5,RRG,1.5,18,14,184,13,2018,10,3
Group 5,RRG,1.5,18,14,185,13,2018,12,1
Group 5,RRG,1.5,18,14,186,10,2018,12,-2
Group 5,RRG,1.5,18,14,187,12,2018,9,3
Group 5,RRG,1.5,18,14,188,11,2018,11,0
Group 5,RRG,1.5,18,14,189,12,2018,9,3
Group 5,RRG,1.5,18,14,190,9,2018,9,0
Group 5,RRG,1.5,18,14,191,14,2018,12,2
Group 5,RRG,1.5,18,14,192,7,2018,9,-2
Group 5,RRG,1.5,18,14,193,12,2018,10,2
Group 5,RRG,1.5,18,14,194,12,2018,13,-1
Group 5,RRG,1.5,18,14,195,14,2018,10,4
Group 5,RRG,1.5,18,14,196,12,2018,12,0
Group 5,RRG,1.5,18,14,197,8,2018,13,-5
Group 5,RRG,1.5,18,14,198,13,2018,13,0
Group 5,RRG,1.5,18,14,199,8,2018,10,-2
Group 5,RRG,1.5,18,14,200,13,2018,11,2
Group 5,RRG,1.5,18,14,201,14,2018,8,6
Group 5,RRG,1.5,18,14,202,8,2018,9,-1
Group 5,RRG,1.5,18,14,203,12,2018,12,0
Group 5,RRG,1.5,18,14,204,12,2018,11,1
Group 5,RRG,1.5,18,14,205,12,2018,12,0
Group 5,RRG,1.5,18,14,206,12,2018,11,1
Group 5,RRG,1.5,18,14,207,10,2018,12,-2
Group 5,RRG,1.5,18,14,208,10,2018,10,0
Group 5,RRG,1.5,18,14,209,12,2018,8,4
Group 5,RRG,1.5,18,14,210,14,2018,12,2
Group 5,RRG,1.5,18,14,211,13,2018,14,-1
Group 5,RRG,1.5,18,14,212,14,2018,11,3
Group 5,RRG,1.5,18,14,213,12,2018,8,4
Group 5,RRG,1.5,18,14,214,12,2018,12,0
Group 5,RRG,1.5,18,14,215,11,2018,12,-1
Group 5,RRG,1.5,18,14,216,14,2018,11,3
Group 5,RRG,1.5,18,14,217,11,2018,13,-2
Group 5,RRG,1.5,18,14,218,12,2018,11,1
Group 5,RRG,1.5,18,14,219,12,2018,9,3
Group 5,RRG,1.5,18,14,220,10,2018,12,-2
Group 5,RRG,1.5,18,14,221,10,2018,11,-1
Group 5,RRG,1.5,18,14,222,12,2018,12,0
Group 5,RRG,1.5,18,14,223,10,2018,11,-1
Group 5,RRG,1.5,18,14,224,11,2018,10,1
Group 5,RRG,1.5,18,14,225,9,2018,11,-2
Group 5,RRG,1.5,18,14,226,12,2018,11,1
Group 5,RRG,1.5,18,14,227,12,2018,11,1
Group 5,RRG,1.5,18,14,228,11,2018,12,-1
Group 5,RRG,1.5,18,14,229,10,2018,8,2
Group 5,RRG,1.5,18,14,230,11,2018,14,-3
Group 5,RRG,1.5,18,14,231,12,2018,13,-1
Group 5,RRG,1.5,18,14,232,11,2018,12,-1
Group 5,RRG,1.5,18,14,233,11,2018,8,3
Group 5,RRG,1.5,18,14,234,14,2018,10,4
Group 5,RRG,1.5,18,14,235,12,2018,13,-1
Group 5,RRG,1.5,18,14,236,12,2018,12,0
Group 5,RRG,1.5,18,14,237,14,2018,12,2
Group 5,RRG,1.5,18,14,238,12,2018,12,0
Group 5,RRG,1.5,18,14,239,12,2018,11,1
Group 5,RRG,1.5,18,14,240,13,2018,12,1
Group 5,RRG,1.5,18,14,241,11,2018,8,3
Group 5,RRG,1.5,18,14,242,13,2018,11,2
Group 5,RRG,1.5,18,14,243,10,2018,9,1
Group 5,RRG,1.5,18,14,244,13,2018,13,0
Group 5,RRG,1.5,18,14,245,14,2018,11,3
Group 5,RRG,1.5,18,14,246,10,2018,12,-2
Group 5,RRG,1.5,18,14,247,13,2018,12,1
Group 5,RRG,1.5,18,14,248,11,2018,8,3
Group 5,RRG,1.5,18,14,249,12,2018,12,0
Group 5,RRG,1.5,18,14,250,12,2018,13,-1
Group 5,RRG,1.5,18,14,251,13,2018,10,3
Group 5,RRG,1.5,18,14,252,11,2018,12,-1
Group 5,RRG,1.5,18,14,253,13,2018,11,2
Group 5,RRG,1.5,18,14,254,10,2018,11,-1
Group 5,RRG,1.5,18,14,255,10,2018,12,-2
Group 5,RRG,1.5,18,14,256,12,2018,13,-1
Group 5,RRG,1.5,18,14,257,9,2018,12,-3
Group 5,RRG,1.5,18,14,258,10,2018,10,0
Group 5,RRG,1.5,18,14,259,13,2018,11,2
Group 5,RRG,1.5,18,14,260,10,2018,13,-3
Group 5,RRG,1.5,18,14,261,11,2018,11,0
Group 5,RRG,1.5,18,14,262,12,2018,9,3
Group 5,RRG,1.5,18,14,263,14,2018,7,7
Group 5,RRG,1.5,18,14,264,10,2018,12,-2
Group 5,RRG,1.5,18,14,265,14,2018,8,6
Group 5,RRG,1.5,18,14,266,10,2018,9,1
Group 5,RRG,1.5,18,14,267,12,2018,13,-1
Group 5,RRG,1.5,18,14,268,7,2018,12,-5
Group 5,RRG,1.5,18,14,269,13,2018,11,2
Group 5,RRG,1.5,18,14,270,10,2018,12,-2
Group 5,RRG,1.5,18,14,271,12,2018,9,3
Group 5,RRG,1.5,18,14,272,11,2018,12,-1
Group 5,RRG,1.5,18,14,273,9,2018,13,-4
Group 5,RRG,1.5,18,14,274,14,2018,10,4
Group 5,RRG,1.5,18,14,275,10,2018,12,-2
Group 5,RRG,1.5,18,14,276,13,2018,9,4
Group 5,RRG,1.5,18,14,277,11,2018,12,-1
Group 5,RRG,1.5,18,14,278,13,2018,12,1
Group 5,RRG,1.5,18,14,279,12,2018,11,1
Group 5,RRG,1.5,18,14,280,12,2018,11,1
Group 5,RRG,1.5,18,14,281,11,2018,12,-1
Group 5,RRG,1.5,18,14,282,13,2018,12,1
Group 5,RRG,1.5,18,14,283,14,2018,12,2
Group 5,RRG,1.5,18,14,284,12,2018,9,3
Group 5,RRG,1.5,18,14,285,12,2018,11,1
Group 5,RRG,1.5,18,14,286,11,2018,9,2
Group 5,RRG,1.5,18,14,287,11,2018,11,0
Group 5,RRG,1.5,18,14,288,9,2018,13,-4
Group 5,RRG,1.5,18,14,289,10,2018,11,-1
Group 5,RRG,1.5,18,14,290,14,2018,13,1
Group 5,RRG,1.5,18,14,291,12,2018,13,-1
Group 5,RRG,1.5,18,14,292,12,2018,10,2
Group 5,RRG,1.5,18,14,293,12,2018,12,0
Group 5,RRG,1.5,18,14,294,12,2018,9,3
Group 5,RRG,1.5,18,14,295,11,2018,8,3
Group 5,RRG,1.5,18,14,296,10,2018,13,-3
Group 5,RRG,1.5,18,14,297,11,2018,11,0
Group 5,RRG,1.5,18,14,298,13,2018,13,0
Group 5,RRG,1.5,18,14,299,14,2018,10,4
Group 5,RRG,1.5,18,14,300,11,2018,12,-1
Group 5,RRG,1.5,18,14,301,9,2018,13,-4
Group 5,RRG,1.5,18,14,302,12,2018,11,1
Group 5,RRG,1.5,18,14,303,13,2018,13,0
Group 5,RRG,1.5,18,14,304,13,2018,11,2
Group 5,RRG,1.5,18,14,305,13,2018,11,2
Group 5,RRG,1.5,18,14,306,8,2018,11,-3
Group 5,RRG,1.5,18,14,307,14,2018,10,4
Group 5,RRG,1.5,18,14,308,13,2018,10,3
Group 5,RRG,1.5,18,14,309,11,2018,10,1
Group 5,RRG,1.5,18,14,310,3,2018,12,-9
Group 5,RRG,1.5,18,14,311,12,2018,11,1
Group 5,RRG,1.5,18,14,312,14,2018,12,2
Group 5,RRG,1.5,18,14,313,11,2018,12,-1
Group 5,RRG,1.5,18,14,314,13,2018,13,0
Group 5,RRG,1.5,18,14,315,11,2018,9,2
Group 5,RRG,1.5,18,14,316,6,2018,12,-6
Group 5,RRG,1.5,18,14,317,5,2018,10,-5
Group 5,RRG,1.5,18,14,318,14,2018,10,4
Group 5,RRG,1.5,18,14,319,13,2018,12,1
Group 5,RRG,1.5,18,14,320,10,2018,14,-4
Group 5,RRG,1.5,18,14,321,8,2018,10,-2
Group 5,RRG,1.5,18,14,322,12,2018,10,2
Group 5,RRG,1.5,18,14,323,12,2018,12,0
Group 5,RRG,1.5,18,14,324,9,2018,13,-4
Group 5,RRG,1.5,18,14,325,13,2018,10,3
Group 5,RRG,1.5,18,14,326,10,2018,10,0
Group 5,RRG,1.5,18,14,327,13,2018,11,2
Group 5,RRG,1.5,18,14,328,14,2018,12,2
Group 5,RRG,1.5,18,14,329,9,2018,9,0
Group 5,RRG,1.5,18,14,330,13,2018,12,1
Group 5,RRG,1.5,18,14,331,11,2018,8,3
Group 5,RRG,1.5,18,14,332,13,2018,11,2
Group 5,RRG,1.5,18,14,333,11,2018,12,-1
Group 5,RRG,1.5,18,14,334,11,2018,8,3
Group 5,RRG,1.5,18,14,335,12,2018,13,-1
Group 5,RRG,1.5,18,14,336,10,2018,10,0
Group 5,RRG,1.5,18,14,337,11,2018,10,1
Group 5,RRG,1.5,18,14,338,11,2018,9,2
Group 5,RRG,1.5,18,14,339,12,2018,10,2
Group 5,RRG,1.5,18,14,340,9,2018,12,-3
Group 5,RRG,1.5,18,14,341,12,2018,9,3
Group 5,RRG,1.5,18,14,342,13,2018,14,-1
Group 5,RRG,1.5,18,14,343,11,2018,10,1
Group 5,RRG,1.5,18,14,344,9,2018,11,-2
Group 5,RRG,1.5,18,14,345,13,2018,13,0
Group 5,RRG,1.5,18,14,346,14,2018,12,2
Group 5,RRG,1.5,18,14,347,13,2018,14,-1
Group 5,RRG,1.5,18,14,348,14,2018,9,5
Group 5,RRG,1.5,18,14,349,11,2018,13,-2
Group 5,RRG,1.5,18,14,350,12,2018,11,1
Group 5,RRG,1.5,18,14,351,11,2018,12,-1
Group 5,RRG,1.5,18,14,352,11,2018,12,-1
Group 5,RRG,1.5,18,14,353,11,2018,7,4
Group 5,RRG,1.5,18,14,354,6,2018,13,-7
Group 5,RRG,1.5,18,14,355,11,2018,12,-1
Group 5,RRG,1.5,18,14,356,10,2018,10,0
Group 5,RRG,1.5,18,14,357,10,2018,11,-1
Group 5,RRG,1.5,18,14,358,11,2018,9,2
Group 5,RRG,1.5,18,14,359,7,2018,10,-3
Group 5,RRG,1.5,18,14,360,14,2018,11,3
Group 5,RRG,1.5,18,14,361,12,2018,10,2
Group 5,RRG,1.5,18,14,362,10,2018,8,2
Group 5,RRG,1.5,18,14,363,9,2018,14,-5
Group 5,RRG,1.5,18,14,364,13,2018,13,0
Group 5,RRG,1.5,18,14,365,13,2018,13,0
Group 5,RRG,1.5,18,14,366,14,2018,11,3
Group 5,RRG,1.5,18,14,367,14,2018,11,3
Group 5,RRG,1.5,18,14,368,12,2018,12,0
Group 5,RRG,1.5,18,14,369,11,2018,11,0
Group 5,RRG,1.5,18,14,370,8,2018,13,-5
Group 5,RRG,1.5,18,14,371,13,2018,12,1
Group 5,RRG,1.5,18,14,372,10,2018,10,0
Group 5,RRG,1.5,18,14,373,7,2018,12,-5
Group 5,RRG,1.5,18,14,374,14,2018,11,3
Group 5,RRG,1.5,18,14,375,11,2018,13,-2
Group 5,RRG,1.5,18,14,376,14,2018,12,2
Group 5,RRG,1.5,18,14,377,9,2018,10,-1
Group 5,RRG,1.5,18,14,378,9,2018,10,-1
Group 5,RRG,1.5,18,14,379,12,2018,11,1
Group 5,RRG,1.5,18,14,380,13,2018,9,4
Group 5,RRG,1.5,18,14,381,12,2018,11,1
Group 5,RRG,1.5,18,14,382,12,2018,13,-1
Group 5,RRG,1.5,18,14,383,12,2018,13,-1
Group 5,RRG,1.5,18,14,384,10,2018,11,-1
Group 5,RRG,1.5,18,14,385,13,2018,14,-1
Group 5,RRG,1.5,18,14,386,13,2018,12,1
Group 5,RRG,1.5,18,14,387,8,2018,11,-3
Group 5,RRG,1.5,18,14,388,12,2018,12,0
Group 5,RRG,1.5,18,14,389,12,2018,14,-2
Group 5,RRG,1.5,18,14,390,9,2018,10,-1
Group 5,RRG,1.5,18,14,391,13,2018,12,1
Group 5,RRG,1.5,18,14,392,14,2018,11,3
Group 5,RRG,1.5,18,14,393,12,2018,12,0
Group 5,RRG,1.5,18,14,394,9,2018,10,-1
Group 5,RRG,1.5,18,14,395,11,2018,11,0
Group 5,RRG,1.5,18,14,396,10,2018,11,-1
Group 5,RRG,1.5,18,14,397,11,2018,14,-3
Group 5,RRG,1.5,18,14,398,13,2018,13,0
Group 5,RRG,1.5,18,14,399,11,2018,10,1
Group 5,RRG,1.5,18,14,400,13,2018,8,5
Group 5,RRG,1.5,18,14,401,10,2018,10,0
Group 5,RRG,1.5,18,14,402,12,2018,11,1
Group 5,RRG,1.5,18,14,403,13,2018,13,0
Group 5,RRG,1.5,18,14,404,12,2018,8,4
Group 5,RRG,1.5,18,14,405,12,2018,12,0
Group 5,RRG,1.5,18,14,406,13,2018,11,2
Group 5,RRG,1.5,18,14,407,9,2018,10,-1
Group 5,RRG,1.5,18,14,408,13,2018,9,4
Group 5,RRG,1.5,18,14,409,12,2018,10,2
Group 5,RRG,1.5,18,14,410,13,2018,13,0
Group 5,RRG,1.5,18,14,411,10,2018,9,1
Group 5,RRG,1.5,18,14,412,14,2018,9,5
Group 5,RRG,1.5,18,14,413,11,2018,13,-2
Group 5,RRG,1.5,18,14,414,11,2018,9,2
Group 5,RRG,1.5,18,14,415,10,2018,12,-2
Group 5,RRG,1.5,18,14,416,8,2018,10,-2
Group 5,RRG,1.5,18,14,417,12,2018,12,0
Group 5,RRG,1.5,18,14,418,13,2018,12,1
Group 5,RRG,1.5,18,14,419,14,2018,11,3
Group 5,RRG,1.5,18,14,420,14,2018,10,4
Group 5,RRG,1.5,18,14,421,12,2018,14,-2
Group 5,RRG,1.5,18,14,422,13,2018,13,0
Group 5,RRG,1.5,18,14,423,13,2018,13,0
Group 5,RRG,1.5,18,14,424,13,2018,13,0
Group 5,RRG,1.5,18,14,425,11,2018,13,-2
Group 5,RRG,1.5,18,14,426,13,2018,7,6
Group 5,RRG,1.5,18,14,427,13,2018,13,0
Group 5,RRG,1.5,18,14,428,13,2018,10,3
Group 5,RRG,1.5,18,14,429,12,2018,12,0
Group 5,RRG,1.5,18,14,430,11,2018,13,-2
Group 5,RRG,1.5,18,14,431,12,2018,10,2
Group 5,RRG,1.5,18,14,432,12,2018,11,1
Group 5,RRG,1.5,18,14,433,10,2018,11,-1
Group 5,RRG,1.5,18,14,434,11,2018,11,0
Group 5,RRG,1.5,18,14,435,13,2018,11,2
Group 5,RRG,1.5,18,14,436,3,2018,10,-7
Group 5,RRG,1.5,18,14,437,13,2018,12,1
Group 5,RRG,1.5,18,14,438,12,2018,8,4
Group 5,RRG,1.5,18,14,439,14,2018,10,4
Group 5,RRG,1.5,18,14,440,6,2018,10,-4
Group 5,RRG,1.5,18,14,441,11,2018,12,-1
Group 5,RRG,1.5,18,14,442,10,2018,9,1
Group 5,RRG,1.5,18,14,443,14,2018,13,1
Group 5,RRG,1.5,18,14,444,14,2018,11,3
Group 5,RRG,1.5,18,14,445,12,2018,10,2
Group 5,RRG,1.5,18,14,446,11,2018,8,3
Group 5,RRG,1.5,18,14,447,13,2018,13,0
Group 5,RRG,1.5,18,14,448,14,2018,12,2
Group 5,RRG,1.5,18,14,449,12,2018,14,-2
Group 5,RRG,1.5,18,14,450,14,2018,11,3
Group 5,RRG,1.5,18,14,451,14,2018,9,5
Group 5,RRG,1.5,18,14,452,14,2018,14,0
Group 5,RRG,1.5,18,14,453,10,2018,10,0
Group 5,RRG,1.5,18,14,454,12,2018,14,-2
Group 5,RRG,1.5,18,14,455,12,2018,11,1
Group 5,RRG,1.5,18,14,456,10,2018,12,-2
Group 5,RRG,1.5,18,14,457,11,2018,12,-1
Group 5,RRG,1.5,18,14,458,13,2018,9,4
Group 5,RRG,1.5,18,14,459,11,2018,9,2
Group 5,RRG,1.5,18,14,460,13,2018,12,1
Group 5,RRG,1.5,18,14,461,9,2018,7,2
Group 5,RRG,1.5,18,14,462,14,2018,9,5
Group 5,RRG,1.5,18,14,463,12,2018,10,2
Group 5,RRG,1.5,18,14,464,13,2018,11,2
Group 5,RRG,1.5,18,14,465,11,2018,12,-1
Group 5,RRG,1.5,18,14,466,13,2018,7,6
Group 5,RRG,1.5,18,14,467,12,2018,11,1
Group 5,RRG,1.5,18,14,468,12,2018,9,3
Group 5,RRG,1.5,18,14,469,13,2018,10,3
Group 5,RRG,1.5,18,14,470,12,2018,13,-1
Group 5,RRG,1.5,18,14,471,10,2018,10,0
Group 5,RRG,1.5,18,14,472,6,2018,10,-4
Group 5,RRG,1.5,18,14,473,14,2018,13,1
Group 5,RRG,1.5,18,14,474,12,2018,9,3
Group 5,RRG,1.5,18,14,475,12,2018,9,3
Group 5,RRG,1.5,18,14,476,9,2018,10,-1
Group 5,RRG,1.5,18,14,477,12,2018,8,4
Group 5,RRG,1.5,18,14,478,12,2018,13,-1
Group 5,RRG,1.5,18,14,479,11,2018,12,-1
Group 5,RRG,1.5,18,14,480,11,2018,11,0
Group 5,RRG,1.5,18,14,481,12,2018,11,1
Group 5,RRG,1.5,18,14,482,11,2018,10,1
Group 5,RRG,1.5,18,14,483,12,2018,13,-1
Group 5,RRG,1.5,18,14,484,11,2018,13,-2
Group 5,RRG,1.5,18,14,485,9,2018,13,-4
Group 5,RRG,1.5,18,14,486,10,2018,13,-3
Group 5,RRG,1.5,18,14,487,9,2018,14,-5
Group 5,RRG,1.5,18,14,488,10,2018,12,-2
Group 5,RRG,1.5,18,14,489,12,2018,12,0
Group 5,RRG,1.5,18,14,490,13,2018,10,3
Group 5,RRG,1.5,18,14,491,7,2018,12,-5
Group 5,RRG,1.5,18,14,492,14,2018,8,6
Group 5,RRG,1.5,18,14,493,13,2018,10,3
Group 5,RRG,1.5,18,14,494,14,2018,11,3
Group 5,RRG,1.5,18,14,495,13,2018,11,2
Group 5,RRG,1.5,18,14,496,11,2018,14,-3
Group 5,RRG,1.5,18,14,497,14,2018,11,3
Group 5,RRG,1.5,18,14,498,7,2018,12,-5
Group 5,RRG,1.5,18,14,499,10,2018,13,-3
Group 5,RRG,1.5,18,14,500,3,2018,11,-8
Group 5,RRG,1.5,18,14,501,11,2018,14,-3
Group 5,RRG,1.5,18,14,502,12,2018,12,0
Group 5,RRG,1.5,18,14,503,10,2018,14,-4
Group 5,RRG,1.5,18,14,504,10,2018,11,-1
Group 5,RRG,1.5,18,14,505,12,2018,12,0
Group 5,RRG,1.5,18,14,506,13,2018,14,-1
Group 5,RRG,1.5,18,14,507,13,2018,13,0
Group 5,RRG,1.5,18,14,508,13,2018,14,-1
Group 5,RRG,1.5,18,14,509,13,2018,12,1
Group 5,RRG,1.5,18,14,510,12,2018,12,0
Group 5,RRG,1.5,18,14,511,8,2018,10,-2
Group 5,RRG,1.5,18,14,512,13,2018,13,0
Group 5,RRG,1.5,18,14,513,13,2018,7,6
Group 5,RRG,1.5,18,14,514,10,2018,13,-3
Group 5,RRG,1.5,18,14,515,12,2018,14,-2
Group 5,RRG,1.5,18,14,516,12,2018,7,5
Group 5,RRG,1.5,18,14,517,13,2018,13,0
Group 5,RRG,1.5,18,14,518,13,2018,9,4
Group 5,RRG,1.5,18,14,519,6,2018,7,-1
Group 5,RRG,1.5,18,14,520,13,2018,14,-1
Group 5,RRG,1.5,18,14,521,10,2018,10,0
Group 5,RRG,1.5,18,14,522,11,2018,6,5
Group 5,RRG,1.5,18,14,523,10,2018,9,1
Group 5,RRG,1.5,18,14,524,13,2018,10,3
Group 5,RRG,1.5,18,14,525,12,2018,11,1
Group 5,RRG,1.5,18,14,526,10,2018,12,-2
Group 5,RRG,1.5,18,14,527,10,2018,11,-1
Group 5,RRG,1.5,18,14,528,11,2018,14,-3
Group 5,RRG,1.5,18,14,529,12,2018,11,1
Group 5,RRG,1.5,18,14,530,11,2018,12,-1
Group 5,RRG,1.5,18,14,531,11,2018,11,0
Group 5,RRG,1.5,18,14,532,14,2018,12,2
Group 5,RRG,1.5,18,14,533,10,2018,9,1
Group 5,RRG,1.5,18,14,534,14,2018,9,5
Group 5,RRG,1.5,18,14,535,13,2018,9,4
Group 5,RRG,1.5,18,14,536,14,2018,7,7
Group 5,RRG,1.5,18,14,537,10,2018,12,-2
Group 5,RRG,1.5,18,14,538,4,2018,13,-9
Group 5,RRG,1.5,18,14,539,14,2018,13,1
Group 5,RRG,1.5,18,14,540,9,2018,11,-2
Group 5,RRG,1.5,18,14,541,12,2018,10,2
Group 5,RRG,1.5,18,14,542,13,2018,9,4
Group 5,RRG,1.5,18,14,543,12,2018,9,3
Group 5,RRG,1.5,18,14,544,14,2018,10,4
Group 5,RRG,1.5,18,14,545,13,2018,12,1
Group 5,RRG,1.5,18,14,546,13,2018,12,1
Group 5,RRG,1.5,18,14,547,10,2018,8,2
Group 5,RRG,1.5,18,14,548,13,2018,11,2
Group 5,RRG,1.5,18,14,549,11,2018,13,-2
Group 5,RRG,1.5,18,14,550,11,2018,6,5
Group 5,RRG,1.5,18,14,551,14,2018,12,2
Group 5,RRG,1.5,18,14,552,10,2018,7,3
Group 5,RRG,1.5,18,14,553,12,2018,13,-1
Group 5,RRG,1.5,18,14,554,11,2018,12,-1
Group 5,RRG,1.5,18,14,555,11,2018,12,-1
Group 5,RRG,1.5,18,14,556,11,2018,10,1
Group 5,RRG,1.5,18,14,557,13,2018,13,0
Group 5,RRG,1.5,18,14,558,14,2018,9,5
Group 5,RRG,1.5,18,14,559,11,2018,13,-2
Group 5,RRG,1.5,18,14,560,12,2018,12,0
Group 5,RRG,1.5,18,14,561,12,2018,10,2
Group 5,RRG,1.5,18,14,562,9,2018,8,1
Group 5,RRG,1.5,18,14,563,13,2018,10,3
Group 5,RRG,1.5,18,14,564,14,2018,10,4
Group 5,RRG,1.5,18,14,565,11,2018,9,2
Group 5,RRG,1.5,18,14,566,12,2018,9,3
Group 5,RRG,1.5,18,14,567,14,2018,10,4
Group 5,RRG,1.5,18,14,568,14,2018,12,2
Group 5,RRG,1.5,18,14,569,14,2018,9,5
Group 5,RRG,1.5,18,14,570,9,2018,9,0
Group 5,RRG,1.5,18,14,571,10,2018,11,-1
Group 5,RRG,1.5,18,14,572,12,2018,9,3
Group 5,RRG,1.5,18,14,573,11,2018,10,1
Group 5,RRG,1.5,18,14,574,9,2018,8,1
Group 5,RRG,1.5,18,14,575,12,2018,11,1
Group 5,RRG,1.5,18,14,576,13,2018,10,3
Group 5,RRG,1.5,18,14,577,12,2018,13,-1
Group 5,RRG,1.5,18,14,578,10,2018,10,0
Group 5,RRG,1.5,18,14,579,12,2018,13,-1
Group 5,RRG,1.5,18,14,580,9,2018,10,-1
Group 5,RRG,1.5,18,14,581,9,2018,11,-2
Group 5,RRG,1.5,18,14,582,11,2018,11,0
Group 5,RRG,1.5,18,14,583,9,2018,10,-1
Group 5,RRG,1.5,18,14,584,13,2018,11,2
Group 5,RRG,1.5,18,14,585,12,2018,12,0
Group 5,RRG,1.5,18,14,586,13,2018,13,0
Group 5,RRG,1.5,18,14,587,14,2018,9,5
Group 5,RRG,1.5,18,14,588,11,2018,11,0
Group 5,RRG,1.5,18,14,589,9,2018,10,-1
Group 5,RRG,1.5,18,14,590,14,2018,13,1
Group 5,RRG,1.5,18,14,591,10,2018,10,0
Group 5,RRG,1.5,18,14,592,11,2018,10,1
Group 5,RRG,1.5,18,14,593,10,2018,12,-2
Group 5,RRG,1.5,18,14,594,9,2018,11,-2
Group 5,RRG,1.5,18,14,595,10,2018,12,-2
Group 5,RRG,1.5,18,14,596,11,2018,10,1
Group 5,RRG,1.5,18,14,597,12,2018,10,2
Group 5,RRG,1.5,18,14,598,8,2018,8,0
Group 5,RRG,1.5,18,14,599,13,2018,11,2
Group 5,RRG,1.5,18,14,600,9,2018,14,-5
Group 5,RRG,1.5,18,14,601,12,2018,9,3
Group 5,RRG,1.5,18,14,602,12,2018,8,4
Group 5,RRG,1.5,18,14,603,11,2018,11,0
Group 5,RRG,1.5,18,14,604,14,2018,10,4
Group 5,RRG,1.5,18,14,605,14,2018,11,3
Group 5,RRG,1.5,18,14,606,9,2018,12,-3
Group 5,RRG,1.5,18,14,607,12,2018,12,0
Group 5,RRG,1.5,18,14,608,12,2018,11,1
Group 5,RRG,1.5,18,14,609,8,2018,11,-3
Group 5,RRG,1.5,18,14,610,10,2018,11,-1
Group 5,RRG,1.5,18,14,611,12,2018,14,-2
Group 5,RRG,1.5,18,14,612,11,2018,11,0
Group 5,RRG,1.5,18,14,613,14,2018,11,3
Group 5,RRG,1.5,18,14,614,13,2018,9,4
Group 5,RRG,1.5,18,14,615,11,2018,12,-1
Group 5,RRG,1.5,18,14,616,10,2018,12,-2
Group 5,RRG,1.5,18,14,617,13,2018,10,3
Group 5,RRG,1.5,18,14,618,12,2018,10,2
Group 5,RRG,1.5,18,14,619,12,2018,8,4
Group 5,RRG,1.5,18,14,620,11,2018,14,-3
Group 5,RRG,1.5,18,14,621,13,2018,12,1
Group 5,RRG,1.5,18,14,622,14,2018,14,0
Group 5,RRG,1.5,18,14,623,11,2018,13,-2
Group 5,RRG,1.5,18,14,624,10,2018,11,-1
Group 5,RRG,1.5,18,14,625,9,2018,13,-4
Group 5,RRG,1.5,18,14,626,9,2018,14,-5
Group 5,RRG,1.5,18,14,627,14,2018,8,6
Group 5,RRG,1.5,18,14,628,10,2018,13,-3
Group 5,RRG,1.5,18,14,629,13,2018,10,3
Group 5,RRG,1.5,18,14,630,9,2018,14,-5
Group 5,RRG,1.5,18,14,631,11,2018,13,-2
Group 5,RRG,1.5,18,14,632,10,2018,14,-4
Group 5,RRG,1.5,18,14,633,12,2018,11,1
Group 5,RRG,1.5,18,14,634,14,2018,12,2
Group 5,RRG,1.5,18,14,635,10,2018,9,1
Group 5,RRG,1.5,18,14,636,13,2018,11,2
Group 5,RRG,1.5,18,14,637,8,2018,12,-4
Group 5,RRG,1.5,18,14,638,12,2018,11,1
Group 5,RRG,1.5,18,14,639,10,2018,8,2
Group 5,RRG,1.5,18,14,640,13,2018,13,0
Group 5,RRG,1.5,18,14,641,13,2018,11,2
Group 5,RRG,1.5,18,14,642,12,2018,9,3
Group 5,RRG,1.5,18,14,643,12,2018,12,0
Group 5,RRG,1.5,18,14,644,11,2018,11,0
Group 5,RRG,1.5,18,14,645,12,2018,11,1
Group 5,RRG,1.5,18,14,646,11,2018,10,1
Group 5,RRG,1.5,18,14,647,11,2018,12,-1
Group 5,RRG,1.5,18,14,648,14,2018,8,6
Group 5,RRG,1.5,18,14,649,14,2018,13,1
Group 5,RRG,1.5,18,14,650,14,2018,11,3
Group 5,RRG,1.5,18,14,651,12,2018,9,3
Group 5,RRG,1.5,18,14,652,10,2018,10,0
Group 5,RRG,1.5,18,14,653,12,2018,7,5
Group 5,RRG,1.5,18,14,654,12,2018,10,2
Group 5,RRG,1.5,18,14,655,12,2018,11,1
Group 5,RRG,1.5,18,14,656,14,2018,10,4
Group 5,RRG,1.5,18,14,657,12,2018,13,-1
Group 5,RRG,1.5,18,14,658,13,2018,7,6
Group 5,RRG,1.5,18,14,659,8,2018,10,-2
Group 5,RRG,1.5,18,14,660,12,2018,9,3
Group 5,RRG,1.5,18,14,661,14,2018,11,3
Group 5,RRG,1.5,18,14,662,8,2018,11,-3
Group 5,RRG,1.5,18,14,663,12,2018,12,0
Group 5,RRG,1.5,18,14,664,10,2018,8,2
Group 5,RRG,1.5,18,14,665,12,2018,12,0
Group 5,RRG,1.5,18,14,666,8,2018,11,-3
Group 5,RRG,1.5,18,14,667,12,2018,12,0
Group 5,RRG,1.5,18,14,668,10,2018,9,1
Group 5,RRG,1.5,18,14,669,9,2018,11,-2
Group 5,RRG,1.5,18,14,670,12,2018,12,0
Group 5,RRG,1.5,18,14,671,13,2018,12,1
Group 5,RRG,1.5,18,14,672,14,2018,5,9
Group 5,RRG,1.5,18,14,673,10,2018,13,-3
Group 5,RRG,1.5,18,14,674,13,2018,8,5
Group 5,RRG,1.5,18,14,675,9,2018,10,-1
Group 5,RRG,1.5,18,14,676,11,2018,10,1
Group 5,RRG,1.5,18,14,677,11,2018,12,-1
Group 5,RRG,1.5,18,14,678,10,2018,14,-4
Group 5,RRG,1.5,18,14,679,11,2018,14,-3
Group 5,RRG,1.5,18,14,680,14,2018,6,8
Group 5,RRG,1.5,18,14,681,10,2018,11,-1
Group 5,RRG,1.5,18,14,682,12,2018,10,2
Group 5,RRG,1.5,18,14,683,13,2018,8,5
Group 5,RRG,1.5,18,14,684,13,2018,11,2
Group 5,RRG,1.5,18,14,685,7,2018,13,-6
Group 5,RRG,1.5,18,14,686,12,2018,11,1
Group 5,RRG,1.5,18,14,687,11,2018,12,-1
Group 5,RRG,1.5,18,14,688,14,2018,11,3
Group 5,RRG,1.5,18,14,689,12,2018,12,0
Group 5,RRG,1.5,18,14,690,10,2018,11,-1
Group 5,RRG,1.5,18,14,691,12,2018,12,0
Group 5,RRG,1.5,18,14,692,13,2018,11,2
Group 5,RRG,1.5,18,14,693,12,2018,7,5
Group 5,RRG,1.5,18,14,694,10,2018,12,-2
Group 5,RRG,1.5,18,14,695,12,2018,12,0
Group 5,RRG,1.5,18,14,696,13,2018,9,4
Group 5,RRG,1.5,18,14,697,10,2018,13,-3
Group 5,RRG,1.5,18,14,698,9,2018,10,-1
Group 5,RRG,1.5,18,14,699,13,2018,10,3
Group 5,RRG,1.5,18,14,700,12,2018,12,0
Group 5,RRG,1.5,18,14,701,9,2018,11,-2
Group 5,RRG,1.5,18,14,702,9,2018,8,1
Group 5,RRG,1.5,18,14,703,11,2018,12,-1
Group 5,RRG,1.5,18,14,704,13,2018,13,0
Group 5,RRG,1.5,18,14,705,12,2018,12,0
Group 5,RRG,1.5,18,14,706,12,2018,10,2
Group 5,RRG,1.5,18,14,707,12,2018,8,4
Group 5,RRG,1.5,18,14,708,12,2018,14,-2
Group 5,RRG,1.5,18,14,709,12,2018,12,0
Group 5,RRG,1.5,18,14,710,12,2018,10,2
Group 5,RRG,1.5,18,14,711,12,2018,10,2
Group 5,RRG,1.5,18,14,712,11,2018,8,3
Group 5,RRG,1.5,18,14,713,12,2018,8,4
Group 5,RRG,1.5,18,14,714,11,2018,10,1
Group 5,RRG,1.5,18,14,715,11,2018,10,1
Group 5,RRG,1.5,18,14,716,5,2018,3,2
Group 5,RRG,1.5,18,14,717,14,2018,13,1
Group 5,RRG,1.5,18,14,718,10,2018,4,6
Group 5,RRG,1.5,18,14,719,13,2018,13,0
Group 5,RRG,1.5,18,14,720,11,2018,12,-1
Group 5,RRG,1.5,18,14,721,13,2018,13,0
Group 5,RRG,1.5,18,14,722,10,2018,14,-4
Group 5,RRG,1.5,18,14,723,13,2018,12,1
Group 5,RRG,1.5,18,14,724,10,2018,11,-1
Group 5,RRG,1.5,18,14,725,13,2018,11,2
Group 5,RRG,1.5,18,14,726,9,2018,10,-1
Group 5,RRG,1.5,18,14,727,14,2018,14,0
Group 5,RRG,1.5,18,14,728,12,2018,13,-1
Group 5,RRG,1.5,18,14,729,11,2018,8,3
Group 5,RRG,1.5,18,14,730,11,2018,13,-2
Group 5,RRG,1.5,18,14,731,14,2018,13,1
Group 5,RRG,1.5,18,14,732,14,2018,13,1
Group 5,RRG,1.5,18,14,733,11,2018,10,1
Group 5,RRG,1.5,18,14,734,11,2018,12,-1
Group 5,RRG,1.5,18,14,735,10,2018,11,-1
Group 5,RRG,1.5,18,14,736,12,2018,14,-2
Group 5,RRG,1.5,18,14,737,12,2018,10,2
Group 5,RRG,1.5,18,14,738,12,2018,10,2
Group 5,RRG,1.5,18,14,739,13,2018,11,2
Group 5,RRG,1.5,18,14,740,14,2018,12,2
Group 5,RRG,1.5,18,14,741,10,2018,10,0
Group 5,RRG,1.5,18,14,742,11,2018,14,-3
Group 5,RRG,1.5,18,14,743,14,2018,12,2
Group 5,RRG,1.5,18,14,744,14,2018,13,1
Group 5,RRG,1.5,18,14,745,9,2018,12,-3
Group 5,RRG,1.5,18,14,746,9,2018,10,-1
Group 5,RRG,1.5,18,14,747,9,2018,10,-1
Group 5,RRG,1.5,18,14,748,13,2018,12,1
Group 5,RRG,1.5,18,14,749,12,2018,11,1
Group 5,RRG,1.5,18,14,750,11,2018,11,0
Group 5,RRG,1.5,18,14,751,11,2018,13,-2
Group 5,RRG,1.5,18,14,752,13,2018,14,-1
Group 5,RRG,1.5,18,14,753,12,2018,9,3
Group 5,RRG,1.5,18,14,754,14,2018,11,3
Group 5,RRG,1.5,18,14,755,10,2018,9,1
Group 5,RRG,1.5,18,14,756,10,2018,11,-1
Group 5,RRG,1.5,18,14,757,11,2018,13,-2
Group 5,RRG,1.5,18,14,758,13,2018,9,4
Group 5,RRG,1.5,18,14,759,13,2018,14,-1
Group 5,RRG,1.5,18,14,760,13,2018,12,1
Group 5,RRG,1.5,18,14,761,12,2018,12,0
Group 5,RRG,1.5,18,14,762,14,2018,9,5
Group 5,RRG,1.5,18,14,763,12,2018,9,3
Group 5,RRG,1.5,18,14,764,12,2018,10,2
Group 5,RRG,1.5,18,14,765,10,2018,11,-1
Group 5,RRG,1.5,18,14,766,14,2018,11,3
Group 5,RRG,1.5,18,14,767,12,2018,10,2
Group 5,RRG,1.5,18,14,768,12,2018,12,0
Group 5,RRG,1.5,18,14,769,8,2018,11,-3
Group 5,RRG,1.5,18,14,770,12,2018,7,5
Group 5,RRG,1.5,18,14,771,12,2018,9,3
Group 5,RRG,1.5,18,14,772,11,2018,13,-2
Group 5,RRG,1.5,18,14,773,10,2018,11,-1
Group 5,RRG,1.5,18,14,774,11,2018,13,-2
Group 5,RRG,1.5,18,14,775,13,2018,10,3
Group 5,RRG,1.5,18,14,776,10,2018,9,1
Group 5,RRG,1.5,18,14,777,9,2018,13,-4
Group 5,RRG,1.5,18,14,778,10,2018,11,-1
Group 5,RRG,1.5,18,14,779,13,2018,13,0
Group 5,RRG,1.5,18,14,780,13,2018,13,0
Group 5,RRG,1.5,18,14,781,12,2018,10,2
Group 5,RRG,1.5,18,14,782,8,2018,10,-2
Group 5,RRG,1.5,18,14,783,14,2018,11,3
Group 5,RRG,1.5,18,14,784,14,2018,11,3
Group 5,RRG,1.5,18,14,785,11,2018,9,2
Group 5,RRG,1.5,18,14,786,11,2018,6,5
Group 5,RRG,1.5,18,14,787,12,2018,9,3
Group 5,RRG,1.5,18,14,788,11,2018,6,5
Group 5,RRG,1.5,18,14,789,13,2018,9,4
Group 5,RRG,1.5,18,14,790,12,2018,12,0
Group 5,RRG,1.5,18,14,791,14,2018,9,5
Group 5,RRG,1.5,18,14,792,12,2018,14,-2
Group 5,RRG,1.5,18,14,793,13,2018,10,3
Group 5,RRG,1.5,18,14,794,12,2018,12,0
Group 5,RRG,1.5,18,14,795,13,2018,11,2
Group 5,RRG,1.5,18,14,796,12,2018,9,3
Group 5,RRG,1.5,18,14,797,11,2018,13,-2
Group 5,RRG,1.5,18,14,798,11,2018,8,3
Group 5,RRG,1.5,18,14,799,14,2018,10,4
Group 5,RRG,1.5,18,14,800,7,2018,8,-1
Group 5,RRG,1.5,18,14,801,11,2018,6,5
Group 5,RRG,1.5,18,14,802,13,2018,11,2
Group 5,RRG,1.5,18,14,803,9,2018,9,0
Group 5,RRG,1.5,18,14,804,9,2018,7,2
Group 5,RRG,1.5,18,14,805,11,2018,9,2
Group 5,RRG,1.5,18,14,806,13,2018,13,0
Group 5,RRG,1.5,18,14,807,14,2018,13,1
Group 5,RRG,1.5,18,14,808,14,2018,10,4
Group 5,RRG,1.5,18,14,809,12,2018,10,2
Group 5,RRG,1.5,18,14,810,11,2018,9,2
Group 5,RRG,1.5,18,14,811,12,2018,12,0
Group 5,RRG,1.5,18,14,812,13,2018,12,1
Group 5,RRG,1.5,18,14,813,12,2018,13,-1
Group 5,RRG,1.5,18,14,814,14,2018,13,1
Group 5,RRG,1.5,18,14,815,11,2018,13,-2
Group 5,RRG,1.5,18,14,816,10,2018,12,-2
Group 5,RRG,1.5,18,14,817,12,2018,12,0
Group 5,RRG,1.5,18,14,818,11,2018,10,1
Group 5,RRG,1.5,18,14,819,11,2018,8,3
Group 5,RRG,1.5,18,14,820,13,2018,11,2
Group 5,RRG,1.5,18,14,821,10,2018,10,0
Group 5,RRG,1.5,18,14,822,14,2018,12,2
Group 5,RRG,1.5,18,14,823,11,2018,13,-2
Group 5,RRG,1.5,18,14,824,11,2018,12,-1
Group 5,RRG,1.5,18,14,825,13,2018,12,1
Group 5,RRG,1.5,18,14,826,14,2018,11,3
Group 5,RRG,1.5,18,14,827,14,2018,8,6
Group 5,RRG,1.5,18,14,828,12,2018,13,-1
Group 5,RRG,1.5,18,14,829,11,2018,8,3
Group 5,RRG,1.5,18,14,830,9,2018,13,-4
Group 5,RRG,1.5,18,14,831,11,2018,11,0
Group 5,RRG,1.5,18,14,832,9,2018,10,-1
Group 5,RRG,1.5,18,14,833,11,2018,13,-2
Group 5,RRG,1.5,18,14,834,13,2018,13,0
Group 5,RRG,1.5,18,14,835,12,2018,10,2
Group 5,RRG,1.5,18,14,836,9,2018,13,-4
Group 5,RRG,1.5,18,14,837,8,2018,14,-6
Group 5,RRG,1.5,18,14,838,13,2018,12,1
Group 5,RRG,1.5,18,14,839,9,2018,11,-2
Group 5,RRG,1.5,18,14,840,13,2018,14,-1
Group 5,RRG,1.5,18,14,841,11,2018,11,0
Group 5,RRG,1.5,18,14,842,8,2018,13,-5
Group 5,RRG,1.5,18,14,843,13,2018,11,2
Group 5,RRG,1.5,18,14,844,11,2018,5,6
Group 5,RRG,1.5,18,14,845,12,2018,10,2
Group 5,RRG,1.5,18,14,846,14,2018,13,1
Group 5,RRG,1.5,18,14,847,10,2018,12,-2
Group 5,RRG,1.5,18,14,848,9,2018,9,0
Group 5,RRG,1.5,18,14,849,10,2018,10,0
Group 5,RRG,1.5,18,14,850,10,2018,12,-2
Group 5,RRG,1.5,18,14,851,8,2018,12,-4
Group 5,RRG,1.5,18,14,852,11,2018,13,-2
Group 5,RRG,1.5,18,14,853,11,2018,10,1
Group 5,RRG,1.5,18,14,854,13,2018,9,4
Group 5,RRG,1.5,18,14,855,13,2018,14,-1
Group 5,RRG,1.5,18,14,856,11,2018,12,-1
Group 5,RRG,1.5,18,14,857,12,2018,10,2
Group 5,RRG,1.5,18,14,858,10,2018,11,-1
Group 5,RRG,1.5,18,14,859,7,2018,11,-4
Group 5,RRG,1.5,18,14,860,11,2018,11,0
Group 5,RRG,1.5,18,14,861,12,2018,9,3
Group 5,RRG,1.5,18,14,862,11,2018,12,-1
Group 5,RRG,1.5,18,14,863,13,2018,14,-1
Group 5,RRG,1.5,18,14,864,12,2018,13,-1
Group 5,RRG,1.5,18,14,865,14,2018,10,4
Group 5,RRG,1.5,18,14,866,13,2018,13,0
Group 5,RRG,1.5,18,14,867,11,2018,8,3
Group 5,RRG,1.5,18,14,868,12,2018,9,3
Group 5,RRG,1.5,18,14,869,13,2018,10,3
Group 5,RRG,1.5,18,14,870,11,2018,10,1
Group 5,RRG,1.5,18,14,871,13,2018,10,3
Group 5,RRG,1.5,18,14,872,13,2018,11,2
Group 5,RRG,1.5,18,14,873,12,2018,12,0
Group 5,RRG,1.5,18,14,874,12,2018,12,0
Group 5,RRG,1.5,18,14,875,13,2018,9,4
Group 5,RRG,1.5,18,14,876,9,2018,11,-2
Group 5,RRG,1.5,18,14,877,9,2018,11,-2
Group 5,RRG,1.5,18,14,878,14,2018,6,8
Group 5,RRG,1.5,18,14,879,12,2018,11,1
Group 5,RRG,1.5,18,14,880,14,2018,11,3
Group 5,RRG,1.5,18,14,881,11,2018,11,0
Group 5,RRG,1.5,18,14,882,14,2018,14,0
Group 5,RRG,1.5,18,14,883,11,2018,14,-3
Group 5,RRG,1.5,18,14,884,10,2018,12,-2
Group 5,RRG,1.5,18,14,885,13,2018,13,0
Group 5,RRG,1.5,18,14,886,12,2018,12,0
Group 5,RRG,1.5,18,14,887,14,2018,12,2
Group 5,RRG,1.5,18,14,888,8,2018,13,-5
Group 5,RRG,1.5,18,14,889,13,2018,10,3
Group 5,RRG,1.5,18,14,890,10,2018,11,-1
Group 5,RRG,1.5,18,14,891,11,2018,12,-1
Group 5,RRG,1.5,18,14,892,13,2018,11,2
Group 5,RRG,1.5,18,14,893,7,2018,10,-3
Group 5,RRG,1.5,18,14,894,10,2018,13,-3
Group 5,RRG,1.5,18,14,895,5,2018,9,-4
Group 5,RRG,1.5,18,14,896,12,2018,12,0
Group 5,RRG,1.5,18,14,897,14,2018,10,4
Group 5,RRG,1.5,18,14,898,14,2018,11,3
Group 5,RRG,1.5,18,14,899,11,2018,8,3
Group 5,RRG,1.5,18,14,900,12,2018,9,3
Group 5,RRG,1.5,18,14,901,11,2018,7,4
Group 5,RRG,1.5,18,14,902,14,2018,10,4
Group 5,RRG,1.5,18,14,903,11,2018,12,-1
Group 5,RRG,1.5,18,14,904,10,2018,9,1
Group 5,RRG,1.5,18,14,905,13,2018,10,3
Group 5,RRG,1.5,18,14,906,10,2018,10,0
Group 5,RRG,1.5,18,14,907,14,2018,11,3
Group 5,RRG,1.5,18,14,908,13,2018,10,3
Group 5,RRG,1.5,18,14,909,12,2018,9,3
Group 5,RRG,1.5,18,14,910,12,2018,8,4
Group 5,RRG,1.5,18,14,911,10,2018,11,-1
Group 5,RRG,1.5,18,14,912,14,2018,9,5
Group 5,RRG,1.5,18,14,913,12,2018,6,6
Group 5,RRG,1.5,18,14,914,9,2018,10,-1
Group 5,RRG,1.5,18,14,915,11,2018,8,3
Group 5,RRG,1.5,18,14,916,12,2018,9,3
Group 5,RRG,1.5,18,14,917,12,2018,12,0
Group 5,RRG,1.5,18,14,918,13,2018,11,2
Group 5,RRG,1.5,18,14,919,7,2018,11,-4
Group 5,RRG,1.5,18,14,920,11,2018,14,-3
Group 5,RRG,1.5,18,14,921,12,2018,12,0
Group 5,RRG,1.5,18,14,922,13,2018,11,2
Group 5,RRG,1.5,18,14,923,10,2018,10,0
Group 5,RRG,1.5,18,14,924,14,2018,12,2
Group 5,RRG,1.5,18,14,925,9,2018,11,-2
Group 5,RRG,1.5,18,14,926,13,2018,12,1
Group 5,RRG,1.5,18,14,927,10,2018,12,-2
Group 5,RRG,1.5,18,14,928,11,2018,12,-1
Group 5,RRG,1.5,18,14,929,12,2018,11,1
Group 5,RRG,1.5,18,14,930,11,2018,13,-2
Group 5,RRG,1.5,18,14,931,12,2018,13,-1
Group 5,RRG,1.5,18,14,932,9,2018,13,-4
Group 5,RRG,1.5,18,14,933,13,2018,9,4
Group 5,RRG,1.5,18,14,934,12,2018,10,2
Group 5,RRG,1.5,18,14,935,8,2018,11,-3
Group 5,RRG,1.5,18,14,936,9,2018,12,-3
Group 5,RRG,1.5,18,14,937,12,2018,12,0
Group 5,RRG,1.5,18,14,938,11,2018,13,-2
Group 5,RRG,1.5,18,14,939,13,2018,12,1
Group 5,RRG,1.5,18,14,940,14,2018,10,4
Group 5,RRG,1.5,18,14,941,10,2018,12,-2
Group 5,RRG,1.5,18,14,942,11,2018,12,-1
Group 5,RRG,1.5,18,14,943,12,2018,9,3
Group 5,RRG,1.5,18,14,944,12,2018,11,1
Group 5,RRG,1.5,18,14,945,9,2018,10,-1
Group 5,RRG,1.5,18,14,946,14,2018,13,1
Group 5,RRG,1.5,18,14,947,14,2018,12,2
Group 5,RRG,1.5,18,14,948,9,2018,13,-4
Group 5,RRG,1.5,18,14,949,14,2018,11,3
Group 5,RRG,1.5,18,14,950,11,2018,14,-3
Group 5,RRG,1.5,18,14,951,13,2018,11,2
Group 5,RRG,1.5,18,14,952,13,2018,12,1
Group 5,RRG,1.5,18,14,953,13,2018,9,4
Group 5,RRG,1.5,18,14,954,13,2018,8,5
Group 5,RRG,1.5,18,14,955,12,2018,13,-1
Group 5,RRG,1.5,18,14,956,12,2018,8,4
Group 5,RRG,1.5,18,14,957,12,2018,12,0
Group 5,RRG,1.5,18,14,958,14,2018,14,0
Group 5,RRG,1.5,18,14,959,11,2018,10,1
Group 5,RRG,1.5,18,14,960,13,2018,8,5
Group 5,RRG,1.5,18,14,961,9,2018,11,-2
Group 5,RRG,1.5,18,14,962,10,2018,11,-1
Group 5,RRG,1.5,18,14,963,13,2018,11,2
Group 5,RRG,1.5,18,14,964,12,2018,9,3
Group 5,RRG,1.5,18,14,965,11,2018,11,0
Group 5,RRG,1.5,18,14,966,12,2018,7,5
Group 5,RRG,1.5,18,14,967,13,2018,12,1
Group 5,RRG,1.5,18,14,968,14,2018,9,5
Group 5,RRG,1.5,18,14,969,13,2018,12,1
Group 5,RRG,1.5,18,14,970,13,2018,12,1
Group 5,RRG,1.5,18,14,971,13,2018,11,2
Group 5,RRG,1.5,18,14,972,11,2018,8,3
Group 5,RRG,1.5,18,14,973,11,2018,13,-2
Group 5,RRG,1.5,18,14,974,12,2018,11,1
Group 5,RRG,1.5,18,14,975,13,2018,12,1
Group 5,RRG,1.5,18,14,976,12,2018,10,2
Group 5,RRG,1.5,18,14,977,13,2018,9,4
Group 5,RRG,1.5,18,14,978,8,2018,13,-5
Group 5,RRG,1.5,18,14,979,13,2018,8,5
Group 5,RRG,1.5,18,14,980,11,2018,10,1
Group 5,RRG,1.5,18,14,981,14,2018,14,0
Group 5,RRG,1.5,18,14,982,12,2018,10,2
Group 5,RRG,1.5,18,14,983,12,2018,13,-1
Group 5,RRG,1.5,18,14,984,13,2018,9,4
Group 5,RRG,1.5,18,14,985,13,2018,12,1
Group 5,RRG,1.5,18,14,986,14,2018,12,2
Group 5,RRG,1.5,18,14,987,12,2018,13,-1
Group 5,RRG,1.5,18,14,988,9,2018,12,-3
Group 5,RRG,1.5,18,14,989,11,2018,10,1
Group 5,RRG,1.5,18,14,990,9,2018,9,0
Group 5,RRG,1.5,18,14,991,12,2018,13,-1
Group 5,RRG,1.5,18,14,992,12,2018,13,-1
Group 5,RRG,1.5,18,14,993,12,2018,10,2
Group 5,RRG,1.5,18,14,994,11,2018,9,2
Group 5,RRG,1.5,18,14,995,14,2018,10,4
Group 5,RRG,1.5,18,14,996,9,2018,12,-3
Group 5,RRG,1.5,18,14,997,14,2018,11,3
Group 5,RRG,1.5,18,14,998,13,2018,11,2
Group 5,RRG,1.5,18,14,999,11,2018,12,-1
Group 5,RRG,1.5,18,14,1000,10,2018,11,-1
Group 5,RRG,1.5,18,14,1001,7,2018,14,-7
Group 5,RRG,1.5,18,14,1002,13,2018,13,0
Group 5,RRG,1.5,18,14,1003,9,2018,14,-5
Group 5,RRG,1.5,18,14,1004,1,2018,14,-13
Group 5,RRG,1.5,18,14,1005,14,2018,13,1
Group 5,RRG,1.5,18,14,1006,6,2018,10,-4
Group 5,RRG,1.5,18,14,1007,11,2018,11,0
Group 5,RRG,1.5,18,14,1008,14,2018,12,2
Group 5,RRG,1.5,18,14,1009,11,2018,12,-1
Group 5,RRG,1.5,18,14,1010,13,2018,10,3
Group 5,RRG,1.5,18,14,1011,14,2018,10,4
Group 5,RRG,1.5,18,14,1012,12,2018,13,-1
Group 5,RRG,1.5,18,14,1013,8,2018,11,-3
Group 5,RRG,1.5,18,14,1014,12,2018,13,-1
Group 5,RRG,1.5,18,14,1015,11,2018,10,1
Group 5,RRG,1.5,18,14,1016,12,2018,8,4
Group 5,RRG,1.5,18,14,1017,11,2018,10,1
Group 5,RRG,1.5,18,14,1018,12,2018,7,5
Group 5,RRG,1.5,18,14,1019,13,2018,9,4
Group 5,RRG,1.5,18,14,1020,11,2018,10,1
Group 5,RRG,1.5,18,14,1021,11,2018,13,-2
Group 5,RRG,1.5,18,14,1022,14,2018,11,3
Group 5,RRG,1.5,18,14,1023,13,2018,11,2
Group 5,RRG,1.5,18,14,1024,10,2018,9,1
Group 5,RRG,1.5,18,14,1025,13,2018,12,1
Group 5,RRG,1.5,18,14,1026,11,2018,14,-3
Group 5,RRG,1.5,18,14,1027,7,2018,12,-5
Group 5,RRG,1.5,18,14,1028,8,2018,13,-5
Group 5,RRG,1.5,18,14,1029,8,2018,7,1
Group 5,RRG,1.5,18,14,1030,12,2018,11,1
Group 5,RRG,1.5,18,14,1031,12,2018,11,1
Group 5,RRG,1.5,18,14,1032,11,2018,10,1
Group 5,RRG,1.5,18,14,1033,9,2018,12,-3
Group 5,RRG,1.5,18,14,1034,11,2018,11,0
Group 5,RRG,1.5,18,14,1035,10,2018,10,0
Group 5,RRG,1.5,18,14,1036,14,2018,13,1
Group 5,RRG,1.5,18,14,1037,12,2018,12,0
Group 5,RRG,1.5,18,14,1038,13,2018,12,1
Group 5,RRG,1.5,18,14,1039,10,2018,13,-3
Group 5,RRG,1.5,18,14,1040,9,2018,10,-1
Group 5,RRG,1.5,18,14,1041,12,2018,11,1
Group 5,RRG,1.5,18,14,1042,10,2018,9,1
Group 5,RRG,1.5,18,14,1043,10,2018,14,-4
Group 5,RRG,1.5,18,14,1044,11,2018,12,-1
Group 5,RRG,1.5,18,14,1045,11,2018,10,1
Group 5,RRG,1.5,18,14,1046,8,2018,9,-1
Group 5,RRG,1.5,18,14,1047,12,2018,10,2
Group 5,RRG,1.5,18,14,1048,12,2018,9,3
Group 5,RRG,1.5,18,14,1049,12,2018,12,0
Group 5,RRG,1.5,18,14,1050,13,2018,10,3
Group 5,RRG,1.5,18,14,1051,11,2018,8,3
Group 5,RRG,1.5,18,14,1052,11,2018,10,1
Group 5,RRG,1.5,18,14,1053,8,2018,9,-1
Group 5,RRG,1.5,18,14,1054,11,2018,7,4
Group 5,RRG,1.5,18,14,1055,13,2018,12,1
Group 5,RRG,1.5,18,14,1056,14,2018,10,4
Group 5,RRG,1.5,18,14,1057,12,2018,9,3
Group 5,RRG,1.5,18,14,1058,12,2018,11,1
Group 5,RRG,1.5,18,14,1059,10,2018,14,-4
Group 5,RRG,1.5,18,14,1060,11,2018,14,-3
Group 5,RRG,1.5,18,14,1061,12,2018,10,2
Group 5,RRG,1.5,18,14,1062,12,2018,11,1
Group 5,RRG,1.5,18,14,1063,12,2018,13,-1
Group 5,RRG,1.5,18,14,1064,12,2018,13,-1
Group 5,RRG,1.5,18,14,1065,10,2018,10,0
Group 5,RRG,1.5,18,14,1066,8,2018,9,-1
Group 5,RRG,1.5,18,14,1067,12,2018,13,-1
Group 5,RRG,1.5,18,14,1068,13,2018,11,2
Group 5,RRG,1.5,18,14,1069,13,2018,6,7
Group 5,RRG,1.5,18,14,1070,12,2018,9,3
Group 5,RRG,1.5,18,14,1071,11,2018,11,0
Group 5,RRG,1.5,18,14,1072,11,2018,9,2
Group 5,RRG,1.5,18,14,1073,7,2018,13,-6
Group 5,RRG,1.5,18,14,1074,12,2018,7,5
Group 5,RRG,1.5,18,14,1075,8,2018,12,-4
Group 5,RRG,1.5,18,14,1076,14,2018,11,3
Group 5,RRG,1.5,18,14,1077,11,2018,13,-2
Group 5,RRG,1.5,18,14,1078,7,2018,13,-6
Group 5,RRG,1.5,18,14,1079,10,2018,11,-1
Group 5,RRG,1.5,18,14,1080,6,2018,12,-6
Group 5,RRG,1.5,18,14,1081,12,2018,12,0
Group 5,RRG,1.5,18,14,1082,14,2018,8,6
Group 5,RRG,1.5,18,14,1083,12,2018,11,1
Group 5,RRG,1.5,18,14,1084,11,2018,11,0
Group 5,RRG,1.5,18,14,1085,10,2018,9,1
Group 5,RRG,1.5,18,14,1086,13,2018,9,4
Group 5,RRG,1.5,18,14,1087,14,2018,10,4
Group 5,RRG,1.5,18,14,1088,14,2018,8,6
Group 5,RRG,1.5,18,14,1089,5,2018,13,-8
Group 5,RRG,1.5,18,14,1090,13,2018,12,1
Group 5,RRG,1.5,18,14,1091,13,2018,11,2
Group 5,RRG,1.5,18,14,1092,13,2018,9,4
Group 5,RRG,1.5,18,14,1093,11,2018,13,-2
Group 5,RRG,1.5,18,14,1094,10,2018,10,0
Group 5,RRG,1.5,18,14,1095,12,2018,10,2
Group 5,RRG,1.5,18,14,1096,11,2018,8,3
Group 5,RRG,1.5,18,14,1097,10,2018,12,-2
Group 5,RRG,1.5,18,14,1098,12,2018,9,3
Group 5,RRG,1.5,18,14,1099,14,2018,7,7
Group 5,RRG,1.5,18,14,1100,14,2018,6,8
Group 5,RRG,1.5,18,14,1101,13,2018,9,4
Group 5,RRG,1.5,18,14,1102,7,2018,10,-3
Group 5,RRG,1.5,18,14,1103,7,2018,9,-2
Group 5,RRG,1.5,18,14,1104,8,2018,13,-5
Group 5,RRG,1.5,18,14,1105,7,2018,12,-5
Group 5,RRG,1.5,18,14,1106,9,2018,11,-2
Group 5,RRG,1.5,18,14,1107,9,2018,10,-1
Group 5,RRG,1.5,18,14,1108,13,2018,10,3
Group 5,RRG,1.5,18,14,1109,14,2018,14,0
Group 5,RRG,1.5,18,14,1110,13,2018,8,5
Group 5,RRG,1.5,18,14,1111,13,2018,11,2
Group 5,RRG,1.5,18,14,1112,14,2018,11,3
Group 5,RRG,1.5,18,14,1113,10,2018,11,-1
Group 5,RRG,1.5,18,14,1114,12,2018,10,2
Group 5,RRG,1.5,18,14,1115,11,2018,11,0
Group 5,RRG,1.5,18,14,1116,11,2018,13,-2
Group 5,RRG,1.5,18,14,1117,12,2018,11,1
Group 5,RRG,1.5,18,14,1118,12,2018,12,0
Group 5,RRG,1.5,18,14,1119,12,2018,14,-2
Group 5,RRG,1.5,18,14,1120,12,2018,14,-2
Group 5,RRG,1.5,18,14,1121,13,2018,10,3
Group 5,RRG,1.5,18,14,1122,13,2018,8,5
Group 5,RRG,1.5,18,14,1123,8,2018,10,-2
Group 5,RRG,1.5,18,14,1124,13,2018,9,4
Group 5,RRG,1.5,18,14,1125,12,2018,10,2
Group 5,RRG,1.5,18,14,1126,14,2018,10,4
Group 5,RRG,1.5,18,14,1127,13,2018,10,3
Group 5,RRG,1.5,18,14,1128,14,2018,10,4
Group 5,RRG,1.5,18,14,1129,13,2018,12,1
Group 5,RRG,1.5,18,14,1130,12,2018,11,1
Group 5,RRG,1.5,18,14,1131,14,2018,13,1
Group 5,RRG,1.5,18,14,1132,13,2018,13,0
Group 5,RRG,1.5,18,14,1133,13,2018,14,-1
Group 5,RRG,1.5,18,14,1134,12,2018,11,1
Group 5,RRG,1.5,18,14,1135,13,2018,13,0
Group 5,RRG,1.5,18,14,1136,14,2018,10,4
Group 5,RRG,1.5,18,14,1137,13,2018,10,3
Group 5,RRG,1.5,18,14,1138,11,2018,8,3
Group 5,RRG,1.5,18,14,1139,14,2018,11,3
Group 5,RRG,1.5,18,14,1140,12,2018,11,1
Group 5,RRG,1.5,18,14,1141,13,2018,11,2
Group 5,RRG,1.5,18,14,1142,10,2018,13,-3
Group 5,RRG,1.5,18,14,1143,13,2018,10,3
Group 5,RRG,1.5,18,14,1144,9,2018,11,-2
Group 5,RRG,1.5,18,14,1145,12,2018,14,-2
Group 5,RRG,1.5,18,14,1146,8,2018,12,-4
Group 5,RRG,1.5,18,14,1147,10,2018,11,-1
Group 5,RRG,1.5,18,14,1148,14,2018,11,3
Group 5,RRG,1.5,18,14,1149,12,2018,12,0
Group 5,RRG,1.5,18,14,1150,6,2018,12,-6
Group 5,RRG,1.5,18,14,1151,14,2018,10,4
Group 5,RRG,1.5,18,14,1152,14,2018,11,3
Group 5,RRG,1.5,18,14,1153,9,2018,13,-4
Group 5,RRG,1.5,18,14,1154,9,2018,12,-3
Group 5,RRG,1.5,18,14,1155,9,2018,11,-2
Group 5,RRG,1.5,18,14,1156,14,2018,11,3
Group 5,RRG,1.5,18,14,1157,12,2018,10,2
Group 5,RRG,1.5,18,14,1158,12,2018,11,1
Group 5,RRG,1.5,18,14,1159,11,2018,13,-2
Group 5,RRG,1.5,18,14,1160,10,2018,10,0
Group 5,RRG,1.5,18,14,1161,13,2018,13,0
Group 5,RRG,1.5,18,14,1162,11,2018,13,-2
Group 5,RRG,1.5,18,14,1163,10,2018,10,0
Group 5,RRG,1.5,18,14,1164,14,2018,9,5
Group 5,RRG,1.5,18,14,1165,12,2018,13,-1
Group 5,RRG,1.5,18,14,1166,12,2018,11,1
Group 5,RRG,1.5,18,14,1167,12,2018,10,2
Group 5,RRG,1.5,18,14,1168,12,2018,12,0
Group 5,RRG,1.5,18,14,1169,13,2018,11,2
Group 5,RRG,1.5,18,14,1170,10,2018,12,-2
Group 5,RRG,1.5,18,14,1171,12,2018,10,2
Group 5,RRG,1.5,18,14,1172,12,2018,14,-2
Group 5,RRG,1.5,18,14,1173,11,2018,13,-2
Group 5,RRG,1.5,18,14,1174,12,2018,11,1
Group 5,RRG,1.5,18,14,1175,10,2018,11,-1
Group 5,RRG,1.5,18,14,1176,8,2018,10,-2
Group 5,RRG,1.5,18,14,1177,13,2018,14,-1
Group 5,RRG,1.5,18,14,1178,12,2018,11,1
Group 5,RRG,1.5,18,14,1179,10,2018,14,-4
Group 5,RRG,1.5,18,14,1180,6,2018,10,-4
Group 5,RRG,1.5,18,14,1181,11,2018,12,-1
Group 5,RRG,1.5,18,14,1182,13,2018,12,1
Group 5,RRG,1.5,18,14,1183,12,2018,10,2
Group 5,RRG,1.5,18,14,1184,13,2018,11,2
Group 5,RRG,1.5,18,14,1185,8,2018,9,-1
Group 5,RRG,1.5,18,14,1186,13,2018,14,-1
Group 5,RRG,1.5,18,14,1187,13,2018,10,3
Group 5,RRG,1.5,18,14,1188,12,2018,13,-1
Group 5,RRG,1.5,18,14,1189,11,2018,11,0
Group 5,RRG,1.5,18,14,1190,6,2018,13,-7
Group 5,RRG,1.5,18,14,1191,11,2018,12,-1
Group 5,RRG,1.5,18,14,1192,12,2018,10,2
Group 5,RRG,1.5,18,14,1193,14,2018,14,0
Group 5,RRG,1.5,18,14,1194,11,2018,11,0
Group 5,RRG,1.5,18,14,1195,12,2018,11,1
Group 5,RRG,1.5,18,14,1196,11,2018,13,-2
Group 5,RRG,1.5,18,14,1197,9,2018,12,-3
Group 5,RRG,1.5,18,14,1198,11,2018,7,4
Group 5,RRG,1.5,18,14,1199,12,2018,7,5
Group 5,RRG,1.5,18,14,1200,12,2018,12,0
Group 5,RRG,1.5,18,14,1201,14,2018,11,3
Group 5,RRG,1.5,18,14,1202,11,2018,8,3
Group 5,RRG,1.5,18,14,1203,9,2018,7,2
Group 5,RRG,1.5,18,14,1204,12,2018,12,0
Group 5,RRG,1.5,18,14,1205,13,2018,12,1
Group 5,RRG,1.5,18,14,1206,12,2018,13,-1
Group 5,RRG,1.5,18,14,1207,7,2018,10,-3
Group 5,RRG,1.5,18,14,1208,13,2018,8,5
Group 5,RRG,1.5,18,14,1209,13,2018,12,1
Group 5,RRG,1.5,18,14,1210,11,2018,10,1
Group 5,RRG,1.5,18,14,1211,9,2018,12,-3
Group 5,RRG,1.5,18,14,1212,7,2018,7,0
Group 5,RRG,1.5,18,14,1213,12,2018,11,1
Group 5,RRG,1.5,18,14,1214,13,2018,14,-1
Group 5,RRG,1.5,18,14,1215,13,2018,6,7
Group 5,RRG,1.5,18,14,1216,12,2018,12,0
Group 5,RRG,1.5,18,14,1217,10,2018,13,-3
Group 5,RRG,1.5,18,14,1218,9,2018,10,-1
Group 5,RRG,1.5,18,14,1219,12,2018,13,-1
Group 5,RRG,1.5,18,14,1220,10,2018,12,-2
Group 5,RRG,1.5,18,14,1221,11,2018,13,-2
Group 5,RRG,1.5,18,14,1222,13,2018,11,2
Group 5,RRG,1.5,18,14,1223,13,2018,12,1
Group 5,RRG,1.5,18,14,1224,12,2018,13,-1
Group 5,RRG,1.5,18,14,1225,14,2018,11,3
Group 5,RRG,1.5,18,14,1226,13,2018,12,1
Group 5,RRG,1.5,18,14,1227,13,2018,12,1
Group 5,RRG,1.5,18,14,1228,13,2018,12,1
Group 5,RRG,1.5,18,14,1229,13,2018,11,2
Group 5,RRG,1.5,18,14,1230,7,2018,13,-6
Group 5,RRG,1.5,18,14,1231,6,2018,11,-5
Group 5,RRG,1.5,18,14,1232,10,2018,14,-4
Group 5,RRG,1.5,18,14,1233,7,2018,12,-5
Group 5,RRG,1.5,18,14,1234,8,2018,12,-4
Group 5,RRG,1.5,18,14,1235,14,2018,10,4
Group 5,RRG,1.5,18,14,1236,13,2018,12,1
Group 5,RRG,1.5,18,14,1237,12,2018,10,2
Group 5,RRG,1.5,18,14,1238,7,2018,8,-1
Group 5,RRG,1.5,18,14,1239,8,2018,11,-3
Group 5,RRG,1.5,18,14,1240,12,2018,12,0
Group 5,RRG,1.5,18,14,1241,9,2018,10,-1
Group 5,RRG,1.5,18,14,1242,14,2018,12,2
Group 5,RRG,1.5,18,14,1243,14,2018,12,2
Group 5,RRG,1.5,18,14,1244,2,2018,11,-9
Group 5,RRG,1.5,18,14,1245,8,2018,9,-1
Group 5,RRG,1.5,18,14,1246,3,2018,13,-10
Group 5,RRG,1.5,18,14,1247,9,2018,14,-5
Group 5,RRG,1.5,18,14,1248,7,2018,13,-6
Group 5,RRG,1.5,18,14,1249,13,2018,13,0
Group 5,RRG,1.5,18,14,1250,13,2018,12,1
Group 5,RRG,1.5,18,14,1251,14,2018,12,2
Group 5,RRG,1.5,18,14,1252,11,2018,11,0
Group 5,RRG,1.5,18,14,1253,11,2018,8,3
Group 5,RRG,1.5,18,14,1254,13,2018,10,3
Group 5,RRG,1.5,18,14,1255,12,2018,11,1
Group 5,RRG,1.5,18,14,1256,8,2018,11,-3
Group 5,RRG,1.5,18,14,1257,12,2018,12,0
Group 5,RRG,1.5,18,14,1258,9,2018,9,0
Group 5,RRG,1.5,18,14,1259,11,2018,8,3
Group 5,RRG,1.5,18,14,1260,11,2018,10,1
Group 5,RRG,1.5,18,14,1261,11,2018,13,-2
Group 5,RRG,1.5,18,14,1262,10,2018,8,2
Group 5,RRG,1.5,18,14,1263,14,2018,10,4
Group 5,RRG,1.5,18,14,1264,14,2018,11,3
Group 5,RRG,1.5,18,14,1265,13,2018,11,2
Group 5,RRG,1.5,18,14,1266,10,2018,11,-1
Group 5,RRG,1.5,18,14,1267,13,2018,9,4
Group 5,RRG,1.5,18,14,1268,12,2018,14,-2
Group 5,RRG,1.5,18,14,1269,10,2018,13,-3
Group 5,RRG,1.5,18,14,1270,9,2018,12,-3
Group 5,RRG,1.5,18,14,1271,10,2018,10,0
Group 5,RRG,1.5,18,14,1272,10,2018,11,-1
Group 5,RRG,1.5,18,14,1273,13,2018,11,2
Group 5,RRG,1.5,18,14,1274,12,2018,12,0
Group 5,RRG,1.5,18,14,1275,13,2018,9,4
Group 5,RRG,1.5,18,14,1276,12,2018,13,-1
Group 5,RRG,1.5,18,14,1277,11,2018,10,1
Group 5,RRG,1.5,18,14,1278,12,2018,12,0
Group 5,RRG,1.5,18,14,1279,12,2018,12,0
Group 5,RRG,1.5,18,14,1280,10,2018,14,-4
Group 5,RRG,1.5,18,14,1281,10,2018,11,-1
Group 5,RRG,1.5,18,14,1282,11,2018,9,2
Group 5,RRG,1.5,18,14,1283,10,2018,13,-3
Group 5,RRG,1.5,18,14,1284,13,2018,12,1
Group 5,RRG,1.5,18,14,1285,10,2018,12,-2
Group 5,RRG,1.5,18,14,1286,12,2018,14,-2
Group 5,RRG,1.5,18,14,1287,10,2018,10,0
Group 5,RRG,1.5,18,14,1288,12,2018,10,2
Group 5,RRG,1.5,18,14,1289,14,2018,13,1
Group 5,RRG,1.5,18,14,1290,8,2018,11,-3
Group 5,RRG,1.5,18,14,1291,13,2018,13,0
Group 5,RRG,1.5,18,14,1292,8,2018,13,-5
Group 5,RRG,1.5,18,14,1293,13,2018,13,0
Group 5,RRG,1.5,18,14,1294,9,2018,10,-1
Group 5,RRG,1.5,18,14,1295,12,2018,13,-1
Group 5,RRG,1.5,18,14,1296,14,2018,7,7
Group 5,RRG,1.5,18,14,1297,12,2018,8,4
Group 5,RRG,1.5,18,14,1298,12,2018,11,1
Group 5,RRG,1.5,18,14,1299,11,2018,11,0
Group 5,RRG,1.5,18,14,1300,14,2018,12,2
Group 5,RRG,1.5,18,14,1301,11,2018,8,3
Group 5,RRG,1.5,18,14,1302,13,2018,5,8
Group 5,RRG,1.5,18,14,1303,14,2018,9,5
Group 5,RRG,1.5,18,14,1304,12,2018,13,-1
Group 5,RRG,1.5,18,14,1305,8,2018,14,-6
Group 5,RRG,1.5,18,14,1306,11,2018,12,-1
Group 5,RRG,1.5,18,14,1307,8,2018,12,-4
Group 5,RRG,1.5,18,14,1308,11,2018,11,0
Group 5,RRG,1.5,18,14,1309,8,2018,11,-3
Group 5,RRG,1.5,18,14,1310,12,2018,12,0
Group 5,RRG,1.5,18,14,1311,9,2018,11,-2
Group 5,RRG,1.5,18,14,1312,8,2018,12,-4
Group 5,RRG,1.5,18,14,1313,9,2018,12,-3
Group 5,RRG,1.5,18,14,1314,8,2018,7,1
Group 5,RRG,1.5,18,14,1315,11,2018,12,-1
Group 5,RRG,1.5,18,14,1316,12,2018,13,-1
Group 5,RRG,1.5,18,14,1317,10,2018,12,-2
Group 5,RRG,1.5,18,14,1318,11,2018,11,0
Group 5,RRG,1.5,18,14,1319,13,2018,10,3
Group 5,RRG,1.5,18,14,1320,14,2018,14,0
Group 5,RRG,1.5,18,14,1321,8,2018,13,-5
Group 5,RRG,1.5,18,14,1322,6,2018,11,-5
Group 5,RRG,1.5,18,14,1323,11,2018,11,0
Group 5,RRG,1.5,18,14,1324,12,2018,11,1
Group 5,RRG,1.5,18,14,1325,11,2018,8,3
Group 5,RRG,1.5,18,14,1326,13,2018,12,1
Group 5,RRG,1.5,18,14,1327,12,2018,14,-2
Group 5,RRG,1.5,18,14,1328,6,2018,11,-5
Group 5,RRG,1.5,18,14,1329,6,2018,12,-6
Group 5,RRG,1.5,18,14,1330,13,2018,13,0
Group 5,RRG,1.5,18,14,1331,10,2018,12,-2
Group 5,RRG,1.5,18,14,1332,11,2018,10,1
Group 5,RRG,1.5,18,14,1333,12,2018,12,0
Group 5,RRG,1.5,18,14,1334,4,2018,9,-5
Group 5,RRG,1.5,18,14,1335,11,2018,14,-3
Group 5,RRG,1.5,18,14,1336,11,2018,11,0
Group 5,RRG,1.5,18,14,1337,8,2018,12,-4
Group 5,RRG,1.5,18,14,1338,13,2018,11,2
Group 5,RRG,1.5,18,14,1339,8,2018,12,-4
Group 5,RRG,1.5,18,14,1340,11,2018,12,-1
Group 5,RRG,1.5,18,14,1341,14,2018,11,3
Group 5,RRG,1.5,18,14,1342,10,2018,11,-1
Group 5,RRG,1.5,18,14,1343,14,2018,9,5
Group 5,RRG,1.5,18,14,1344,13,2018,11,2
Group 5,RRG,1.5,18,14,1345,10,2018,13,-3
Group 5,RRG,1.5,18,14,1346,12,2018,11,1
Group 5,RRG,1.5,18,14,1347,14,2018,12,2
Group 5,RRG,1.5,18,14,1348,12,2018,13,-1
Group 5,RRG,1.5,18,14,1349,12,2018,11,1
Group 5,RRG,1.5,18,14,1350,10,2018,12,-2
Group 5,RRG,1.5,18,14,1351,11,2018,12,-1
Group 5,RRG,1.5,18,14,1352,9,2018,10,-1
Group 5,RRG,1.5,18,14,1353,14,2018,9,5
Group 5,RRG,1.5,18,14,1354,13,2018,11,2
Group 5,RRG,1.5,18,14,1355,12,2018,12,0
Group 5,RRG,1.5,18,14,1356,11,2018,12,-1
Group 5,RRG,1.5,18,14,1357,12,2018,13,-1
Group 5,RRG,1.5,18,14,1358,10,2018,13,-3
Group 5,RRG,1.5,18,14,1359,11,2018,12,-1
Group 5,RRG,1.5,18,14,1360,8,2018,9,-1
Group 5,RRG,1.5,18,14,1361,13,2018,13,0
Group 5,RRG,1.5,18,14,1362,12,2018,12,0
Group 5,RRG,1.5,18,14,1363,14,2018,13,1
Group 5,RRG,1.5,18,14,1364,12,2018,11,1
Group 5,RRG,1.5,18,14,1365,8,2018,12,-4
Group 5,RRG,1.5,18,14,1366,12,2018,12,0
Group 5,RRG,1.5,18,14,1367,10,2018,12,-2
Group 5,RRG,1.5,18,14,1368,11,2018,10,1
Group 5,RRG,1.5,18,14,1369,14,2018,8,6
Group 5,RRG,1.5,18,14,1370,12,2018,11,1
Group 5,RRG,1.5,18,14,1371,10,2018,14,-4
Group 5,RRG,1.5,18,14,1372,13,2018,14,-1
Group 5,RRG,1.5,18,14,1373,13,2018,11,2
Group 5,RRG,1.5,18,14,1374,11,2018,10,1
Group 5,RRG,1.5,18,14,1375,7,2018,7,0
Group 5,RRG,1.5,18,14,1376,11,2018,12,-1
Group 5,RRG,1.5,18,14,1377,13,2018,11,2
Group 5,RRG,1.5,18,14,1378,12,2018,10,2
Group 5,RRG,1.5,18,14,1379,13,2018,14,-1
Group 5,RRG,1.5,18,14,1380,12,2018,13,-1
Group 5,RRG,1.5,18,14,1381,13,2018,14,-1
Group 5,RRG,1.5,18,14,1382,9,2018,9,0
Group 5,RRG,1.5,18,14,1383,8,2018,8,0
Group 5,RRG,1.5,18,14,1384,14,2018,11,3
Group 5,RRG,1.5,18,14,1385,10,2018,11,-1
Group 5,RRG,1.5,18,14,1386,12,2018,11,1
Group 5,RRG,1.5,18,14,1387,9,2018,11,-2
Group 5,RRG,1.5,18,14,1388,13,2018,9,4
Group 5,RRG,1.5,18,14,1389,12,2018,14,-2
Group 5,RRG,1.5,18,14,1390,11,2018,9,2
Group 5,RRG,1.5,18,14,1391,11,2018,13,-2
Group 5,RRG,1.5,18,14,1392,13,2018,12,1
Group 5,RRG,1.5,18,14,1393,5,2018,11,-6
Group 5,RRG,1.5,18,14,1394,8,2018,12,-4
Group 5,RRG,1.5,18,14,1395,13,2018,11,2
Group 5,RRG,1.5,18,14,1396,11,2018,11,0
Group 5,RRG,1.5,18,14,1397,10,2018,10,0
Group 5,RRG,1.5,18,14,1398,13,2018,5,8
Group 5,RRG,1.5,18,14,1399,13,2018,10,3
Group 5,RRG,1.5,18,14,1400,11,2018,11,0
Group 5,RRG,1.5,18,14,1401,10,2018,8,2
Group 5,RRG,1.5,18,14,1402,10,2018,10,0
Group 5,RRG,1.5,18,14,1403,13,2018,11,2
Group 5,RRG,1.5,18,14,1404,10,2018,13,-3
Group 5,RRG,1.5,18,14,1405,11,2018,14,-3
Group 5,RRG,1.5,18,14,1406,9,2018,13,-4
Group 5,RRG,1.5,18,14,1407,11,2018,11,0
Group 5,RRG,1.5,18,14,1408,9,2018,11,-2
Group 5,RRG,1.5,18,14,1409,10,2018,13,-3
Group 5,RRG,1.5,18,14,1410,13,2018,11,2
Group 5,RRG,1.5,18,14,1411,11,2018,10,1
Group 5,RRG,1.5,18,14,1412,10,2018,14,-4
Group 5,RRG,1.5,18,14,1413,12,2018,11,1
Group 5,RRG,1.5,18,14,1414,7,2018,12,-5
Group 5,RRG,1.5,18,14,1415,12,2018,9,3
Group 5,RRG,1.5,18,14,1416,13,2018,11,2
Group 5,RRG,1.5,18,14,1417,11,2018,11,0
Group 5,RRG,1.5,18,14,1418,13,2018,6,7
Group 5,RRG,1.5,18,14,1419,10,2018,10,0
Group 5,RRG,1.5,18,14,1420,10,2018,13,-3
Group 5,RRG,1.5,18,14,1421,11,2018,12,-1
Group 5,RRG,1.5,18,14,1422,10,2018,10,0
Group 5,RRG,1.5,18,14,1423,12,2018,7,5
Group 5,RRG,1.5,18,14,1424,8,2018,12,-4
Group 5,RRG,1.5,18,14,1425,10,2018,11,-1
Group 5,RRG,1.5,18,14,1426,13,2018,12,1
Group 5,RRG,1.5,18,14,1427,11,2018,12,-1
Group 5,RRG,1.5,18,14,1428,12,2018,11,1
Group 5,RRG,1.5,18,14,1429,13,2018,12,1
Group 5,RRG,1.5,18,14,1430,12,2018,9,3
Group 5,RRG,1.5,18,14,1431,12,2018,12,0
Group 5,RRG,1.5,18,14,1432,13,2018,12,1
Group 5,RRG,1.5,18,14,1433,14,2018,10,4
Group 5,RRG,1.5,18,14,1434,13,2018,9,4
Group 5,RRG,1.5,18,14,1435,11,2018,8,3
Group 5,RRG,1.5,18,14,1436,12,2018,11,1
Group 5,RRG,1.5,18,14,1437,12,2018,11,1
Group 5,RRG,1.5,18,14,1438,12,2018,14,-2
Group 5,RRG,1.5,18,14,1439,13,2018,9,4
Group 5,RRG,1.5,18,14,1440,6,2018,12,-6
Group 5,RRG,1.5,18,14,1441,8,2018,11,-3
Group 5,RRG,1.5,18,14,1442,10,2018,11,-1
Group 5,RRG,1.5,18,14,1443,12,2018,14,-2
Group 5,RRG,1.5,18,14,1444,14,2018,10,4
Group 5,RRG,1.5,18,14,1445,12,2018,12,0
Group 5,RRG,1.5,18,14,1446,10,2018,12,-2
Group 5,RRG,1.5,18,14,1447,13,2018,11,2
Group 5,RRG,1.5,18,14,1448,11,2018,11,0
Group 5,RRG,1.5,18,14,1449,11,2018,9,2
Group 5,RRG,1.5,18,14,1450,12,2018,13,-1
Group 5,RRG,1.5,18,14,1451,12,2018,11,1
Group 5,RRG,1.5,18,14,1452,11,2018,8,3
Group 5,RRG,1.5,18,14,1453,13,2018,11,2
Group 5,RRG,1.5,18,14,1454,13,2018,6,7
Group 5,RRG,1.5,18,14,1455,13,2018,12,1
Group 5,RRG,1.5,18,14,1456,5,2018,7,-2
Group 5,RRG,1.5,18,14,1457,13,2018,14,-1
Group 5,RRG,1.5,18,14,1458,10,2018,14,-4
Group 5,RRG,1.5,18,14,1459,10,2018,8,2
Group 5,RRG,1.5,18,14,1460,10,2018,9,1
Group 5,RRG,1.5,18,14,1461,14,2018,11,3
Group 5,RRG,1.5,18,14,1462,14,2018,12,2
Group 5,RRG,1.5,18,14,1463,13,2018,10,3
Group 5,RRG,1.5,18,14,1464,10,2018,11,-1
Group 5,RRG,1.5,18,14,1465,11,2018,11,0
Group 5,RRG,1.5,18,14,1466,14,2018,9,5
Group 5,RRG,1.5,18,14,1467,13,2018,12,1
Group 5,RRG,1.5,18,14,1468,8,2018,12,-4
Group 5,RRG,1.5,18,14,1469,11,2018,12,-1
Group 5,RRG,1.5,18,14,1470,10,2018,12,-2
Group 5,RRG,1.5,18,14,1471,12,2018,14,-2
Group 5,RRG,1.5,18,14,1472,11,2018,14,-3
Group 5,RRG,1.5,18,14,1473,12,2018,11,1
Group 5,RRG,1.5,18,14,1474,10,2018,11,-1
Group 5,RRG,1.5,18,14,1475,13,2018,10,3
Group 5,RRG,1.5,18,14,1476,10,2018,11,-1
Group 5,RRG,1.5,18,14,1477,12,2018,9,3
Group 5,RRG,1.5,18,14,1478,12,2018,12,0
Group 5,RRG,1.5,18,14,1479,12,2018,6,6
Group 5,RRG,1.5,18,14,1480,8,2018,9,-1
Group 5,RRG,1.5,18,14,1481,6,2018,9,-3
Group 5,RRG,1.5,18,14,1482,8,2018,11,-3
Group 5,RRG,1.5,18,14,1483,7,2018,13,-6
Group 5,RRG,1.5,18,14,1484,10,2018,14,-4
Group 5,RRG,1.5,18,14,1485,9,2018,11,-2
Group 5,RRG,1.5,18,14,1486,9,2018,13,-4
Group 5,RRG,1.5,18,14,1487,8,2018,13,-5
Group 5,RRG,1.5,18,14,1488,12,2018,10,2
Group 5,RRG,1.5,18,14,1489,9,2018,13,-4
Group 5,RRG,1.5,18,14,1490,12,2018,14,-2
Group 5,RRG,1.5,18,14,1491,9,2018,6,3
Group 5,RRG,1.5,18,14,1492,14,2018,11,3
Group 5,RRG,1.5,18,14,1493,11,2018,9,2
Group 5,RRG,1.5,18,14,1494,13,2018,8,5
Group 5,RRG,1.5,18,14,1495,11,2018,8,3
Group 5,RRG,1.5,18,14,1496,13,2018,13,0
Group 5,RRG,1.5,18,14,1497,11,2018,12,-1
Group 5,RRG,1.5,18,14,1498,13,2018,11,2
Group 5,RRG,1.5,18,14,1499,11,2018,13,-2
Group 5,RRG,1.5,18,14,1500,9,2018,11,-2
Group 5,RRG,1.5,18,14,1501,13,2018,12,1
Group 5,RRG,1.5,18,14,1502,11,2018,13,-2
Group 5,RRG,1.5,18,14,1503,13,2018,12,1
Group 5,RRG,1.5,18,14,1504,13,2018,13,0
Group 5,RRG,1.5,18,14,1505,9,2018,11,-2
Group 5,RRG,1.5,18,14,1506,11,2018,13,-2
Group 5,RRG,1.5,18,14,1507,13,2018,9,4
Group 5,RRG,1.5,18,14,1508,8,2018,11,-3
Group 5,RRG,1.5,18,14,1509,11,2018,12,-1
Group 5,RRG,1.5,18,14,1510,11,2018,7,4
Group 5,RRG,1.5,18,14,1511,8,2018,11,-3
Group 5,RRG,1.5,18,14,1512,11,2018,11,0
Group 5,RRG,1.5,18,14,1513,14,2018,12,2
Group 5,RRG,1.5,18,14,1514,9,2018,9,0
Group 5,RRG,1.5,18,14,1515,11,2018,10,1
Group 5,RRG,1.5,18,14,1516,11,2018,11,0
Group 5,RRG,1.5,18,14,1517,11,2018,12,-1
Group 5,RRG,1.5,18,14,1518,12,2018,6,6
Group 5,RRG,1.5,18,14,1519,12,2018,9,3
Group 5,RRG,1.5,18,14,1520,11,2018,12,-1
Group 5,RRG,1.5,18,14,1521,14,2018,9,5
Group 5,RRG,1.5,18,14,1522,12,2018,12,0
Group 5,RRG,1.5,18,14,1523,11,2018,11,0
Group 5,RRG,1.5,18,14,1524,12,2018,14,-2
Group 5,RRG,1.5,18,14,1525,10,2018,11,-1
Group 5,RRG,1.5,18,14,1526,12,2018,10,2
Group 5,RRG,1.5,18,14,1527,14,2018,11,3
Group 5,RRG,1.5,18,14,1528,13,2018,13,0
Group 5,RRG,1.5,18,14,1529,12,2018,9,3
Group 5,RRG,1.5,18,14,1530,8,2018,11,-3
Group 5,RRG,1.5,18,14,1531,12,2018,10,2
Group 5,RRG,1.5,18,14,1532,11,2018,11,0
Group 5,RRG,1.5,18,14,1533,11,2018,13,-2
Group 5,RRG,1.5,18,14,1534,10,2018,9,1
Group 5,RRG,1.5,18,14,1535,11,2018,12,-1
Group 5,RRG,1.5,18,14,1536,14,2018,13,1
Group 5,RRG,1.5,18,14,1537,12,2018,11,1
Group 5,RRG,1.5,18,14,1538,13,2018,11,2
Group 5,RRG,1.5,18,14,1539,11,2018,12,-1
Group 5,RRG,1.5,18,14,1540,13,2018,11,2
Group 5,RRG,1.5,18,14,1541,9,2018,11,-2
Group 5,RRG,1.5,18,14,1542,7,2018,12,-5
Group 5,RRG,1.5,18,14,1543,10,2018,12,-2
Group 5,RRG,1.5,18,14,1544,13,2018,11,2
Group 5,RRG,1.5,18,14,1545,13,2018,9,4
Group 5,RRG,1.5,18,14,1546,13,2018,8,5
Group 5,RRG,1.5,18,14,1547,14,2018,12,2
Group 5,RRG,1.5,18,14,1548,10,2018,13,-3
Group 5,RRG,1.5,18,14,1549,10,2018,13,-3
Group 5,RRG,1.5,18,14,1550,10,2018,11,-1
Group 5,RRG,1.5,18,14,1551,14,2018,11,3
Group 5,RRG,1.5,18,14,1552,9,2018,12,-3
Group 5,RRG,1.5,18,14,1553,7,2018,7,0
Group 5,RRG,1.5,18,14,1554,8,2018,8,0
Group 5,RRG,1.5,18,14,1555,12,2018,10,2
Group 5,RRG,1.5,18,14,1556,5,2018,9,-4
Group 5,RRG,1.5,18,14,1557,14,2018,13,1
Group 5,RRG,1.5,18,14,1558,13,2018,14,-1
Group 5,RRG,1.5,18,14,1559,11,2018,10,1
Group 5,RRG,1.5,18,14,1560,14,2018,12,2
Group 5,RRG,1.5,18,14,1561,9,2018,10,-1
Group 5,RRG,1.5,18,14,1562,11,2018,11,0
Group 5,RRG,1.5,18,14,1563,11,2018,11,0
Group 5,RRG,1.5,18,14,1564,14,2018,12,2
Group 5,RRG,1.5,18,14,1565,10,2018,7,3
Group 5,RRG,1.5,18,14,1566,3,2018,11,-8
Group 5,RRG,1.5,18,14,1567,13,2018,12,1
Group 5,RRG,1.5,18,14,1568,13,2018,11,2
Group 5,RRG,1.5,18,14,1569,10,2018,14,-4
Group 5,RRG,1.5,18,14,1570,12,2018,11,1
Group 5,RRG,1.5,18,14,1571,12,2018,12,0
Group 5,RRG,1.5,18,14,1572,9,2018,13,-4
Group 5,RRG,1.5,18,14,1573,11,2018,10,1
Group 5,RRG,1.5,18,14,1574,8,2018,7,1
Group 5,RRG,1.5,18,14,1575,4,2018,13,-9
Group 5,RRG,1.5,18,14,1576,14,2018,13,1
Group 5,RRG,1.5,18,14,1577,12,2018,7,5
Group 5,RRG,1.5,18,14,1578,12,2018,10,2
Group 5,RRG,1.5,18,14,1579,14,2018,12,2
Group 5,RRG,1.5,18,14,1580,12,2018,14,-2
Group 5,RRG,1.5,18,14,1581,8,2018,13,-5
Group 5,RRG,1.5,18,14,1582,12,2018,8,4
Group 5,RRG,1.5,18,14,1583,12,2018,11,1
Group 5,RRG,1.5,18,14,1584,10,2018,10,0
Group 5,RRG,1.5,18,14,1585,14,2018,10,4
Group 5,RRG,1.5,18,14,1586,8,2018,10,-2
Group 5,RRG,1.5,18,14,1587,9,2018,13,-4
Group 5,RRG,1.5,18,14,1588,8,2018,12,-4
Group 5,RRG,1.5,18,14,1589,10,2018,4,6
Group 5,RRG,1.5,18,14,1590,9,2018,11,-2
Group 5,RRG,1.5,18,14,1591,9,2018,10,-1
Group 5,RRG,1.5,18,14,1592,12,2018,12,0
Group 5,RRG,1.5,18,14,1593,11,2018,13,-2
Group 5,RRG,1.5,18,14,1594,14,2018,12,2
Group 5,RRG,1.5,18,14,1595,12,2018,12,0
Group 5,RRG,1.5,18,14,1596,12,2018,11,1
Group 5,RRG,1.5,18,14,1597,11,2018,12,-1
Group 5,RRG,1.5,18,14,1598,12,2018,11,1
Group 5,RRG,1.5,18,14,1599,10,2018,11,-1
Group 5,RRG,1.5,18,14,1600,13,2018,11,2
Group 5,RRG,1.5,18,14,1601,10,2018,12,-2
Group 5,RRG,1.5,18,14,1602,12,2018,12,0
Group 5,RRG,1.5,18,14,1603,12,2018,10,2
Group 5,RRG,1.5,18,14,1604,11,2018,8,3
Group 5,RRG,1.5,18,14,1605,12,2018,9,3
Group 5,RRG,1.5,18,14,1606,13,2018,8,5
Group 5,RRG,1.5,18,14,1607,10,2018,12,-2
Group 5,RRG,1.5,18,14,1608,12,2018,14,-2
Group 5,RRG,1.5,18,14,1609,12,2018,13,-1
Group 5,RRG,1.5,18,14,1610,12,2018,10,2
Group 5,RRG,1.5,18,14,1611,14,2018,10,4
Group 5,RRG,1.5,18,14,1612,11,2018,11,0
Group 5,RRG,1.5,18,14,1613,12,2018,12,0
Group 5,RRG,1.5,18,14,1614,12,2018,10,2
Group 5,RRG,1.5,18,14,1615,12,2018,12,0
Group 5,RRG,1.5,18,14,1616,10,2018,11,-1
Group 5,RRG,1.5,18,14,1617,13,2018,14,-1
Group 5,RRG,1.5,18,14,1618,13,2018,7,6
Group 5,RRG,1.5,18,14,1619,12,2018,9,3
Group 5,RRG,1.5,18,14,1620,12,2018,9,3
Group 5,RRG,1.5,18,14,1621,11,2018,14,-3
Group 5,RRG,1.5,18,14,1622,8,2018,11,-3
Group 5,RRG,1.5,18,14,1623,8,2018,10,-2
Group 5,RRG,1.5,18,14,1624,12,2018,13,-1
Group 5,RRG,1.5,18,14,1625,10,2018,12,-2
Group 5,RRG,1.5,18,14,1626,9,2018,14,-5
Group 5,RRG,1.5,18,14,1627,9,2018,13,-4
Group 5,RRG,1.5,18,14,1628,9,2018,12,-3
Group 5,RRG,1.5,18,14,1629,12,2018,10,2
Group 5,RRG,1.5,18,14,1630,14,2018,10,4
Group 5,RRG,1.5,18,14,1631,14,2018,9,5
Group 5,RRG,1.5,18,14,1632,11,2018,14,-3
Group 5,RRG,1.5,18,14,1633,13,2018,13,0
Group 5,RRG,1.5,18,14,1634,14,2018,9,5
Group 5,RRG,1.5,18,14,1635,11,2018,9,2
Group 5,RRG,1.5,18,14,1636,13,2018,12,1
Group 5,RRG,1.5,18,14,1637,12,2018,10,2
Group 5,RRG,1.5,18,14,1638,14,2018,11,3
Group 5,RRG,1.5,18,14,1639,9,2018,8,1
Group 5,RRG,1.5,18,14,1640,13,2018,11,2
Group 5,RRG,1.5,18,14,1641,12,2018,11,1
Group 5,RRG,1.5,18,14,1642,12,2018,11,1
Group 5,RRG,1.5,18,14,1643,13,2018,10,3
Group 5,RRG,1.5,18,14,1644,10,2018,11,-1
Group 5,RRG,1.5,18,14,1645,13,2018,12,1
Group 5,RRG,1.5,18,14,1646,9,2018,9,0
Group 5,RRG,1.5,18,14,1647,11,2018,13,-2
Group 5,RRG,1.5,18,14,1648,10,2018,12,-2
Group 5,RRG,1.5,18,14,1649,13,2018,11,2
Group 5,RRG,1.5,18,14,1650,13,2018,10,3
Group 5,RRG,1.5,18,14,1651,7,2018,10,-3
Group 5,RRG,1.5,18,14,1652,13,2018,8,5
Group 5,RRG,1.5,18,14,1653,12,2018,8,4
Group 5,RRG,1.5,18,14,1654,14,2018,9,5
Group 5,RRG,1.5,18,14,1655,12,2018,9,3
Group 5,RRG,1.5,18,14,1656,12,2018,13,-1
Group 5,RRG,1.5,18,14,1657,9,2018,10,-1
Group 5,RRG,1.5,18,14,1658,11,2018,13,-2
Group 5,RRG,1.5,18,14,1659,13,2018,10,3
Group 5,RRG,1.5,18,14,1660,13,2018,6,7
Group 5,RRG,1.5,18,14,1661,13,2018,9,4
Group 5,RRG,1.5,18,14,1662,12,2018,12,0
Group 5,RRG,1.5,18,14,1663,12,2018,11,1
Group 5,RRG,1.5,18,14,1664,9,2018,14,-5
Group 5,RRG,1.5,18,14,1665,9,2018,12,-3
Group 5,RRG,1.5,18,14,1666,11,2018,12,-1
Group 5,RRG,1.5,18,14,1667,10,2018,12,-2
Group 5,RRG,1.5,18,14,1668,9,2018,10,-1
Group 5,RRG,1.5,18,14,1669,13,2018,14,-1
Group 5,RRG,1.5,18,14,1670,13,2018,12,1
Group 5,RRG,1.5,18,14,1671,11,2018,12,-1
Group 5,RRG,1.5,18,14,1672,9,2018,9,0
Group 5,RRG,1.5,18,14,1673,13,2018,11,2
Group 5,RRG,1.5,18,14,1674,12,2018,11,1
Group 5,RRG,1.5,18,14,1675,10,2018,13,-3
Group 5,RRG,1.5,18,14,1676,13,2018,14,-1
Group 5,RRG,1.5,18,14,1677,13,2018,10,3
Group 5,RRG,1.5,18,14,1678,10,2018,12,-2
Group 5,RRG,1.5,18,14,1679,12,2018,10,2
Group 5,RRG,1.5,18,14,1680,10,2018,11,-1
Group 5,RRG,1.5,18,14,1681,13,2018,12,1
Group 5,RRG,1.5,18,14,1682,10,2018,11,-1
Group 5,RRG,1.5,18,14,1683,11,2018,13,-2
Group 5,RRG,1.5,18,14,1684,10,2018,14,-4
Group 5,RRG,1.5,18,14,1685,8,2018,14,-6
Group 5,RRG,1.5,18,14,1686,13,2018,9,4
Group 5,RRG,1.5,18,14,1687,11,2018,14,-3
Group 5,RRG,1.5,18,14,1688,13,2018,8,5
Group 5,RRG,1.5,18,14,1689,10,2018,13,-3
Group 5,RRG,1.5,18,14,1690,13,2018,14,-1
Group 5,RRG,1.5,18,14,1691,11,2018,12,-1
Group 5,RRG,1.5,18,14,1692,11,2018,13,-2
Group 5,RRG,1.5,18,14,1693,14,2018,10,4
Group 5,RRG,1.5,18,14,1694,12,2018,10,2
Group 5,RRG,1.5,18,14,1695,11,2018,11,0
Group 5,RRG,1.5,18,14,1696,13,2018,9,4
Group 5,RRG,1.5,18,14,1697,12,2018,10,2
Group 5,RRG,1.5,18,14,1698,11,2018,10,1
Group 5,RRG,1.5,18,14,1699,11,2018,11,0
Group 5,RRG,1.5,18,14,1700,11,2018,11,0
Group 5,RRG,1.5,18,14,1701,9,2018,12,-3
Group 5,RRG,1.5,18,14,1702,12,2018,12,0
Group 5,RRG,1.5,18,14,1703,10,2018,12,-2
Group 5,RRG,1.5,18,14,1704,10,2018,11,-1
Group 5,RRG,1.5,18,14,1705,13,2018,13,0
Group 5,RRG,1.5,18,14,1706,8,2018,11,-3
Group 5,RRG,1.5,18,14,1707,12,2018,9,3
Group 5,RRG,1.5,18,14,1708,11,2018,10,1
Group 5,RRG,1.5,18,14,1709,9,2018,8,1
Group 5,RRG,1.5,18,14,1710,10,2018,11,-1
Group 5,RRG,1.5,18,14,1711,8,2018,5,3
Group 5,RRG,1.5,18,14,1712,14,2018,14,0
Group 5,RRG,1.5,18,14,1713,13,2018,14,-1
Group 5,RRG,1.5,18,14,1714,14,2018,11,3
Group 5,RRG,1.5,18,14,1715,10,2018,10,0
Group 5,RRG,1.5,18,14,1716,13,2018,11,2
Group 5,RRG,1.5,18,14,1717,11,2018,9,2
Group 5,RRG,1.5,18,14,1718,13,2018,11,2
Group 5,RRG,1.5,18,14,1719,14,2018,12,2
Group 5,RRG,1.5,18,14,1720,11,2018,8,3
Group 5,RRG,1.5,18,14,1721,12,2018,11,1
Group 5,RRG,1.5,18,14,1722,10,2018,12,-2
Group 5,RRG,1.5,18,14,1723,11,2018,13,-2
Group 5,RRG,1.5,18,14,1724,9,2018,11,-2
Group 5,RRG,1.5,18,14,1725,11,2018,11,0
Group 5,RRG,1.5,18,14,1726,10,2018,10,0
Group 5,RRG,1.5,18,14,1727,13,2018,12,1
Group 5,RRG,1.5,18,14,1728,11,2018,11,0
Group 5,RRG,1.5,18,14,1729,13,2018,9,4
Group 5,RRG,1.5,18,14,1730,10,2018,12,-2
Group 5,RRG,1.5,18,14,1731,11,2018,10,1
Group 5,RRG,1.5,18,14,1732,12,2018,10,2
Group 5,RRG,1.5,18,14,1733,12,2018,12,0
Group 5,RRG,1.5,18,14,1734,12,2018,14,-2
Group 5,RRG,1.5,18,14,1735,12,2018,7,5
Group 5,RRG,1.5,18,14,1736,14,2018,9,5
Group 5,RRG,1.5,18,14,1737,9,2018,11,-2
Group 5,RRG,1.5,18,14,1738,12,2018,13,-1
Group 5,RRG,1.5,18,14,1739,14,2018,14,0
Group 5,RRG,1.5,18,14,1740,12,2018,11,1
Group 5,RRG,1.5,18,14,1741,12,2018,13,-1
Group 5,RRG,1.5,18,14,1742,11,2018,11,0
Group 5,RRG,1.5,18,14,1743,11,2018,12,-1
Group 5,RRG,1.5,18,14,1744,9,2018,10,-1
Group 5,RRG,1.5,18,14,1745,6,2018,8,-2
Group 5,RRG,1.5,18,14,1746,8,2018,10,-2
Group 5,RRG,1.5,18,14,1747,9,2018,13,-4
Group 5,RRG,1.5,18,14,1748,12,2018,11,1
Group 5,RRG,1.5,18,14,1749,10,2018,11,-1
Group 5,RRG,1.5,18,14,1750,6,2018,11,-5
Group 5,RRG,1.5,18,14,1751,13,2018,11,2
Group 5,RRG,1.5,18,14,1752,14,2018,13,1
Group 5,RRG,1.5,18,14,1753,11,2018,8,3
Group 5,RRG,1.5,18,14,1754,14,2018,11,3
Group 5,RRG,1.5,18,14,1755,13,2018,12,1
Group 5,RRG,1.5,18,14,1756,12,2018,9,3
Group 5,RRG,1.5,18,14,1757,12,2018,11,1
Group 5,RRG,1.5,18,14,1758,13,2018,10,3
Group 5,RRG,1.5,18,14,1759,10,2018,7,3
Group 5,RRG,1.5,18,14,1760,10,2018,10,0
Group 5,RRG,1.5,18,14,1761,8,2018,7,1
Group 5,RRG,1.5,18,14,1762,12,2018,14,-2
Group 5,RRG,1.5,18,14,1763,10,2018,13,-3
Group 5,RRG,1.5,18,14,1764,8,2018,11,-3
Group 5,RRG,1.5,18,14,1765,14,2018,13,1
Group 5,RRG,1.5,18,14,1766,13,2018,10,3
Group 5,RRG,1.5,18,14,1767,8,2018,14,-6
Group 5,RRG,1.5,18,14,1768,14,2018,10,4
Group 5,RRG,1.5,18,14,1769,12,2018,14,-2
Group 5,RRG,1.5,18,14,1770,13,2018,12,1
Group 5,RRG,1.5,18,14,1771,12,2018,13,-1
Group 5,RRG,1.5,18,14,1772,6,2018,12,-6
Group 5,RRG,1.5,18,14,1773,12,2018,11,1
Group 5,RRG,1.5,18,14,1774,7,2018,12,-5
Group 5,RRG,1.5,18,14,1775,8,2018,13,-5
Group 5,RRG,1.5,18,14,1776,13,2018,10,3
Group 5,RRG,1.5,18,14,1777,13,2018,9,4
Group 5,RRG,1.5,18,14,1778,12,2018,14,-2
Group 5,RRG,1.5,18,14,1779,12,2018,11,1
Group 5,RRG,1.5,18,14,1780,11,2018,10,1
Group 5,RRG,1.5,18,14,1781,11,2018,10,1
Group 5,RRG,1.5,18,14,1782,11,2018,12,-1
Group 5,RRG,1.5,18,14,1783,11,2018,10,1
Group 5,RRG,1.5,18,14,1784,13,2018,11,2
Group 5,RRG,1.5,18,14,1785,11,2018,8,3
Group 5,RRG,1.5,18,14,1786,12,2018,11,1
Group 5,RRG,1.5,18,14,1787,14,2018,10,4
Group 5,RRG,1.5,18,14,1788,12,2018,10,2
Group 5,RRG,1.5,18,14,1789,10,2018,12,-2
Group 5,RRG,1.5,18,14,1790,14,2018,10,4
Group 5,RRG,1.5,18,14,1791,8,2018,7,1
Group 5,RRG,1.5,18,14,1792,11,2018,10,1
Group 5,RRG,1.5,18,14,1793,11,2018,10,1
Group 5,RRG,1.5,18,14,1794,7,2018,8,-1
Group 5,RRG,1.5,18,14,1795,13,2018,13,0
Group 5,RRG,1.5,18,14,1796,12,2018,13,-1
Group 5,RRG,1.5,18,14,1797,12,2018,11,1
Group 5,RRG,1.5,18,14,1798,13,2018,14,-1
Group 5,RRG,1.5,18,14,1799,13,2018,13,0
Group 5,RRG,1.5,18,14,1800,11,2018,10,1
Group 5,RRG,1.5,18,14,1801,12,2018,13,-1
Group 5,RRG,1.5,18,14,1802,12,2018,9,3
Group 5,RRG,1.5,18,14,1803,13,2018,10,3
Group 5,RRG,1.5,18,14,1804,12,2018,13,-1
Group 5,RRG,1.5,18,14,1805,9,2018,14,-5
Group 5,RRG,1.5,18,14,1806,11,2018,8,3
Group 5,RRG,1.5,18,14,1807,14,2018,12,2
Group 5,RRG,1.5,18,14,1808,11,2018,11,0
Group 5,RRG,1.5,18,14,1809,8,2018,12,-4
Group 5,RRG,1.5,18,14,1810,9,2018,11,-2
Group 5,RRG,1.5,18,14,1811,8,2018,6,2
Group 5,RRG,1.5,18,14,1812,12,2018,8,4
Group 5,RRG,1.5,18,14,1813,12,2018,9,3
Group 5,RRG,1.5,18,14,1814,10,2018,13,-3
Group 5,RRG,1.5,18,14,1815,11,2018,13,-2
Group 5,RRG,1.5,18,14,1816,11,2018,13,-2
Group 5,RRG,1.5,18,14,1817,9,2018,11,-2
Group 5,RRG,1.5,18,14,1818,11,2018,12,-1
Group 5,RRG,1.5,18,14,1819,9,2018,12,-3
Group 5,RRG,1.5,18,14,1820,11,2018,13,-2
Group 5,RRG,1.5,18,14,1821,10,2018,8,2
Group 5,RRG,1.5,18,14,1822,12,2018,11,1
Group 5,RRG,1.5,18,14,1823,12,2018,12,0
Group 5,RRG,1.5,18,14,1824,11,2018,11,0
Group 5,RRG,1.5,18,14,1825,13,2018,11,2
Group 5,RRG,1.5,18,14,1826,14,2018,9,5
Group 5,RRG,1.5,18,14,1827,11,2018,11,0
Group 5,RRG,1.5,18,14,1828,12,2018,13,-1
Group 5,RRG,1.5,18,14,1829,13,2018,10,3
Group 5,RRG,1.5,18,14,1830,13,2018,11,2
Group 5,RRG,1.5,18,14,1831,12,2018,7,5
Group 5,RRG,1.5,18,14,1832,10,2018,9,1
Group 5,RRG,1.5,18,14,1833,9,2018,13,-4
Group 5,RRG,1.5,18,14,1834,14,2018,11,3
Group 5,RRG,1.5,18,14,1835,14,2018,13,1
Group 5,RRG,1.5,18,14,1836,14,2018,13,1
Group 5,RRG,1.5,18,14,1837,11,2018,10,1
Group 5,RRG,1.5,18,14,1838,12,2018,9,3
Group 5,RRG,1.5,18,14,1839,8,2018,9,-1
Group 5,RRG,1.5,18,14,1840,8,2018,14,-6
Group 5,RRG,1.5,18,14,1841,14,2018,12,2
Group 5,RRG,1.5,18,14,1842,12,2018,12,0
Group 5,RRG,1.5,18,14,1843,13,2018,11,2
Group 5,RRG,1.5,18,14,1844,14,2018,14,0
Group 5,RRG,1.5,18,14,1845,14,2018,11,3
Group 5,RRG,1.5,18,14,1846,12,2018,10,2
Group 5,RRG,1.5,18,14,1847,5,2018,11,-6
Group 5,RRG,1.5,18,14,1848,10,2018,13,-3
Group 5,RRG,1.5,18,14,1849,9,2018,11,-2
Group 5,RRG,1.5,18,14,1850,11,2018,12,-1
Group 5,RRG,1.5,18,14,1851,10,2018,12,-2
Group 5,RRG,1.5,18,14,1852,12,2018,13,-1
Group 5,RRG,1.5,18,14,1853,12,2018,11,1
Group 5,RRG,1.5,18,14,1854,12,2018,12,0
Group 5,RRG,1.5,18,14,1855,13,2018,10,3
Group 5,RRG,1.5,18,14,1856,8,2018,11,-3
Group 5,RRG,1.5,18,14,1857,11,2018,12,-1
Group 5,RRG,1.5,18,14,1858,12,2018,11,1
Group 5,RRG,1.5,18,14,1859,11,2018,10,1
Group 5,RRG,1.5,18,14,1860,14,2018,10,4
Group 5,RRG,1.5,18,14,1861,11,2018,9,2
Group 5,RRG,1.5,18,14,1862,9,2018,12,-3
Group 5,RRG,1.5,18,14,1863,10,2018,12,-2
Group 5,RRG,1.5,18,14,1864,13,2018,13,0
Group 5,RRG,1.5,18,14,1865,13,2018,10,3
Group 5,RRG,1.5,18,14,1866,13,2018,9,4
Group 5,RRG,1.5,18,14,1867,11,2018,11,0
Group 5,RRG,1.5,18,14,1868,13,2018,9,4
Group 5,RRG,1.5,18,14,1869,13,2018,9,4
Group 5,RRG,1.5,18,14,1870,13,2018,9,4
Group 5,RRG,1.5,18,14,1871,12,2018,10,2
Group 5,RRG,1.5,18,14,1872,10,2018,10,0
Group 5,RRG,1.5,18,14,1873,8,2018,14,-6
Group 5,RRG,1.5,18,14,1874,12,2018,12,0
Group 5,RRG,1.5,18,14,1875,10,2018,11,-1
Group 5,RRG,1.5,18,14,1876,13,2018,9,4
Group 5,RRG,1.5,18,14,1877,12,2018,12,0
Group 5,RRG,1.5,18,14,1878,9,2018,11,-2
Group 5,RRG,1.5,18,14,1879,12,2018,10,2
Group 5,RRG,1.5,18,14,1880,10,2018,13,-3
Group 5,RRG,1.5,18,14,1881,13,2018,11,2
Group 5,RRG,1.5,18,14,1882,11,2018,10,1
Group 5,RRG,1.5,18,14,1883,10,2018,8,2
Group 5,RRG,1.5,18,14,1884,14,2018,10,4
Group 5,RRG,1.5,18,14,1885,12,2018,11,1
Group 5,RRG,1.5,18,14,1886,13,2018,8,5
Group 5,RRG,1.5,18,14,1887,10,2018,13,-3
Group 5,RRG,1.5,18,14,1888,14,2018,11,3
Group 5,RRG,1.5,18,14,1889,13,2018,11,2
Group 5,RRG,1.5,18,14,1890,11,2018,12,-1
Group 5,RRG,1.5,18,14,1891,12,2018,11,1
Group 5,RRG,1.5,18,14,1892,11,2018,10,1
Group 5,RRG,1.5,18,14,1893,10,2018,11,-1
Group 5,RRG,1.5,18,14,1894,9,2018,8,1
Group 5,RRG,1.5,18,14,1895,12,2018,12,0
Group 5,RRG,1.5,18,14,1896,10,2018,8,2
Group 5,RRG,1.5,18,14,1897,14,2018,12,2
Group 5,RRG,1.5,18,14,1898,13,2018,13,0
Group 5,RRG,1.5,18,14,1899,12,2018,11,1
Group 5,RRG,1.5,18,14,1900,10,2018,7,3
Group 5,RRG,1.5,18,14,1901,10,2018,9,1
Group 5,RRG,1.5,18,14,1902,13,2018,14,-1
Group 5,RRG,1.5,18,14,1903,7,2018,12,-5
Group 5,RRG,1.5,18,14,1904,13,2018,12,1
Group 5,RRG,1.5,18,14,1905,9,2018,13,-4
Group 5,RRG,1.5,18,14,1906,10,2018,12,-2
Group 5,RRG,1.5,18,14,1907,11,2018,11,0
Group 5,RRG,1.5,18,14,1908,12,2018,13,-1
Group 5,RRG,1.5,18,14,1909,13,2018,11,2
Group 5,RRG,1.5,18,14,1910,13,2018,14,-1
Group 5,RRG,1.5,18,14,1911,10,2018,12,-2
Group 5,RRG,1.5,18,14,1912,11,2018,10,1
Group 5,RRG,1.5,18,14,1913,13,2018,10,3
Group 5,RRG,1.5,18,14,1914,10,2018,13,-3
Group 5,RRG,1.5,18,14,1915,11,2018,13,-2
Group 5,RRG,1.5,18,14,1916,12,2018,12,0
Group 5,RRG,1.5,18,14,1917,11,2018,10,1
Group 5,RRG,1.5,18,14,1918,8,2018,7,1
Group 5,RRG,1.5,18,14,1919,10,2018,10,0
Group 5,RRG,1.5,18,14,1920,14,2018,12,2
Group 5,RRG,1.5,18,14,1921,11,2018,14,-3
Group 5,RRG,1.5,18,14,1922,12,2018,13,-1
Group 5,RRG,1.5,18,14,1923,11,2018,9,2
Group 5,RRG,1.5,18,14,1924,12,2018,12,0
Group 5,RRG,1.5,18,14,1925,10,2018,14,-4
Group 5,RRG,1.5,18,14,1926,13,2018,9,4
Group 5,RRG,1.5,18,14,1927,11,2018,9,2
Group 5,RRG,1.5,18,14,1928,13,2018,11,2
Group 5,RRG,1.5,18,14,1929,8,2018,12,-4
Group 5,RRG,1.5,18,14,1930,11,2018,11,0
Group 5,RRG,1.5,18,14,1931,10,2018,12,-2
Group 5,RRG,1.5,18,14,1932,6,2018,10,-4
Group 5,RRG,1.5,18,14,1933,10,2018,11,-1
Group 5,RRG,1.5,18,14,1934,12,2018,9,3
Group 5,RRG,1.5,18,14,1935,12,2018,7,5
Group 5,RRG,1.5,18,14,1936,14,2018,8,6
Group 5,RRG,1.5,18,14,1937,13,2018,10,3
Group 5,RRG,1.5,18,14,1938,12,2018,10,2
Group 5,RRG,1.5,18,14,1939,8,2018,13,-5
Group 5,RRG,1.5,18,14,1940,10,2018,13,-3
Group 5,RRG,1.5,18,14,1941,14,2018,14,0
Group 5,RRG,1.5,18,14,1942,14,2018,11,3
Group 5,RRG,1.5,18,14,1943,12,2018,13,-1
Group 5,RRG,1.5,18,14,1944,12,2018,8,4
Group 5,RRG,1.5,18,14,1945,11,2018,11,0
Group 5,RRG,1.5,18,14,1946,12,2018,8,4
Group 5,RRG,1.5,18,14,1947,14,2018,13,1
Group 5,RRG,1.5,18,14,1948,14,2018,8,6
Group 5,RRG,1.5,18,14,1949,9,2018,10,-1
Group 5,RRG,1.5,18,14,1950,13,2018,12,1
Group 5,RRG,1.5,18,14,1951,7,2018,11,-4
Group 5,RRG,1.5,18,14,1952,14,2018,10,4
Group 5,RRG,1.5,18,14,1953,14,2018,10,4
Group 5,RRG,1.5,18,14,1954,5,2018,13,-8
Group 5,RRG,1.5,18,14,1955,14,2018,12,2
Group 5,RRG,1.5,18,14,1956,8,2018,12,-4
Group 5,RRG,1.5,18,14,1957,10,2018,14,-4
Group 5,RRG,1.5,18,14,1958,8,2018,12,-4
Group 5,RRG,1.5,18,14,1959,13,2018,12,1
Group 5,RRG,1.5,18,14,1960,14,2018,12,2
Group 5,RRG,1.5,18,14,1961,6,2018,12,-6
Group 5,RRG,1.5,18,14,1962,9,2018,13,-4
Group 5,RRG,1.5,18,14,1963,10,2018,10,0
Group 5,RRG,1.5,18,14,1964,13,2018,13,0
Group 5,RRG,1.5,18,14,1965,12,2018,8,4
Group 5,RRG,1.5,18,14,1966,10,2018,11,-1
Group 5,RRG,1.5,18,14,1967,12,2018,13,-1
Group 5,RRG,1.5,18,14,1968,11,2018,10,1
Group 5,RRG,1.5,18,14,1969,12,2018,11,1
Group 5,RRG,1.5,18,14,1970,12,2018,7,5
Group 5,RRG,1.5,18,14,1971,14,2018,9,5
Group 5,RRG,1.5,18,14,1972,12,2018,8,4
Group 5,RRG,1.5,18,14,1973,7,2018,13,-6
Group 5,RRG,1.5,18,14,1974,10,2018,7,3
Group 5,RRG,1.5,18,14,1975,8,2018,14,-6
Group 5,RRG,1.5,18,14,1976,10,2018,12,-2
Group 5,RRG,1.5,18,14,1977,9,2018,12,-3
Group 5,RRG,1.5,18,14,1978,13,2018,12,1
Group 5,RRG,1.5,18,14,1979,12,2018,11,1
Group 5,RRG,1.5,18,14,1980,14,2018,9,5
Group 5,RRG,1.5,18,14,1981,13,2018,10,3
Group 5,RRG,1.5,18,14,1982,13,2018,11,2
Group 5,RRG,1.5,18,14,1983,12,2018,11,1
Group 5,RRG,1.5,18,14,1984,12,2018,12,0
Group 5,RRG,1.5,18,14,1985,13,2018,14,-1
Group 5,RRG,1.5,18,14,1986,10,2018,13,-3
Group 5,RRG,1.5,18,14,1987,11,2018,10,1
Group 5,RRG,1.5,18,14,1988,11,2018,11,0
Group 5,RRG,1.5,18,14,1989,9,2018,13,-4
Group 5,RRG,1.5,18,14,1990,2,2018,9,-7
Group 5,RRG,1.5,18,14,1991,10,2018,7,3
Group 5,RRG,1.5,18,14,1992,12,2018,11,1
Group 5,RRG,1.5,18,14,1993,10,2018,13,-3
Group 5,RRG,1.5,18,14,1994,11,2018,5,6
Group 5,RRG,1.5,18,14,1995,9,2018,12,-3
Group 5,RRG,1.5,18,14,1996,10,2018,12,-2
Group 5,RRG,1.5,18,14,1997,9,2018,12,-3
Group 5,RRG,1.5,18,14,1998,13,2018,10,3
Group 5,RRG,1.5,18,14,1999,13,2018,7,6
Group 5,RRG,1.5,18,14,2000,12,2018,10,2
Group 5,RRG,1.5,18,14,2001,14,2018,8,6
Group 5,RRG,1.5,18,14,2002,10,2018,7,3
Group 5,RRG,1.5,18,14,2003,10,2018,11,-1
Group 5,RRG,1.5,18,14,2004,10,2018,12,-2
Group 5,RRG,1.5,18,14,2005,12,2018,7,5
Group 5,RRG,1.5,18,14,2006,12,2018,9,3
Group 5,RRG,1.5,18,14,2007,9,2018,13,-4
Group 5,RRG,1.5,18,14,2008,7,2018,12,-5
Group 5,RRG,1.5,18,14,2009,10,2018,13,-3
Group 5,RRG,1.5,18,14,2010,10,2018,13,-3
Group 5,RRG,1.5,18,14,2011,4,2018,10,-6
Group 5,RRG,1.5,18,14,2012,11,2018,5,6
Group 5,RRG,1.5,18,14,2013,13,2018,10,3
Group 5,RRG,1.5,18,14,2014,10,2018,9,1
Group 5,RRG,1.5,18,14,2015,13,2018,10,3
Group 5,RRG,1.5,18,14,2016,8,2018,10,-2
Group 5,RRG,1.5,18,14,2017,12,2018,10,2
Group 5,RRG,1.5,18,14,2018,9,2018,8,1
Group 5,RRG,1.5,18,14,2019,11,2018,12,-1
Group 5,RRG,1.5,18,14,2020,13,2018,11,2
Group 5,RRG,1.5,18,14,2021,10,2018,9,1
Group 5,RRG,1.5,18,14,2022,9,2018,7,2
Group 5,RRG,1.5,18,14,2023,8,2018,11,-3
Group 5,RRG,1.5,18,14,2024,14,2018,11,3
Group 5,RRG,1.5,18,14,2025,12,2018,12,0
Group 5,RRG,1.5,18,14,2026,11,2018,10,1
Group 5,RRG,1.5,18,14,2027,12,2018,12,0
Group 5,RRG,1.5,18,14,2028,13,2018,10,3
Group 5,RRG,1.5,18,14,2029,14,2018,6,8
Group 5,RRG,1.5,18,14,2030,11,2018,7,4
Group 5,RRG,1.5,18,14,2031,12,2018,13,-1
Group 5,RRG,1.5,18,14,2032,13,2018,11,2
Group 5,RRG,1.5,18,14,2033,11,2018,13,-2
Group 5,RRG,1.5,18,14,2034,13,2018,11,2
Group 5,RRG,1.5,18,14,2035,13,2018,11,2
Group 5,RRG,1.5,18,14,2036,10,2018,9,1
Group 5,RRG,1.5,18,14,2037,13,2018,9,4
Group 5,RRG,1.5,18,14,2038,13,2018,12,1
Group 5,RRG,1.5,18,14,2039,14,2018,12,2
Group 5,RRG,1.5,18,14,2040,9,2018,11,-2
Group 5,RRG,1.5,18,14,2041,6,2018,10,-4
Group 5,RRG,1.5,18,14,2042,11,2018,10,1
Group 5,RRG,1.5,18,14,2043,12,2018,13,-1
Group 5,RRG,1.5,18,14,2044,11,2018,12,-1
Group 5,RRG,1.5,18,14,2045,10,2018,11,-1
Group 5,RRG,1.5,18,14,2046,9,2018,10,-1
Group 5,RRG,1.5,18,14,2047,13,2018,13,0
Group 5,RRG,1.5,18,14,2048,8,2018,10,-2
Group 5,RRG,1.5,18,14,2049,11,2018,14,-3
Group 5,RRG,1.5,18,14,2050,13,2018,13,0
Group 5,RRG,1.5,18,14,2051,13,2018,11,2
Group 5,RRG,1.5,18,14,2052,11,2018,12,-1
Group 5,RRG,1.5,18,14,2053,13,2018,13,0
Group 5,RRG,1.5,18,14,2054,12,2018,7,5
Group 5,RRG,1.5,18,14,2055,14,2018,13,1
Group 5,RRG,1.5,18,14,2056,14,2018,9,5
Group 5,RRG,1.5,18,14,2057,13,2018,10,3
Group 5,RRG,1.5,18,14,2058,11,2018,6,5
Group 5,RRG,1.5,18,14,2059,13,2018,11,2
Group 5,RRG,1.5,18,14,2060,11,2018,11,0
Group 5,RRG,1.5,18,14,2061,13,2018,10,3
Group 5,RRG,1.5,18,14,2062,11,2018,7,4
Group 5,RRG,1.5,18,14,2063,11,2018,12,-1
Group 5,RRG,1.5,18,14,2064,11,2018,10,1
Group 5,RRG,1.5,18,14,2065,11,2018,11,0
Group 5,RRG,1.5,18,14,2066,13,2018,12,1
Group 5,RRG,1.5,18,14,2067,12,2018,11,1
Group 5,RRG,1.5,18,14,2068,13,2018,8,5
Group 5,RRG,1.5,18,14,2069,14,2018,10,4
Group 5,RRG,1.5,18,14,2070,8,2018,12,-4
Group 5,RRG,1.5,18,14,2071,7,2018,13,-6
Group 5,RRG,1.5,18,14,2072,12,2018,13,-1
Group 5,RRG,1.5,18,14,2073,8,2018,7,1
Group 5,RRG,1.5,18,14,2074,14,2018,14,0
Group 5,RRG,1.5,18,14,2075,14,2018,10,4
Group 5,RRG,1.5,18,14,2076,14,2018,12,2
Group 5,RRG,1.5,18,14,2077,10,2018,12,-2
Group 5,RRG,1.5,18,14,2078,8,2018,13,-5
Group 5,RRG,1.5,18,14,2079,14,2018,14,0
Group 5,RRG,1.5,18,14,2080,11,2018,14,-3
Group 5,RRG,1.5,18,14,2081,12,2018,12,0
Group 5,RRG,1.5,18,14,2082,12,2018,11,1
Group 5,RRG,1.5,18,14,2083,11,2018,11,0
Group 5,RRG,1.5,18,14,2084,12,2018,9,3
Group 5,RRG,1.5,18,14,2085,14,2018,11,3
Group 5,RRG,1.5,18,14,2086,13,2018,14,-1
Group 5,RRG,1.5,18,14,2087,13,2018,11,2
Group 5,RRG,1.5,18,14,2088,12,2018,9,3
Group 5,RRG,1.5,18,14,2089,12,2018,9,3
Group 5,RRG,1.5,18,14,2090,13,2018,10,3
Group 5,RRG,1.5,18,14,2091,12,2018,13,-1
Group 5,RRG,1.5,18,14,2092,12,2018,13,-1
Group 5,RRG,1.5,18,14,2093,10,2018,11,-1
Group 5,RRG,1.5,18,14,2094,9,2018,12,-3
Group 5,RRG,1.5,18,14,2095,13,2018,11,2
Group 5,RRG,1.5,18,14,2096,10,2018,14,-4
Group 5,RRG,1.5,18,14,2097,12,2018,11,1
Group 5,RRG,1.5,18,14,2098,14,2018,12,2
Group 5,RRG,1.5,18,14,2099,11,2018,10,1
Group 5,RRG,1.5,18,14,2100,12,2018,10,2
Group 5,RRG,1.5,18,14,2101,12,2018,9,3
Group 5,RRG,1.5,18,14,2102,13,2018,13,0
Group 5,RRG,1.5,18,14,2103,11,2018,11,0
Group 5,RRG,1.5,18,14,2104,13,2018,10,3
Group 5,RRG,1.5,18,14,2105,12,2018,13,-1
Group 5,RRG,1.5,18,14,2106,12,2018,10,2
Group 5,RRG,1.5,18,14,2107,11,2018,11,0
Group 5,RRG,1.5,18,14,2108,14,2018,11,3
Group 5,RRG,1.5,18,14,2109,8,2018,11,-3
Group 5,RRG,1.5,18,14,2110,9,2018,12,-3
Group 5,RRG,1.5,18,14,2111,7,2018,8,-1
Group 5,RRG,1.5,18,14,2112,13,2018,9,4
Group 5,RRG,1.5,18,14,2113,9,2018,14,-5
Group 5,RRG,1.5,18,14,2114,11,2018,12,-1
Group 5,RRG,1.5,18,14,2115,9,2018,10,-1
Group 5,RRG,1.5,18,14,2116,13,2018,9,4
Group 5,RRG,1.5,18,14,2117,13,2018,11,2
Group 5,RRG,1.5,18,14,2118,10,2018,12,-2
Group 5,RRG,1.5,18,14,2119,12,2018,6,6
Group 5,RRG,1.5,18,14,2120,14,2018,12,2
Group 5,RRG,1.5,18,14,2121,13,2018,12,1
Group 5,RRG,1.5,18,14,2122,13,2018,6,7
Group 5,RRG,1.5,18,14,2123,13,2018,11,2
Group 5,RRG,1.5,18,14,2124,13,2018,9,4
Group 5,RRG,1.5,18,14,2125,6,2018,6,0
Group 5,RRG,1.5,18,14,2126,5,2018,8,-3
Group 5,RRG,1.5,18,14,2127,8,2018,9,-1
Group 5,RRG,1.5,18,14,2128,10,2018,13,-3
Group 5,RRG,1.5,18,14,2129,11,2018,12,-1
Group 5,RRG,1.5,18,14,2130,10,2018,12,-2
Group 5,RRG,1.5,18,14,2131,8,2018,9,-1
Group 5,RRG,1.5,18,14,2132,8,2018,13,-5
Group 5,RRG,1.5,18,14,2133,9,2018,12,-3
Group 5,RRG,1.5,18,14,2134,12,2018,10,2
Group 5,RRG,1.5,18,14,2135,9,2018,8,1
Group 5,RRG,1.5,18,14,2136,11,2018,13,-2
Group 5,RRG,1.5,18,14,2137,10,2018,11,-1
Group 5,RRG,1.5,18,14,2138,8,2018,9,-1
Group 5,RRG,1.5,18,14,2139,10,2018,10,0
Group 5,RRG,1.5,18,14,2140,13,2018,10,3
Group 5,RRG,1.5,18,14,2141,14,2018,10,4
Group 5,RRG,1.5,18,14,2142,12,2018,11,1
Group 5,RRG,1.5,18,14,2143,10,2018,13,-3
Group 5,RRG,1.5,18,14,2144,12,2018,8,4
Group 5,RRG,1.5,18,14,2145,14,2018,11,3
Group 5,RRG,1.5,18,14,2146,14,2018,10,4
Group 5,RRG,1.5,18,14,2147,14,2018,9,5
Group 5,RRG,1.5,18,14,2148,14,2018,10,4
Group 5,RRG,1.5,18,14,2149,12,2018,13,-1
Group 5,RRG,1.5,18,14,2150,9,2018,9,0
Group 5,RRG,1.5,18,14,2151,7,2018,9,-2
Group 5,RRG,1.5,18,14,2152,14,2018,13,1
Group 5,RRG,1.5,18,14,2153,14,2018,11,3
Group 5,RRG,1.5,18,14,2154,12,2018,10,2
Group 5,RRG,1.5,18,14,2155,11,2018,10,1
Group 5,RRG,1.5,18,14,2156,11,2018,10,1
Group 5,RRG,1.5,18,14,2157,9,2018,12,-3
Group 5,RRG,1.5,18,14,2158,13,2018,9,4
Group 5,RRG,1.5,18,14,2159,14,2018,11,3
Group 5,RRG,1.5,18,14,2160,13,2018,11,2
Group 5,RRG,1.5,18,14,2161,10,2018,12,-2
Group 5,RRG,1.5,18,14,2162,9,2018,14,-5
Group 5,RRG,1.5,18,14,2163,10,2018,10,0
Group 5,RRG,1.5,18,14,2164,12,2018,10,2
Group 5,RRG,1.5,18,14,2165,11,2018,11,0
Group 5,RRG,1.5,18,14,2166,11,2018,9,2
Group 5,RRG,1.5,18,14,2167,11,2018,11,0
Group 5,RRG,1.5,18,14,2168,12,2018,11,1
Group 5,RRG,1.5,18,14,2169,7,2018,12,-5
Group 5,RRG,1.5,18,14,2170,11,2018,9,2
Group 5,RRG,1.5,18,14,2171,5,2018,11,-6
Group 5,RRG,1.5,18,14,2172,10,2018,4,6
Group 5,RRG,1.5,18,14,2173,11,2018,12,-1
Group 5,RRG,1.5,18,14,2174,14,2018,13,1
Group 5,RRG,1.5,18,14,2175,14,2018,12,2
Group 5,RRG,1.5,18,14,2176,9,2018,10,-1
Group 5,RRG,1.5,18,14,2177,11,2018,11,0
Group 5,RRG,1.5,18,14,2178,9,2018,10,-1
Group 5,RRG,1.5,18,14,2179,12,2018,8,4
Group 5,RRG,1.5,18,14,2180,12,2018,8,4
Group 5,RRG,1.5,18,14,2181,13,2018,10,3
Group 5,RRG,1.5,18,14,2182,13,2018,10,3
Group 5,RRG,1.5,18,14,2183,10,2018,10,0
Group 5,RRG,1.5,18,14,2184,14,2018,11,3
Group 5,RRG,1.5,18,14,2185,13,2018,9,4
Group 5,RRG,1.5,18,14,2186,13,2018,12,1
Group 5,RRG,1.5,18,14,2187,13,2018,13,0
Group 5,RRG,1.5,18,14,2188,11,2018,11,0
Group 5,RRG,1.5,18,14,2189,12,2018,12,0
Group 5,RRG,1.5,18,14,2190,10,2018,10,0
Group 5,RRG,1.5,18,14,2191,11,2018,13,-2
Group 5,RRG,1.5,18,14,2192,14,2018,10,4
Group 5,RRG,1.5,18,14,2193,13,2018,11,2
Group 5,RRG,1.5,18,14,2194,12,2018,14,-2
Group 5,RRG,1.5,18,14,2195,11,2018,11,0
Group 5,RRG,1.5,18,14,2196,10,2018,11,-1
Group 5,RRG,1.5,18,14,2197,12,2018,10,2
Group 5,RRG,1.5,18,14,2198,11,2018,12,-1
Group 5,RRG,1.5,18,14,2199,14,2018,10,4
Group 5,RRG,1.5,18,14,2200,12,2018,10,2
Group 5,RRG,1.5,18,14,2201,10,2018,13,-3
Group 5,RRG,1.5,18,14,2202,11,2018,8,3
Group 5,RRG,1.5,18,14,2203,12,2018,12,0
Group 5,RRG,1.5,18,14,2204,13,2018,12,1
Group 5,RRG,1.5,18,14,2205,8,2018,11,-3
Group 5,RRG,1.5,18,14,2206,11,2018,10,1
Group 5,RRG,1.5,18,14,2207,9,2018,14,-5
Group 5,RRG,1.5,18,14,2208,13,2018,10,3
Group 5,RRG,1.5,18,14,2209,13,2018,12,1
Group 5,RRG,1.5,18,14,2210,10,2018,10,0
Group 5,RRG,1.5,18,14,2211,12,2018,10,2
Group 5,RRG,1.5,18,14,2212,12,2018,9,3
Group 5,RRG,1.5,18,14,2213,13,2018,11,2
Group 5,RRG,1.5,18,14,2214,10,2018,8,2
Group 5,RRG,1.5,18,14,2215,10,2018,9,1
Group 5,RRG,1.5,18,14,2216,10,2018,6,4
Group 5,RRG,1.5,18,14,2217,11,2018,12,-1
Group 5,RRG,1.5,18,14,2218,11,2018,12,-1
Group 5,RRG,1.5,18,14,2219,14,2018,12,2
Group 5,RRG,1.5,18,14,2220,11,2018,10,1
Group 5,RRG,1.5,18,14,2221,12,2018,9,3
Group 5,RRG,1.5,18,14,2222,13,2018,11,2
Group 5,RRG,1.5,18,14,2223,9,2018,14,-5
Group 5,RRG,1.5,18,14,2224,14,2018,9,5
Group 5,RRG,1.5,18,14,2225,14,2018,12,2
Group 5,RRG,1.5,18,14,2226,13,2018,12,1
Group 5,RRG,1.5,18,14,2227,10,2018,13,-3
Group 5,RRG,1.5,18,14,2228,9,2018,9,0
Group 5,RRG,1.5,18,14,2229,13,2018,12,1
Group 5,RRG,1.5,18,14,2230,11,2018,11,0
Group 5,RRG,1.5,18,14,2231,12,2018,13,-1
Group 5,RRG,1.5,18,14,2232,9,2018,12,-3
Group 5,RRG,1.5,18,14,2233,9,2018,5,4
Group 5,RRG,1.5,18,14,2234,13,2018,12,1
Group 5,RRG,1.5,18,14,2235,11,2018,14,-3
Group 5,RRG,1.5,18,14,2236,13,2018,9,4
Group 5,RRG,1.5,18,14,2237,13,2018,11,2
Group 5,RRG,1.5,18,14,2238,9,2018,9,0
Group 5,RRG,1.5,18,14,2239,6,2018,10,-4
Group 5,RRG,1.5,18,14,2240,11,2018,12,-1
Group 5,RRG,1.5,18,14,2241,10,2018,11,-1
Group 5,RRG,1.5,18,14,2242,12,2018,13,-1
Group 5,RRG,1.5,18,14,2243,11,2018,12,-1
Group 5,RRG,1.5,18,14,2244,12,2018,11,1
Group 5,RRG,1.5,18,14,2245,13,2018,13,0
Group 5,RRG,1.5,18,14,2246,11,2018,8,3
Group 5,RRG,1.5,18,14,2247,10,2018,12,-2
Group 5,RRG,1.5,18,14,2248,10,2018,14,-4
Group 5,RRG,1.5,18,14,2249,11,2018,10,1
Group 5,RRG,1.5,18,14,2250,7,2018,12,-5
Group 5,RRG,1.5,18,14,2251,9,2018,13,-4
Group 5,RRG,1.5,18,14,2252,6,2018,13,-7
Group 5,RRG,1.5,18,14,2253,11,2018,13,-2
Group 5,RRG,1.5,18,14,2254,8,2018,12,-4
Group 5,RRG,1.5,18,14,2255,11,2018,10,1
Group 5,RRG,1.5,18,14,2256,13,2018,10,3
Group 5,RRG,1.5,18,14,2257,12,2018,10,2
Group 5,RRG,1.5,18,14,2258,12,2018,10,2
Group 5,RRG,1.5,18,14,2259,14,2018,8,6
Group 5,RRG,1.5,18,14,2260,12,2018,13,-1
Group 5,RRG,1.5,18,14,2261,12,2018,10,2
Group 5,RRG,1.5,18,14,2262,14,2018,10,4
Group 5,RRG,1.5,18,14,2263,13,2018,9,4
Group 5,RRG,1.5,18,14,2264,10,2018,13,-3
Group 5,RRG,1.5,18,14,2265,13,2018,11,2
Group 5,RRG,1.5,18,14,2266,13,2018,11,2
Group 5,RRG,1.5,18,14,2267,13,2018,11,2
Group 5,RRG,1.5,18,14,2268,11,2018,13,-2
Group 5,RRG,1.5,18,14,2269,13,2018,9,4
Group 5,RRG,1.5,18,14,2270,14,2018,12,2
Group 5,RRG,1.5,18,14,2271,11,2018,11,0
Group 5,RRG,1.5,18,14,2272,11,2018,7,4
Group 5,RRG,1.5,18,14,2273,12,2018,8,4
Group 5,RRG,1.5,18,14,2274,7,2018,11,-4
Group 5,RRG,1.5,18,14,2275,13,2018,11,2
Group 5,RRG,1.5,18,14,2276,12,2018,10,2
Group 5,RRG,1.5,18,14,2277,14,2018,12,2
Group 5,RRG,1.5,18,14,2278,14,2018,12,2
Group 5,RRG,1.5,18,14,2279,10,2018,11,-1
Group 5,RRG,1.5,18,14,2280,14,2018,13,1
Group 5,RRG,1.5,18,14,2281,14,2018,14,0
Group 5,RRG,1.5,18,14,2282,13,2018,10,3
Group 5,RRG,1.5,18,14,2283,12,2018,8,4
Group 5,RRG,1.5,18,14,2284,14,2018,9,5
Group 5,RRG,1.5,18,14,2285,11,2018,13,-2
Group 5,RRG,1.5,18,14,2286,13,2018,12,1
Group 5,RRG,1.5,18,14,2287,14,2018,12,2
Group 5,RRG,1.5,18,14,2288,11,2018,13,-2
Group 5,RRG,1.5,18,14,2289,12,2018,13,-1
Group 5,RRG,1.5,18,14,2290,11,2018,14,-3
Group 5,RRG,1.5,18,14,2291,12,2018,13,-1
Group 5,RRG,1.5,18,14,2292,11,2018,12,-1
Group 5,RRG,1.5,18,14,2293,12,2018,14,-2
Group 5,RRG,1.5,18,14,2294,9,2018,11,-2
Group 5,RRG,1.5,18,14,2295,12,2018,11,1
Group 5,RRG,1.5,18,14,2296,10,2018,11,-1
Group 5,RRG,1.5,18,14,2297,8,2018,9,-1
Group 5,RRG,1.5,18,14,2298,11,2018,12,-1
Group 5,RRG,1.5,18,14,2299,13,2018,13,0
Group 5,RRG,1.5,18,14,2300,10,2018,11,-1
Group 5,RRG,1.5,18,14,2301,11,2018,12,-1
Group 5,RRG,1.5,18,14,2302,12,2018,11,1
Group 5,RRG,1.5,18,14,2303,14,2018,11,3
Group 5,RRG,1.5,18,14,2304,11,2018,10,1
Group 5,RRG,1.5,18,14,2305,13,2018,9,4
Group 5,RRG,1.5,18,14,2306,14,2018,9,5
Group 5,RRG,1.5,18,14,2307,12,2018,4,8
Group 5,RRG,1.5,18,14,2308,13,2018,11,2
Group 5,RRG,1.5,18,14,2309,10,2018,10,0
Group 5,RRG,1.5,18,14,2310,9,2018,13,-4
Group 5,RRG,1.5,18,14,2311,10,2018,11,-1
Group 5,RRG,1.5,18,14,2312,9,2018,8,1
Group 5,RRG,1.5,18,14,2313,12,2018,5,7
Group 5,RRG,1.5,18,14,2314,11,2018,7,4
Group 5,RRG,1.5,18,14,2315,11,2018,11,0
Group 5,RRG,1.5,18,14,2316,11,2018,9,2
Group 5,RRG,1.5,18,14,2317,13,2018,13,0
Group 5,RRG,1.5,18,14,2318,12,2018,10,2
Group 5,RRG,1.5,18,14,2319,12,2018,12,0
Group 5,RRG,1.5,18,14,2320,13,2018,12,1
Group 5,RRG,1.5,18,14,2321,12,2018,13,-1
Group 5,RRG,1.5,18,14,2322,11,2018,10,1
Group 5,RRG,1.5,18,14,2323,12,2018,10,2
Group 5,RRG,1.5,18,14,2324,12,2018,14,-2
Group 5,RRG,1.5,18,14,2325,13,2018,10,3
Group 5,RRG,1.5,18,14,2326,12,2018,14,-2
Group 5,RRG,1.5,18,14,2327,11,2018,13,-2
Group 5,RRG,1.5,18,14,2328,9,2018,10,-1
Group 5,RRG,1.5,18,14,2329,11,2018,9,2
Group 5,RRG,1.5,18,14,2330,12,2018,9,3
Group 5,RRG,1.5,18,14,2331,13,2018,9,4
Group 5,RRG,1.5,18,14,2332,10,2018,12,-2
Group 5,RRG,1.5,18,14,2333,11,2018,8,3
Group 5,RRG,1.5,18,14,2334,12,2018,10,2
Group 5,RRG,1.5,18,14,2335,13,2018,8,5
Group 5,RRG,1.5,18,14,2336,13,2018,11,2
Group 5,RRG,1.5,18,14,2337,12,2018,9,3
Group 5,RRG,1.5,18,14,2338,12,2018,13,-1
Group 5,RRG,1.5,18,14,2339,13,2018,10,3
Group 5,RRG,1.5,18,14,2340,13,2018,14,-1
Group 5,RRG,1.5,18,14,2341,11,2018,8,3
Group 5,RRG,1.5,18,14,2342,8,2018,10,-2
Group 5,RRG,1.5,18,14,2343,8,2018,10,-2
Group 5,RRG,1.5,18,14,2344,12,2018,14,-2
Group 5,RRG,1.5,18,14,2345,13,2018,11,2
Group 5,RRG,1.5,18,14,2346,12,2018,10,2
Group 5,RRG,1.5,18,14,2347,11,2018,12,-1
Group 5,RRG,1.5,18,14,2348,9,2018,11,-2
Group 5,RRG,1.5,18,14,2349,11,2018,8,3
Group 5,RRG,1.5,18,14,2350,12,2018,12,0
Group 5,RRG,1.5,18,14,2351,12,2018,11,1
Group 5,RRG,1.5,18,14,2352,11,2018,11,0
Group 5,RRG,1.5,18,14,2353,9,2018,11,-2
Group 5,RRG,1.5,18,14,2354,12,2018,8,4
Group 5,RRG,1.5,18,14,2355,13,2018,12,1
Group 5,RRG,1.5,18,14,2356,13,2018,12,1
Group 5,RRG,1.5,18,14,2357,13,2018,10,3
Group 5,RRG,1.5,18,14,2358,11,2018,12,-1
Group 5,RRG,1.5,18,14,2359,12,2018,12,0
Group 5,RRG,1.5,18,14,2360,12,2018,11,1
Group 5,RRG,1.5,18,14,2361,10,2018,13,-3
Group 5,RRG,1.5,18,14,2362,7,2018,12,-5
Group 5,RRG,1.5,18,14,2363,11,2018,10,1
Group 5,RRG,1.5,18,14,2364,13,2018,10,3
Group 5,RRG,1.5,18,14,2365,12,2018,9,3
Group 5,RRG,1.5,18,14,2366,10,2018,11,-1
Group 5,RRG,1.5,18,14,2367,11,2018,13,-2
Group 5,RRG,1.5,18,14,2368,11,2018,13,-2
Group 5,RRG,1.5,18,14,2369,10,2018,8,2
Group 5,RRG,1.5,18,14,2370,14,2018,6,8
Group 5,RRG,1.5,18,14,2371,11,2018,10,1
Group 5,RRG,1.5,18,14,2372,10,2018,10,0
Group 5,RRG,1.5,18,14,2373,11,2018,11,0
Group 5,RRG,1.5,18,14,2374,11,2018,13,-2
Group 5,RRG,1.5,18,14,2375,13,2018,11,2
Group 5,RRG,1.5,18,14,2376,8,2018,9,-1
Group 5,RRG,1.5,18,14,2377,4,2018,10,-6
Group 5,RRG,1.5,18,14,2378,10,2018,10,0
Group 5,RRG,1.5,18,14,2379,9,2018,10,-1
Group 5,RRG,1.5,18,14,2380,12,2018,13,-1
Group 5,RRG,1.5,18,14,2381,11,2018,7,4
Group 5,RRG,1.5,18,14,2382,12,2018,13,-1
Group 5,RRG,1.5,18,14,2383,13,2018,11,2
Group 5,RRG,1.5,18,14,2384,12,2018,13,-1
Group 5,RRG,1.5,18,14,2385,12,2018,7,5
Group 5,RRG,1.5,18,14,2386,11,2018,8,3
Group 5,RRG,1.5,18,14,2387,12,2018,12,0
Group 5,RRG,1.5,18,14,2388,10,2018,11,-1
Group 5,RRG,1.5,18,14,2389,13,2018,13,0
Group 5,RRG,1.5,18,14,2390,9,2018,13,-4
Group 5,RRG,1.5,18,14,2391,7,2018,12,-5
Group 5,RRG,1.5,18,14,2392,8,2018,9,-1
Group 5,RRG,1.5,18,14,2393,11,2018,12,-1
Group 5,RRG,1.5,18,14,2394,12,2018,11,1
Group 5,RRG,1.5,18,14,2395,13,2018,12,1
Group 5,RRG,1.5,18,14,2396,11,2018,14,-3
Group 5,RRG,1.5,18,14,2397,6,2018,10,-4
Group 5,RRG,1.5,18,14,2398,10,2018,11,-1
Group 5,RRG,1.5,18,14,2399,13,2018,11,2
Group 5,RRG,1.5,18,14,2400,8,2018,11,-3
Group 5,RRG,1.5,18,14,2401,10,2018,12,-2
Group 5,RRG,1.5,18,14,2402,13,2018,11,2
Group 5,RRG,1.5,18,14,2403,13,2018,11,2
Group 5,RRG,1.5,18,14,2404,9,2018,11,-2
Group 5,RRG,1.5,18,14,2405,11,2018,12,-1
Group 5,RRG,1.5,18,14,2406,10,2018,10,0
Group 5,RRG,1.5,18,14,2407,8,2018,12,-4
Group 5,RRG,1.5,18,14,2408,13,2018,13,0
Group 5,RRG,1.5,18,14,2409,5,2018,10,-5
Group 5,RRG,1.5,18,14,2410,10,2018,10,0
Group 5,RRG,1.5,18,14,2411,9,2018,11,-2
Group 5,RRG,1.5,18,14,2412,12,2018,13,-1
Group 5,RRG,1.5,18,14,2413,14,2018,10,4
Group 5,RRG,1.5,18,14,2414,10,2018,11,-1
Group 5,RRG,1.5,18,14,2415,13,2018,10,3
Group 5,RRG,1.5,18,14,2416,14,2018,13,1
Group 5,RRG,1.5,18,14,2417,10,2018,13,-3
Group 5,RRG,1.5,18,14,2418,13,2018,11,2
Group 5,RRG,1.5,18,14,2419,13,2018,12,1
Group 5,RRG,1.5,18,14,2420,11,2018,10,1
Group 5,RRG,1.5,18,14,2421,12,2018,11,1
Group 5,RRG,1.5,18,14,2422,12,2018,12,0
Group 5,RRG,1.5,18,14,2423,14,2018,11,3
Group 5,RRG,1.5,18,14,2424,11,2018,12,-1
Group 5,RRG,1.5,18,14,2425,13,2018,13,0
Group 5,RRG,1.5,18,14,2426,11,2018,11,0
Group 5,RRG,1.5,18,14,2427,11,2018,11,0
Group 5,RRG,1.5,18,14,2428,12,2018,12,0
Group 5,RRG,1.5,18,14,2429,10,2018,8,2
Group 5,RRG,1.5,18,14,2430,11,2018,11,0
Group 5,RRG,1.5,18,14,2431,10,2018,9,1
Group 5,RRG,1.5,18,14,2432,12,2018,13,-1
Group 5,RRG,1.5,18,14,2433,9,2018,12,-3
Group 5,RRG,1.5,18,14,2434,12,2018,10,2
Group 5,RRG,1.5,18,14,2435,13,2018,9,4
Group 5,RRG,1.5,18,14,2436,12,2018,10,2
Group 5,RRG,1.5,18,14,2437,8,2018,12,-4
Group 5,RRG,1.5,18,14,2438,13,2018,13,0
Group 5,RRG,1.5,18,14,2439,10,2018,13,-3
Group 5,RRG,1.5,18,14,2440,9,2018,12,-3
Group 5,RRG,1.5,18,14,2441,13,2018,7,6
Group 5,RRG,1.5,18,14,2442,14,2018,14,0
Group 5,RRG,1.5,18,14,2443,14,2018,12,2
Group 5,RRG,1.5,18,14,2444,10,2018,12,-2
Group 5,RRG,1.5,18,14,2445,12,2018,10,2
Group 5,RRG,1.5,18,14,2446,9,2018,11,-2
Group 5,RRG,1.5,18,14,2447,13,2018,11,2
Group 5,RRG,1.5,18,14,2448,11,2018,9,2
Group 5,RRG,1.5,18,14,2449,11,2018,10,1
Group 5,RRG,1.5,18,14,2450,12,2018,8,4
Group 5,RRG,1.5,18,14,2451,7,2018,2,5
Group 5,RRG,1.5,18,14,2452,13,2018,10,3
Group 5,RRG,1.5,18,14,2453,12,2018,11,1
Group 5,RRG,1.5,18,14,2454,12,2018,9,3
Group 5,RRG,1.5,18,14,2455,11,2018,10,1
Group 5,RRG,1.5,18,14,2456,11,2018,11,0
Group 5,RRG,1.5,18,14,2457,5,2018,4,1
Group 5,RRG,1.5,18,14,2458,3,2018,11,-8
Group 5,RRG,1.5,18,14,2459,12,2018,12,0
Group 5,RRG,1.5,18,14,2460,10,2018,13,-3
Group 5,RRG,1.5,18,14,2461,12,2018,12,0
Group 5,RRG,1.5,18,14,2462,11,2018,13,-2
Group 5,RRG,1.5,18,14,2463,14,2018,10,4
Group 5,RRG,1.5,18,14,2464,10,2018,12,-2
Group 5,RRG,1.5,18,14,2465,12,2018,12,0
Group 5,RRG,1.5,18,14,2466,11,2018,11,0
Group 5,RRG,1.5,18,14,2467,10,2018,11,-1
Group 5,RRG,1.5,18,14,2468,10,2018,13,-3
Group 5,RRG,1.5,18,14,2469,7,2018,11,-4
Group 5,RRG,1.5,18,14,2470,11,2018,10,1
Group 5,RRG,1.5,18,14,2471,10,2018,11,-1
Group 5,RRG,1.5,18,14,2472,12,2018,14,-2
Group 5,RRG,1.5,18,14,2473,10,2018,9,1
Group 5,RRG,1.5,18,14,2474,11,2018,12,-1
Group 5,RRG,1.5,18,14,2475,10,2018,10,0
Group 5,RRG,1.5,18,14,2476,14,2018,13,1
Group 5,RRG,1.5,18,14,2477,11,2018,11,0
Group 5,RRG,1.5,18,14,2478,10,2018,10,0
Group 5,RRG,1.5,18,14,2479,11,2018,7,4
Group 5,RRG,1.5,18,14,2480,12,2018,13,-1
Group 5,RRG,1.5,18,14,2481,14,2018,14,0
Group 5,RRG,1.5,18,14,2482,14,2018,11,3
Group 5,RRG,1.5,18,14,2483,13,2018,13,0
Group 5,RRG,1.5,18,14,2484,8,2018,10,-2
Group 5,RRG,1.5,18,14,2485,12,2018,14,-2
Group 5,RRG,1.5,18,14,2486,12,2018,12,0
Group 5,RRG,1.5,18,14,2487,14,2018,13,1
Group 5,RRG,1.5,18,14,2488,11,2018,8,3
Group 5,RRG,1.5,18,14,2489,13,2018,12,1
Group 5,RRG,1.5,18,14,2490,10,2018,13,-3
Group 5,RRG,1.5,18,14,2491,14,2018,13,1
Group 5,RRG,1.5,18,14,2492,9,2018,8,1
Group 5,RRG,1.5,18,14,2493,12,2018,11,1
Group 5,RRG,1.5,18,14,2494,11,2018,13,-2
Group 5,RRG,1.5,18,14,2495,12,2018,9,3
Group 5,RRG,1.5,18,14,2496,12,2018,12,0
Group 5,RRG,1.5,18,14,2497,10,2018,14,-4
Group 5,RRG,1.5,18,14,2498,10,2018,11,-1
Group 5,RRG,1.5,18,14,2499,10,2018,10,0
Group 5,RRG,1.5,18,14,2500,10,2018,11,-1
Group 5,RRG,1.5,18,14,2501,9,2018,7,2
Group 5,RRG,1.5,18,14,2502,11,2018,8,3
Group 5,RRG,1.5,18,14,2503,10,2018,11,-1
Group 5,RRG,1.5,18,14,2504,9,2018,12,-3
Group 5,RRG,1.5,18,14,2505,13,2018,8,5
Group 5,RRG,1.5,18,14,2506,11,2018,7,4
Group 5,RRG,1.5,18,14,2507,14,2018,10,4
Group 5,RRG,1.5,18,14,2508,12,2018,9,3
Group 5,RRG,1.5,18,14,2509,10,2018,10,0
Group 5,RRG,1.5,18,14,2510,12,2018,10,2
Group 5,RRG,1.5,18,14,2511,12,2018,11,1
Group 5,RRG,1.5,18,14,2512,13,2018,11,2
Group 5,RRG,1.5,18,14,2513,12,2018,11,1
Group 5,RRG,1.5,18,14,2514,6,2018,11,-5
Group 5,RRG,1.5,18,14,2515,14,2018,14,0
Group 5,RRG,1.5,18,14,2516,14,2018,13,1
Group 5,RRG,1.5,18,14,2517,14,2018,13,1
Group 5,RRG,1.5,18,14,2518,12,2018,12,0
Group 5,RRG,1.5,18,14,2519,12,2018,12,0
Group 5,RRG,1.5,18,14,2520,12,2018,13,-1
Group 5,RRG,1.5,18,14,2521,10,2018,11,-1
Group 5,RRG,1.5,18,14,2522,11,2018,13,-2
Group 5,RRG,1.5,18,14,2523,13,2018,11,2
Group 5,RRG,1.5,18,14,2524,7,2018,11,-4
Group 5,RRG,1.5,18,14,2525,14,2018,13,1
Group 5,RRG,1.5,18,14,2526,13,2018,10,3
Group 5,RRG,1.5,18,14,2527,14,2018,9,5
Group 5,RRG,1.5,18,14,2528,14,2018,12,2
Group 5,RRG,1.5,18,14,2529,12,2018,14,-2
Group 5,RRG,1.5,18,14,2530,10,2018,13,-3
Group 5,RRG,1.5,18,14,2531,12,2018,7,5
Group 5,RRG,1.5,18,14,2532,13,2018,10,3
Group 5,RRG,1.5,18,14,2533,14,2018,12,2
Group 5,RRG,1.5,18,14,2534,13,2018,11,2
Group 5,RRG,1.5,18,14,2535,11,2018,13,-2
Group 5,RRG,1.5,18,14,2536,12,2018,13,-1
Group 5,RRG,1.5,18,14,2537,6,2018,14,-8
Group 5,RRG,1.5,18,14,2538,9,2018,8,1
Group 5,RRG,1.5,18,14,2539,13,2018,12,1
Group 5,RRG,1.5,18,14,2540,13,2018,10,3
Group 5,RRG,1.5,18,14,2541,11,2018,12,-1
Group 5,RRG,1.5,18,14,2542,10,2018,13,-3
Group 5,RRG,1.5,18,14,2543,8,2018,12,-4
Group 5,RRG,1.5,18,14,2544,14,2018,10,4
Group 5,RRG,1.5,18,14,2545,12,2018,12,0
Group 5,RRG,1.5,18,14,2546,12,2018,12,0
Group 5,RRG,1.5,18,14,2547,12,2018,13,-1
Group 5,RRG,1.5,18,14,2548,13,2018,9,4
Group 5,RRG,1.5,18,14,2549,10,2018,13,-3
Group 5,RRG,1.5,18,14,2550,11,2018,10,1
Group 5,RRG,1.5,18,14,2551,12,2018,12,0
Group 5,RRG,1.5,18,14,2552,11,2018,13,-2
Group 5,RRG,1.5,18,14,2553,13,2018,5,8
Group 5,RRG,1.5,18,14,2554,13,2018,11,2
Group 5,RRG,1.5,18,14,2555,10,2018,11,-1
Group 5,RRG,1.5,18,14,2556,13,2018,11,2
Group 5,RRG,1.5,18,14,2557,13,2018,10,3
Group 5,RRG,1.5,18,14,2558,13,2018,11,2
Group 5,RRG,1.5,18,14,2559,13,2018,14,-1
Group 5,RRG,1.5,18,14,2560,14,2018,5,9
Group 5,RRG,1.5,18,14,2561,11,2018,10,1
Group 5,RRG,1.5,18,14,2562,8,2018,11,-3
Group 5,RRG,1.5,18,14,2563,12,2018,10,2
Group 5,RRG,1.5,18,14,2564,8,2018,9,-1
Group 5,RRG,1.5,18,14,2565,13,2018,12,1
Group 5,RRG,1.5,18,14,2566,7,2018,11,-4
Group 5,RRG,1.5,18,14,2567,6,2018,11,-5
Group 5,RRG,1.5,18,14,2568,7,2018,12,-5
Group 5,RRG,1.5,18,14,2569,11,2018,7,4
Group 5,RRG,1.5,18,14,2570,12,2018,10,2
Group 5,RRG,1.5,18,14,2571,13,2018,11,2
Group 5,RRG,1.5,18,14,2572,14,2018,11,3
Group 5,RRG,1.5,18,14,2573,10,2018,14,-4
Group 5,RRG,1.5,18,14,2574,11,2018,12,-1
Group 5,RRG,1.5,18,14,2575,12,2018,14,-2
Group 5,RRG,1.5,18,14,2576,12,2018,14,-2
Group 5,RRG,1.5,18,14,2577,10,2018,14,-4
Group 5,RRG,1.5,18,14,2578,14,2018,11,3
Group 5,RRG,1.5,18,14,2579,13,2018,12,1
Group 5,RRG,1.5,18,14,2580,14,2018,10,4
Group 5,RRG,1.5,18,14,2581,12,2018,8,4
Group 5,RRG,1.5,18,14,2582,13,2018,12,1
Group 5,RRG,1.5,18,14,2583,12,2018,9,3
Group 5,RRG,1.5,18,14,2584,13,2018,11,2
Group 5,RRG,1.5,18,14,2585,13,2018,12,1
Group 5,RRG,1.5,18,14,2586,13,2018,8,5
Group 5,RRG,1.5,18,14,2587,13,2018,12,1
Group 5,RRG,1.5,18,14,2588,12,2018,11,1
Group 5,RRG,1.5,18,14,2589,5,2018,11,-6
Group 5,RRG,1.5,18,14,2590,10,2018,11,-1
Group 5,RRG,1.5,18,14,2591,9,2018,8,1
Group 5,RRG,1.5,18,14,2592,14,2018,12,2
Group 5,RRG,1.5,18,14,2593,9,2018,13,-4
Group 5,RRG,1.5,18,14,2594,13,2018,12,1
Group 5,RRG,1.5,18,14,2595,10,2018,12,-2
Group 5,RRG,1.5,18,14,2596,12,2018,12,0
Group 5,RRG,1.5,18,14,2597,8,2018,12,-4
Group 5,RRG,1.5,18,14,2598,13,2018,11,2
Group 5,RRG,1.5,18,14,2599,10,2018,12,-2
Group 5,RRG,1.5,18,14,2600,10,2018,10,0
Group 5,RRG,1.5,18,14,2601,8,2018,12,-4
Group 5,RRG,1.5,18,14,2602,10,2018,13,-3
Group 5,RRG,1.5,18,14,2603,12,2018,12,0
Group 5,RRG,1.5,18,14,2604,12,2018,14,-2
Group 5,RRG,1.5,18,14,2605,10,2018,11,-1
Group 5,RRG,1.5,18,14,2606,10,2018,12,-2
Group 5,RRG,1.5,18,14,2607,14,2018,14,0
Group 5,RRG,1.5,18,14,2608,13,2018,13,0
Group 5,RRG,1.5,18,14,2609,11,2018,9,2
Group 5,RRG,1.5,18,14,2610,13,2018,11,2
Group 5,RRG,1.5,18,14,2611,14,2018,14,0
Group 5,RRG,1.5,18,14,2612,12,2018,12,0
Group 5,RRG,1.5,18,14,2613,12,2018,10,2
Group 5,RRG,1.5,18,14,2614,8,2018,13,-5
Group 5,RRG,1.5,18,14,2615,10,2018,12,-2
Group 5,RRG,1.5,18,14,2616,8,2018,11,-3
Group 5,RRG,1.5,18,14,2617,11,2018,13,-2
Group 5,RRG,1.5,18,14,2618,13,2018,10,3
Group 5,RRG,1.5,18,14,2619,8,2018,11,-3
Group 5,RRG,1.5,18,14,2620,13,2018,10,3
Group 5,RRG,1.5,18,14,2621,14,2018,8,6
Group 5,RRG,1.5,18,14,2622,11,2018,13,-2
Group 5,RRG,1.5,18,14,2623,13,2018,11,2
Group 5,RRG,1.5,18,14,2624,10,2018,13,-3
Group 5,RRG,1.5,18,14,2625,12,2018,12,0
Group 5,RRG,1.5,18,14,2626,10,2018,12,-2
Group 5,RRG,1.5,18,14,2627,13,2018,9,4
Group 5,RRG,1.5,18,14,2628,8,2018,11,-3
Group 5,RRG,1.5,18,14,2629,10,2018,13,-3
Group 5,RRG,1.5,18,14,2630,9,2018,11,-2
Group 5,RRG,1.5,18,14,2631,10,2018,14,-4
Group 5,RRG,1.5,18,14,2632,11,2018,8,3
Group 5,RRG,1.5,18,14,2633,14,2018,14,0
Group 5,RRG,1.5,18,14,2634,12,2018,10,2
Group 5,RRG,1.5,18,14,2635,10,2018,10,0
Group 5,RRG,1.5,18,14,2636,12,2018,9,3
Group 5,RRG,1.5,18,14,2637,11,2018,8,3
Group 5,RRG,1.5,18,14,2638,11,2018,10,1
Group 5,RRG,1.5,18,14,2639,13,2018,13,0
Group 5,RRG,1.5,18,14,2640,4,2018,10,-6
Group 5,RRG,1.5,18,14,2641,13,2018,12,1
Group 5,RRG,1.5,18,14,2642,13,2018,12,1
Group 5,RRG,1.5,18,14,2643,14,2018,11,3
Group 5,RRG,1.5,18,14,2644,10,2018,11,-1
Group 5,RRG,1.5,18,14,2645,12,2018,11,1
Group 5,RRG,1.5,18,14,2646,14,2018,11,3
Group 5,RRG,1.5,18,14,2647,12,2018,11,1
Group 5,RRG,1.5,18,14,2648,11,2018,11,0
Group 5,RRG,1.5,18,14,2649,12,2018,10,2
Group 5,RRG,1.5,18,14,2650,13,2018,11,2
Group 5,RRG,1.5,18,14,2651,10,2018,10,0
Group 5,RRG,1.5,18,14,2652,13,2018,13,0
Group 5,RRG,1.5,18,14,2653,13,2018,10,3
Group 5,RRG,1.5,18,14,2654,13,2018,12,1
Group 5,RRG,1.5,18,14,2655,12,2018,9,3
Group 5,RRG,1.5,18,14,2656,12,2018,11,1
Group 5,RRG,1.5,18,14,2657,12,2018,11,1
Group 5,RRG,1.5,18,14,2658,8,2018,10,-2
Group 5,RRG,1.5,18,14,2659,9,2018,13,-4
Group 5,RRG,1.5,18,14,2660,14,2018,8,6
Group 5,RRG,1.5,18,14,2661,10,2018,10,0
Group 5,RRG,1.5,18,14,2662,12,2018,10,2
Group 5,RRG,1.5,18,14,2663,9,2018,14,-5
Group 5,RRG,1.5,18,14,2664,12,2018,12,0
Group 5,RRG,1.5,18,14,2665,13,2018,10,3
Group 5,RRG,1.5,18,14,2666,13,2018,13,0
Group 5,RRG,1.5,18,14,2667,12,2018,11,1
Group 5,RRG,1.5,18,14,2668,9,2018,10,-1
Group 5,RRG,1.5,18,14,2669,10,2018,9,1
Group 5,RRG,1.5,18,14,2670,11,2018,11,0
Group 5,RRG,1.5,18,14,2671,9,2018,11,-2
Group 5,RRG,1.5,18,14,2672,12,2018,11,1
Group 5,RRG,1.5,18,14,2673,12,2018,11,1
Group 5,RRG,1.5,18,14,2674,12,2018,12,0
Group 5,RRG,1.5,18,14,2675,10,2018,11,-1
Group 5,RRG,1.5,18,14,2676,13,2018,12,1
Group 5,RRG,1.5,18,14,2677,12,2018,11,1
Group 5,RRG,1.5,18,14,2678,12,2018,10,2
Group 5,RRG,1.5,18,14,2679,9,2018,12,-3
Group 5,RRG,1.5,18,14,2680,14,2018,11,3
Group 5,RRG,1.5,18,14,2681,14,2018,10,4
Group 5,RRG,1.5,18,14,2682,11,2018,13,-2
Group 5,RRG,1.5,18,14,2683,13,2018,13,0
Group 5,RRG,1.5,18,14,2684,13,2018,10,3
Group 5,RRG,1.5,18,14,2685,6,2018,13,-7
Group 5,RRG,1.5,18,14,2686,10,2018,12,-2
Group 5,RRG,1.5,18,14,2687,11,2018,12,-1
Group 5,RRG,1.5,18,14,2688,13,2018,12,1
Group 5,RRG,1.5,18,14,2689,14,2018,7,7
Group 5,RRG,1.5,18,14,2690,11,2018,10,1
Group 5,RRG,1.5,18,14,2691,12,2018,13,-1
Group 5,RRG,1.5,18,14,2692,12,2018,14,-2
Group 5,RRG,1.5,18,14,2693,10,2018,14,-4
Group 5,RRG,1.5,18,14,2694,10,2018,12,-2
Group 5,RRG,1.5,18,14,2695,12,2018,9,3
Group 5,RRG,1.5,18,14,2696,10,2018,10,0
Group 5,RRG,1.5,18,14,2697,11,2018,10,1
Group 5,RRG,1.5,18,14,2698,12,2018,14,-2
Group 5,RRG,1.5,18,14,2699,12,2018,9,3
Group 5,RRG,1.5,18,14,2700,12,2018,11,1
Group 5,RRG,1.5,18,14,2701,11,2018,13,-2
Group 5,RRG,1.5,18,14,2702,7,2018,12,-5
Group 5,RRG,1.5,18,14,2703,10,2018,13,-3
Group 5,RRG,1.5,18,14,2704,12,2018,14,-2
Group 5,RRG,1.5,18,14,2705,13,2018,14,-1
Group 5,RRG,1.5,18,14,2706,12,2018,11,1
Group 5,RRG,1.5,18,14,2707,12,2018,13,-1
Group 5,RRG,1.5,18,14,2708,13,2018,13,0
Group 5,RRG,1.5,18,14,2709,12,2018,10,2
Group 5,RRG,1.5,18,14,2710,12,2018,9,3
Group 5,RRG,1.5,18,14,2711,7,2018,14,-7
Group 5,RRG,1.5,18,14,2712,12,2018,11,1
Group 5,RRG,1.5,18,14,2713,13,2018,11,2
Group 5,RRG,1.5,18,14,2714,13,2018,9,4
Group 5,RRG,1.5,18,14,2715,4,2018,13,-9
Group 5,RRG,1.5,18,14,2716,5,2018,7,-2
Group 5,RRG,1.5,18,14,2717,6,2018,7,-1
Group 5,RRG,1.5,18,14,2718,12,2018,9,3
Group 5,RRG,1.5,18,14,2719,12,2018,10,2
Group 5,RRG,1.5,18,14,2720,11,2018,14,-3
Group 5,RRG,1.5,18,14,2721,9,2018,9,0
Group 5,RRG,1.5,18,14,2722,13,2018,14,-1
Group 5,RRG,1.5,18,14,2723,13,2018,11,2
Group 5,RRG,1.5,18,14,2724,13,2018,11,2
Group 5,RRG,1.5,18,14,2725,13,2018,10,3
Group 5,RRG,1.5,18,14,2726,10,2018,8,2
Group 5,RRG,1.5,18,14,2727,12,2018,10,2
Group 5,RRG,1.5,18,14,2728,13,2018,6,7
Group 5,RRG,1.5,18,14,2729,12,2018,10,2
Group 5,RRG,1.5,18,14,2730,14,2018,10,4
Group 5,RRG,1.5,18,14,2731,10,2018,12,-2
Group 5,RRG,1.5,18,14,2732,9,2018,11,-2
Group 5,RRG,1.5,18,14,2733,13,2018,11,2
Group 5,RRG,1.5,18,14,2734,9,2018,10,-1
Group 5,RRG,1.5,18,14,2735,14,2018,8,6
Group 5,RRG,1.5,18,14,2736,9,2018,13,-4
Group 5,RRG,1.5,18,14,2737,12,2018,10,2
Group 5,RRG,1.5,18,14,2738,11,2018,12,-1
Group 5,RRG,1.5,18,14,2739,12,2018,11,1
Group 5,RRG,1.5,18,14,2740,9,2018,11,-2
Group 5,RRG,1.5,18,14,2741,10,2018,10,0
Group 5,RRG,1.5,18,14,2742,14,2018,11,3
Group 5,RRG,1.5,18,14,2743,12,2018,11,1
Group 5,RRG,1.5,18,14,2744,12,2018,11,1
Group 5,RRG,1.5,18,14,2745,6,2018,11,-5
Group 5,RRG,1.5,18,14,2746,13,2018,13,0
Group 5,RRG,1.5,18,14,2747,12,2018,14,-2
Group 5,RRG,1.5,18,14,2748,10,2018,14,-4
Group 5,RRG,1.5,18,14,2749,13,2018,13,0
Group 5,RRG,1.5,18,14,2750,13,2018,11,2
Group 5,RRG,1.5,18,14,2751,14,2018,11,3
Group 5,RRG,1.5,18,14,2752,9,2018,11,-2
Group 5,RRG,1.5,18,14,2753,12,2018,10,2
Group 5,RRG,1.5,18,14,2754,13,2018,8,5
Group 5,RRG,1.5,18,14,2755,13,2018,9,4
Group 5,RRG,1.5,18,14,2756,12,2018,11,1
Group 5,RRG,1.5,18,14,2757,10,2018,11,-1
Group 5,RRG,1.5,18,14,2758,11,2018,10,1
Group 5,RRG,1.5,18,14,2759,10,2018,13,-3
Group 5,RRG,1.5,18,14,2760,9,2018,13,-4
Group 5,RRG,1.5,18,14,2761,5,2018,9,-4
Group 5,RRG,1.5,18,14,2762,12,2018,11,1
Group 5,RRG,1.5,18,14,2763,13,2018,11,2
Group 5,RRG,1.5,18,14,2764,12,2018,11,1
Group 5,RRG,1.5,18,14,2765,11,2018,11,0
Group 5,RRG,1.5,18,14,2766,14,2018,12,2
Group 5,RRG,1.5,18,14,2767,7,2018,9,-2
Group 5,RRG,1.5,18,14,2768,11,2018,13,-2
Group 5,RRG,1.5,18,14,2769,13,2018,12,1
Group 5,RRG,1.5,18,14,2770,13,2018,11,2
Group 5,RRG,1.5,18,14,2771,12,2018,14,-2
Group 5,RRG,1.5,18,14,2772,11,2018,11,0
Group 5,RRG,1.5,18,14,2773,12,2018,12,0
Group 5,RRG,1.5,18,14,2774,9,2018,14,-5
Group 5,RRG,1.5,18,14,2775,13,2018,12,1
Group 5,RRG,1.5,18,14,2776,14,2018,13,1
Group 5,RRG,1.5,18,14,2777,12,2018,12,0
Group 5,RRG,1.5,18,14,2778,14,2018,11,3
Group 5,RRG,1.5,18,14,2779,11,2018,11,0
Group 5,RRG,1.5,18,14,2780,13,2018,14,-1
Group 5,RRG,1.5,18,14,2781,13,2018,11,2
Group 5,RRG,1.5,18,14,2782,11,2018,13,-2
Group 5,RRG,1.5,18,14,2783,14,2018,12,2
Group 5,RRG,1.5,18,14,2784,12,2018,13,-1
Group 5,RRG,1.5,18,14,2785,13,2018,12,1
Group 5,RRG,1.5,18,14,2786,11,2018,10,1
Group 5,RRG,1.5,18,14,2787,8,2018,13,-5
Group 5,RRG,1.5,18,14,2788,7,2018,11,-4
Group 5,RRG,1.5,18,14,2789,12,2018,14,-2
Group 5,RRG,1.5,18,14,2790,13,2018,12,1
Group 5,RRG,1.5,18,14,2791,12,2018,5,7
Group 5,RRG,1.5,18,14,2792,13,2018,12,1
Group 5,RRG,1.5,18,14,2793,12,2018,12,0
Group 5,RRG,1.5,18,14,2794,13,2018,13,0
Group 5,RRG,1.5,18,14,2795,12,2018,11,1
Group 5,RRG,1.5,18,14,2796,13,2018,12,1
Group 5,RRG,1.5,18,14,2797,9,2018,9,0
Group 5,RRG,1.5,18,14,2798,12,2018,9,3
Group 5,RRG,1.5,18,14,2799,11,2018,13,-2
Group 5,RRG,1.5,18,14,2800,14,2018,6,8
Group 5,RRG,1.5,18,14,2801,13,2018,12,1
Group 5,RRG,1.5,18,14,2802,11,2018,9,2
Group 5,RRG,1.5,18,14,2803,13,2018,12,1
Group 5,RRG,1.5,18,14,2804,12,2018,13,-1
Group 5,RRG,1.5,18,14,2805,13,2018,10,3
Group 5,RRG,1.5,18,14,2806,10,2018,12,-2
Group 5,RRG,1.5,18,14,2807,13,2018,14,-1
Group 5,RRG,1.5,18,14,2808,12,2018,11,1
Group 5,RRG,1.5,18,14,2809,11,2018,13,-2
Group 5,RRG,1.5,18,14,2810,8,2018,6,2
Group 5,RRG,1.5,18,14,2811,9,2018,6,3
Group 5,RRG,1.5,18,14,2812,10,2018,11,-1
Group 5,RRG,1.5,18,14,2813,11,2018,6,5
Group 5,RRG,1.5,18,14,2814,12,2018,13,-1
Group 5,RRG,1.5,18,14,2815,13,2018,14,-1
Group 5,RRG,1.5,18,14,2816,10,2018,10,0
Group 5,RRG,1.5,18,14,2817,11,2018,4,7
Group 5,RRG,1.5,18,14,2818,12,2018,10,2
Group 5,RRG,1.5,18,14,2819,12,2018,12,0
Group 5,RRG,1.5,18,14,2820,14,2018,11,3
Group 5,RRG,1.5,18,14,2821,14,2018,9,5
Group 5,RRG,1.5,18,14,2822,14,2018,12,2
Group 5,RRG,1.5,18,14,2823,11,2018,8,3
Group 5,RRG,1.5,18,14,2824,9,2018,13,-4
Group 5,RRG,1.5,18,14,2825,10,2018,12,-2
Group 5,RRG,1.5,18,14,2826,9,2018,12,-3
Group 5,RRG,1.5,18,14,2827,10,2018,8,2
Group 5,RRG,1.5,18,14,2828,8,2018,13,-5
Group 5,RRG,1.5,18,14,2829,11,2018,12,-1
Group 5,RRG,1.5,18,14,2830,10,2018,10,0
Group 5,RRG,1.5,18,14,2831,14,2018,10,4
Group 5,RRG,1.5,18,14,2832,10,2018,12,-2
Group 5,RRG,1.5,18,14,2833,9,2018,11,-2
Group 5,RRG,1.5,18,14,2834,13,2018,12,1
Group 5,RRG,1.5,18,14,2835,9,2018,10,-1
Group 5,RRG,1.5,18,14,2836,8,2018,9,-1
Group 5,RRG,1.5,18,14,2837,9,2018,11,-2
Group 5,RRG,1.5,18,14,2838,10,2018,13,-3
Group 5,RRG,1.5,18,14,2839,9,2018,10,-1
Group 5,RRG,1.5,18,14,2840,13,2018,9,4
Group 5,RRG,1.5,18,14,2841,13,2018,10,3
Group 5,RRG,1.5,18,14,2842,11,2018,13,-2
Group 5,RRG,1.5,18,14,2843,10,2018,11,-1
Group 5,RRG,1.5,18,14,2844,12,2018,14,-2
Group 5,RRG,1.5,18,14,2845,8,2018,13,-5
Group 5,RRG,1.5,18,14,2846,7,2018,14,-7
Group 5,RRG,1.5,18,14,2847,9,2018,13,-4
Group 5,RRG,1.5,18,14,2848,11,2018,11,0
Group 5,RRG,1.5,18,14,2849,13,2018,10,3
Group 5,RRG,1.5,18,14,2850,12,2018,8,4
Group 5,RRG,1.5,18,14,2851,12,2018,13,-1
Group 5,RRG,1.5,18,14,2852,13,2018,13,0
Group 5,RRG,1.5,18,14,2853,10,2018,13,-3
Group 5,RRG,1.5,18,14,2854,10,2018,10,0
Group 5,RRG,1.5,18,14,2855,11,2018,11,0
Group 5,RRG,1.5,18,14,2856,11,2018,13,-2
Group 5,RRG,1.5,18,14,2857,13,2018,8,5
Group 5,RRG,1.5,18,14,2858,12,2018,13,-1
Group 5,RRG,1.5,18,14,2859,12,2018,11,1
Group 5,RRG,1.5,18,14,2860,10,2018,9,1
Group 5,RRG,1.5,18,14,2861,12,2018,9,3
Group 5,RRG,1.5,18,14,2862,14,2018,13,1
Group 5,RRG,1.5,18,14,2863,10,2018,10,0
Group 5,RRG,1.5,18,14,2864,12,2018,11,1
Group 5,RRG,1.5,18,14,2865,14,2018,14,0
Group 5,RRG,1.5,18,14,2866,7,2018,8,-1
Group 5,RRG,1.5,18,14,2867,12,2018,11,1
Group 5,RRG,1.5,18,14,2868,13,2018,9,4
Group 5,RRG,1.5,18,14,2869,11,2018,13,-2
Group 5,RRG,1.5,18,14,2870,14,2018,13,1
Group 5,RRG,1.5,18,14,2871,13,2018,13,0
Group 5,RRG,1.5,18,14,2872,12,2018,8,4
Group 5,RRG,1.5,18,14,2873,13,2018,8,5
Group 5,RRG,1.5,18,14,2874,10,2018,12,-2
Group 5,RRG,1.5,18,14,2875,10,2018,11,-1
Group 5,RRG,1.5,18,14,2876,11,2018,12,-1
Group 5,RRG,1.5,18,14,2877,12,2018,13,-1
Group 5,RRG,1.5,18,14,2878,2,2018,13,-11
Group 5,RRG,1.5,18,14,2879,8,2018,13,-5
Group 5,RRG,1.5,18,14,2880,9,2018,10,-1
Group 5,RRG,1.5,18,14,2881,12,2018,11,1
Group 5,RRG,1.5,18,14,2882,7,2018,10,-3
Group 5,RRG,1.5,18,14,2883,8,2018,11,-3
Group 5,RRG,1.5,18,14,2884,14,2018,11,3
Group 5,RRG,1.5,18,14,2885,9,2018,9,0
Group 5,RRG,1.5,18,14,2886,12,2018,14,-2
Group 5,RRG,1.5,18,14,2887,10,2018,12,-2
Group 5,RRG,1.5,18,14,2888,12,2018,8,4
Group 5,RRG,1.5,18,14,2889,12,2018,11,1
Group 5,RRG,1.5,18,14,2890,12,2018,14,-2
Group 5,RRG,1.5,18,14,2891,12,2018,11,1
Group 5,RRG,1.5,18,14,2892,9,2018,12,-3
Group 5,RRG,1.5,18,14,2893,9,2018,10,-1
Group 5,RRG,1.5,18,14,2894,11,2018,14,-3
Group 5,RRG,1.5,18,14,2895,8,2018,13,-5
Group 5,RRG,1.5,18,14,2896,6,2018,11,-5
Group 5,RRG,1.5,18,14,2897,12,2018,12,0
Group 5,RRG,1.5,18,14,2898,11,2018,8,3
Group 5,RRG,1.5,18,14,2899,10,2018,10,0
Group 5,RRG,1.5,18,14,2900,14,2018,10,4
Group 5,RRG,1.5,18,14,2901,11,2018,10,1
Group 5,RRG,1.5,18,14,2902,10,2018,11,-1
Group 5,RRG,1.5,18,14,2903,11,2018,7,4
Group 5,RRG,1.5,18,14,2904,13,2018,13,0
Group 5,RRG,1.5,18,14,2905,11,2018,12,-1
Group 5,RRG,1.5,18,14,2906,8,2018,12,-4
Group 5,RRG,1.5,18,14,2907,10,2018,10,0
Group 5,RRG,1.5,18,14,2908,13,2018,10,3
Group 5,RRG,1.5,18,14,2909,11,2018,8,3
Group 5,RRG,1.5,18,14,2910,12,2018,10,2
Group 5,RRG,1.5,18,14,2911,12,2018,12,0
Group 5,RRG,1.5,18,14,2912,14,2018,12,2
Group 5,RRG,1.5,18,14,2913,8,2018,9,-1
Group 5,RRG,1.5,18,14,2914,13,2018,11,2
Group 5,RRG,1.5,18,14,2915,11,2018,10,1
Group 5,RRG,1.5,18,14,2916,13,2018,12,1
Group 5,RRG,1.5,18,14,2917,9,2018,12,-3
Group 5,RRG,1.5,18,14,2918,12,2018,13,-1
Group 5,RRG,1.5,18,14,2919,12,2018,14,-2
Group 5,RRG,1.5,18,14,2920,12,2018,12,0
Group 5,RRG,1.5,18,14,2921,11,2018,12,-1
Group 5,RRG,1.5,18,14,2922,11,2018,8,3
Group 5,RRG,1.5,18,14,2923,11,2018,9,2
Group 5,RRG,1.5,18,14,2924,12,2018,9,3
Group 5,RRG,1.5,18,14,2925,12,2018,14,-2
Group 5,RRG,1.5,18,14,2926,13,2018,12,1
Group 5,RRG,1.5,18,14,2927,14,2018,11,3
Group 5,RRG,1.5,18,14,2928,13,2018,11,2
Group 5,RRG,1.5,18,14,2929,11,2018,11,0
Group 5,RRG,1.5,18,14,2930,10,2018,10,0
Group 5,RRG,1.5,18,14,2931,8,2018,14,-6
Group 5,RRG,1.5,18,14,2932,7,2018,9,-2
Group 5,RRG,1.5,18,14,2933,12,2018,12,0
Group 5,RRG,1.5,18,14,2934,14,2018,13,1
Group 5,RRG,1.5,18,14,2935,10,2018,11,-1
Group 5,RRG,1.5,18,14,2936,13,2018,11,2
Group 5,RRG,1.5,18,14,2937,12,2018,11,1
Group 5,RRG,1.5,18,14,2938,12,2018,12,0
Group 5,RRG,1.5,18,14,2939,11,2018,10,1
Group 5,RRG,1.5,18,14,2940,12,2018,12,0
Group 5,RRG,1.5,18,14,2941,11,2018,13,-2
Group 5,RRG,1.5,18,14,2942,12,2018,12,0
Group 5,RRG,1.5,18,14,2943,10,2018,10,0
Group 5,RRG,1.5,18,14,2944,11,2018,10,1
Group 5,RRG,1.5,18,14,2945,10,2018,11,-1
Group 5,RRG,1.5,18,14,2946,13,2018,12,1
Group 5,RRG,1.5,18,14,2947,9,2018,13,-4
Group 5,RRG,1.5,18,14,2948,13,2018,11,2
Group 5,RRG,1.5,18,14,2949,11,2018,10,1
Group 5,RRG,1.5,18,14,2950,14,2018,13,1
Group 5,RRG,1.5,18,14,2951,11,2018,9,2
Group 5,RRG,1.5,18,14,2952,12,2018,9,3
Group 5,RRG,1.5,18,14,2953,14,2018,12,2
Group 5,RRG,1.5,18,14,2954,11,2018,5,6
Group 5,RRG,1.5,18,14,2955,11,2018,11,0
Group 5,RRG,1.5,18,14,2956,14,2018,11,3
Group 5,RRG,1.5,18,14,2957,12,2018,12,0
Group 5,RRG,1.5,18,14,2958,13,2018,11,2
Group 5,RRG,1.5,18,14,2959,13,2018,13,0
Group 5,RRG,1.5,18,14,2960,11,2018,8,3
Group 5,RRG,1.5,18,14,2961,14,2018,8,6
Group 5,RRG,1.5,18,14,2962,9,2018,11,-2
Group 5,RRG,1.5,18,14,2963,10,2018,14,-4
Group 5,RRG,1.5,18,14,2964,12,2018,13,-1
Group 5,RRG,1.5,18,14,2965,10,2018,11,-1
Group 5,RRG,1.5,18,14,2966,9,2018,12,-3
Group 5,RRG,1.5,18,14,2967,12,2018,11,1
Group 5,RRG,1.5,18,14,2968,5,2018,14,-9
Group 5,RRG,1.5,18,14,2969,12,2018,13,-1
Group 5,RRG,1.5,18,14,2970,14,2018,9,5
Group 5,RRG,1.5,18,14,2971,12,2018,14,-2
Group 5,RRG,1.5,18,14,2972,11,2018,14,-3
Group 5,RRG,1.5,18,14,2973,14,2018,13,1
Group 5,RRG,1.5,18,14,2974,11,2018,13,-2
Group 5,RRG,1.5,18,14,2975,12,2018,10,2
Group 5,RRG,1.5,18,14,2976,8,2018,13,-5
Group 5,RRG,1.5,18,14,2977,9,2018,12,-3
Group 5,RRG,1.5,18,14,2978,9,2018,8,1
Group 5,RRG,1.5,18,14,2979,12,2018,11,1
Group 5,RRG,1.5,18,14,2980,9,2018,11,-2
Group 5,RRG,1.5,18,14,2981,12,2018,7,5
Group 5,RRG,1.5,18,14,2982,13,2018,8,5
Group 5,RRG,1.5,18,14,2983,11,2018,10,1
Group 5,RRG,1.5,18,14,2984,11,2018,8,3
Group 5,RRG,1.5,18,14,2985,11,2018,12,-1
Group 5,RRG,1.5,18,14,2986,13,2018,13,0
Group 5,RRG,1.5,18,14,2987,13,2018,8,5
Group 5,RRG,1.5,18,14,2988,12,2018,8,4
Group 5,RRG,1.5,18,14,2989,12,2018,13,-1
Group 5,RRG,1.5,18,14,2990,9,2018,10,-1
Group 5,RRG,1.5,18,14,2991,9,2018,9,0
Group 5,RRG,1.5,18,14,2992,11,2018,13,-2
Group 5,RRG,1.5,18,14,2993,14,2018,11,3
Group 5,RRG,1.5,18,14,2994,11,2018,12,-1
Group 5,RRG,1.5,18,14,2995,11,2018,12,-1
Group 5,RRG,1.5,18,14,2996,13,2018,10,3
Group 5,RRG,1.5,18,14,2997,10,2018,9,1
Group 5,RRG,1.5,18,14,2998,14,2018,10,4
Group 5,RRG,1.5,18,14,2999,12,2018,14,-2
Group 5,RRG,1.5,18,14,3000,13,2018,12,1
Group 5,RRG,1.5,18,14,3001,7,2018,11,-4
Group 5,RRG,1.5,18,14,3002,12,2018,11,1
Group 5,RRG,1.5,18,14,3003,13,2018,12,1
Group 5,RRG,1.5,18,14,3004,11,2018,11,0
Group 5,RRG,1.5,18,14,3005,11,2018,12,-1
Group 5,RRG,1.5,18,14,3006,9,2018,12,-3
Group 5,RRG,1.5,18,14,3007,12,2018,10,2
Group 5,RRG,1.5,18,14,3008,11,2018,9,2
Group 5,RRG,1.5,18,14,3009,10,2018,14,-4
Group 5,RRG,1.5,18,14,3010,12,2018,12,0
Group 5,RRG,1.5,18,14,3011,12,2018,7,5
Group 5,RRG,1.5,18,14,3012,11,2018,12,-1
Group 5,RRG,1.5,18,14,3013,10,2018,12,-2
Group 5,RRG,1.5,18,14,3014,11,2018,11,0
Group 5,RRG,1.5,18,14,3015,11,2018,10,1
Group 5,RRG,1.5,18,14,3016,13,2018,14,-1
Group 5,RRG,1.5,18,14,3017,10,2018,10,0
Group 5,RRG,1.5,18,14,3018,10,2018,8,2
Group 5,RRG,1.5,18,14,3019,10,2018,12,-2
Group 5,RRG,1.5,18,14,3020,14,2018,14,0
Group 5,RRG,1.5,18,14,3021,13,2018,12,1
Group 5,RRG,1.5,18,14,3022,14,2018,10,4
Group 5,RRG,1.5,18,14,3023,13,2018,7,6
Group 5,RRG,1.5,18,14,3024,13,2018,11,2
Group 5,RRG,1.5,18,14,3025,13,2018,12,1
Group 5,RRG,1.5,18,14,3026,11,2018,10,1
Group 5,RRG,1.5,18,14,3027,13,2018,13,0
Group 5,RRG,1.5,18,14,3028,12,2018,12,0
Group 5,RRG,1.5,18,14,3029,13,2018,13,0
Group 5,RRG,1.5,18,14,3030,14,2018,6,8
Group 5,RRG,1.5,18,14,3031,11,2018,9,2
Group 5,RRG,1.5,18,14,3032,13,2018,10,3
Group 5,RRG,1.5,18,14,3033,13,2018,11,2
Group 5,RRG,1.5,18,14,3034,13,2018,10,3
Group 5,RRG,1.5,18,14,3035,10,2018,13,-3
Group 5,RRG,1.5,18,14,3036,11,2018,10,1
Group 5,RRG,1.5,18,14,3037,9,2018,11,-2
Group 5,RRG,1.5,18,14,3038,11,2018,12,-1
Group 5,RRG,1.5,18,14,3039,9,2018,14,-5
Group 5,RRG,1.5,18,14,3040,11,2018,12,-1
Group 5,RRG,1.5,18,14,3041,12,2018,10,2
Group 5,RRG,1.5,18,14,3042,12,2018,11,1
Group 5,RRG,1.5,18,14,3043,8,2018,13,-5
Group 5,RRG,1.5,18,14,3044,12,2018,12,0
Group 5,RRG,1.5,18,14,3045,13,2018,9,4
Group 5,RRG,1.5,18,14,3046,12,2018,10,2
Group 5,RRG,1.5,18,14,3047,11,2018,11,0
Group 5,RRG,1.5,18,14,3048,12,2018,13,-1
Group 5,RRG,1.5,18,14,3049,12,2018,11,1
Group 5,RRG,1.5,18,14,3050,12,2018,7,5
Group 5,RRG,1.5,18,14,3051,13,2018,11,2
Group 5,RRG,1.5,18,14,3052,11,2018,9,2
Group 5,RRG,1.5,18,14,3053,12,2018,10,2
Group 5,RRG,1.5,18,14,3054,13,2018,13,0
Group 5,RRG,1.5,18,14,3055,10,2018,12,-2
Group 5,RRG,1.5,18,14,3056,12,2018,9,3
Group 5,RRG,1.5,18,14,3057,8,2018,11,-3
Group 5,RRG,1.5,18,14,3058,9,2018,9,0
Group 5,RRG,1.5,18,14,3059,12,2018,11,1
Group 5,RRG,1.5,18,14,3060,13,2018,14,-1
Group 5,RRG,1.5,18,14,3061,8,2018,10,-2
Group 5,RRG,1.5,18,14,3062,14,2018,12,2
Group 5,RRG,1.5,18,14,3063,13,2018,6,7
Group 5,RRG,1.5,18,14,3064,11,2018,8,3
Group 5,RRG,1.5,18,14,3065,13,2018,12,1
Group 5,RRG,1.5,18,14,3066,9,2018,9,0
Group 5,RRG,1.5,18,14,3067,12,2018,12,0
Group 5,RRG,1.5,18,14,3068,11,2018,11,0
Group 5,RRG,1.5,18,14,3069,13,2018,13,0
Group 5,RRG,1.5,18,14,3070,12,2018,10,2
Group 5,RRG,1.5,18,14,3071,14,2018,13,1
Group 5,RRG,1.5,18,14,3072,13,2018,13,0
Group 5,RRG,1.5,18,14,3073,13,2018,11,2
Group 5,RRG,1.5,18,14,3074,14,2018,13,1
Group 5,RRG,1.5,18,14,3075,14,2018,8,6
Group 5,RRG,1.5,18,14,3076,8,2018,8,0
Group 5,RRG,1.5,18,14,3077,12,2018,8,4
Group 5,RRG,1.5,18,14,3078,8,2018,13,-5
Group 5,RRG,1.5,18,14,3079,12,2018,11,1
Group 5,RRG,1.5,18,14,3080,12,2018,12,0
Group 5,RRG,1.5,18,14,3081,14,2018,12,2
Group 5,RRG,1.5,18,14,3082,12,2018,11,1
Group 5,RRG,1.5,18,14,3083,7,2018,8,-1
Group 5,RRG,1.5,18,14,3084,12,2018,14,-2
Group 5,RRG,1.5,18,14,3085,11,2018,10,1
Group 5,RRG,1.5,18,14,3086,12,2018,10,2
Group 5,RRG,1.5,18,14,3087,9,2018,14,-5
Group 5,RRG,1.5,18,14,3088,13,2018,12,1
Group 5,RRG,1.5,18,14,3089,13,2018,9,4
Group 5,RRG,1.5,18,14,3090,11,2018,10,1
Group 5,RRG,1.5,18,14,3091,14,2018,12,2
Group 5,RRG,1.5,18,14,3092,14,2018,11,3
Group 5,RRG,1.5,18,14,3093,10,2018,10,0
Group 5,RRG,1.5,18,14,3094,12,2018,12,0
Group 5,RRG,1.5,18,14,3095,13,2018,10,3
Group 5,RRG,1.5,18,14,3096,14,2018,11,3
Group 5,RRG,1.5,18,14,3097,14,2018,14,0
Group 5,RRG,1.5,18,14,3098,12,2018,11,1
Group 5,RRG,1.5,18,14,3099,13,2018,8,5
Group 5,RRG,1.5,18,14,3100,13,2018,9,4
Group 5,RRG,1.5,18,14,3101,10,2018,13,-3
Group 5,RRG,1.5,18,14,3102,11,2018,10,1
Group 5,RRG,1.5,18,14,3103,13,2018,11,2
Group 5,RRG,1.5,18,14,3104,4,2018,12,-8
Group 5,RRG,1.5,18,14,3105,11,2018,13,-2
Group 5,RRG,1.5,18,14,3106,13,2018,10,3
Group 5,RRG,1.5,18,14,3107,11,2018,13,-2
Group 5,RRG,1.5,18,14,3108,12,2018,13,-1
Group 5,RRG,1.5,18,14,3109,14,2018,11,3
Group 5,RRG,1.5,18,14,3110,13,2018,10,3
Group 5,RRG,1.5,18,14,3111,12,2018,11,1
Group 5,RRG,1.5,18,14,3112,10,2018,11,-1
Group 5,RRG,1.5,18,14,3113,10,2018,8,2
Group 5,RRG,1.5,18,14,3114,9,2018,10,-1
Group 5,RRG,1.5,18,14,3115,13,2018,11,2
Group 5,RRG,1.5,18,14,3116,12,2018,10,2
Group 5,RRG,1.5,18,14,3117,8,2018,10,-2
Group 5,RRG,1.5,18,14,3118,12,2018,11,1
Group 5,RRG,1.5,18,14,3119,12,2018,13,-1
Group 5,RRG,1.5,18,14,3120,12,2018,12,0
Group 5,RRG,1.5,18,14,3121,11,2018,13,-2
Group 5,RRG,1.5,18,14,3122,14,2018,6,8
Group 5,RRG,1.5,18,14,3123,13,2018,10,3
Group 5,RRG,1.5,18,14,3124,13,2018,10,3
Group 5,RRG,1.5,18,14,3125,10,2018,14,-4
Group 5,RRG,1.5,18,14,3126,12,2018,10,2
Group 5,RRG,1.5,18,14,3127,12,2018,9,3
Group 5,RRG,1.5,18,14,3128,8,2018,11,-3
Group 5,RRG,1.5,18,14,3129,9,2018,8,1
Group 5,RRG,1.5,18,14,3130,9,2018,11,-2
Group 5,RRG,1.5,18,14,3131,14,2018,13,1
Group 5,RRG,1.5,18,14,3132,12,2018,13,-1
Group 5,RRG,1.5,18,14,3133,12,2018,10,2
Group 5,RRG,1.5,18,14,3134,13,2018,10,3
Group 5,RRG,1.5,18,14,3135,9,2018,11,-2
Group 5,RRG,1.5,18,14,3136,12,2018,8,4
Group 5,RRG,1.5,18,14,3137,13,2018,14,-1
Group 5,RRG,1.5,18,14,3138,12,2018,9,3
Group 5,RRG,1.5,18,14,3139,14,2018,10,4
Group 5,RRG,1.5,18,14,3140,14,2018,9,5
Group 5,RRG,1.5,18,14,3141,10,2018,10,0
Group 5,RRG,1.5,18,14,3142,14,2018,8,6
Group 5,RRG,1.5,18,14,3143,11,2018,12,-1
Group 5,RRG,1.5,18,14,3144,13,2018,10,3
Group 5,RRG,1.5,18,14,3145,14,2018,14,0
Group 5,RRG,1.5,18,14,3146,13,2018,12,1
Group 5,RRG,1.5,18,14,3147,11,2018,12,-1
Group 5,RRG,1.5,18,14,3148,13,2018,12,1
Group 5,RRG,1.5,18,14,3149,13,2018,11,2
Group 5,RRG,1.5,18,14,3150,14,2018,12,2
Group 5,RRG,1.5,18,14,3151,14,2018,11,3
Group 5,RRG,1.5,18,14,3152,9,2018,11,-2
Group 5,RRG,1.5,18,14,3153,12,2018,10,2
Group 5,RRG,1.5,18,14,3154,13,2018,12,1
Group 5,RRG,1.5,18,14,3155,12,2018,13,-1
Group 5,RRG,1.5,18,14,3156,9,2018,13,-4
Group 5,RRG,1.5,18,14,3157,14,2018,13,1
Group 5,RRG,1.5,18,14,3158,13,2018,9,4
Group 5,RRG,1.5,18,14,3159,11,2018,13,-2
Group 5,RRG,1.5,18,14,3160,9,2018,12,-3
Group 5,RRG,1.5,18,14,3161,13,2018,10,3
Group 5,RRG,1.5,18,14,3162,11,2018,10,1
Group 5,RRG,1.5,18,14,3163,12,2018,11,1
Group 5,RRG,1.5,18,14,3164,13,2018,11,2
Group 5,RRG,1.5,18,14,3165,12,2018,9,3
Group 5,RRG,1.5,18,14,3166,10,2018,12,-2
Group 5,RRG,1.5,18,14,3167,13,2018,8,5
Group 5,RRG,1.5,18,14,3168,14,2018,11,3
Group 5,RRG,1.5,18,14,3169,6,2018,14,-8
Group 5,RRG,1.5,18,14,3170,11,2018,12,-1
Group 5,RRG,1.5,18,14,3171,14,2018,12,2
Group 5,RRG,1.5,18,14,3172,12,2018,9,3
Group 5,RRG,1.5,18,14,3173,14,2018,10,4
Group 5,RRG,1.5,18,14,3174,9,2018,10,-1
Group 5,RRG,1.5,18,14,3175,4,2018,12,-8
Group 5,RRG,1.5,18,14,3176,5,2018,13,-8
Group 5,RRG,1.5,18,14,3177,4,2018,10,-6
Group 5,RRG,1.5,18,14,3178,10,2018,12,-2
Group 5,RRG,1.5,18,14,3179,12,2018,13,-1
Group 5,RRG,1.5,18,14,3180,11,2018,11,0
Group 5,RRG,1.5,18,14,3181,11,2018,11,0
Group 5,RRG,1.5,18,14,3182,10,2018,10,0
Group 5,RRG,1.5,18,14,3183,12,2018,13,-1
Group 5,RRG,1.5,18,14,3184,10,2018,11,-1
Group 5,RRG,1.5,18,14,3185,11,2018,10,1
Group 5,RRG,1.5,18,14,3186,10,2018,13,-3
Group 5,RRG,1.5,18,14,3187,10,2018,9,1
Group 5,RRG,1.5,18,14,3188,10,2018,10,0
Group 5,RRG,1.5,18,14,3189,14,2018,10,4
Group 5,RRG,1.5,18,14,3190,9,2018,13,-4
Group 5,RRG,1.5,18,14,3191,8,2018,12,-4
Group 5,RRG,1.5,18,14,3192,8,2018,10,-2
Group 5,RRG,1.5,18,14,3193,9,2018,13,-4
Group 5,RRG,1.5,18,14,3194,7,2018,13,-6
Group 5,RRG,1.5,18,14,3195,13,2018,12,1
Group 5,RRG,1.5,18,14,3196,12,2018,11,1
Group 5,RRG,1.5,18,14,3197,12,2018,10,2
Group 5,RRG,1.5,18,14,3198,13,2018,10,3
Group 5,RRG,1.5,18,14,3199,10,2018,10,0
Group 5,RRG,1.5,18,14,3200,14,2018,9,5
Group 5,RRG,1.5,18,14,3201,12,2018,11,1
Group 5,RRG,1.5,18,14,3202,10,2018,12,-2
Group 5,RRG,1.5,18,14,3203,13,2018,10,3
Group 5,RRG,1.5,18,14,3204,8,2018,12,-4
Group 5,RRG,1.5,18,14,3205,13,2018,9,4
Group 5,RRG,1.5,18,14,3206,12,2018,11,1
Group 5,RRG,1.5,18,14,3207,13,2018,10,3
Group 5,RRG,1.5,18,14,3208,14,2018,7,7
Group 5,RRG,1.5,18,14,3209,10,2018,11,-1
Group 5,RRG,1.5,18,14,3210,11,2018,7,4
Group 5,RRG,1.5,18,14,3211,13,2018,14,-1
Group 5,RRG,1.5,18,14,3212,12,2018,9,3
Group 5,RRG,1.5,18,14,3213,13,2018,13,0
Group 5,RRG,1.5,18,14,3214,8,2018,11,-3
Group 5,RRG,1.5,18,14,3215,13,2018,11,2
Group 5,RRG,1.5,18,14,3216,10,2018,8,2
Group 5,RRG,1.5,18,14,3217,13,2018,12,1
Group 5,RRG,1.5,18,14,3218,11,2018,13,-2
Group 5,RRG,1.5,18,14,3219,11,2018,9,2
Group 5,RRG,1.5,18,14,3220,14,2018,7,7
Group 5,RRG,1.5,18,14,3221,12,2018,12,0
Group 5,RRG,1.5,18,14,3222,12,2018,9,3
Group 5,RRG,1.5,18,14,3223,13,2018,12,1
Group 5,RRG,1.5,18,14,3224,10,2018,12,-2
Group 5,RRG,1.5,18,14,3225,13,2018,11,2
Group 5,RRG,1.5,18,14,3226,14,2018,12,2
Group 5,RRG,1.5,18,14,3227,11,2018,13,-2
Group 5,RRG,1.5,18,14,3228,12,2018,12,0
Group 5,RRG,1.5,18,14,3229,11,2018,13,-2
Group 5,RRG,1.5,18,14,3230,10,2018,9,1
Group 5,RRG,1.5,18,14,3231,12,2018,11,1
Group 5,RRG,1.5,18,14,3232,14,2018,14,0
Group 5,RRG,1.5,18,14,3233,10,2018,12,-2
Group 5,RRG,1.5,18,14,3234,11,2018,12,-1
Group 5,RRG,1.5,18,14,3235,11,2018,11,0
Group 5,RRG,1.5,18,14,3236,11,2018,13,-2
Group 5,RRG,1.5,18,14,3237,9,2018,13,-4
Group 5,RRG,1.5,18,14,3238,13,2018,11,2
Group 5,RRG,1.5,18,14,3239,12,2018,12,0
Group 5,RRG,1.5,18,14,3240,13,2018,11,2
Group 5,RRG,1.5,18,14,3241,10,2018,11,-1
Group 5,RRG,1.5,18,14,3242,11,2018,13,-2
Group 5,RRG,1.5,18,14,3243,11,2018,10,1
Group 5,RRG,1.5,18,14,3244,12,2018,11,1
Group 5,RRG,1.5,18,14,3245,10,2018,14,-4
Group 5,RRG,1.5,18,14,3246,11,2018,12,-1
Group 5,RRG,1.5,18,14,3247,7,2018,13,-6
Group 5,RRG,1.5,18,14,3248,11,2018,9,2
Group 5,RRG,1.5,18,14,3249,12,2018,13,-1
Group 5,RRG,1.5,18,14,3250,14,2018,14,0
Group 5,RRG,1.5,18,14,3251,11,2018,12,-1
Group 5,RRG,1.5,18,14,3252,13,2018,13,0
Group 5,RRG,1.5,18,14,3253,13,2018,11,2
Group 5,RRG,1.5,18,14,3254,11,2018,8,3
Group 5,RRG,1.5,18,14,3255,11,2018,13,-2
Group 5,RRG,1.5,18,14,3256,10,2018,10,0
Group 5,RRG,1.5,18,14,3257,11,2018,11,0
Group 5,RRG,1.5,18,14,3258,8,2018,10,-2
Group 5,RRG,1.5,18,14,3259,14,2018,10,4
Group 5,RRG,1.5,18,14,3260,14,2018,4,10
Group 5,RRG,1.5,18,14,3261,13,2018,10,3
Group 5,RRG,1.5,18,14,3262,9,2018,10,-1
Group 5,RRG,1.5,18,14,3263,10,2018,8,2
Group 5,RRG,1.5,18,14,3264,12,2018,9,3
Group 5,RRG,1.5,18,14,3265,14,2018,9,5
Group 5,RRG,1.5,18,14,3266,11,2018,9,2
Group 5,RRG,1.5,18,14,3267,11,2018,12,-1
Group 5,RRG,1.5,18,14,3268,7,2018,11,-4
Group 5,RRG,1.5,18,14,3269,12,2018,11,1
Group 5,RRG,1.5,18,14,3270,11,2018,12,-1
Group 5,RRG,1.5,18,14,3271,13,2018,11,2
Group 5,RRG,1.5,18,14,3272,9,2018,14,-5
Group 5,RRG,1.5,18,14,3273,8,2018,13,-5
Group 5,RRG,1.5,18,14,3274,11,2018,12,-1
Group 5,RRG,1.5,18,14,3275,13,2018,13,0
Group 5,RRG,1.5,18,14,3276,11,2018,13,-2
Group 5,RRG,1.5,18,14,3277,12,2018,9,3
Group 5,RRG,1.5,18,14,3278,12,2018,13,-1
Group 5,RRG,1.5,18,14,3279,11,2018,11,0
Group 5,RRG,1.5,18,14,3280,8,2018,7,1
Group 5,RRG,1.5,18,14,3281,7,2018,12,-5
Group 5,RRG,1.5,18,14,3282,10,2018,10,0
Group 5,RRG,1.5,18,14,3283,9,2018,11,-2
Group 5,RRG,1.5,18,14,3284,12,2018,13,-1
Group 5,RRG,1.5,18,14,3285,13,2018,13,0
Group 5,RRG,1.5,18,14,3286,14,2018,10,4
Group 5,RRG,1.5,18,14,3287,12,2018,11,1
Group 5,RRG,1.5,18,14,3288,13,2018,13,0
Group 5,RRG,1.5,18,14,3289,10,2018,13,-3
Group 5,RRG,1.5,18,14,3290,13,2018,8,5
Group 5,RRG,1.5,18,14,3291,10,2018,6,4
Group 5,RRG,1.5,18,14,3292,11,2018,5,6
Group 5,RRG,1.5,18,14,3293,10,2018,11,-1
Group 5,RRG,1.5,18,14,3294,13,2018,11,2
Group 5,RRG,1.5,18,14,3295,10,2018,11,-1
Group 5,RRG,1.5,18,14,3296,11,2018,10,1
Group 5,RRG,1.5,18,14,3297,9,2018,10,-1
Group 5,RRG,1.5,18,14,3298,12,2018,14,-2
Group 5,RRG,1.5,18,14,3299,14,2018,11,3
Group 5,RRG,1.5,18,14,3300,14,2018,14,0
Group 5,RRG,1.5,18,14,3301,14,2018,7,7
Group 5,RRG,1.5,18,14,3302,12,2018,14,-2
Group 5,RRG,1.5,18,14,3303,11,2018,8,3
Group 5,RRG,1.5,18,14,3304,12,2018,10,2
Group 5,RRG,1.5,18,14,3305,14,2018,6,8
Group 5,RRG,1.5,18,14,3306,14,2018,8,6
Group 5,RRG,1.5,18,14,3307,9,2018,14,-5
Group 5,RRG,1.5,18,14,3308,11,2018,9,2
Group 5,RRG,1.5,18,14,3309,10,2018,13,-3
Group 5,RRG,1.5,18,14,3310,11,2018,14,-3
Group 5,RRG,1.5,18,14,3311,13,2018,11,2
Group 5,RRG,1.5,18,14,3312,12,2018,8,4
Group 5,RRG,1.5,18,14,3313,13,2018,10,3
Group 5,RRG,1.5,18,14,3314,13,2018,8,5
Group 5,RRG,1.5,18,14,3315,10,2018,10,0
Group 5,RRG,1.5,18,14,3316,13,2018,12,1
Group 5,RRG,1.5,18,14,3317,10,2018,10,0
Group 5,RRG,1.5,18,14,3318,13,2018,10,3
Group 5,RRG,1.5,18,14,3319,11,2018,12,-1
Group 5,RRG,1.5,18,14,3320,10,2018,11,-1
Group 5,RRG,1.5,18,14,3321,12,2018,9,3
Group 5,RRG,1.5,18,14,3322,11,2018,11,0
Group 5,RRG,1.5,18,14,3323,11,2018,11,0
Group 5,RRG,1.5,18,14,3324,10,2018,9,1
Group 5,RRG,1.5,18,14,3325,14,2018,11,3
Group 5,RRG,1.5,18,14,3326,11,2018,9,2
Group 5,RRG,1.5,18,14,3327,13,2018,13,0
Group 5,RRG,1.5,18,14,3328,14,2018,11,3
Group 5,RRG,1.5,18,14,3329,10,2018,12,-2
Group 5,RRG,1.5,18,14,3330,12,2018,12,0
Group 5,RRG,1.5,18,14,3331,12,2018,8,4
Group 5,RRG,1.5,18,14,3332,10,2018,10,0
Group 5,RRG,1.5,18,14,3333,9,2018,10,-1
Group 5,RRG,1.5,18,14,3334,13,2018,8,5
Group 5,RRG,1.5,18,14,3335,14,2018,8,6
Group 5,RRG,1.5,18,14,3336,11,2018,11,0
Group 5,RRG,1.5,18,14,3337,11,2018,9,2
Group 5,RRG,1.5,18,14,3338,8,2018,10,-2
Group 5,RRG,1.5,18,14,3339,10,2018,9,1
Group 5,RRG,1.5,18,14,3340,12,2018,10,2
Group 5,RRG,1.5,18,14,3341,10,2018,10,0
Group 5,RRG,1.5,18,14,3342,11,2018,8,3
Group 5,RRG,1.5,18,14,3343,12,2018,12,0
Group 5,RRG,1.5,18,14,3344,13,2018,9,4
Group 5,RRG,1.5,18,14,3345,12,2018,10,2
Group 5,RRG,1.5,18,14,3346,13,2018,11,2
Group 5,RRG,1.5,18,14,3347,6,2018,10,-4
Group 5,RRG,1.5,18,14,3348,12,2018,9,3
Group 5,RRG,1.5,18,14,3349,14,2018,13,1
Group 5,RRG,1.5,18,14,3350,12,2018,11,1
Group 5,RRG,1.5,18,14,3351,10,2018,9,1
Group 5,RRG,1.5,18,14,3352,11,2018,11,0
Group 5,RRG,1.5,18,14,3353,12,2018,11,1
Group 5,RRG,1.5,18,14,3354,11,2018,12,-1
Group 5,RRG,1.5,18,14,3355,11,2018,12,-1
Group 5,RRG,1.5,18,14,3356,13,2018,8,5
Group 5,RRG,1.5,18,14,3357,10,2018,11,-1
Group 5,RRG,1.5,18,14,3358,12,2018,7,5
Group 5,RRG,1.5,18,14,3359,13,2018,12,1
Group 5,RRG,1.5,18,14,3360,12,2018,9,3
Group 5,RRG,1.5,18,14,3361,5,2018,14,-9
Group 5,RRG,1.5,18,14,3362,11,2018,11,0
Group 5,RRG,1.5,18,14,3363,11,2018,11,0
Group 5,RRG,1.5,18,14,3364,13,2018,8,5
Group 5,RRG,1.5,18,14,3365,12,2018,13,-1
Group 5,RRG,1.5,18,14,3366,14,2018,12,2
Group 5,RRG,1.5,18,14,3367,11,2018,11,0
Group 5,RRG,1.5,18,14,3368,10,2018,9,1
Group 5,RRG,1.5,18,14,3369,10,2018,13,-3
Group 5,RRG,1.5,18,14,3370,7,2018,10,-3
Group 5,RRG,1.5,18,14,3371,10,2018,12,-2
Group 5,RRG,1.5,18,14,3372,9,2018,10,-1
Group 5,RRG,1.5,18,14,3373,13,2018,12,1
Group 5,RRG,1.5,18,14,3374,11,2018,11,0
Group 5,RRG,1.5,18,14,3375,10,2018,11,-1
Group 5,RRG,1.5,18,14,3376,9,2018,12,-3
Group 5,RRG,1.5,18,14,3377,13,2018,11,2
Group 5,RRG,1.5,18,14,3378,9,2018,14,-5
Group 5,RRG,1.5,18,14,3379,13,2018,7,6
Group 5,RRG,1.5,18,14,3380,9,2018,10,-1
Group 5,RRG,1.5,18,14,3381,13,2018,12,1
Group 5,RRG,1.5,18,14,3382,13,2018,12,1
Group 5,RRG,1.5,18,14,3383,14,2018,11,3
Group 5,RRG,1.5,18,14,3384,10,2018,11,-1
Group 5,RRG,1.5,18,14,3385,13,2018,11,2
Group 5,RRG,1.5,18,14,3386,11,2018,9,2
Group 5,RRG,1.5,18,14,3387,12,2018,12,0
Group 5,RRG,1.5,18,14,3388,13,2018,10,3
Group 5,RRG,1.5,18,14,3389,13,2018,9,4
Group 5,RRG,1.5,18,14,3390,8,2018,12,-4
Group 5,RRG,1.5,18,14,3391,8,2018,14,-6
Group 5,RRG,1.5,18,14,3392,10,2018,10,0
Group 5,RRG,1.5,18,14,3393,6,2018,11,-5
Group 5,RRG,1.5,18,14,3394,11,2018,13,-2
Group 5,RRG,1.5,18,14,3395,11,2018,12,-1
Group 5,RRG,1.5,18,14,3396,12,2018,12,0
Group 5,RRG,1.5,18,14,3397,13,2018,12,1
Group 5,RRG,1.5,18,14,3398,13,2018,12,1
Group 5,RRG,1.5,18,14,3399,13,2018,10,3
Group 5,RRG,1.5,18,14,3400,14,2018,14,0
Group 5,RRG,1.5,18,14,3401,12,2018,13,-1
Group 5,RRG,1.5,18,14,3402,13,2018,9,4
Group 5,RRG,1.5,18,14,3403,13,2018,7,6
Group 5,RRG,1.5,18,14,3404,12,2018,7,5
Group 5,RRG,1.5,18,14,3405,13,2018,9,4
Group 5,RRG,1.5,18,14,3406,11,2018,10,1
Group 5,RRG,1.5,18,14,3407,11,2018,11,0
Group 5,RRG,1.5,18,14,3408,9,2018,11,-2
Group 5,RRG,1.5,18,14,3409,12,2018,12,0
Group 5,RRG,1.5,18,14,3410,7,2018,11,-4
Group 5,RRG,1.5,18,14,3411,13,2018,12,1
Group 5,RRG,1.5,18,14,3412,13,2018,12,1
Group 5,RRG,1.5,18,14,3413,11,2018,11,0
Group 5,RRG,1.5,18,14,3414,10,2018,13,-3
Group 5,RRG,1.5,18,14,3415,11,2018,11,0
Group 5,RRG,1.5,18,14,3416,13,2018,11,2
Group 5,RRG,1.5,18,14,3417,12,2018,9,3
Group 5,RRG,1.5,18,14,3418,11,2018,10,1
Group 5,RRG,1.5,18,14,3419,10,2018,8,2
Group 5,RRG,1.5,18,14,3420,9,2018,9,0
Group 5,RRG,1.5,18,14,3421,9,2018,12,-3
Group 5,RRG,1.5,18,14,3422,11,2018,10,1
Group 5,RRG,1.5,18,14,3423,10,2018,12,-2
Group 5,RRG,1.5,18,14,3424,10,2018,14,-4
Group 5,RRG,1.5,18,14,3425,11,2018,12,-1
Group 5,RRG,1.5,18,14,3426,11,2018,9,2
Group 5,RRG,1.5,18,14,3427,11,2018,12,-1
Group 5,RRG,1.5,18,14,3428,11,2018,11,0
Group 5,RRG,1.5,18,14,3429,11,2018,11,0
Group 5,RRG,1.5,18,14,3430,12,2018,11,1
Group 5,RRG,1.5,18,14,3431,10,2018,9,1
Group 5,RRG,1.5,18,14,3432,12,2018,9,3
Group 5,RRG,1.5,18,14,3433,8,2018,10,-2
Group 5,RRG,1.5,18,14,3434,9,2018,12,-3
Group 5,RRG,1.5,18,14,3435,12,2018,12,0
Group 5,RRG,1.5,18,14,3436,14,2018,8,6
Group 5,RRG,1.5,18,14,3437,12,2018,11,1
Group 5,RRG,1.5,18,14,3438,13,2018,10,3
Group 5,RRG,1.5,18,14,3439,11,2018,12,-1
Group 5,RRG,1.5,18,14,3440,9,2018,12,-3
Group 5,RRG,1.5,18,14,3441,12,2018,11,1
Group 5,RRG,1.5,18,14,3442,12,2018,14,-2
Group 5,RRG,1.5,18,14,3443,12,2018,11,1
Group 5,RRG,1.5,18,14,3444,12,2018,12,0
Group 5,RRG,1.5,18,14,3445,11,2018,12,-1
Group 5,RRG,1.5,18,14,3446,13,2018,8,5
Group 5,RRG,1.5,18,14,3447,13,2018,11,2
Group 5,RRG,1.5,18,14,3448,13,2018,12,1
Group 5,RRG,1.5,18,14,3449,13,2018,11,2
Group 5,RRG,1.5,18,14,3450,13,2018,11,2
Group 5,RRG,1.5,18,14,3451,10,2018,9,1
Group 5,RRG,1.5,18,14,3452,13,2018,11,2
Group 5,RRG,1.5,18,14,3453,11,2018,10,1
Group 5,RRG,1.5,18,14,3454,13,2018,10,3
Group 5,RRG,1.5,18,14,3455,13,2018,13,0
Group 5,RRG,1.5,18,14,3456,14,2018,10,4
Group 5,RRG,1.5,18,14,3457,13,2018,10,3
Group 5,RRG,1.5,18,14,3458,12,2018,11,1
Group 5,RRG,1.5,18,14,3459,13,2018,13,0
Group 5,RRG,1.5,18,14,3460,8,2018,13,-5
Group 5,RRG,1.5,18,14,3461,13,2018,9,4
Group 5,RRG,1.5,18,14,3462,13,2018,10,3
Group 5,RRG,1.5,18,14,3463,12,2018,11,1
Group 5,RRG,1.5,18,14,3464,10,2018,11,-1
Group 5,RRG,1.5,18,14,3465,12,2018,8,4
Group 5,RRG,1.5,18,14,3466,14,2018,12,2
Group 5,RRG,1.5,18,14,3467,13,2018,9,4
Group 5,RRG,1.5,18,14,3468,12,2018,14,-2
Group 5,RRG,1.5,18,14,3469,12,2018,12,0
Group 5,RRG,1.5,18,14,3470,11,2018,13,-2
Group 5,RRG,1.5,18,14,3471,10,2018,11,-1
Group 5,RRG,1.5,18,14,3472,11,2018,10,1
Group 5,RRG,1.5,18,14,3473,12,2018,14,-2
Group 5,RRG,1.5,18,14,3474,11,2018,13,-2
Group 5,RRG,1.5,18,14,3475,14,2018,11,3
Group 5,RRG,1.5,18,14,3476,12,2018,13,-1
Group 5,RRG,1.5,18,14,3477,13,2018,14,-1
Group 5,RRG,1.5,18,14,3478,12,2018,12,0
Group 5,RRG,1.5,18,14,3479,11,2018,10,1
Group 5,RRG,1.5,18,14,3480,12,2018,13,-1
Group 5,RRG,1.5,18,14,3481,12,2018,9,3
Group 5,RRG,1.5,18,14,3482,8,2018,13,-5
Group 5,RRG,1.5,18,14,3483,9,2018,11,-2
Group 5,RRG,1.5,18,14,3484,12,2018,13,-1
Group 5,RRG,1.5,18,14,3485,7,2018,11,-4
Group 5,RRG,1.5,18,14,3486,13,2018,9,4
Group 5,RRG,1.5,18,14,3487,7,2018,12,-5
Group 5,RRG,1.5,18,14,3488,12,2018,7,5
Group 5,RRG,1.5,18,14,3489,14,2018,9,5
Group 5,RRG,1.5,18,14,3490,14,2018,11,3
Group 5,RRG,1.5,18,14,3491,12,2018,11,1
Group 5,RRG,1.5,18,14,3492,7,2018,8,-1
Group 5,RRG,1.5,18,14,3493,12,2018,13,-1
Group 5,RRG,1.5,18,14,3494,14,2018,13,1
Group 5,RRG,1.5,18,14,3495,11,2018,13,-2
Group 5,RRG,1.5,18,14,3496,12,2018,13,-1
Group 5,RRG,1.5,18,14,3497,12,2018,11,1
Group 5,RRG,1.5,18,14,3498,9,2018,12,-3
Group 5,RRG,1.5,18,14,3499,11,2018,14,-3
Group 5,RRG,1.5,18,14,3500,10,2018,12,-2
Group 5,RRG,1.5,18,14,3501,13,2018,8,5
Group 5,RRG,1.5,18,14,3502,12,2018,14,-2
Group 5,RRG,1.5,18,14,3503,11,2018,14,-3
Group 5,RRG,1.5,18,14,3504,12,2018,10,2
Group 5,RRG,1.5,18,14,3505,11,2018,6,5
Group 5,RRG,1.5,18,14,3506,14,2018,12,2
Group 5,RRG,1.5,18,14,3507,10,2018,8,2
Group 5,RRG,1.5,18,14,3508,12,2018,7,5
Group 5,RRG,1.5,18,14,3509,11,2018,11,0
Group 5,RRG,1.5,18,14,3510,2,2018,8,-6
Group 5,RRG,1.5,18,14,3511,10,2018,14,-4
Group 5,RRG,1.5,18,14,3512,13,2018,9,4
Group 5,RRG,1.5,18,14,3513,13,2018,10,3
Group 5,RRG,1.5,18,14,3514,8,2018,13,-5
Group 5,RRG,1.5,18,14,3515,13,2018,11,2
Group 5,RRG,1.5,18,14,3516,10,2018,12,-2
Group 5,RRG,1.5,18,14,3517,12,2018,12,0
Group 5,RRG,1.5,18,14,3518,10,2018,10,0
Group 5,RRG,1.5,18,14,3519,10,2018,8,2
Group 5,RRG,1.5,18,14,3520,6,2018,11,-5
Group 5,RRG,1.5,18,14,3521,8,2018,11,-3
Group 5,RRG,1.5,18,14,3522,5,2018,11,-6
Group 5,RRG,1.5,18,14,3523,9,2018,10,-1
Group 5,RRG,1.5,18,14,3524,12,2018,11,1
Group 5,RRG,1.5,18,14,3525,13,2018,12,1
Group 5,RRG,1.5,18,14,3526,9,2018,10,-1
Group 5,RRG,1.5,18,14,3527,6,2018,11,-5
Group 5,RRG,1.5,18,14,3528,10,2018,11,-1
Group 5,RRG,1.5,18,14,3529,11,2018,11,0
Group 5,RRG,1.5,18,14,3530,10,2018,11,-1
Group 5,RRG,1.5,18,14,3531,3,2018,11,-8
Group 5,RRG,1.5,18,14,3532,14,2018,14,0
Group 5,RRG,1.5,18,14,3533,10,2018,7,3
Group 5,RRG,1.5,18,14,3534,9,2018,10,-1
Group 5,RRG,1.5,18,14,3535,12,2018,14,-2
Group 5,RRG,1.5,18,14,3536,10,2018,14,-4
Group 5,RRG,1.5,18,14,3537,12,2018,12,0
Group 5,RRG,1.5,18,14,3538,11,2018,13,-2
Group 5,RRG,1.5,18,14,3539,9,2018,12,-3
Group 5,RRG,1.5,18,14,3540,11,2018,9,2
Group 5,RRG,1.5,18,14,3541,13,2018,9,4
Group 5,RRG,1.5,18,14,3542,13,2018,11,2
Group 5,RRG,1.5,18,14,3543,9,2018,10,-1
Group 5,RRG,1.5,18,14,3544,12,2018,14,-2
Group 5,RRG,1.5,18,14,3545,13,2018,9,4
Group 5,RRG,1.5,18,14,3546,11,2018,12,-1
Group 5,RRG,1.5,18,14,3547,11,2018,11,0
Group 5,RRG,1.5,18,14,3548,11,2018,12,-1
Group 5,RRG,1.5,18,14,3549,11,2018,13,-2
Group 5,RRG,1.5,18,14,3550,13,2018,12,1
Group 5,RRG,1.5,18,14,3551,4,2018,7,-3
Group 5,RRG,1.5,18,14,3552,12,2018,10,2
Group 5,RRG,1.5,18,14,3553,14,2018,9,5
Group 5,RRG,1.5,18,14,3554,12,2018,10,2
Group 5,RRG,1.5,18,14,3555,8,2018,11,-3
Group 5,RRG,1.5,18,14,3556,11,2018,12,-1
Group 5,RRG,1.5,18,14,3557,10,2018,8,2
Group 5,RRG,1.5,18,14,3558,12,2018,12,0
Group 5,RRG,1.5,18,14,3559,10,2018,13,-3
Group 5,RRG,1.5,18,14,3560,10,2018,10,0
Group 5,RRG,1.5,18,14,3561,7,2018,8,-1
Group 5,RRG,1.5,18,14,3562,4,2018,7,-3
Group 5,RRG,1.5,18,14,3563,12,2018,8,4
Group 5,RRG,1.5,18,14,3564,12,2018,7,5
Group 5,RRG,1.5,18,14,3565,10,2018,13,-3
Group 5,RRG,1.5,18,14,3566,10,2018,8,2
Group 5,RRG,1.5,18,14,3567,14,2018,13,1
Group 5,RRG,1.5,18,14,3568,14,2018,13,1
Group 5,RRG,1.5,18,14,3569,11,2018,11,0
Group 5,RRG,1.5,18,14,3570,10,2018,7,3
Group 5,RRG,1.5,18,14,3571,12,2018,11,1
Group 5,RRG,1.5,18,14,3572,12,2018,12,0
Group 5,RRG,1.5,18,14,3573,14,2018,12,2
Group 5,RRG,1.5,18,14,3574,14,2018,13,1
Group 5,RRG,1.5,18,14,3575,11,2018,11,0
Group 5,RRG,1.5,18,14,3576,13,2018,11,2
Group 5,RRG,1.5,18,14,3577,13,2018,14,-1
Group 5,RRG,1.5,18,14,3578,10,2018,11,-1
Group 5,RRG,1.5,18,14,3579,12,2018,12,0
Group 5,RRG,1.5,18,14,3580,12,2018,11,1
Group 5,RRG,1.5,18,14,3581,8,2018,9,-1
Group 5,RRG,1.5,18,14,3582,12,2018,12,0
Group 5,RRG,1.5,18,14,3583,13,2018,7,6
Group 5,RRG,1.5,18,14,3584,13,2018,11,2
Group 5,RRG,1.5,18,14,3585,14,2018,14,0
Group 5,RRG,1.5,18,14,3586,13,2018,12,1
Group 5,RRG,1.5,18,14,3587,11,2018,10,1
Group 5,RRG,1.5,18,14,3588,13,2018,13,0
Group 5,RRG,1.5,18,14,3589,12,2018,12,0
Group 5,RRG,1.5,18,14,3590,12,2018,11,1
Group 5,RRG,1.5,18,14,3591,6,2018,12,-6
Group 5,RRG,1.5,18,14,3592,11,2018,10,1
Group 5,RRG,1.5,18,14,3593,12,2018,12,0
Group 5,RRG,1.5,18,14,3594,14,2018,12,2
Group 5,RRG,1.5,18,14,3595,10,2018,10,0
Group 5,RRG,1.5,18,14,3596,13,2018,10,3
Group 5,RRG,1.5,18,14,3597,8,2018,9,-1
Group 5,RRG,1.5,18,14,3598,13,2018,8,5
Group 5,RRG,1.5,18,14,3599,5,2018,13,-8
Group 5,RRG,1.5,18,14,3600,7,2018,12,-5
Group 5,RRG,1.5,18,14,3601,11,2018,13,-2
Group 5,RRG,1.5,18,14,3602,13,2018,11,2
Group 5,RRG,1.5,18,14,3603,13,2018,12,1
Group 5,RRG,1.5,18,14,3604,12,2018,10,2
Group 5,RRG,1.5,18,14,3605,12,2018,11,1
Group 5,RRG,1.5,18,14,3606,13,2018,9,4
Group 5,RRG,1.5,18,14,3607,12,2018,12,0
Group 5,RRG,1.5,18,14,3608,14,2018,9,5
Group 5,RRG,1.5,18,14,3609,13,2018,10,3
Group 5,RRG,1.5,18,14,3610,10,2018,10,0
Group 5,RRG,1.5,18,14,3611,11,2018,13,-2
Group 5,RRG,1.5,18,14,3612,12,2018,14,-2
Group 5,RRG,1.5,18,14,3613,9,2018,10,-1
Group 5,RRG,1.5,18,14,3614,12,2018,12,0
Group 5,RRG,1.5,18,14,3615,14,2018,13,1
Group 5,RRG,1.5,18,14,3616,12,2018,12,0
Group 5,RRG,1.5,18,14,3617,10,2018,12,-2
Group 5,RRG,1.5,18,14,3618,8,2018,12,-4
Group 5,RRG,1.5,18,14,3619,13,2018,11,2
Group 5,RRG,1.5,18,14,3620,11,2018,9,2
Group 5,RRG,1.5,18,14,3621,8,2018,10,-2
Group 5,RRG,1.5,18,14,3622,5,2018,12,-7
Group 5,RRG,1.5,18,14,3623,11,2018,13,-2
Group 5,RRG,1.5,18,14,3624,12,2018,9,3
Group 5,RRG,1.5,18,14,3625,10,2018,13,-3
Group 5,RRG,1.5,18,14,3626,11,2018,13,-2
Group 5,RRG,1.5,18,14,3627,10,2018,12,-2
Group 5,RRG,1.5,18,14,3628,10,2018,13,-3
Group 5,RRG,1.5,18,14,3629,11,2018,10,1
Group 5,RRG,1.5,18,14,3630,10,2018,9,1
Group 5,RRG,1.5,18,14,3631,10,2018,11,-1
Group 5,RRG,1.5,18,14,3632,9,2018,9,0
Group 5,RRG,1.5,18,14,3633,10,2018,11,-1
Group 5,RRG,1.5,18,14,3634,11,2018,9,2
Group 5,RRG,1.5,18,14,3635,14,2018,9,5
Group 5,RRG,1.5,18,14,3636,13,2018,10,3
Group 5,RRG,1.5,18,14,3637,12,2018,10,2
Group 5,RRG,1.5,18,14,3638,14,2018,10,4
Group 5,RRG,1.5,18,14,3639,12,2018,10,2
Group 5,RRG,1.5,18,14,3640,13,2018,10,3
Group 5,RRG,1.5,18,14,3641,11,2018,13,-2
Group 5,RRG,1.5,18,14,3642,13,2018,12,1
Group 5,RRG,1.5,18,14,3643,14,2018,11,3
Group 5,RRG,1.5,18,14,3644,12,2018,11,1
Group 5,RRG,1.5,18,14,3645,13,2018,13,0
Group 5,RRG,1.5,18,14,3646,14,2018,11,3
Group 5,RRG,1.5,18,14,3647,9,2018,12,-3
Group 5,RRG,1.5,18,14,3648,12,2018,13,-1
Group 5,RRG,1.5,18,14,3649,13,2018,13,0
Group 5,RRG,1.5,18,14,3650,13,2018,13,0
Group 5,RRG,1.5,18,14,3651,12,2018,13,-1
Group 5,RRG,1.5,18,14,3652,9,2018,12,-3
Group 5,RRG,1.5,18,14,3653,12,2018,9,3
Group 5,RRG,1.5,18,14,3654,12,2018,13,-1
Group 5,RRG,1.5,18,14,3655,13,2018,12,1
Group 5,RRG,1.5,18,14,3656,7,2018,8,-1
Group 5,RRG,1.5,18,14,3657,11,2018,9,2
Group 5,RRG,1.5,18,14,3658,11,2018,10,1
Group 5,RRG,1.5,18,14,3659,11,2018,11,0
Group 5,RRG,1.5,18,14,3660,13,2018,9,4
Group 5,RRG,1.5,18,14,3661,6,2018,12,-6
Group 5,RRG,1.5,18,14,3662,14,2018,13,1
Group 5,RRG,1.5,18,14,3663,13,2018,8,5
Group 5,RRG,1.5,18,14,3664,14,2018,12,2
Group 5,RRG,1.5,18,14,3665,10,2018,11,-1
Group 5,RRG,1.5,18,14,3666,10,2018,11,-1
Group 5,RRG,1.5,18,14,3667,7,2018,14,-7
Group 5,RRG,1.5,18,14,3668,14,2018,8,6
Group 5,RRG,1.5,18,14,3669,12,2018,8,4
Group 5,RRG,1.5,18,14,3670,12,2018,13,-1
Group 5,RRG,1.5,18,14,3671,12,2018,11,1
Group 5,RRG,1.5,18,14,3672,13,2018,10,3
Group 5,RRG,1.5,18,14,3673,10,2018,13,-3
Group 5,RRG,1.5,18,14,3674,11,2018,10,1
Group 5,RRG,1.5,18,14,3675,12,2018,9,3
Group 5,RRG,1.5,18,14,3676,13,2018,13,0
Group 5,RRG,1.5,18,14,3677,12,2018,7,5
Group 5,RRG,1.5,18,14,3678,10,2018,12,-2
Group 5,RRG,1.5,18,14,3679,12,2018,9,3
Group 5,RRG,1.5,18,14,3680,14,2018,11,3
Group 5,RRG,1.5,18,14,3681,13,2018,7,6
Group 5,RRG,1.5,18,14,3682,13,2018,9,4
Group 5,RRG,1.5,18,14,3683,10,2018,11,-1
Group 5,RRG,1.5,18,14,3684,10,2018,11,-1
Group 5,RRG,1.5,18,14,3685,12,2018,11,1
Group 5,RRG,1.5,18,14,3686,11,2018,12,-1
Group 5,RRG,1.5,18,14,3687,12,2018,10,2
Group 5,RRG,1.5,18,14,3688,14,2018,12,2
Group 5,RRG,1.5,18,14,3689,12,2018,10,2
Group 5,RRG,1.5,18,14,3690,12,2018,10,2
Group 5,RRG,1.5,18,14,3691,10,2018,14,-4
Group 5,RRG,1.5,18,14,3692,13,2018,13,0
Group 5,RRG,1.5,18,14,3693,11,2018,13,-2
Group 5,RRG,1.5,18,14,3694,11,2018,9,2
Group 5,RRG,1.5,18,14,3695,12,2018,9,3
Group 5,RRG,1.5,18,14,3696,12,2018,10,2
Group 5,RRG,1.5,18,14,3697,12,2018,11,1
Group 5,RRG,1.5,18,14,3698,12,2018,12,0
Group 5,RRG,1.5,18,14,3699,11,2018,10,1
Group 5,RRG,1.5,18,14,3700,14,2018,9,5
Group 5,RRG,1.5,18,14,3701,12,2018,9,3
Group 5,RRG,1.5,18,14,3702,13,2018,14,-1
Group 5,RRG,1.5,18,14,3703,11,2018,10,1
Group 5,RRG,1.5,18,14,3704,12,2018,11,1
Group 5,RRG,1.5,18,14,3705,9,2018,10,-1
Group 5,RRG,1.5,18,14,3706,11,2018,9,2
Group 5,RRG,1.5,18,14,3707,12,2018,10,2
Group 5,RRG,1.5,18,14,3708,12,2018,12,0
Group 5,RRG,1.5,18,14,3709,13,2018,10,3
Group 5,RRG,1.5,18,14,3710,11,2018,10,1
Group 5,RRG,1.5,18,14,3711,11,2018,13,-2
Group 5,RRG,1.5,18,14,3712,11,2018,12,-1
Group 5,RRG,1.5,18,14,3713,9,2018,11,-2
Group 5,RRG,1.5,18,14,3714,12,2018,13,-1
Group 5,RRG,1.5,18,14,3715,9,2018,10,-1
Group 5,RRG,1.5,18,14,3716,12,2018,11,1
Group 5,RRG,1.5,18,14,3717,7,2018,11,-4
Group 5,RRG,1.5,18,14,3718,13,2018,12,1
Group 5,RRG,1.5,18,14,3719,8,2018,11,-3
Group 5,RRG,1.5,18,14,3720,6,2018,14,-8
Group 5,RRG,1.5,18,14,3721,11,2018,11,0
Group 5,RRG,1.5,18,14,3722,11,2018,11,0
Group 5,RRG,1.5,18,14,3723,11,2018,9,2
Group 5,RRG,1.5,18,14,3724,11,2018,14,-3
Group 5,RRG,1.5,18,14,3725,14,2018,8,6
Group 5,RRG,1.5,18,14,3726,7,2018,10,-3
Group 5,RRG,1.5,18,14,3727,10,2018,13,-3
Group 5,RRG,1.5,18,14,3728,12,2018,9,3
Group 5,RRG,1.5,18,14,3729,13,2018,10,3
Group 5,RRG,1.5,18,14,3730,12,2018,11,1
Group 5,RRG,1.5,18,14,3731,11,2018,13,-2
Group 5,RRG,1.5,18,14,3732,13,2018,12,1
Group 5,RRG,1.5,18,14,3733,8,2018,10,-2
Group 5,RRG,1.5,18,14,3734,11,2018,11,0
Group 5,RRG,1.5,18,14,3735,8,2018,11,-3
Group 5,RRG,1.5,18,14,3736,13,2018,8,5
Group 5,RRG,1.5,18,14,3737,10,2018,11,-1
Group 5,RRG,1.5,18,14,3738,11,2018,11,0
Group 5,RRG,1.5,18,14,3739,14,2018,11,3
Group 5,RRG,1.5,18,14,3740,11,2018,13,-2
Group 5,RRG,1.5,18,14,3741,9,2018,6,3
Group 5,RRG,1.5,18,14,3742,13,2018,11,2
Group 5,RRG,1.5,18,14,3743,14,2018,10,4
Group 5,RRG,1.5,18,14,3744,13,2018,9,4
Group 5,RRG,1.5,18,14,3745,12,2018,12,0
Group 5,RRG,1.5,18,14,3746,14,2018,13,1
Group 5,RRG,1.5,18,14,3747,13,2018,13,0
Group 5,RRG,1.5,18,14,3748,11,2018,9,2
Group 5,RRG,1.5,18,14,3749,4,2018,10,-6
Group 5,RRG,1.5,18,14,3750,14,2018,13,1
Group 5,RRG,1.5,18,14,3751,10,2018,8,2
Group 5,RRG,1.5,18,14,3752,12,2018,10,2
Group 5,RRG,1.5,18,14,3753,10,2018,7,3
Group 5,RRG,1.5,18,14,3754,13,2018,14,-1
Group 5,RRG,1.5,18,14,3755,9,2018,12,-3
Group 5,RRG,1.5,18,14,3756,11,2018,11,0
Group 5,RRG,1.5,18,14,3757,11,2018,11,0
Group 5,RRG,1.5,18,14,3758,12,2018,11,1
Group 5,RRG,1.5,18,14,3759,13,2018,11,2
Group 5,RRG,1.5,18,14,3760,14,2018,12,2
Group 5,RRG,1.5,18,14,3761,10,2018,13,-3
Group 5,RRG,1.5,18,14,3762,13,2018,13,0
Group 5,RRG,1.5,18,14,3763,11,2018,7,4
Group 5,RRG,1.5,18,14,3764,11,2018,9,2
Group 5,RRG,1.5,18,14,3765,13,2018,6,7
Group 5,RRG,1.5,18,14,3766,9,2018,6,3
Group 5,RRG,1.5,18,14,3767,11,2018,12,-1
Group 5,RRG,1.5,18,14,3768,11,2018,14,-3
Group 5,RRG,1.5,18,14,3769,12,2018,13,-1
Group 5,RRG,1.5,18,14,3770,8,2018,12,-4
Group 5,RRG,1.5,18,14,3771,7,2018,12,-5
Group 5,RRG,1.5,18,14,3772,11,2018,10,1
Group 5,RRG,1.5,18,14,3773,14,2018,12,2
Group 5,RRG,1.5,18,14,3774,14,2018,8,6
Group 5,RRG,1.5,18,14,3775,13,2018,9,4
Group 5,RRG,1.5,18,14,3776,8,2018,12,-4
Group 5,RRG,1.5,18,14,3777,7,2018,10,-3
Group 5,RRG,1.5,18,14,3778,14,2018,9,5
Group 5,RRG,1.5,18,14,3779,9,2018,10,-1
Group 5,RRG,1.5,18,14,3780,14,2018,9,5
Group 5,RRG,1.5,18,14,3781,8,2018,10,-2
Group 5,RRG,1.5,18,14,3782,12,2018,10,2
Group 5,RRG,1.5,18,14,3783,13,2018,13,0
Group 5,RRG,1.5,18,14,3784,10,2018,10,0
Group 5,RRG,1.5,18,14,3785,10,2018,8,2
Group 5,RRG,1.5,18,14,3786,9,2018,9,0
Group 5,RRG,1.5,18,14,3787,14,2018,8,6
Group 5,RRG,1.5,18,14,3788,12,2018,11,1
Group 5,RRG,1.5,18,14,3789,12,2018,12,0
Group 5,RRG,1.5,18,14,3790,12,2018,11,1
Group 5,RRG,1.5,18,14,3791,12,2018,10,2
Group 5,RRG,1.5,18,14,3792,13,2018,14,-1
Group 5,RRG,1.5,18,14,3793,10,2018,11,-1
Group 5,RRG,1.5,18,14,3794,14,2018,12,2
Group 5,RRG,1.5,18,14,3795,11,2018,10,1
Group 5,RRG,1.5,18,14,3796,11,2018,9,2
Group 5,RRG,1.5,18,14,3797,14,2018,10,4
Group 5,RRG,1.5,18,14,3798,14,2018,11,3
Group 5,RRG,1.5,18,14,3799,11,2018,11,0
Group 5,RRG,1.5,18,14,3800,12,2018,13,-1
Group 5,RRG,1.5,18,14,3801,11,2018,10,1
Group 5,RRG,1.5,18,14,3802,12,2018,10,2
Group 5,RRG,1.5,18,14,3803,12,2018,14,-2
Group 5,RRG,1.5,18,14,3804,12,2018,13,-1
Group 5,RRG,1.5,18,14,3805,13,2018,10,3
Group 5,RRG,1.5,18,14,3806,9,2018,8,1
Group 5,RRG,1.5,18,14,3807,12,2018,12,0
Group 5,RRG,1.5,18,14,3808,10,2018,11,-1
Group 5,RRG,1.5,18,14,3809,10,2018,10,0
Group 5,RRG,1.5,18,14,3810,11,2018,12,-1
Group 5,RRG,1.5,18,14,3811,14,2018,10,4
Group 5,RRG,1.5,18,14,3812,12,2018,9,3
Group 5,RRG,1.5,18,14,3813,11,2018,12,-1
Group 5,RRG,1.5,18,14,3814,13,2018,11,2
Group 5,RRG,1.5,18,14,3815,12,2018,9,3
Group 5,RRG,1.5,18,14,3816,13,2018,9,4
Group 5,RRG,1.5,18,14,3817,12,2018,8,4
Group 5,RRG,1.5,18,14,3818,11,2018,7,4
Group 5,RRG,1.5,18,14,3819,14,2018,6,8
Group 5,RRG,1.5,18,14,3820,11,2018,11,0
Group 5,RRG,1.5,18,14,3821,13,2018,11,2
Group 5,RRG,1.5,18,14,3822,9,2018,8,1
Group 5,RRG,1.5,18,14,3823,13,2018,13,0
Group 5,RRG,1.5,18,14,3824,12,2018,11,1
Group 5,RRG,1.5,18,14,3825,13,2018,9,4
Group 5,RRG,1.5,18,14,3826,11,2018,10,1
Group 5,RRG,1.5,18,14,3827,11,2018,8,3
Group 5,RRG,1.5,18,14,3828,11,2018,10,1
Group 5,RRG,1.5,18,14,3829,12,2018,10,2
Group 5,RRG,1.5,18,14,3830,9,2018,11,-2
Group 5,RRG,1.5,18,14,3831,13,2018,9,4
Group 5,RRG,1.5,18,14,3832,10,2018,13,-3
Group 5,RRG,1.5,18,14,3833,12,2018,11,1
Group 5,RRG,1.5,18,14,3834,13,2018,13,0
Group 5,RRG,1.5,18,14,3835,12,2018,12,0
Group 5,RRG,1.5,18,14,3836,12,2018,12,0
Group 5,RRG,1.5,18,14,3837,11,2018,11,0
Group 5,RRG,1.5,18,14,3838,8,2018,11,-3
Group 5,RRG,1.5,18,14,3839,13,2018,13,0
Group 5,RRG,1.5,18,14,3840,14,2018,11,3
Group 5,RRG,1.5,18,14,3841,10,2018,12,-2
Group 5,RRG,1.5,18,14,3842,9,2018,13,-4
Group 5,RRG,1.5,18,14,3843,12,2018,14,-2
Group 5,RRG,1.5,18,14,3844,11,2018,11,0
Group 5,RRG,1.5,18,14,3845,11,2018,12,-1
Group 5,RRG,1.5,18,14,3846,11,2018,11,0
Group 5,RRG,1.5,18,14,3847,12,2018,10,2
Group 5,RRG,1.5,18,14,3848,13,2018,11,2
Group 5,RRG,1.5,18,14,3849,13,2018,11,2
Group 5,RRG,1.5,18,14,3850,14,2018,11,3
Group 5,RRG,1.5,18,14,3851,13,2018,14,-1
Group 5,RRG,1.5,18,14,3852,10,2018,12,-2
Group 5,RRG,1.5,18,14,3853,13,2018,10,3
Group 5,RRG,1.5,18,14,3854,12,2018,11,1
Group 5,RRG,1.5,18,14,3855,12,2018,11,1
Group 5,RRG,1.5,18,14,3856,10,2018,13,-3
Group 5,RRG,1.5,18,14,3857,10,2018,11,-1
Group 5,RRG,1.5,18,14,3858,5,2018,12,-7
Group 5,RRG,1.5,18,14,3859,13,2018,11,2
Group 5,RRG,1.5,18,14,3860,13,2018,9,4
Group 5,RRG,1.5,18,14,3861,13,2018,12,1
Group 5,RRG,1.5,18,14,3862,7,2018,9,-2
Group 5,RRG,1.5,18,14,3863,7,2018,13,-6
Group 5,RRG,1.5,18,14,3864,11,2018,12,-1
Group 5,RRG,1.5,18,14,3865,14,2018,10,4
Group 5,RRG,1.5,18,14,3866,14,2018,12,2
Group 5,RRG,1.5,18,14,3867,13,2018,9,4
Group 5,RRG,1.5,18,14,3868,13,2018,11,2
Group 5,RRG,1.5,18,14,3869,12,2018,12,0
Group 5,RRG,1.5,18,14,3870,9,2018,13,-4
Group 5,RRG,1.5,18,14,3871,10,2018,8,2
Group 5,RRG,1.5,18,14,3872,14,2018,11,3
Group 5,RRG,1.5,18,14,3873,14,2018,10,4
Group 5,RRG,1.5,18,14,3874,14,2018,11,3
Group 5,RRG,1.5,18,14,3875,11,2018,11,0
Group 5,RRG,1.5,18,14,3876,10,2018,7,3
Group 5,RRG,1.5,18,14,3877,12,2018,9,3
Group 5,RRG,1.5,18,14,3878,13,2018,10,3
Group 5,RRG,1.5,18,14,3879,13,2018,13,0
Group 5,RRG,1.5,18,14,3880,9,2018,11,-2
Group 5,RRG,1.5,18,14,3881,7,2018,9,-2
Group 5,RRG,1.5,18,14,3882,13,2018,10,3
Group 5,RRG,1.5,18,14,3883,14,2018,12,2
Group 5,RRG,1.5,18,14,3884,14,2018,11,3
Group 5,RRG,1.5,18,14,3885,9,2018,11,-2
Group 5,RRG,1.5,18,14,3886,14,2018,13,1
Group 5,RRG,1.5,18,14,3887,12,2018,11,1
Group 5,RRG,1.5,18,14,3888,10,2018,10,0
Group 5,RRG,1.5,18,14,3889,9,2018,9,0
Group 5,RRG,1.5,18,14,3890,9,2018,13,-4
Group 5,RRG,1.5,18,14,3891,13,2018,13,0
Group 5,RRG,1.5,18,14,3892,11,2018,13,-2
Group 5,RRG,1.5,18,14,3893,11,2018,6,5
Group 5,RRG,1.5,18,14,3894,12,2018,12,0
Group 5,RRG,1.5,18,14,3895,10,2018,9,1
Group 5,RRG,1.5,18,14,3896,14,2018,8,6
Group 5,RRG,1.5,18,14,3897,11,2018,8,3
Group 5,RRG,1.5,18,14,3898,12,2018,14,-2
Group 5,RRG,1.5,18,14,3899,11,2018,12,-1
Group 5,RRG,1.5,18,14,3900,9,2018,13,-4
Group 5,RRG,1.5,18,14,3901,13,2018,10,3
Group 5,RRG,1.5,18,14,3902,5,2018,13,-8
Group 5,RRG,1.5,18,14,3903,11,2018,12,-1
Group 5,RRG,1.5,18,14,3904,10,2018,13,-3
Group 5,RRG,1.5,18,14,3905,14,2018,12,2
Group 5,RRG,1.5,18,14,3906,9,2018,11,-2
Group 5,RRG,1.5,18,14,3907,8,2018,10,-2
Group 5,RRG,1.5,18,14,3908,12,2018,12,0
Group 5,RRG,1.5,18,14,3909,12,2018,12,0
Group 5,RRG,1.5,18,14,3910,9,2018,9,0
Group 5,RRG,1.5,18,14,3911,14,2018,10,4
Group 5,RRG,1.5,18,14,3912,11,2018,7,4
Group 5,RRG,1.5,18,14,3913,13,2018,12,1
Group 5,RRG,1.5,18,14,3914,11,2018,11,0
Group 5,RRG,1.5,18,14,3915,11,2018,12,-1
Group 5,RRG,1.5,18,14,3916,11,2018,12,-1
Group 5,RRG,1.5,18,14,3917,11,2018,12,-1
Group 5,RRG,1.5,18,14,3918,13,2018,12,1
Group 5,RRG,1.5,18,14,3919,9,2018,12,-3
Group 5,RRG,1.5,18,14,3920,10,2018,11,-1
Group 5,RRG,1.5,18,14,3921,9,2018,9,0
Group 5,RRG,1.5,18,14,3922,9,2018,13,-4
Group 5,RRG,1.5,18,14,3923,10,2018,12,-2
Group 5,RRG,1.5,18,14,3924,13,2018,10,3
Group 5,RRG,1.5,18,14,3925,10,2018,12,-2
Group 5,RRG,1.5,18,14,3926,12,2018,11,1
Group 5,RRG,1.5,18,14,3927,6,2018,12,-6
Group 5,RRG,1.5,18,14,3928,9,2018,9,0
Group 5,RRG,1.5,18,14,3929,13,2018,8,5
Group 5,RRG,1.5,18,14,3930,11,2018,14,-3
Group 5,RRG,1.5,18,14,3931,10,2018,10,0
Group 5,RRG,1.5,18,14,3932,12,2018,8,4
Group 5,RRG,1.5,18,14,3933,13,2018,14,-1
Group 5,RRG,1.5,18,14,3934,12,2018,11,1
Group 5,RRG,1.5,18,14,3935,13,2018,11,2
Group 5,RRG,1.5,18,14,3936,13,2018,7,6
Group 5,RRG,1.5,18,14,3937,13,2018,13,0
Group 5,RRG,1.5,18,14,3938,12,2018,13,-1
Group 5,RRG,1.5,18,14,3939,11,2018,11,0
Group 5,RRG,1.5,18,14,3940,10,2018,10,0
Group 5,RRG,1.5,18,14,3941,13,2018,9,4
Group 5,RRG,1.5,18,14,3942,14,2018,12,2
Group 5,RRG,1.5,18,14,3943,9,2018,10,-1
Group 5,RRG,1.5,18,14,3944,12,2018,12,0
Group 5,RRG,1.5,18,14,3945,13,2018,12,1
Group 5,RRG,1.5,18,14,3946,13,2018,14,-1
Group 5,RRG,1.5,18,14,3947,9,2018,12,-3
Group 5,RRG,1.5,18,14,3948,13,2018,11,2
Group 5,RRG,1.5,18,14,3949,11,2018,12,-1
Group 5,RRG,1.5,18,14,3950,13,2018,10,3
Group 5,RRG,1.5,18,14,3951,12,2018,12,0
Group 5,RRG,1.5,18,14,3952,13,2018,10,3
Group 5,RRG,1.5,18,14,3953,13,2018,10,3
Group 5,RRG,1.5,18,14,3954,10,2018,11,-1
Group 5,RRG,1.5,18,14,3955,13,2018,11,2
Group 5,RRG,1.5,18,14,3956,12,2018,11,1
Group 5,RRG,1.5,18,14,3957,11,2018,13,-2
Group 5,RRG,1.5,18,14,3958,10,2018,13,-3
Group 5,RRG,1.5,18,14,3959,10,2018,12,-2
Group 5,RRG,1.5,18,14,3960,12,2018,12,0
Group 5,RRG,1.5,18,14,3961,14,2018,10,4
Group 5,RRG,1.5,18,14,3962,10,2018,11,-1
Group 5,RRG,1.5,18,14,3963,12,2018,13,-1
Group 5,RRG,1.5,18,14,3964,13,2018,8,5
Group 5,RRG,1.5,18,14,3965,13,2018,12,1
Group 5,RRG,1.5,18,14,3966,13,2018,8,5
Group 5,RRG,1.5,18,14,3967,12,2018,13,-1
Group 5,RRG,1.5,18,14,3968,8,2018,12,-4
Group 5,RRG,1.5,18,14,3969,13,2018,12,1
Group 5,RRG,1.5,18,14,3970,13,2018,9,4
Group 5,RRG,1.5,18,14,3971,11,2018,8,3
Group 5,RRG,1.5,18,14,3972,11,2018,11,0
Group 5,RRG,1.5,18,14,3973,11,2018,12,-1
Group 5,RRG,1.5,18,14,3974,13,2018,11,2
Group 5,RRG,1.5,18,14,3975,12,2018,12,0
Group 5,RRG,1.5,18,14,3976,11,2018,12,-1
Group 5,RRG,1.5,18,14,3977,13,2018,11,2
Group 5,RRG,1.5,18,14,3978,11,2018,10,1
Group 5,RRG,1.5,18,14,3979,12,2018,12,0
Group 5,RRG,1.5,18,14,3980,13,2018,12,1
Group 5,RRG,1.5,18,14,3981,14,2018,11,3
Group 5,RRG,1.5,18,14,3982,13,2018,11,2
Group 5,RRG,1.5,18,14,3983,10,2018,13,-3
Group 5,RRG,1.5,18,14,3984,11,2018,10,1
Group 5,RRG,1.5,18,14,3985,13,2018,11,2
Group 5,RRG,1.5,18,14,3986,12,2018,8,4
Group 5,RRG,1.5,18,14,3987,14,2018,6,8
Group 5,RRG,1.5,18,14,3988,12,2018,7,5
Group 5,RRG,1.5,18,14,3989,12,2018,11,1
Group 5,RRG,1.5,18,14,3990,13,2018,10,3
Group 5,RRG,1.5,18,14,3991,13,2018,12,1
Group 5,RRG,1.5,18,14,3992,13,2018,11,2
Group 5,RRG,1.5,18,14,3993,14,2018,12,2
Group 5,RRG,1.5,18,14,3994,12,2018,9,3
Group 5,RRG,1.5,18,14,3995,10,2018,10,0
Group 5,RRG,1.5,18,14,3996,10,2018,12,-2
Group 5,RRG,1.5,18,14,3997,13,2018,12,1
Group 5,RRG,1.5,18,14,3998,11,2018,13,-2
Group 5,RRG,1.5,18,14,3999,13,2018,12,1
Group 5,RRG,1.5,18,14,4000,13,2018,8,5
